,date,group,title,pm,st,p300s_pm,p300s_st,delta
49590,1597171141,neo,Zwift - 3R Turbocharged Team Race Series - Round 5 (A),Vector Garmin 3s,Tacx Neo 2,456,428,28
49766,1597274991,neo,Zwift - Build Me Up - Pedaling Drills,Garmin Vector 3s,Tacx Neo 2,385,382,3
50144,1597500841,neo,Zwift - OH MY CRIT - Saturday Smash Race (A),Garmin Vector 3s,Tacx Neo 2,428,435,-7
50562,1597775940,neo,Zwift - 3R Turbocharged Team Race Series - Round 6 (A),Garmin Vector 3s,Tacx Neo 2,392,405,-13
50791,1597879789,neo,Austin Driveway Series Criterium ,Garmin Vector 3s,Tacx Neo 2,386,391,-5
51249,1598105642,neo,Zwift - OH MY CRIT - Saturday Smash Race* (A),Garmin Vector 3s,Tacx Neo 2,372,387,-15
51853,1598380741,neo,Zwift - 3R Turbocharged Team Race Series - Bonus Round (A),Vector Garmin 3s,Tacx Neo 2,386,395,-9
52077,1598480215,neo,Three Sisters ZADA Test,Garmin Vector 3s,Tacx Neo 2,441,443,-2
52287,1598571416,neo,Zwift - WTRL Team Time Trial (C),Garmin Vector 3s,Tacx Neo 2,407,410,-3
52505,1598710441,neo,Zwift - OH MY CRIT - Saturday Smash Race* (A),Garmin Vector 3s,Tacx Neo 2,369,386,-17
53146,1599089341,neo,Zwift - Austin Driveway Series Criterium (A),Garmin Vector 3s,Tacx Neo 2,438,445,-7
53212,1599146043,neo,Zwift - OH MY CRIT! - The Double Race 1/2 (A),Garmin Vector 3s,Tacx Neo 2,403,407,-4
53214,1599149041,neo,Zwift - OH MY CRIT! - The Double Race 2/2 (A),Garmin Vector 3s,Tacx Neo 2,355,362,-7
53983,1599588001,neo,Muir And The Mountain,Garmin Vector 3s,Tacx Neo 2,449,455,-6
55849,1600367220,neo,Zwift - Invitational League // Qualifying Race #2 (Men) ,Garmin Vector 3s,Tacx Neo 2,398,400,-2
56418,1600606681,neo,Zwift - Invitational League // Qualifying  Race #3,Garmin Vector 3s,Tacx Neo 2,411,426,-15
56419,1600606681,neo,Zwift - Invitational League // Qualifying  Race #3,Garmin Vector 3s,Tacx Neo 2,411,426,-15
56684,1600711218,neo,Zwift - CRIT Crusher - Z6 Intervals,Garmin Vector 3s,Tacx Neo 2,403,391,12
57046,1600882980,neo,Zwift - DCU powered by Feltet.dk (A),Garmin Vector 3s,Tacx Neo 2,460,474,-14
57372,1600990620,neo,Zwift - Evoq TTT,Garmin Vector 3s,Tacx Neo 2,405,410,-5
58304,1601402358,neo,Zwift - Rhys Howell[CANYON]’s Meetup Cobbled Clim,Garmin Vector 3s,Tacx Neo 2,447,449,-2
58540,1601487840,neo,Zwift - DCU Race,Garmin Vector 3s,Tacx Neo 2,453,458,-5
58780,1601568240,neo,Zwift - OH MY CRIT! - The Double Race 2/2 (A),Garmin Vector 3s,Tacx Neo 2,398,405,-7
60121,1602092643,neo,Zwift - DCU powered by Feltet.dk (A),Garmin Vector 3s,Tacx Neo 2,402,406,-4
60318,1602173041,neo,Zwift - CRIT Crusher - Z2 Cadence Changes,Garmin Vector 3s,Tacx Neo 2,409,418,-9
61306,1602528481,neo,Zwift - Zwift Racing League,Garmin Vector 3s,Tacx Neo 2,453,462,-9
61869,1602694742,neo,Zwift - Warm-Up,Garmin Vector 3,Tacx Neo 2,425,427,-2
62109,1602769658,neo,Zwift - ZA Road Race #1: 4 - 5 w/kg,Garmin Vector 3,Tacx Neo 2,410,424,-14
63138,1603131367,neo,Zwift - Premier Division // Zwift Racing League (men) ,Garmin Vector 3,Tacx Neo 2,448,453,-5
63383,1603205721,neo,Zwift - ZA Road 2020 - Segment Ride #1: Innsbruck Course,Garmin Vector 3,Tacx Neo 2,430,446,-16
63926,1603299541,neo,Zwift - MIDWEEK Autumn Series by SZR (A),Garmin Vector 3,Tacx Neo 2,379,386,-7
65221,1603742337,neo,Zwift - Premier Division // Zwift Racing League (men) (A),Garmin Vector 3,Tacx Neo 2,450,464,-14
66070,1603980541,neo,Zwift - ZA Road - Race #2 (A),Garmin Vector 3,Tacx Neo 2,425,443,-18
66302,1604014761,neo,Zwift - Espresso,Garmin Vector 3,Tacx Neo 2,410,416,-6
67279,1604343600,neo,Zwift - Premier Division // Zwift Racing League (men) (A),Garmin Vector 3,Tacx Neo 2,428,434,-6
69477,1604951882,neo,Zwift - Premier Division // Zwift Racing League (men) (A),Garmin Vector 3,Tacx Neo 2,453,470,-17
70874,1605212494,neo,Zwift Academy Road: Workout 7 | VO2 Development,Garmin Vector 3,Tacx Neo 2T,428,429,-1
72146,1605553201,neo,Zwift - Premier Division // Zwift Racing League (men) (A),Garmin Vector 3,Tacx Neo 2,418,426,-8
72407,1605655296,neo,Zwift - Thomas Thrall &#039;s Meetup - Three Sisters,Garmin Vector 3,Tacx Neo 2T,465,461,4
72777,1605730616,neo,Zwift Academy Road: Workout 8 | Anaerobic Depletion,Garmin Vector 3,Tacx Neo 2T,351,350,1
74742,1606161481,neo,Zwift - Premier Division // Zwift Racing League (men) (A),Garmin Vector 3,Tacx Neo 2,435,443,-8
75593,1606329776,neo,Zwift - DCU – Feltet.dk November series (A),Garmin Vector 3,Tacx Neo 2,439,443,-4
75948,1606406655,neo,Zwift - OH MY CRIT! - The Double Race 1/2 (A),Garmin Vector 3,Tacx Neo 2,381,384,-3
75950,1606410214,neo,Zwift - OH MY CRIT! - The Double Race 2/2 (A),Garmin Vector 3,Tacx Neo 2,399,411,-12
76024,1606415521,neo,Zwift - WTRL NOPINZ WORLD TTT CHAMPIONSHIPS - Zone 6 (C),Garmin Vector 3,Tacx Neo 2,398,398,0
77038,1606582782,neo,Zwift - Cycling Canada Pre-Worlds Showdown Series (A),Garmin Vector 3,Tacx Neo 2,378,380,-2
77729,1606763102,neo,Zwift - Premier Division // Zwift Racing League (men) (A),Garmin Vector 3,Tacx Neo 2,400,404,-4
78713,1606939030,neo,Zwift - Ramp,Garmin Vector 3,Tacx Neo 2T,307,303,4
81084,1607536786,neo,Zwift - MIDWEEK Winter Series by SZR (A),Garmin Vector 3,Tacx Neo 2,416,431,-15
81506,1607616814,neo,Zwift - OH MY CRIT! - The Double Race 1/2 (A),Garmin Vector 3,Tacx Neo 2T,407,401,6
82414,1607786034,neo,Zwift - OH MY CRIT - Saturday Smash Race (A),Garmin Vector 3,Tacx Neo 2T,475,467,8
86566,1608746188,neo,Zwift - MIDWEEK Winter Series by SZR (A),Garmin Vector 3,Tacx Neo 2T,379,372,7
86984,1608826329,neo,Zwift - OH MY CRIT! - The Double Race 1/2 (A),Garmin Vector 3,Tacx Neo 2T,409,402,7
86985,1608829048,neo,Zwift - OH MY CRIT! - The Double Race 2/2 (A),Garmin Vector 3,Tacx Neo 2T,392,382,10
87076,1608833285,neo,Zwift - Vienna,Garmin Vector 3,Tacx Neo 2T,403,397,6
87489,1608995466,neo,Zwift - OH MY CRIT - Saturday Smash Race (A),Garmin Vector 3,Tacx Neo 2T,409,401,8
90371,1609607294,neo,Tacx Neo 2 / Garmin Vector 3,Garmin Vector 3,Tacx Neo 2,335,303,32
90377,1609601291,neo,RGT Dual Recording,Garmin Vector 3,Tacx Neo 2,335,303,32
91869,1609868779,neo,Zwift - Thomas Thrall&#039;s Meetup - Three Sisters,Garmin Vector 3,Tacx Neo 2T,439,431,8
92872,1610035640,neo,Zwift - Oh My Crit 1/2 ,Garmin Vector 3,Tacx Neo 2T,433,426,7
92873,1610039000,neo,Zwift - OH MY CRIT! - The Double Race 2/2 (A),Garmin Vector 3,Tacx Neo 2T,397,393,4
95016,1610391886,neo,Zwift - Premier Division // Zwift Racing League (men) (A),Garmin Vector 3,Tacx Neo 2T,394,394,0
102952,1611601331,neo,Zwift - Premier Division // Zwift Racing League (men) (A),Garmin Vector 3,Tacx Neo 2T,432,428,4
107000,1612210036,neo,Zwift - Premier Division // Zwift Racing League (men) (A),Garmin Vector 3,Tacx Neo 2T,400,396,4
112954,1613069039,neo,Zwift - Watopia,Garmin Vector 3,Tacx Neo 2T,305,303,2
113590,1613155497,neo,Zwift - Movistar Team Challenge // Round 1 (men),Garmin Vector 3,Tacx Neo 2T,430,434,-4
114347,1613244239,neo,ZADA Test (Tacx Neo 2T),Garmin Vector 3,Tacx Neo 2T,365,362,3
6547,1576608978,wahoo,Zwift - WORLDOFFUSION Racing Series (A),Quarq DZero PM,Wahoo Kickr,427,420,7
22930,1586284211,wahoo,Zwift - 3R Spring Loaded Race Series - Round 2of6 (A) - 3rd I think...,Quarq DZero PM to Zwift,Wahoo Kickr to Bolt,410,411,-1
27167,1587617818,wahoo,Zwift - Ramp Test - dual power test,Quarq DZero PM,Wahoo Kickr 18 ,462,459,3
27322,1587657768,wahoo,Zwift - OH CRIT!! - The Double Race - Race 2/2 (A),Quarq DZero PM to Zwift,Wahoo Kickr 18 to Wahoo Bolt,424,408,16
28374,1587837299,wahoo,Crit City Slam // Zwift Classic,Quarq DZero PM to Zwift,Wahoo Kickr 18 to Wahoo Bolt,456,433,23
28460,1588006764,wahoo,Zwift - DBR Wahoo League (A) - 3rd,Quarq DZero PM to Zwift,Wahoo Kickr 18 to Wahoo Bolt,416,405,11
28975,1588153318,wahoo,Zwift - USA Cycling Race League by Indoor Specialist  (A) - 1st :),Quarq DZero PM to Zwift,Wahoo Kickr 18 to Wahoo Bolt,440,425,15
29336,1588223698,wahoo,Zwift - Christopher MCGLINCHEY [VIT] &#039;s Meetup - Three Sisters,Quarq DZero PM to Bolt ANT+,Wahoo Kickr 18 to Zwift ANT+,401,403,-2
30406,1588408787,wahoo,Zwift - Cycling Ireland Zwift League Rd 6 Road to Ruins (A) - 1st :) ,Quarq DZero PM to Bolt ANT+,Wahoo Kickr 18 to Zwift ANT+,456,448,8
30638,1588434441,wahoo,Zwift - YANA Pro/AM Invitiational (A) -2nd :),Quarq DZero PM to Bolt ANT+,Wahoo Kickr 18 to Zwift ANT+,478,473,5
31873,1588703060,wahoo,3R Spring Loaded Race Series - Round 6of6,Quarq DZero PM to Zwift,Wahoo Kickr 18 to Wahoo Bolt,481,468,13
32664,1588876697,wahoo,Zwift - WTRL Team Time Trial (C),Quarq DZero PM to Zwift,Wahoo Kickr 18 to Wahoo Bolt,437,423,14
32907,1589013400,wahoo,Zwift - CIZL Rd 7 – Sean Lynch Memorial (A)2nd- 1st CIZL :) ,Quarq DZero PM to Zwift,Wahoo Kickr 18 to Wahoo Bolt,468,451,17
34041,1589308290,wahoo,3R & Wahoo Ride Real Race Series - Round 1 of 7,Quarq DZero PM to Zwift,Wahoo Kickr 18 to Wahoo Bolt,428,425,3
34240,1589362888,wahoo,Zwift - USA Cycling Race League by Indoor Specialist (A) - 5th,Quarq DZero PM to Zwift,Wahoo Kickr 18 to Wahoo Bolt,445,442,3
34739,1589475973,wahoo,Zwift - WTRL Team Time Trial Premier League (C) - 2nd,Quarq DZero PM to Bolt ANT+,Wahoo Kickr 18 to Wahoo Bolt,442,440,2
35239,1589618488,wahoo,Zwift - Cycling Ireland Zwift League Rd 8 (A) - 1st :),Quarq DZero PM to Zwift,Wahoo Kickr 18 to Wahoo Bolt,455,468,-13
36110,1589912613,wahoo,Zwift - 3R & Wahoo Ride Real Race Series - Round 2 of 7 (A) 2nd - BRUTAL! New 20min power PB ,Quarq DZero PM to Zwift,Wahoo Kickr 18 to Wahoo Bolt,468,471,-3
36682,1590084032,wahoo,Zwift - Tour for All Invitational Race // Men (A),Quarq DZero PM to Zwift,Wahoo Kickr 18 to Wahoo Bolt,505,506,-1
36951,1590195903,wahoo,Mens Tour of the Gila - Stage 1 - WTRL Team Time Trial,Quarq DZero PM to Zwift,Wahoo Kickr 18 to Wahoo Bolt,455,457,-2
37175,1590248775,wahoo,Zwift - MEN&#039;S TOUR OF THE GILA STAGE 2 CIRCUIT RACE (A) - 2nd,Quarq DZero PM to Zwift,Wahoo Kickr 18 to Wahoo Bolt,481,477,4
37427,1590335222,wahoo,"Zwift - MEN&#039;S TOUR OF THE GILA STAGE 3 EPIC KOM QUEEN STAGE (A) - 2nd, 3rd GC & KOM comp :)",Quarq DZero PM to Zwift,Wahoo Kickr 18 to Wahoo Bolt,459,462,-3
37852,1590518058,wahoo,Zwift - 3R & Wahoo Ride Real Race Series - Round 3 of 7 (A) Forgot TT bike for the TT.... new 20 min power though haha! ,Quarq DZero PM to Zwift,Wahoo Kickr 18 to Wahoo Bolt,469,468,1
38348,1590689320,wahoo,Zwift - Tour for All Invitational Race // Men (A) - 3rd,Quarq DZero PM to Zwift,Wahoo Kickr 18 to Wahoo Bolt,468,468,0
38647,1590829001,wahoo,Zwift - Cycling Ireland Zwift League Rd 10 (A) - 1st :) overall wrapped up! :),Quarq DZero PM to Zwift,Wahoo Kickr 18 to Wahoo Bolt,488,489,-1
39117,1591121106,wahoo,Zwift - UNO X CUP powered by DCU & Feltet.dk (A),Quarq DZero PM to Zwift,Wahoo Kickr 18 to Wahoo Bolt,440,441,-1
40547,1591725630,wahoo,Zwift - UNO X CUP powered by DCU & Feltet.dk (A),Quarq DZero PM to Zwift,Wahoo Kickr 18 to Wahoo Bolt,421,421,0
41360,1592038662,wahoo,Zwift - Cycling Ireland Zwift League Rd 12 (A) - 1st :) Thanks CI for a great series ,Quarq DZero PM to Zwift,Wahoo Kickr 18 to Wahoo Bolt,446,437,9
42010,1592332608,wahoo,Zwift - 3R & Wahoo Ride Real Race Series - Round 5 of 7 (A) - 2nd,Quarq DZero PM to Zwift,Wahoo Kickr 18 to Wahoo Bolt,397,384,13
42661,1592608711,wahoo,Zwift - VIRTUAL JOE MARTIN STAGE RACE ITT,Quarq DZero PM to Zwift,Wahoo Kickr 18 to Wahoo Bolt,463,473,-10
42865,1592668429,wahoo,Zwift - VIRTUAL JOE MARTIN STAGE RACE - 3rd,Quarq DZero PM to Zwift,Wahoo Kickr 18 to Wahoo Bolt,450,433,17
42981,1592754307,wahoo,Zwift - VIRTUAL JOE MARTIN STAGE RACE (A),Quarq DZero PM to Zwift,Wahoo Kickr 18 to Wahoo Bolt,436,430,6
43247,1592937407,wahoo,Zwift - 3R & Wahoo Ride Real Race Series - Round 6 of 7 (A),Quarq DZero PM to Zwift,Wahoo Kickr 18 to Wahoo Bolt,478,476,2
43248,1592937407,wahoo,Zwift - 3R & Wahoo Ride Real Race Series - Round 6 of 7 (A),Quarq DZero PM to Zwift,Wahoo Kickr 18 to Wahoo Bolt,478,476,2
44270,1593542038,wahoo,Zwift - 3R & Wahoo Ride Real Race Series - Round 7 of 7 (A) boom :) 1st win in a while!,Quarq DZero PM to Zwift,Wahoo Kickr to Bolt,431,432,-1
46468,1594835354,wahoo,Zwift - USA Cycling Race League by Indoor Specialist (A),Quarq DZero PM to Zwift,Wahoo Kickr 18 to Wahoo Bolt,425,424,1
49948,1597393928,wahoo,Zwift - Off the MAAP Invitational Race // Stage 1 (Men) (A),Quarq DZero PM to Bolt ANT+,Wahoo Kickr 18 to Zwift ANT+,410,423,-13
50863,1597912878,wahoo,Zwift - Off the MAAP Invitational Race // Stage 3 (men) ,Quarq DZero PM to Bolt ANT+,Wahoo Kickr 18 to Zwift ANT+,424,422,2
51698,1598378231,wahoo,Zwift - RHYS HOWELL [CANYON]&#039;s Meetup - Big Foot Hills,Quarq DZero PM to Zwift,Wahoo Kickr 18 to Wahoo Bolt,437,427,10
58195,1601370141,wahoo,Zwift - KISS at Race - Americas AM (A),Quarq DZero PM to Zwift,Wahoo Kickr 18 to Wahoo Bolt,396,383,13
61279,1602527485,wahoo,Zwift - Premier Division // Zwift Racing League (men) ,Quarq DZero PM to Bolt ANT+,Wahoo Kickr 18 to Zwift ANT+,452,444,8
61280,1602527485,wahoo,Zwift - Premier Division // Zwift Racing League (men) ,Quarq DZero PM to Bolt ANT+,Wahoo Kickr 18 to Zwift ANT+,452,444,8
63076,1603129532,wahoo,Zwift - Premier Division // Zwift Racing League (men) ,Quarq DZero PM to Bolt ANT+,Wahoo Kickr 18 to Zwift ANT+,427,421,6
63087,1603129532,wahoo,Zwift - Premier Division // Zwift Racing League (men) ,Quarq DZero PM to Bolt ANT+,Wahoo Kickr 18 to Zwift ANT+,0,0,0
65173,1603741473,wahoo,Zwift - Premier Division // Zwift Racing League (men) (A),Quarq DZero PM to Bolt ANT+,Wahoo Kickr 18 to Zwift ANT+,428,422,6
67265,1604342926,wahoo,Zwift - Premier Division // Zwift Racing League (men) (A),Quarq DZero PM to Bolt ANT+,Wahoo Kickr 18 to Zwift ANT+,435,427,8
69411,1604951019,wahoo,Zwift - Premier Division // Zwift Racing League (men) (A),Quarq DZero PM to Bolt ANT+,Wahoo Kickr 18 to Zwift ANT+,470,468,2
70215,1605114833,neo,Zwift - Ramp Test - Turbo Test,Quarq AXS DZero to Bolt,Tacx Neo 2T - Zwift,342,319,23
70216,1605116746,neo,Zwift - Ramp Test - turbo test,Quarq DZero PM to Bolt ANT+,Tacx Neo 2T - Zwift,357,339,18
72030,1605552386,wahoo,Zwift - Premier Division // Zwift Racing League (men) (A),Quarq DZero PM to Bolt ANT+,Wahoo Kickr 18 to Zwift ANT+,433,426,7
74687,1606160644,wahoo,Zwift - Premier Division // Zwift Racing League (men) (A),Quarq DZero PM to Bolt ANT+,Wahoo Kickr 18 to Zwift ANT+,482,473,9
76774,1606557602,wahoo,Zwift - Cycling Ireland Zwift League Rd 3 (A),Quarq DZero PM to Zwift,Wahoo Kickr 18 to Wahoo Bolt,440,445,-5
77669,1606762138,wahoo,Zwift - Premier Division // Zwift Racing League (men) (A),Quarq DZero PM to Bolt ANT+,Wahoo Kickr 18 to Zwift ANT+,436,432,4
78873,1607000954,neo,Zwift - Watopia - UCI Tacx NEO 2T,Quarq AXS DZero to Bolt,Tacx Neo 2T - Zwift,340,324,16
79245,1607065467,neo,Zwift - Watopia -  Tacx Neo 2T,Quarq AXS DZero to Bolt,Tacx Neo 2T - Zwift,348,337,11
79669,1607162103,neo,Zwift - Cycling Ireland Zwift League Rd 4 (A),Quarq AXS DZero to Bolt,Tacx Neo 2T - Zwift,391,374,17
80358,1607324355,neo,Zwift - Watopia,Quarq AXS DZero to Bolt,Tacx Neo 2T - Zwift,288,277,11
80800,1607451486,neo,Zwift - Watopia,Quarq AXS DZero to Bolt,Tacx Neo 2T - Zwift,258,252,6
82216,1607767148,wahoo,Zwift - Cycling Ireland Zwift League Rd 5 (A) - 1st,Quarq DZero PM to Zwift,Wahoo Kickr 18 to Wahoo Bolt,461,469,-8
83146,1607968448,wahoo,Zwift - 3R Bologna Race - 2 Laps (A),Quarq DZero PM to Zwift,Wahoo Kickr 18 to Wahoo Bolt,456,464,-8
84323,1608224371,wahoo,Zwift - OH MY CRIT! - The Double Race 2/2 (A),Quarq DZero PM to Zwift,Wahoo Kickr 18 to Wahoo Bolt,395,364,31
85863,1608578276,wahoo,Zwift - Team TFC Mad Monday Winter Series (A) - 1st :),Quarq DZero PM to Zwift,Wahoo Kickr 18 to Wahoo Bolt,432,421,11
86145,1608656915,wahoo,Zwift - 3R Volcano KOM After Party Race - 2 laps + climb (40.2km/25mi 286m) (A) - 1st :) ,Quarq DZero PM to Zwift,Wahoo Kickr 18 to Wahoo Bolt,436,439,-3
86361,1608706108,wahoo,Zwift - Christopher McGlinchey&#039;s Meetup - Three Sisters - ZADA Test,Quarq AXS DZero to Bolt,Wahoo Kickr 18 to Zwift ANT+,439,444,-5
87474,1608995430,wahoo,Zwift - OH MY CRIT - Saturday Smash Race (A),Quarq DZero PM to Zwift,Wahoo Kickr 18 to Wahoo Bolt,408,408,0
87695,1609048716,wahoo,Zwift - KISS 100 Race Series - EU (A) - 1st :),Quarq DZero PM to Zwift,Wahoo Kickr 18 to Wahoo Bolt,408,412,-4
88489,1609239514,wahoo,Zwift - KISS Race Series - Americas AM (A),Quarq DZero PM to Zwift,Wahoo Kickr 18 to Wahoo Bolt,373,380,-7
89100,1609350607,wahoo,Zwift - MIDWEEK Winter Series by SZR (A),Quarq DZero PM to Zwift,Wahoo Kickr 18 to Wahoo Bolt,392,399,-7
89520,1609430566,wahoo,Zwift - OH MY CRIT! - The Double Race 1/2 (A),Quarq DZero PM to Zwift,Wahoo Kickr 18 to Wahoo Bolt,443,432,11
89543,1609434106,wahoo,Zwift - OH MY CRIT! - The Double Race 2/2 (A),Quarq DZero PM to Zwift,Wahoo Kickr 18 to Wahoo Bolt,382,382,0
89701,1609484676,wahoo,Zwift - 3R Innsbruckring Race - 33.2km (A),Quarq DZero PM to Bolt ANT+,Wahoo Kickr 18 to Zwift ANT+,390,398,-8
91395,1609790129,wahoo,Zwift - Emily&#039;s Short Mix,Quarq AXS DZero to Bolt,Wahoo Kickr 18 to Zwift ANT+,363,360,3
91788,1609871307,wahoo,Zwift - TDZ Stage 1: Standard Ride,Quarq AXS DZero to Bolt,Wahoo Kickr 18 to Zwift ANT+,332,327,5
92313,1609955621,wahoo,Zwift - MIDWEEK Winter Series by SZR (A),Quarq AXS DZero to Bolt,Wahoo Kickr 18 to Zwift ANT+,399,397,2
92777,1610038479,wahoo,Zwift - OH MY CRIT! - The Double Race 2/2 (A),Quarq AXS DZero to Bolt,Wahoo Kickr 18 to Zwift ANT+,408,404,4
93221,1610088760,wahoo,Zwift - TDZ Stage 1: Longer Ride,Quarq AXS DZero to Bolt,Wahoo Kickr 18 to Zwift ANT+,324,319,5
93679,1610182817,wahoo,Zwift - KRT/KISS 80 km Endurance Ride (B),Quarq AXS DZero to Bolt,Wahoo Kickr 18 to Zwift ANT+,291,300,-9
93696,1610186044,wahoo,Zwift - Cycling Ireland Zwift League Rd 7 (A) - 1st :),Quarq AXS DZero to Bolt,Wahoo Kickr 18 to Zwift ANT+,376,372,4
94981,1610390794,wahoo,Zwift - Premier Division // Zwift Racing League (men) (A),Quarq AXS DZero to Bolt,Wahoo Kickr 18 to Zwift ANT+,380,378,2
96869,1610640785,wahoo,Zwift - OH MY CRIT! - The Double Race 1/2 (A),Quarq AXS DZero to Bolt,Wahoo Kickr 18 to Zwift ANT+,419,425,-6
96891,1610643163,wahoo,Zwift - OH MY CRIT! - The Double Race 2/2 (A),Quarq AXS DZero to Bolt,Wahoo Kickr 18 to Zwift ANT+,385,382,3
97704,1610778356,wahoo,Zwift - XRS Races - The Saturday Classic (A),Quarq AXS DZero to Bolt,Wahoo Kickr 18 to Zwift ANT+,432,432,0
99188,1610997487,wahoo,Zwift - Premier Division // Zwift Racing League (men) (A),Quarq AXS DZero to Bolt,Wahoo Kickr 18 to Zwift ANT+,413,417,-4
100697,1611226597,wahoo,Zwift - KISS Race Series - Americas AM (A),Quarq AXS DZero to Bolt,Wahoo Kickr 18 to Zwift ANT+,392,399,-7
102890,1611600322,wahoo,Zwift - Premier Division // Zwift Racing League (men) (A),Quarq AXS DZero to Bolt,Wahoo Kickr 18 to Zwift ANT+,438,438,0
106888,1612208571,wahoo,Zwift - Premier Division // Zwift Racing League (men) (A),Quarq AXS DZero to Bolt,Wahoo Kickr 18 to Zwift ANT+,405,405,0
110252,1612677352,wahoo,Zwift - KISS 100 Race Series - EU (A),Quarq AXS DZero to Bolt,Wahoo Kickr 18 to Zwift ANT+,439,440,-1
111021,1612810528,wahoo,Zwift - Premier Division // Zwift Racing League (men) (A),Quarq AXS DZero to Bolt,Wahoo Kickr 18 to Zwift ANT+,440,438,2
112857,1613062877,wahoo,Zwift - OH MY CRIT!! - The Double Race 2/2 (A),Quarq AXS DZero to Bolt,Wahoo Kickr 18 to Zwift ANT+,418,417,1
113279,1613112675,wahoo,Zwift - 3R Innsbruckring Race - 33.2km (A),Quarq AXS DZero to Bolt,Wahoo Kickr 18 to Zwift ANT+,375,372,3
115353,1613418454,wahoo,Zwift - Premier Division // Zwift Racing League (men) (A),Quarq AXS DZero to Bolt,Wahoo Kickr 18 to Zwift ANT+,450,449,1
117187,1613667522,wahoo,Zwift - OH MY CRIT!! - The Double Race 2/2 (A),Quarq AXS DZero to Bolt,Wahoo Kickr 18 to Zwift ANT+,437,433,4
119100,1614020104,wahoo,Zwift - Premier Division // Zwift Racing League (men) (A),Quarq AXS DZero to Bolt,Wahoo Kickr 18 to Zwift ANT+,406,406,0
120705,1614272475,wahoo,Zwift - OH MY CRIT!! - The Double Race 2/2 (A),Quarq AXS DZero to Bolt,Wahoo Kickr 18 to Zwift ANT+,402,397,5
121393,1614407193,wahoo,Zwift - XRS Races - The Saturday Classic (A),2021-02-27-062633-ELEMNT BOLT 6D8D-197-0,Wahoo Kickr 18 to Zwift ANT+,0,0,0
121394,1614407193,wahoo,Zwift - XRS Races - The Saturday Classic (A),Quarq AXS DZero to Bolt,Wahoo Kickr 18 to Zwift ANT+,433,432,1
122571,1614628911,wahoo,Zwift - Premier Division // Zwift Racing League (men) (A),Quarq AXS DZero to Bolt,Wahoo Kickr 18 to Zwift ANT+,447,454,-7
123962,1614874076,wahoo,OH MY CRIT!! - The Double Race 1/2,Quarq AXS DZero to Bolt,Wahoo Kickr 18 to Zwift ANT+,413,416,-3
123986,1614876578,wahoo,Zwift - OH MY CRIT!! - The Double Race 2/2 (A),Quarq AXS DZero to Bolt,Wahoo Kickr 18 to Zwift ANT+,405,403,2
127001,1615481178,wahoo,Zwift - OH MY CRIT!! - The Double Race 2/2 (A),Quarq AXS DZero to Bolt,Wahoo Kickr 18 to Zwift ANT+,410,408,2
129129,1615919196,wahoo,Zwift - CeramicSpeed Race Series: Open Race (A),Quarq AXS DZero to Bolt,Wahoo Kickr 18 to Zwift ANT+,438,435,3
75293,1606270686,neo,Zwift - Watopia,Assioma Duo (Comparison),UCI Tacx Neo 2T (Zwift),210,207,3
67633,1604391827,wahoo,Zwift - Zwift Racing League | WTRL - Men&#039;s EMEA E1 DIVISION 1 (A) TTT 3rd,2020-11-03-082347-ELEMNT_BOLT_95CD-329-0[1],Wahoo kickr,254,412,-158
67647,1604428390,wahoo,Zwift - Zwift Racing League | WTRL - Men&#039;s EMEA E1 DIVISION 1 (A) TTT 3rd,stages,Wahoo kickr,400,412,-12
70263,1605032097,wahoo,Zwift - Zwift Racing League | WTRL - EMEA E1 (MEN) -  Division 1 (A) 7th,stages,Wahoo kickr,418,439,-21
70897,1605207598,wahoo,Zwift -  Flanders The BZR Ronde  (A) 1st,stages,Wahoo kickr,434,442,-8
71067,1605269996,neo,Zwift - Peak-PTY Climb Challenge Fridays (A) 1st,stages,Tacx NEO 2t,378,393,-15
73350,1605812394,neo,Zwift -  Flanders The BZR Ronde  (A) ,stages,Tacx NEO 2t,413,423,-10
73599,1605896991,neo,Zwift - Team WEZ Friday Race,stages,Tacx NEO 2t,467,482,-15
73886,1605971717,neo,Zwift - OH MY CRIT - Saturday Smash Race (A) ,stages,Tacx NEO 2t,357,369,-12
76571,1606501680,neo,Zwift - Team WEZ Friday Race (E),stages,Tacx NEO 2t,417,428,-11
77006,1606576435,neo,Zwift - OH MY CRIT - Saturday Smash Race (A),stages,Tacx NEO 2t,421,432,-11
77007,1606576435,neo,Zwift - OH MY CRIT - Saturday Smash Race (A),stages,Tacx NEO 2t,421,432,-11
79262,1607021703,neo,Zwift - BENELIGA 2020-2021 (E),stages,Tacx NEO 2t,422,430,-8
79505,1607106381,neo,Zwift - Team WEZ Friday Race (E),stages,Tacx NEO 2t,400,410,-10
81746,1607626648,neo,Zwift - BENELIGA 2020-2021 (E),stages,Tacx NEO 2t,424,434,-10
82056,1607711127,neo,Zwift - Team WEZ Friday Race (E),stages,Tacx NEO 2t,458,468,-10
84445,1608231524,neo,Zwift - BENELIGA 2020-2021 (E) ,stages,Tacx NEO 2t,422,440,-18
84817,1608316094,neo,Zwift - Team WEZ Friday Race (E),stages,Tacx NEO 2t,373,391,-18
85132,1608390793,neo,Zwift - OH MY CRIT - Saturday Smash Race (A) ,stages,Tacx NEO 2t,433,448,-15
85916,1608578306,neo,Zwift - Team TFC Mad Monday Winter Series (A),stages,Tacx NEO 2t,412,422,-10
86054,1608634751,neo,Zwift - KISS Race Series - Americas AM (A),stages,Tacx NEO 2t,430,441,-11
87490,1608995568,neo,Zwift - OH MY CRIT - Saturday Smash Race (A),stages,Tacx NEO 2t,411,421,-10
87890,1609078185,neo,Zwift - KISS 100 Race Series - Americas (A),stages,Tacx NEO 2t,391,395,-4
88310,1609183035,neo,Zwift - Team TFC Mad Monday Winter Series (A),stages,Tacx NEO 2t,409,405,4
88532,1609239576,neo,Zwift - KISS Race Series - Americas AM (A) ,stages,Tacx NEO 2t,389,387,2
89118,1609350908,neo,Zwift - MIDWEEK Winter Series by SZR (A),stages,Tacx NEO 2t,394,397,-3
89849,1609506616,neo,Zwift - BMTR New Year&#039;s Day 100 - Riding For Alzheimer&#039;s (A),stages,Tacx NEO 2t,265,281,-16
90161,1609579644,neo,Zwift - DBR SufferDay League III (A),stages,Tacx NEO 2t,425,438,-13
90872,1609683175,neo,Zwift - KISS 100 Race Series - Americas (A) ,stages,Tacx NEO 2t,343,345,-2
91619,1609844363,neo,Zwift - KISS Race Series - Americas AM (A),stages,Tacx NEO 2t,423,433,-10
92340,1609955784,neo,Zwift - MIDWEEK Winter Series by SZR (A),stages,Tacx NEO 2t,408,415,-7
93650,1610045676,neo,Zwift - BENELIGA 2020-2021 (E) ,stages,Tacx NEO 2t,419,426,-7
94494,1610287847,neo,Zwift - KISS 100 Race Series - Americas (A),stages,Tacx NEO 2t,411,415,-4
95047,1610392627,neo,Zwift - Team TFC Mad Monday Winter Series (A) ,stages,Tacx NEO 2t,456,469,-13
95640,1610474876,neo,Zwift - Zwift Racing League | WTRL - Men&#039;s/Mixed EMEA E1 DIVISION 1 (A),stages,Tacx NEO 2t,442,458,-16
97296,1610650553,neo,Zwift - BENELIGA 2020-2021 (E),stages,Tacx NEO 2t,418,431,-13
97486,1610730256,neo,Bologna TT,stages,Tacx NEO 2t,446,459,-13
98115,1610814544,neo,Zwift - TEAM VEGAN Tofu Tornado (A) 1st,stages,Tacx NEO 2t,446,456,-10
99038,1610993573,wahoo,Zwift -  DBR Monday Race (A),Stages 2nd PM,Wahoo kickr,369,370,-1
99682,1611080412,wahoo,Zwift - Zwift Racing League | WTRL - Men&#039;s/Mixed EMEA E1 DIVISION 1 (A),Stages 2nd PM,Wahoo kickr,396,397,-1
105833,1611255484,neo,Zwift - BENELIGA 2020-2021 (E),stages,Tacx NEO 2t,372,386,-14
106281,1612102441,wahoo,Zwift - KISS 100 Race Series - Americas (A) 31 jan,Stages 2nd PM,Wahoo kickr,393,395,-2
106766,1612203169,neo,Zwift -  DBR Monday Race (A),stages,Tacx NEO 2t,414,430,-16
107382,1612289385,neo,Zwift - Zwift Racing League | WTRL - Men&#039;s/Mixed EMEA E1 DIVISION 1 (A) ,stages,Tacx NEO 2t,387,395,-8
108315,1612378549,neo,Zwift - Open - Movistar Team Challenge Community Qualifier Race,stages,Tacx NEO 2t,396,404,-8
108988,1612464710,neo,Zwift - BENELIGA 2020-2021 (E),stages,Tacx NEO 2t,406,419,-13
109950,1612624462,neo,Zwift - OH MY CRIT!! - Saturday Smash Race (A),stages,Tacx NEO 2t,428,442,-14
110510,1612707105,neo,Zwift - KISS 100 Race Series - Americas (A),stages,Tacx NEO 2t,397,408,-11
111594,1612895082,neo,Zwift - Zwift Racing League | WTRL - Men&#039;s/Mixed EMEA E1 DIVISION 1 (A),stages,Tacx NEO 2t,412,418,-6
112258,1612979905,neo,Zwift - MIDWEEK Winter Series by SZR (A),stages,Tacx NEO 2t,456,461,-5
113297,1613069889,wahoo,2021/02/11 20:00 : Zwift - BENELIGA 2020-2021 (E),stages,Wahoo kickr core 5 BENELIGA studio,466,466,0
114175,1613229045,neo,Zwift - OH MY CRIT!! - Saturday Smash Race (A),stages,Tacx NEO 2t,461,462,-1
114818,1613312116,neo,Zwift - KISS 100 Race Series - Americas (A),stages,Tacx NEO 2t,418,422,-4
115864,1613499053,neo,Zwift - Zwift Racing League | WTRL - Men&#039;s/Mixed EMEA E1 DIVISION 1 (A),stages,Tacx NEO 2t,434,443,-9
118281,1613834080,neo,Zwift - OH MY CRIT!! - Saturday Smash Race (A) ,stages,Tacx NEO 2t,432,431,1
119598,1614103979,neo,Zwift - Zwift Racing League | WTRL - Men&#039;s/Mixed EMEA E1 DIVISION 1 (A) ,stages,Tacx NEO 2t,374,381,-7
121243,1614364030,neo,Zwift - KIRCHMAIR Race Series (A),stages,Tacx NEO 2t,399,401,-2
122124,1614521631,neo,Zwift - KISS 100 Race Series - Americas (A),stages,Tacx NEO 2t,422,408,14
124113,1614884336,neo,Zwift - Flanders The BZR Ronde Spring Classics League (A),stages,Tacx NEO 2t,365,360,5
125173,1615060266,neo,Zwift - Zwift Racing League | WTRL Battle Royale Playoff - Men&#039;s TTT (A),stages,Tacx NEO 2t,427,425,2
125815,1615227126,neo,Zwift -  DBR Monday Race (A),stages,Tacx NEO 2t,426,429,-3
126050,1615287390,neo,Zwift - KISS Race Series - Americas AM (A),stages,Tacx NEO 2t,424,434,-10
127034,1615478982,neo,Zwift - OH MY CRIT!! - The Double Race1/2 (A),stages,Tacx NEO 2t,404,398,6
127451,1615556909,neo,Zwift - KISS Race Series - Pacific AM (A),stages,Tacx NEO 2t,424,423,1
81412,1607523302,neo,Zwift - Men&#039;s Elite // 2020 UCI Cycling Esports World Championships,Power2Max,Tacx Neo 2T,416,405,11
95069,1610390355,wahoo,Zwift - Premier Division // Zwift Racing League (men) (A),Trainer To Zwift,Quarq to Wahoo,399,411,-12
96500,1610560478,wahoo,Zwift - MIDWEEK Winter Series by SZR (A),Trainer To Zwift,Quarq to Wahoo,405,403,2
99295,1610997816,wahoo,Zwift - Premier Division // Zwift Racing League (men) (A),Trainer To Zwift,Quarq to Wahoo,401,403,-2
102971,1611601495,wahoo,Zwift - Premier Division // Zwift Racing League (men) (A),Trainer To Zwift,Quarq to Wahoo,417,428,-11
106962,1612210015,wahoo,Zwift - Premier Division // Zwift Racing League (men) (A),Trainer To Zwift,Quarq to Wahoo,417,421,-4
111078,1612812241,wahoo,Zwift - Premier Division // Zwift Racing League (men) (A),Trainer To Zwift,Quarq to Wahoo,425,431,-6
115415,1613419314,wahoo,Zwift - Premier Division // Zwift Racing League (men) (A),Trainer To Zwift,Quarq to Wahoo,425,422,3
119142,1614020992,wahoo,Zwift - Premier Division // Zwift Racing League (men) (A),Trainer To Zwift,Quarq to Wahoo,379,377,2
122654,1614630026,wahoo,Zwift - Premier Division // Zwift Racing League (men) (A),Trainer To Zwift,Quarq to Wahoo,417,411,6
109402,1612549796,wahoo,Zwift - KIRCHMAIR Race Series (A),4IIII,Wahoo Kickr,409,394,15
110872,1612793692,wahoo,Zwift - 3R Classique Reverse Flat Race - 5 Laps (32km/20.1mi 76m) (A),4IIII,Wahoo Kickr,372,377,-5
112875,1613059977,wahoo,Zwift - OH MY CRIT!! - The Double Race 1/2 (A),4IIII,Wahoo Kickr,393,390,3
114224,1613229112,wahoo,Zwift - OH MY CRIT!! - Saturday Smash Race (A),4IIII,Wahoo Kickr,403,388,15
122012,1614506391,wahoo,Zwift - DBR Sunday Race (A),4IIII,Wahoo Kickr,357,354,3
122013,1614510261,wahoo,Zwift - 3R Innsbruckring Sprint Race - 1 Lap (8.8km/5.5mi 77m) (A),4IIII,Wahoo Kickr,373,373,0
123021,1614710956,wahoo,Zwift - Team Italy & Frenchy Fuzion League (A),4IIII,Wahoo Kickr,444,455,-11
123402,1614770143,wahoo,Zwift - 3R Volcano Circuit Flat Race - 6 Laps (27km/16.8mi 120m) (A),4IIII,Wahoo Kickr,376,378,-2
123942,1614868679,wahoo,Zwift - Team Italy Specialissima Race (A),4IIII,Wahoo Kickr,351,351,0
51885,1598380807,wahoo,Zwift - 3R Turbocharged Team Race Series - Bonus Round (A),Quarq AXS to ZWIFT,KICKR 2020 via Wahoo App,347,330,17
52027,1598461192,wahoo,Zwift - MIDWEEK Summer Series by SZR (A),Quarq DUB (Zwift),KICKR V5 2020 (Wahoo App),346,327,19
52507,1598710494,wahoo,Zwift - OH MY CRIT - Saturday Smash Race* (A),Quarq DUB (Zwift),KICKR V5 2020 (Wahoo App),327,310,17
53652,1599398094,wahoo,Zwift - KISS at Race 100 - Americas (A),Quarq DUB (Zwift),KICKR V5 2020 (Wahoo App),379,370,9
53769,1599502792,wahoo,Zwift - TFC Mad Monday Summer Series (10 of 10) (A),Quarq DUB (Zwift),KICKR V5 2020 (Wahoo App),371,351,20
54370,1599753895,wahoo,Zwift - OH MY CRIT! - The Double Race 2/2 (A),Quarq DUB (Zwift),KICKR V5 2020 (Wahoo App),339,327,12
54847,1599991794,wahoo,Zwift - 3R Sand & Sequoias - 1 Lap (20km/12.5mi 173m) (A),KICKR v5 2020 (Zwift),Quarq DUB (Wahoo App),326,334,-8
55071,1600106392,wahoo,Zwift - Invitational League // Qualifying Race #1,KICKR v5 2020 (Zwift),Quarq DUB (Wahoo App),353,380,-27
55990,1600367394,wahoo,Zwift - Invitational League // Qualifying Race #2 (Men) ,KICKR v5 2020 (Zwift),Quarq DUB (Wahoo App),348,361,-13
56698,1600708503,wahoo,Zwift - DBR Ride´N´Roll League (A),Quarq DUB (Zwift),KICKR V5 2020 (Wahoo App),323,323,0
56699,1600712391,wahoo,Zwift - TFC Mad Monday Autumn Series (A),Quarq DUB (Zwift),KICKR V5 2020 (Wahoo App),374,369,5
58509,1601485192,wahoo,Zwift - MIDWEEK Autumn Series by SZR (A),Quarq DUB (Zwift),KICKR V5 2020 (Wahoo App),337,314,23
60103,1602089994,wahoo,Zwift - MIDWEEK Autumn Series by SZR (A),Quarq DUB (Zwift),KICKR V5 2020 (Wahoo App),358,345,13
60311,1602170091,wahoo,Zwift - OH MY CRIT! - The Double Race 1/2 (A),Quarq DUB (Zwift),KICKR V5 2020 (Wahoo App),341,325,16
60313,1602173087,wahoo,Zwift - OH MY CRIT! - The Double Race 2/2 (A),Quarq DUB (Zwift),KICKR V5 2020 (Wahoo App),357,341,16
61612,1602614693,wahoo,Zwift - Zwift Racing League | WTRL,Quarq DUB (Zwift),KICKR V5 2020 (Wahoo App),358,337,21
61931,1602694792,wahoo,Zwift - MIDWEEK Autumn Series by SZR (A),Quarq DUB (Zwift),KICKR V5 2020 (Wahoo App),366,337,29
62123,1602777892,wahoo,Zwift - OH MY CRIT! - The Double Race 2/2 (A),Quarq DUB (Zwift),KICKR V5 2020 (Wahoo App),346,329,17
62630,1602944095,wahoo,Zwift - OH MY CRIT - Saturday Smash Race (A),Quarq DUB (Zwift),KICKR V5 2020 (Wahoo App),339,326,13
66092,1603991092,wahoo,Zwift - OH MY CRIT! - The Double Race 2/2 (A),Quarq AXS (Zwift),KICKR V5 2020 (Wahoo App),342,322,20
66969,1604236492,wahoo,Zwift - KISS at Race 100 - Americas (A),Quarq DUB (Zwift),KICKR V5 2020 (Wahoo App),323,317,6
70255,1605117594,wahoo,Zwift - MIDWEEK Autumn Series by SZR (A),Quarq DUB (Zwift),KICKR V5 2020 (Wahoo App),341,304,37
71268,1605347988,wahoo,Zwift - Cycling Ireland Zwift League Rd 1 (A),Quarq DUB (Zwift),KICKR V5 2020 (Wahoo App),335,327,8
71679,1605449696,wahoo,Zwift - KISS 100 Race Series - Americas (A),Quarq DUB (Zwift),KICKR V5 2020 (Wahoo App),299,277,22
72630,1605722393,wahoo,Zwift - MIDWEEK Autumn Series by SZR (A),Quarq DUB (Zwift),KICKR V5 2020 (Wahoo App),361,355,6
73765,1605952793,wahoo,Zwift - Cycling Ireland Zwift League Rd 2,Quarq DUB (Zwift),KICKR V5 2020 (Wahoo App),341,327,14
75517,1606327193,wahoo,Zwift - MIDWEEK Autumn Series by SZR (A),Quarq DUB (Zwift),KICKR V5 2020 (Wahoo App),347,333,14
76775,1606557593,wahoo,Zwift - Cycling Ireland Zwift League Rd 3 (A),Quarq DUB (Zwift),KICKR V5 2020 (Wahoo App),344,337,7
84291,1608221688,wahoo,Zwift - OH MY CRIT! - The Double Race 1/2 (A),Quarq DUB (Zwift),KICKR V5 2020 (Wahoo App),371,337,34
84415,1608231574,wahoo,Zwift - Cycling Ireland Zwift Social Ride (D),Quarq DUB (Zwift),KICKR V5 2020 (Wahoo App),163,158,5
84745,1608309795,wahoo,Zwift - Watopia,Quarq DUB (Zwift),KICKR V5 2020 (Wahoo App),207,203,4
84803,1608313984,wahoo,Zwift - Watopia,Quarq DUB (Zwift),KICKR V5 2020 (Wahoo App),210,206,4
86195,1608663288,wahoo,Zwift - Team Italy & Frenchy Fuzion League (A),Quarq DUB (Zwift),KICKR V5 2020 (Wahoo App),391,354,37
86617,1608751490,wahoo,Zwift - Watopia,KICKR v5 2020 (Zwift),Quarq DUB (Wahoo App),200,205,-5
86936,1608816896,wahoo,Zwift - Crit City Race (A),Quarq DUB (Zwift),KICKR V5 2020 (Wahoo App),356,325,31
89569,1609434298,wahoo,Wifi took a day OFF - Zwift - OH MY CRIT! - The Double Race 2/2 (A),Quarq DUB (Zwift),KICKR V5 2020 (Wahoo App),359,355,4
91604,1609844392,wahoo,Zwift - KISS Race Series - Americas AM (A),Quarq DUB (Zwift),KICKR V5 2020 (Wahoo App),387,384,3
91848,1609873171,wahoo,Zwift - SST (Mixed Cadence),Quarq DUB (Zwift),KICKR V5 2020 (Wahoo App),266,266,0
92309,1609955991,wahoo,Quarq DUB (Zwift) / KICKR V5 2020 (Wahoo App),Quarq DUB (Zwift),KICKR V5 2020 (Wahoo App),347,325,22
92743,1610036087,wahoo,Zwift - OH MY CRIT! - The Double Race 1/2 (A),Quarq DUB (Zwift),KICKR V5 2020 (Wahoo App),358,343,15
92770,1610039105,wahoo,Zwift - OH MY CRIT! - The Double Race 2/2 (A),Quarq DUB (Zwift),KICKR V5 2020 (Wahoo App),352,345,7
96355,1610560794,wahoo,Zwift - MIDWEEK Winter Series by SZR (A),Quarq DUB (Zwift),KICKR V5 2020 (Wahoo App),371,355,16
96867,1610640893,wahoo,Zwift - OH MY CRIT! - The Double Race 1/2 (A),Quarq DUB (Zwift),KICKR V5 2020 (Wahoo App),356,347,9
96892,1610643894,wahoo,Zwift - OH MY CRIT! - The Double Race 2/2 (A),Quarq DUB (Zwift),KICKR V5 2020 (Wahoo App),348,337,11
100325,1611168249,wahoo,Zwift - Danmarks Cykle Union & Partners 2/6 (A),Quarq DUB (Zwift),KICKR V5 2020 (Wahoo App),384,384,0
100807,1611245692,wahoo,Zwift - OH MY CRIT! - The Double Race 1/2 (A),Quarq DUB (Zwift),KICKR V5 2020 (Wahoo App),364,357,7
100843,1611248692,wahoo,Zwift - OH MY CRIT! - The Double Race 2/2 (A),Quarq DUB (Zwift),KICKR V5 2020 (Wahoo App),368,366,2
101919,1611414896,wahoo,Zwift - OH MY CRIT!! - Saturday Smash Race (A),Quarq DUB (Zwift),KICKR V5 2020 (Wahoo App),365,365,0
104575,1611850498,wahoo,Zwift - OH MY CRIT!! - The Double Race 1/2 (A),Quarq DUB (Zwift),KICKR V5 2020 (Wahoo App),367,350,17
104599,1611853498,wahoo,Zwift - OH MY CRIT!! - The Double Race 2/2 (A),Quarq DUB (Zwift),KICKR V5 2020 (Wahoo App),353,338,15
65877,1603911884,wahoo,Zwift - DBR HEINO CUP III (A),Garmin Vector 3,kickr wahoo,391,395,-4
66361,1604052300,wahoo,Zwift - 3R Innsbruckring Flat Race - 4 Laps (35.2km/21.9mi 308m) (A),Mittagsradfahrt,kickr wahoo,419,430,-11
66590,1604136600,wahoo,Zwift - DBR Saturday Race (A),Garmin Vector 3,kickr wahoo,411,420,-9
66990,1604238301,wahoo,Zwift - La Bicicletta Toronto & Toronto Hustle Donut Race (A),Garmin Vector 3,kickr wahoo,444,469,-25
67513,1604401206,wahoo,Zwift - KISS at Race - Americas AM (A),Garmin Vector 3,kickr wahoo,379,378,1
69384,1604949601,wahoo,Zwift - TFC Mad Monday Autumn Series (A),Garmin Vector 3,kickr wahoo,375,385,-10
70271,1605121501,wahoo,Zwift - DBR HEINO CUP III (A),Garmin Vector 3,kickr wahoo,344,368,-24
70637,1605197718,wahoo,Zwift - OH MY CRIT! - The Double Race 1/2 (A),Garmin Vector 3,kickr wahoo,403,429,-26
71269,1605344707,wahoo,Zwift - e-liga | eCycling league Austria Race 1 (A),Garmin Vector 3,kickr wahoo,418,417,1
71959,1605561306,wahoo,Zwift - 3R Watopia Flat Route Race - 3 Laps (30.8km/19.1mi 162m) (A),Garmin Vector 3,kickr wahoo,380,403,-23
72247,1605637530,wahoo,Zwift - Zwift Racing League | WTRL - Men&#039;s EMEA E1 DIVISION 1 (A),Garmin Vector 3,kickr wahoo,414,434,-20
72985,1605802519,wahoo,Zwift - OH MY CRIT! - The Double Race 1/2 (A),Garmin Vector 3,kickr wahoo,384,405,-21
73021,1605805516,wahoo,Zwift - OH MY CRIT! - The Double Race 2/2 (A),Garmin Vector 3,kickr wahoo,367,382,-15
75532,1606327203,wahoo,Zwift - MIDWEEK Autumn Series by SZR (A),Garmin Vector 3,kickr wahoo,409,416,-7
76176,1606420092,wahoo,Zwift - WTRL NOPINZ WORLD TTT CHAMPIONSHIPS - Zone 10 (C),Garmin Vector 3,kickr wahoo,421,424,-3
76731,1606554320,wahoo,Zwift - e-liga | eCycling league Austria Race 2 (A),Garmin Vector 3,kickr wahoo,411,412,-1
77336,1606659323,wahoo,Zwift - KISS 100 Race Series - Americas (A),Garmin Vector 3,kickr wahoo,353,357,-4
78031,1606847131,wahoo,Zwift - Zwift Racing League | WTRL - Men&#039;s EMEA E1 DIVISION 1 (A),Garmin Vector 3,kickr wahoo,404,429,-25
78923,1607015115,wahoo,Zwift - OH MY CRIT! - The Double Race 2/2 (A),Garmin Vector 3,kickr wahoo,389,407,-18
79793,1607181315,wahoo,Zwift - OH MY CRIT - Saturday Smash Race (A),Garmin Vector 3,kickr wahoo,397,417,-20
80781,1607451301,wahoo,Zwift - Zwift Racing League | WTRL - Men&#039;s EMEA E1 DIVISION 1 (A),Garmin Vector 3,kickr wahoo,446,449,-3
82895,1607868000,wahoo,Zwift - Zwift Fondo Series 2020/21 (A),Garmin Vector 3,kickr wahoo,413,407,6
85781,1608571806,wahoo,Zwift - ZHQ FutureWorks Circuit Race - Anti-sandbagging (A),Garmin Vector 3,kickr wahoo,375,384,-9
87241,1608921011,wahoo,Zwift - KIRCHMAIR Race Series (A),Garmin Vector 3,kickr wahoo,344,342,2
87866,1609082724,wahoo,Zwift - 3R Watopia 65km Race - 6 laps (40mi 324m) (A),Garmin Vector 3,kickr wahoo,417,412,5
90821,1609687518,wahoo,Zwift - 3R Watopia 65km Race - 6 laps (40mi 324m) (A),Garmin Vector 3,kickr wahoo,391,408,-17
93923,1610205311,wahoo,Zwift - OH MY CRIT - Saturday Smash Race (A),Garmin Vector 3,kickr wahoo,383,400,-17
94459,1610288105,wahoo,Zwift - KISS 100 Race Series - Americas (A),Garmin Vector 3,kickr wahoo,434,427,7
94974,1610392504,wahoo,Zwift - Premier Division // Zwift Racing League (men) (A),Garmin Vector 3,kickr wahoo,431,407,24
96354,1610560808,wahoo,Zwift - MIDWEEK Winter Series by SZR (A),Garmin Vector 3,kickr wahoo,430,435,-5
97792,1610787909,wahoo,Zwift - e-liga | eCycling league Austria Race 4 (A),Garmin Vector 3,kickr wahoo,457,477,-20
100313,1611168301,wahoo,Zwift - Danmarks Cykle Union & Partners 2/6 (A),Garmin Vector 3,kickr wahoo,442,442,0
101667,1611392704,wahoo,Zwift - e-liga | eCycling league Austria Race 5 (A),Garmin Vector 3,kickr wahoo,433,440,-7
102900,1611601500,wahoo,Zwift - Premier Division // Zwift Racing League (men) (A),Garmin Vector 3,kickr wahoo,410,423,-13
104113,1611770407,wahoo,Zwift - MIDWEEK Winter Series by SZR (A),Garmin Vector 3,kickr wahoo,370,382,-12
104576,1611850511,wahoo,Zwift - OH MY CRIT!! - The Double Race 1/2 (A),Garmin Vector 3,kickr wahoo,382,398,-16
105736,1612026003,wahoo,Zwift - GCA Liga 2021 #1,Garmin Vector 3,kickr wahoo,430,434,-4
106881,1612210012,wahoo,Zwift - Premier Division // Zwift Racing League (men) (A),Garmin Vector 3,kickr wahoo,300,434,-134
108164,1612375205,wahoo,Zwift - MIDWEEK Winter Series by SZR (A),Garmin Vector 3,kickr wahoo,360,373,-13
108778,1612458302,wahoo,Zwift - OH MY CRIT!! - The Double Race 2/2 (A),Garmin Vector 3,kickr wahoo,403,425,-22
111013,1612812087,wahoo,Zwift - Premier Division // Zwift Racing League (men) (A),Garmin Vector 3,kickr wahoo,416,444,-28
112854,1613063103,wahoo,Zwift - OH MY CRIT!! - The Double Race 2/2 (A),Garmin Vector 3,kickr wahoo,386,407,-21
114665,1613307901,wahoo,Zwift - 3R Watopia Flat Route Race - 4 Laps (40.5km/25.1mi 216m) (A),Garmin Vector 3,kickr wahoo,381,385,-4
115352,1613419242,wahoo,Zwift - Premier Division // Zwift Racing League (men) (A),Garmin Vector 3,kickr wahoo,452,453,-1
116609,1613584804,wahoo,Zwift - MIDWEEK Winter Series by SZR (A),Garmin Vector 3,kickr wahoo,384,385,-1
117166,1613664883,wahoo,Zwift - OH MY CRIT!! - The Double Race 1/2 (A),Garmin Vector 3,kickr wahoo,389,412,-23
117191,1613667892,wahoo,Zwift - OH MY CRIT!! - The Double Race 2/2 (A),Garmin Vector 3,kickr wahoo,398,420,-22
118070,1613811880,wahoo,Zwift - e-liga | eCycling league Austria Race 7 (A),Garmin Vector 3,kickr wahoo,418,432,-14
119096,1614020901,wahoo,Zwift - Premier Division // Zwift Racing League (men) (A),Garmin Vector 3,kickr wahoo,393,394,-1
122568,1614629814,wahoo,Zwift - Premier Division // Zwift Racing League (men) (A),Garmin Vector 3,kickr wahoo,409,411,-2
124809,1615021414,wahoo,Zwift - e-liga | eCycling league Austria Race 8 (A),Garmin Vector 3,kickr wahoo,425,427,-2
127733,1615626258,wahoo,Zwift - e-liga | eCycling league Austria Race 9 (A),Garmin Vector 3,kickr wahoo,431,432,-1
129113,1615917582,wahoo,Zwift - KIRCHMAIR Club Championship 2021 – Race #2 (A),Garmin Vector 3,kickr wahoo,383,407,-24
45090,1594038392,neo,Zwift - Richmond,Quarq Elsa,Tacx Neo 2T,212,206,6
45091,1594038213,neo,Zwift - Watopia,Quarq Elsa,Tacx Neo 2T,0,0,0
45130,1594059402,neo,Zwift - TFC Mad Monday Summer Series (1 of 9) (A),Quarq Elsa,Tacx Neo 2T,330,333,-3
45454,1594227169,neo,Zwift - MIDWEEK Summer Series by SZR (A),Quarq Elsa,Tacx Neo 2T,344,336,8
45632,1594307593,neo,OH MY CRIT! - The Double Race 1/2,Quarq Elsa,Tacx Neo 2T,369,356,13
45942,1594476770,neo,Zwift - OH MY CRIT!! - Saturday Smash Race. Dropouts on secondary f*cking up the numbers(A),Quarq Elsa,Tacx Neo 2T,356,335,21
46239,1594717475,neo,Zwift - 3R Turbocharged Team Race Series - Round 1 (A),Quarq Elsa,Tacx Neo 2T,330,322,8
46613,1594912156,neo,Zwift - OH MY CRIT! - The Double Race 1/2 (A),Quarq Elsa,Tacx Neo 2T,376,361,15
46614,1594914912,neo,Zwift - OH MY CRIT! - The Double Race 2/2 (A),Quarq Elsa,Tacx Neo 2T,330,319,11
46837,1595081630,neo,Zwift - OH MY CRIT!! - Saturday Smash Race (A),Quarq Elsa,Tacx Neo 2T,319,312,7
46951,1595164470,neo,Zwift - KISS at Race 100 - Americas (A),Quarq Elsa,Tacx Neo 2T,316,303,13
47284,1595410922,neo,Zwift - USA Cycling Race League by Indoor Specialist (A),Quarq Elsa,Tacx Neo 2T,362,354,8
47555,1595603506,neo,Zwift - 3R Sand and Sequoias Race (A),Quarq Elsa,Tacx Neo 2T,346,337,9
47746,1595761462,neo,Zwift - 3R Innsbruckring Sprint Race - 1 Lap (8.8km/5.5mi 77m) (A),Quarq Elsa,Tacx Neo 2T,350,342,8
47992,1595948383,neo,Zwift - 3R Turbocharged Team Race Series - Round 3 (A),Quarq Elsa,Tacx Neo 2T,330,338,-8
48167,1596045006,neo,Zwift - USA Cycling Race League by Indoor Specialist (A),Quarq Elsa,Tacx Neo 2T,339,331,8
48324,1596124985,neo,Zwift - OH MY CRIT! - The Double Race 2/2 (A),Quarq Elsa,Tacx Neo 2T,354,346,8
48331,1596127642,neo,Zwift - 3R PedalPlay Interval Ride [~3.5-4.0w/kg avg] (B),Quarq Elsa,Tacx Neo 2T,320,317,3
48408,1596187510,neo,Zwift - DIRT Friday Morning Sprintapalooza (C),Quarq Elsa,Tacx Neo 2T,232,227,5
48500,1596290833,neo,Zwift - OH MY CRIT - Saturday Smash Race (A),Quarq Elsa,Tacx Neo 2T,336,331,5
48558,1596361516,neo,Zwift - Stages of DIRT (A),Quarq Elsa,Tacx Neo 2T,336,329,7
48589,1596370180,neo,Zwift - BMTR After Party Ride (B),Quarq Elsa,Tacx Neo 2T,312,310,2
49067,1596729879,neo,Dropout on secondary f*cking up 1 and 5 min average.Zwift - OH MY CRIT! - The Double Race 2/2 (A),Quarq Elsa,Tacx Neo 2T,328,315,13
49083,1596732903,neo,Zwift - 3R PedalPlay Interval Ride [~3.5-4.0w/kg avg] (B),Quarq Elsa,Tacx Neo 2T,304,302,2
49181,1596792321,neo,Zwift - DIRT Friday Morning Sprintapalooza (C),Quarq Elsa,Tacx Neo 2T,242,244,-2
49357,1596966357,neo,Zwift - Stages of DIRT (A),Quarq Elsa,Tacx Neo 2T,401,388,13
49366,1596971313,neo,Zwift - FTP Test (shorter),Quarq Elsa,Tacx Neo 2T,341,335,6
49434,1597059066,neo,Zwift - Ramp Test,Quarq Elsa,Tacx Neo 2T,392,381,11
49443,1597063176,neo,Zwift - 3R Volcano Climb Race - 1 Lap (22.4km/14mi 204m) (A),Quarq Elsa,Tacx Neo 2T,354,347,7
49727,1597251418,neo,Zwift - MIDWEEK Summer Series by SZR (A),Quarq Elsa,Tacx Neo 2T,339,332,7
49830,1597334135,neo,Zwift - OH MY CRIT! - The Double Race 2/2 (A),Quarq Elsa,Tacx Neo 2T,374,366,8
50140,1597500897,neo,Zwift - OH MY CRIT - Saturday Smash Race (A),Quarq Elsa,Tacx Neo 2T,401,388,13
50225,1597571110,neo,Stages of DIRT,Quarq Elsa,Tacx Neo 2T,325,314,11
50571,1597775985,neo,Zwift - 3R Turbocharged Team Race Series - Round 6 (A),Quarq Elsa,Tacx Neo 2T,346,341,5
50889,1597923330,neo,Zwift - Yorkshire,Rotor 2Inpower,Tacx Neo 2T,227,226,1
50926,1597939483,neo,Zwift - OH MY CRIT! - The Double Race 2/2 (A),Quarq Elsa,Tacx Neo 2T,324,319,5
50948,1597942787,neo,Zwift - Off The MAAP Stage 2 Race (A),Quarq Elsa,Tacx Neo 2T,329,325,4
51262,1598105629,neo,Big dropout f*cking up 1 min max. Zwift - OH MY CRIT - Saturday Smash Race* (A),Quarq Elsa,Tacx Neo 2T,340,324,16
52169,1598544272,neo,Zwift - OH MY CRIT! - The Double Race 2/2 (A),Quarq Elsa,Tacx Neo 2T,331,318,13
52219,1598549158,neo,Zwift - FUSION ECT BEUNSTOPPABLE Racing Series (A),Quarq Elsa,Tacx Neo 2T,307,304,3
52512,1598710461,neo,Zwift - 08/29/2020,Quarq Elsa,Tacx Neo 2T,334,325,9
53204,1599148830,neo,Zwift - OH MY CRIT! - The Double Race 2/2 (A),Quarq Elsa,Tacx Neo 2T,342,333,9
53241,1599153996,neo,Zwift - FUSION ECT BEUNSTOPPABLE Racing Series (A),Quarq Elsa,Tacx Neo 2T,328,323,5
53397,1599211515,neo,Zwift - DIRT Friday Morning Sprintapalooza (C),Quarq Elsa,Tacx Neo 2T,239,234,5
53651,1599398020,neo,Zwift - KISS at Race 100 - Americas (A),Quarq Elsa,Tacx Neo 2T,380,370,10
53980,1599590439,neo,Zwift - 3R Sundown Race Series  (E),Quarq Elsa,Tacx Neo 2T,363,355,8
54719,1599920100,neo,Zwift - OH MY CRIT - Saturday Smash Race (A),Quarq Elsa,Tacx Neo 2T,334,322,12
55388,1600195463,neo,Zwift - 3R Sundown Race Series  (E),Quarq Elsa,Tacx Neo 2T,350,341,9
55520,1600252796,neo,Zwift - DIRT Watts Up Wednesday Ride (C),Quarq Elsa,Tacx Neo 2T,223,221,2
55855,1600367308,neo,Zwift - Invitational League // Qualifying Race #2 (Men) ,Quarq Elsa,Tacx Neo 2T,355,348,7
56269,1600524914,neo,Forget to start computer - Missing first 18 min - Zwift - OH MY CRIT - Saturday Smash Race (A),Quarq Elsa,Tacx Neo 2T,319,312,7
56667,1600708486,neo,Zwift - DBR Ride´N´Roll League (A),Quarq Elsa,Tacx Neo 2T,340,333,7
56851,1600800165,neo,Zwift - 3R Sundown Race Series  (E),Quarq Elsa,Tacx Neo 2T,382,373,9
57033,1600882939,neo,Zwift - DCU powered by Feltet.dk (A),Quarq Elsa,Tacx Neo 2T,341,335,6
57727,1601129622,neo,Zwift - OH MY CRIT - Saturday Smash Race (A),Quarq Elsa,Tacx Neo 2T,345,341,4
57856,1601201307,neo,Gear change fuck up affect sprint numbers. Zwift - 3R Sand & Sequoias - 1 Lap (20km/12.5mi 173m) (A),Quarq Elsa,Tacx Neo 2T,325,320,5
57870,1601204683,neo,Zwift - 3R Innsbruckring Sprint Race - 1 Lap (8.8km/5.5mi 77m) (A),Quarq Elsa,Tacx Neo 2T,352,342,10
57876,1601206976,neo,Zwift - Crit City Race (A),Quarq Elsa,Tacx Neo 2T,324,319,5
58177,1601372346,wahoo,Zwift - France,Quarq Elsa,Wahoo Kickr Core,219,223,-4
58247,1601380207,neo,ZADA Three Sisters Test - Struggling with sore throat and chest pain,Quarq Elsa,Tacx Neo 2T,359,352,7
58550,1601487849,neo,Zwift - DCU powered by Feltet.dk (A),Quarq Elsa,Tacx Neo 2T,345,337,8
58779,1601568262,neo,Zwift - OH MY CRIT! - The Double Race 2/2 (A),Quarq Elsa,Tacx Neo 2T,351,345,6
59256,1601734142,neo,Zwift - OH MY CRIT - Saturday Smash Race (A),Quarq Elsa,Tacx Neo 2T,395,380,15
59625,1601921961,neo,Zwift - TFC Mad Monday Autumn Series (A),Quarq Elsa,Tacx Neo 2T,340,335,5
59772,1601983475,wahoo,ODZ Covfefe,Quarq Elsa,Wahoo Kickr 5.0,290,291,-1
60100,1602092568,wahoo,Zwift - DCU powered by Feltet.dk (A),Quarq Elsa,Wahoo Kickr 5.0,340,341,-1
60257,1602149591,wahoo,ZADA Three sisters test,Quarq Elsa,Wahoo Kickr 5.0,372,373,-1
60308,1602172818,wahoo,Zwift - OH MY CRIT! - The Double Race 2/2 (A),Quarq Elsa,Wahoo Kickr 5.0,374,374,0
60368,1602178062,wahoo,Zwift - FUSION ECT BEUNSTOPPABLE Racing Series (A),Quarq Elsa,Wahoo Kickr 5.0,320,329,-9
61027,1602436782,wahoo,Zwift - 3R Greater London 8 Hilly Race - 1 Lap (23.8km/14.8mi 238m) (A),Quarq Elsa,Wahoo Kickr 5.0,400,408,-8
61180,1602522870,wahoo,Zwift - DBR Ride´N´Roll League (A),Quarq Elsa,Wahoo Kickr 5.0,331,332,-1
61866,1602694662,wahoo,Zwift - MIDWEEK Autumn Series by SZR (A),Quarq Elsa,Wahoo Kickr 5.0,382,381,1
61899,1602698395,wahoo,DBR HEINO CUP III,Quarq Elsa,Wahoo Kickr 5.0,324,324,0
62120,1602777887,wahoo,Zwift - OH MY CRIT! - The Double Race 2/2 (A),Quarq Elsa,Wahoo Kickr 5.0,369,376,-7
62217,1602782986,wahoo,Zwift - FUSION ECT BEUNSTOPPABLE Racing Series (A),Quarq Elsa,Wahoo Kickr 5.0,369,374,-5
62375,1602840322,wahoo,Zwift - DIRT Friday Morning Sprintapalooza (C),Quarq Elsa,Wahoo Kickr 5.0,236,237,-1
62626,1602943872,wahoo,Zwift - OH MY CRIT - Saturday Smash Race (A),Quarq Elsa,Wahoo Kickr 5.0,363,368,-5
62874,1603026887,wahoo,Zwift - KISS at Race 100 - Americas (A),Quarq Elsa,Wahoo Kickr 5.0,338,339,-1
62893,1603037113,wahoo,Zwift - 3R Tick Tock Flat Race - 1 Lap (19km/11.8mi 50m) (A),Quarq Elsa,Wahoo Kickr 5.0,313,315,-2
63422,1603215022,wahoo,WTRL Racing,Quarq Elsa,Wahoo Kickr 5.0,384,388,-4
63818,1603299421,wahoo,Zwift - MIDWEEK Autumn Series by SZR (A),Quarq Elsa,Wahoo Kickr 5.0,365,370,-5
63898,1603303396,wahoo,DBR HEINO CUP III,Quarq Elsa,Wahoo Kickr 5.0,321,320,1
64157,1603382654,wahoo,Zwift - OH MY CRIT! - The Double Race 2/2 (A),Quarq Elsa,Wahoo Kickr 5.0,351,354,-3
64332,1603445527,wahoo,Zwift - DIRT Friday Morning Sprintapalooza (C),Quarq Elsa,Wahoo Kickr 5.0,242,244,-2
64648,1603548800,wahoo,Zwift - OH MY CRIT - Saturday Smash Race (A),Quarq Elsa,Wahoo Kickr 5.0,344,345,-1
65211,1603742092,wahoo,Dropout on secondary Zwift - Premier Division // Zwift Racing League (men) (A),Quarq Elsa,Wahoo Kickr 5.0,373,378,-5
65797,1603907926,wahoo,Zwift - MIDWEEK Autumn Series by SZR (A),Quarq Elsa,Wahoo Kickr 5.0,343,343,0
66104,1603990965,wahoo,Zwift - OH MY CRIT! - The Double Race 2/2 (A),Quarq Elsa,Wahoo Kickr 5.0,360,358,2
66179,1603996054,wahoo,FUSION ECT BEUNSTOPPABLE Racing Series,Quarq Elsa,Wahoo Kickr 5.0,369,371,-2
66411,1604060703,wahoo,Zwift - DIRT Friday Pacific Sprintapalooza  (C),Quarq Elsa,Wahoo Kickr 5.0,247,248,-1
66708,1604157305,wahoo,Zwift - OH MY CRIT - Saturday Smash Race (A),Quarq Elsa,Wahoo Kickr 5.0,346,341,5
66963,1604236516,wahoo,Zwift - KISS at Race 100 - Americas (A),Quarq Elsa,Wahoo Kickr 5.0,350,349,1
66987,1604246714,wahoo,Zwift - 3R Tick Tock Flat Race - 1 Lap (19km/11.8mi 50m) (A),Quarq Elsa,Wahoo Kickr 5.0,325,328,-3
67527,1604405691,wahoo,Zwift - ODZ Covfefe (C),Quarq Elsa,Wahoo Kickr 5.0,339,341,-2
68016,1604512791,wahoo,Zwift - MIDWEEK Autumn Series by SZR (A),Quarq Elsa,Wahoo Kickr 5.0,328,330,-2
68178,1604595798,wahoo,Zwift - OH MY CRIT! - The Double Race 2/2 (A),Quarq Elsa,Wahoo Kickr 5.0,360,360,0
68806,1604762081,wahoo,Zwift - OH MY CRIT - Saturday Smash Race (A),Quarq Elsa,Wahoo Kickr 5.0,361,363,-2
68992,1604825846,wahoo,Zwift - Zwift Fondo Series 2020/21: Gran Fondo ,Quarq Elsa,Wahoo Kickr 5.0,358,363,-5
69623,1605005878,wahoo,Small dropouts on primary Zwift - KISS at Race - Americas AM (A),Quarq Elsa,Wahoo Kickr 5.0,375,387,-12
69648,1605010494,wahoo,Zwift - ODZ Covfefe (C),Quarq Elsa,Wahoo Kickr 5.0,343,346,-3
70281,1605117341,wahoo,Zwift - MIDWEEK Autumn Series by SZR (A),Quarq Elsa,Wahoo Kickr 5.0,348,355,-7
70306,1605120569,wahoo,Zwift - DCU – Feltet.dk November series (A),Quarq Elsa,Wahoo Kickr 5.0,362,363,-1
70653,1605200683,wahoo,Zwift - OH MY CRIT! - The Double Race 2/2 (A),Quarq Elsa,Wahoo Kickr 5.0,328,320,8
70815,1605205777,wahoo,Zwift - FUSION ECT BEUNSTOPPABLE Racing Series (A),Quarq Elsa,Wahoo Kickr 5.0,292,298,-6
71409,1605366912,wahoo,Zwift - OH MY CRIT - Saturday Smash Race (A),Quarq Elsa,Wahoo Kickr 5.0,337,334,3
72645,1605725890,wahoo,Zwift - DCU – Feltet.dk November series (A),Quarq Elsa,Wahoo Kickr 5.0,352,353,-1
73150,1605813229,wahoo,Zwift - World Championships Experience // Danish Cycling Federation,Quarq Elsa,Wahoo Kickr 5.0,360,359,1
73408,1605867907,wahoo,Zwift - DIRT Friday Morning Sprintapalooza (C),Quarq Elsa,Wahoo Kickr 5.0,236,238,-2
74691,1606160688,wahoo,Dropout on secondary in sprint. Zwift - Premier Division // Zwift Racing League (men) (A),Quarq Elsa,Wahoo Kickr 5.0,410,414,-4
75521,1606326779,wahoo,Dropout on secondary Zwift - MIDWEEK Autumn Series by SZR (A),Quarq Elsa,Wahoo Kickr 5.0,360,370,-10
75591,1606330611,wahoo,Zwift - DCU – Feltet.dk November series (A),Quarq Elsa,Wahoo Kickr 5.0,354,359,-5
75918,1606407046,wahoo,Zwift - OH MY CRIT! - The Double Race 1/2 (A),Quarq Elsa,Wahoo Kickr 5.0,345,348,-3
75941,1606410160,wahoo,OH MY CRIT! - The Double Race 2/2,Quarq Elsa,Wahoo Kickr 5.0,326,327,-1
76996,1606576410,wahoo,Zwift - OH MY CRIT - Saturday Smash Race (A),Quarq Elsa,Wahoo Kickr 5.0,351,350,1
77307,1606659230,wahoo,Zwift - KISS 100 Race Series - Americas (A),Quarq Elsa,Wahoo Kickr 5.0,325,318,7
77642,1606760984,wahoo,Zwift - Frenchy Fuzion Watopia Tour - Etape 1 (E),Quarq Elsa,Wahoo Kickr 5.0,348,355,-7
78569,1606931734,wahoo,Zwift - MIDWEEK Winter Series by SZR (A),Quarq Elsa,Wahoo Kickr 5.0,346,350,-4
78900,1607011838,wahoo,Zwift - OH MY CRIT! - The Double Race 1/2 (A),Quarq Elsa,Wahoo Kickr 5.0,368,368,0
78924,1607014437,wahoo,Zwift - OH MY CRIT! - The Double Race 2/2 (A),Quarq Elsa,Wahoo Kickr 5.0,358,361,-3
79003,1607019905,wahoo,Zwift - FUSION DECEMBER CUP (A),Quarq Elsa,Wahoo Kickr 5.0,306,309,-3
79802,1607181138,wahoo,Zwift - OH MY CRIT - Saturday Smash Race (A),Quarq Elsa,Wahoo Kickr 5.0,367,369,-2
80486,1607364861,wahoo,Dropout on secondary in sprint - Zwift -  DBR Monday Race (A),Quarq Elsa,Wahoo Kickr 5.0,332,333,-1
80526,1607368577,wahoo,Zwift - Team TFC Mad Monday Races (A),Quarq Elsa,Wahoo Kickr 5.0,346,346,0
81089,1607536788,wahoo,Zwift - MIDWEEK Winter Series by SZR (A),Quarq Elsa,Wahoo Kickr 5.0,375,379,-4
81515,1607619766,wahoo,Zwift - OH MY CRIT! - The Double Race 2/2 (A),Quarq Elsa,Wahoo Kickr 5.0,362,362,0
81624,1607624976,wahoo,Dropout on secondary in sprint. Zwift - FUSION DECEMBER CUP (A),Quarq Elsa,Wahoo Kickr 5.0,357,362,-5
81883,1607682283,wahoo,Zwift - DIRT Friday Morning Sprintapalooza (C),Quarq Elsa,Wahoo Kickr 5.0,228,228,0
82397,1607785979,wahoo,Zwift - OH MY CRIT - Saturday Smash Race (A),Quarq Elsa,Wahoo Kickr 5.0,405,414,-9
82829,1607879914,wahoo,Zwift - 3R Racing (A),Quarq Elsa,Wahoo Kickr 5.0,378,377,1
83195,1607973460,wahoo,Zwift - Team TFC Mad Monday Winter Series (A),Quarq Elsa,Wahoo Kickr 5.0,338,339,-1
83996,1608141323,wahoo,Zwift - MIDWEEK Winter Series by SZR (A),Quarq Elsa,Wahoo Kickr 5.0,360,362,-2
84290,1608221506,wahoo,Zwift - OH MY CRIT! - The Double Race 1/2 (A),Quarq Elsa,Wahoo Kickr 5.0,393,393,0
84317,1608224486,wahoo,Zwift - OH MY CRIT! - The Double Race 2/2 (A),Quarq Elsa,Wahoo Kickr 5.0,372,376,-4
84408,1608229290,wahoo,Zwift - FUSION DECEMBER CUP (A),Quarq Elsa,Wahoo Kickr 5.0,332,337,-5
85110,1608390742,wahoo,Zwift - OH MY CRIT - Saturday Smash Race (A),Quarq Elsa,Wahoo Kickr 5.0,412,416,-4
85456,1608473666,wahoo,Dropout on secondary in sprint. Zwift - KISS 100 Race Series - Americas (A),Quarq Elsa,Wahoo Kickr 5.0,315,318,-3
86049,1608635414,wahoo,Zwift - Japan Zwift Tuesday Race (A),Quarq Elsa,Wahoo Kickr 5.0,376,378,-2
86073,1608639841,wahoo,Zwift - Team ODZ Tuesday Coffee and Espresso Ride (C),Quarq Elsa,Wahoo Kickr 5.0,340,343,-3
86402,1608720294,wahoo,Zwift - USA Cycling Race League by Indoor Specialist (A),Quarq Elsa,Wahoo Kickr 5.0,334,338,-4
86422,1608726613,wahoo,Forget to start garmin. Only recorded last 5 min. Zwift - 3R LaGuardia Loop Flat Race - 10 Laps (28.3km/17.6mi 270m) (A),Quarq Elsa,Wahoo Kickr 5.0,315,315,0
86874,1608807599,wahoo,Still having dropout problems. Zwift - KISS Race Series - Americas AM (A),Quarq Elsa,Wahoo Kickr 5.0,350,355,-5
87465,1608995691,wahoo,OH MY CRIT - Saturday Smash Race,Quarq Elsa,Wahoo Kickr 5.0,359,362,-3
87903,1609078441,wahoo,Zwift - KISS 100 Race Series - Americas (A),Quarq Elsa,Wahoo Kickr 5.0,356,359,-3
88487,1609239530,wahoo,Zwift - KISS Race Series - Americas AM (A),Quarq Elsa,Wahoo Kickr 5.0,339,340,-1
88926,1609322386,wahoo,Zwift - EVR Definitely Not the WTNC (A),Quarq Elsa,Wahoo Kickr 5.0,349,353,-4
88977,1609331247,wahoo,Zwift - 3R LaGuardia Loop Flat Race - 10 Laps (28.3km/17.6mi 270m) (A),Quarq Elsa,Wahoo Kickr 5.0,336,341,-5
89507,1609431185,wahoo,New trainer firmware - Zwift - OH MY CRIT! - The Double Race 1/2 (A),Quarq Elsa,Wahoo Kickr 5.0,337,342,-5
90260,1609600400,wahoo,Zwift - OH MY CRIT - Saturday Smash Race (A),Quarq Elsa,Wahoo Kickr 5.0,360,366,-6
90861,1609683284,wahoo,Zwift - KISS 100 Race Series - Americas (A),Quarq Elsa,Wahoo Kickr 5.0,313,320,-7
91601,1609844292,wahoo,Zwift - KISS Race Series - Americas AM (A),Quarq Elsa,Wahoo Kickr 5.0,381,387,-6
92304,1609955812,wahoo,Zwift - MIDWEEK Winter Series by SZR (A),Quarq Elsa,Wahoo Kickr 5.0,341,347,-6
92774,1610038998,wahoo,Zwift - OH MY CRIT! - The Double Race 2/2 (A),Quarq Elsa,Wahoo Kickr 5.0,361,367,-6
92926,1610044192,wahoo,Secondary fckup in sprint. Zwift - FUSION WINTER CUP (A),Quarq Elsa,Wahoo Kickr 5.0,333,343,-10
93260,1610101513,wahoo,Zwift - DIRT Friday Morning Sprintapalooza (C),Quarq Elsa,Wahoo Kickr 5.0,231,228,3
93262,1610108175,wahoo,Small test of dzero and kickr,Quarq dzero,Wahoo Kickr 5.0,244,239,5
93902,1610205162,wahoo,Zwift - OH MY CRIT - Saturday Smash Race (A),Quarq Elsa,Wahoo Kickr 5.0,355,362,-7
94992,1610392180,wahoo,Zwift - Premier Division // Zwift Racing League (men) (A),Quarq Elsa,Wahoo Kickr 5.0,349,357,-8
95430,1610449216,wahoo,Kickr test vs Dzero Zwift - TDZ Stage 2: Longer Ride,Quarq dzero,Wahoo Kickr 5.0,270,268,2
96144,1610531709,wahoo,Zwift - Innsbruck,Quarq Elsa,Wahoo Kickr 5.0,264,265,-1
96429,1610563470,wahoo,Zwift - Danmarks Cykle Union & Partners 1/6 (A),Quarq Elsa,Wahoo Kickr 5.0,360,358,2
96870,1610640744,wahoo,Small dropout on secondary in last minute. Zwift - OH MY CRIT! - The Double Race 1/2 (A),Quarq Elsa,Wahoo Kickr 5.0,351,350,1
96889,1610643813,wahoo,Zwift - OH MY CRIT! - The Double Race 2/2 (A),Quarq Elsa,Wahoo Kickr 5.0,350,351,-1
97360,1610706322,wahoo,Zwift - DIRT Friday Morning Sprintapalooza (C),Quarq Elsa,Wahoo Kickr 5.0,229,228,1
98027,1610809872,wahoo,Zwift - OH MY CRIT - Saturday Smash Race (A),Quarq Elsa,Wahoo Kickr 5.0,343,337,6
98104,1610814561,wahoo,Zwift - TEAM VEGAN Tofu Tornado (A),Quarq Elsa,Wahoo Kickr 5.0,372,366,6
98562,1610892849,wahoo,Zwift - KISS 100 Race Series - Americas (A),Quarq Elsa,Wahoo Kickr 5.0,338,330,8
99514,1611054013,wahoo,Zwift - KISS Race Series - Americas AM (A),Quarq Elsa,Wahoo Kickr 5.0,377,380,-3
100323,1611168290,wahoo,Zwift - Danmarks Cykle Union & Partners 2/6 (A),Quarq Elsa,Wahoo Kickr 5.0,374,371,3
100810,1611245601,wahoo,Zwift - OH MY CRIT! - The Double Race 1/2 (A),Quarq Elsa,Wahoo Kickr 5.0,361,357,4
101912,1611414744,wahoo,Zwift - OH MY CRIT!! - Saturday Smash Race (A),Quarq Elsa,Wahoo Kickr 5.0,361,363,-2
103003,1611601145,wahoo,Zwift - Premier Division // Zwift Racing League (men) (A),Quarq Elsa,Wahoo Kickr 5.0,355,361,-6
104167,1611773036,wahoo,Zwift - Danmarks Cykle Union & Partners 3/6 (A),Quarq Elsa,Wahoo Kickr 5.0,369,368,1
104596,1611853443,wahoo,Zwift - OH MY CRIT!! - The Double Race 2/2 (A),Quarq Elsa,Wahoo Kickr 5.0,343,346,-3
104725,1611858472,wahoo,Zwift - FUSION WINTER CUP (A),Quarq Elsa,Wahoo Kickr 5.0,385,383,2
105640,1612019611,wahoo,Zwift - OH MY CRIT!! - Saturday Smash Race (A),Quarq Elsa,Wahoo Kickr 5.0,356,353,3
105689,1612024576,wahoo,Crit City Race,Quarq Elsa,Wahoo Kickr 5.0,360,362,-2
106920,1612209975,wahoo,Zwift - Premier Division // Zwift Racing League (men) (A),Quarq Elsa,Wahoo Kickr 5.0,347,357,-10
107951,1612348832,wahoo,Zwift - The Morning Grind by STPC (A),Quarq Elsa,Wahoo Kickr 5.0,326,332,-6
108231,1612377843,wahoo,Zwift - Danmarks Cykle Union & Partners 4/6 (A),Quarq Elsa,Wahoo Kickr 5.0,361,364,-3
108771,1612458273,wahoo,Zwift - OH MY CRIT!! - The Double Race 2/2 (A),Quarq Elsa,Wahoo Kickr 5.0,373,375,-2
109912,1612624382,wahoo,Zwift - OH MY CRIT!! - Saturday Smash Race (A),Quarq Elsa,Wahoo Kickr 5.0,389,390,-1
110518,1612707198,wahoo,Zwift - KISS 100 Race Series - Americas (A),Quarq Elsa,Wahoo Kickr 5.0,384,384,0
111657,1612896595,wahoo,Small dropout on secondary in last minute. Zwift - Team Italy & Frenchy Fuzion League (A),Quarq Elsa,Wahoo Kickr 5.0,339,344,-5
112306,1612982468,wahoo,Zwift - Danmarks Cykle Union & Partners 5/6 (A),Quarq Elsa,Wahoo Kickr 5.0,370,369,1
112850,1613062912,wahoo,Zwift - OH MY CRIT!! - The Double Race 2/2 (A),Quarq Elsa,Wahoo Kickr 5.0,366,369,-3
113026,1613068126,wahoo,Zwift - FUSION WINTER CUP (A),Quarq Elsa,Wahoo Kickr 5.0,352,353,-1
114144,1613229171,wahoo,Zwift - OH MY CRIT!! - Saturday Smash Race (A),Quarq Elsa,Wahoo Kickr 5.0,382,383,-1
114316,1613239367,wahoo,Zwift - 3R Three Sisters Hilly Race (47km/29.2mi 879m) (A),Quarq Elsa,Wahoo Kickr 5.0,383,382,1
115650,1613473053,wahoo,Zwift - KISS Race Series - Americas AM (A),Quarq Elsa,Wahoo Kickr 5.0,327,321,6
116422,1613558606,wahoo,Zwift - The Morning Grind by STPC (A),Quarq Elsa,Wahoo Kickr 5.0,373,370,3
116685,1613587404,wahoo,Zwift - Danmarks Cykle Union & Partners 6/6 (A),Quarq Elsa,Wahoo Kickr 5.0,348,342,6
117188,1613667861,wahoo,Zwift - OH MY CRIT!! - The Double Race 2/2 (A),Quarq Elsa,Wahoo Kickr 5.0,379,376,3
117262,1613673423,wahoo,Zwift - The Breaks Indoor Racing Tour (A),Quarq Elsa,Wahoo Kickr 5.0,334,331,3
117647,1613730296,wahoo,Zwift - DIRT Friday Morning Sprintapalooza (C),Quarq Elsa,Wahoo Kickr 5.0,229,230,-1
118049,1613808240,wahoo,Zwift - 3R Weekend Race Club - Race 1 (A),Quarq Elsa,Wahoo Kickr 5.0,331,333,-2
119125,1614020845,wahoo,Zwift - Premier Division // Zwift Racing League (men) (A),Quarq Elsa,Wahoo Kickr 5.0,348,354,-6
120333,1614192270,wahoo,Zwift - Scandinavian Cup 2021 - Round 1 - Men (A),Quarq Elsa,Wahoo Kickr 5.0,329,338,-9
120713,1614272556,wahoo,Zwift - OH MY CRIT!! - The Double Race 2/2 (A),Quarq Elsa,Wahoo Kickr 5.0,364,362,2
120826,1614277704,wahoo,Zwift - FUSION WINTER CUP (A),Quarq Elsa,Wahoo Kickr 5.0,371,370,1
121633,1614438870,wahoo,Zwift - OH MY CRIT!! - Saturday Smash Race (A),Quarq Elsa,Wahoo Kickr 5.0,347,347,0
122612,1614629805,wahoo,Zwift - Premier Division // Zwift Racing League (men) (A),Quarq Elsa,Wahoo Kickr 5.0,358,359,-1
123645,1614796991,wahoo,Zwift - Scandinavian Cup 2021 - Round 2 - Men (A),Quarq Elsa,Wahoo Kickr 5.0,357,359,-2
123963,1614874343,wahoo,Zwift - OH MY CRIT!! - The Double Race 1/2 (A),Quarq Elsa,Wahoo Kickr 5.0,362,364,-2
123980,1614877324,wahoo,Zwift - OH MY CRIT!! - The Double Race 2/2 (A),Quarq Elsa,Wahoo Kickr 5.0,357,355,2
125005,1615043431,wahoo,Zwift - OH MY CRIT!! - Saturday Smash Race (A),Quarq Elsa,Wahoo Kickr 5.0,348,345,3
125320,1615107893,wahoo,Zwift - Newbury Velo Road Race (A),Quarq Elsa,Wahoo Kickr 5.0,352,351,1
126032,1615287464,wahoo,Zwift - KISS Race Series - Americas AM (A),Quarq Elsa,Wahoo Kickr 5.0,339,342,-3
126599,1615401781,wahoo,Zwift - Scandinavian Cup 2021 - Round 3 - Men (A),Quarq Elsa,Wahoo Kickr 5.0,370,369,1
126997,1615482184,wahoo,Zwift - OH MY CRIT!! - The Double Race 2/2 (A),Quarq Elsa,Wahoo Kickr 5.0,350,347,3
127137,1615487223,wahoo,Zwift - FUSION SPRING CUP (A),Quarq Elsa,Wahoo Kickr 5.0,354,354,0
127444,1615555481,wahoo,Zwift - DIRT Friday Pacific Sprintapalooza  (C),Quarq Elsa,Wahoo Kickr 5.0,244,239,5
127782,1615629258,wahoo,Zwift - Cycling Ireland eRacing Spring League Rd 3 (A),Quarq Elsa,Wahoo Kickr 5.0,375,377,-2
128424,1615731291,wahoo,Zwift - KISS 100 Race Series (Americas) (A),Quarq Elsa,Wahoo Kickr 5.0,348,346,2
129161,1615919332,wahoo,Zwift - CeramicSpeed Race Series: Open Race (A),Quarq Elsa,Wahoo Kickr 5.0,378,379,-1
16883,1583350200,wahoo,Zwift - Zwift Beta Race (A),Srm Dura ace,Wahoo Kickr,350,353,-3
17833,1584040520,wahoo,Zwift - Tour of Watopia Pro-Am Men&#039;s Race #1 (A) 5e plaats tussen de grote jongens,Srm Dura ace,Wahoo Kickr,376,386,-10
18148,1584277501,wahoo,Zwift - 3R Watopia Flat Route Race - 4 Laps (40.5km/25.1mi 216m) (A),Favero assioma duo,Wahoo Kickr ( power source ),330,336,-6
18436,1584471300,wahoo,Team Italy & Frenchy Fuzion League,Favero assioma duo,Wahoo Kickr ( zwift power source ),343,345,-2
18904,1584731693,wahoo,Tour of Watopia Pro-Am Mens Race #2,Favero assioma duo,Wahoo Kickr ( zwift power source ),365,381,-16
19496,1585077291,wahoo,Zwift - Tour of Watopia Pro-Am Men&#039;s Race #3 (A),Favero assioma duo,Wahoo Kickr ( zwift power source ),355,360,-5
19795,1585249195,wahoo,Zwift - KALAS Cup - Round 9 (A),Srm Dura ace ( spare bike ),Wahoo Kickr ( zwift power source ),346,349,-3
21063,1585734296,wahoo,Zwift - USA Cycling Race League by Indoor Specialist  (A) 3th place,Srm Dura ace ( spare bike ),Wahoo Kickr ( zwift power source ),317,331,-14
22774,1586282098,wahoo,Zwift - Team Italy & Frenchy Fuzion League (A),Srm Dura ace ( spare bike ),Wahoo Kickr ( zwift power source ),368,361,7
23298,1586455795,wahoo,Zwift - London International // Zwift Classic (A),Srm Dura ace ( spare bike ),Wahoo Kickr ( zwift power source ),387,390,-3
25612,1587147052,wahoo,Zwift - Richmond Challenge // Zwift Classic (A),Srm Dura ace ( spare bike ),Wahoo Kickr ( zwift power source ),356,361,-5
25814,1587208132,wahoo,Zwift - USA Cycling&#039;s Dadurday Chase Race by DIRT (A),Srm Dura ace ( spare bike ),Wahoo Kickr ( zwift power source ),336,346,-10
27184,1587625497,wahoo,Zwift - 3R Innsbruckring Flat Race - 5 Laps (44km/27.3mi 385m) (A),Srm Dura ace ( spare bike ),Wahoo Kickr ( zwift power source ),316,324,-8
28033,1587838200,wahoo,Zwift - Crit City Slam // Zwift Classic (A),Srm Dura ace ( spare bike ),Wahoo Kickr ( zwift power source ),370,375,-5
32068,1588787712,wahoo,Zwift - USA Cycling Race League p/b Saris+ThePro&#039;sCloset  (A),Srm Dura ace ( spare bike ),Wahoo Kickr ( zwift power source ),346,364,-18
40798,1591811714,wahoo,USA Cycling Race League by Saris/Pros Closet,Favero assioma duo,Wahoo Kickr ( zwift power source ),392,392,0
41794,1592222483,wahoo,Zwift - ZADA 3 sisters test,Favero assioma duo,Wahoo Kickr ( zwift power source ),373,379,-6
52113,1598519959,wahoo,Zwift - Cycling Australia&#039;s The Chop by AHDR (A),Favero assioma duo,Wahoo Kickr ( zwift power source ),363,369,-6
52904,1598981399,wahoo,Zwift - WTRL Gravel Series (A) 3th,Favero assioma duo,Wahoo Kickr ( zwift power source ),349,352,-3
54390,1599758463,wahoo,Zwift - Espresso,Favero assioma duo,Wahoo Kickr ( zwift power source ),341,350,-9
56404,1600606799,wahoo,Invitational League // Qualifying Race #3 (Men),Favero assioma duo,Wahoo Kickr ( zwift power source ),352,349,3
57019,1600880398,wahoo,Zwift - MIDWEEK Autumn Series by SZR (A) + cool down,Dura-Ace PM,Wahoo Kickr ( zwift power source ),338,343,-5
57726,1601129699,wahoo,Zwift - OH MY CRIT - Saturday Smash Race (A),Favero assioma duo,Wahoo Kickr ( zwift power source ),328,333,-5
58521,1601485200,wahoo,Zwift - MIDWEEK Autumn Series by SZR (A) + cooldown,Favero assioma duo,Wahoo Kickr ( zwift power source ),343,363,-20
59273,1601734509,wahoo,Zwift - OH MY CRIT - Saturday Smash Race (A) + endurance,Favero assioma duo,Wahoo Kickr ( zwift power source ),384,392,-8
9586,1579115703,wahoo,Zwift - Tour de Zwift // Pro-Am Invitational,KICKr (Zwift Power Source),Assiomas (Wahoo Bolt),445,465,-20
9591,1579115703,wahoo,Zwift - Tour de Zwift // Pro-Am Invitational,KICKr (Zwift Power Source),Assiomas (Wahoo Bolt),444,463,-19
10312,1579602006,wahoo,Zwift - Eat The Pain Race (A),KICKr (Zwift Power Source),Assiomas (Wahoo Bolt),439,459,-20
10465,1579719405,wahoo,Zwift - PowerMeter Comparaison Greg&#039;s Test Lab,KICKr (Zwift Power Source),Assiomas (Wahoo Bolt),381,387,-6
10651,1579806900,wahoo,Zwift - Tour de Zwift // Pro-Am Invitational,KICKr (Zwift Power Source),Assiomas (Wahoo Bolt),507,511,-4
11453,1580230804,wahoo,Zwift - Crank it Up Fiets (E),KICKr (Zwift Power Source),Assiomas (Wahoo Bolt),415,459,-44
14330,1581848999,neo,Zwift - LIVE finals of De Ronde League,Assiomas (to Roam),Tacx Neo 2 (live event),441,409,32
14353,1581872100,wahoo,Zwift - LIVE finals of De Ronde League (A),Assiomas (to Roam),Wahoo Kickr18 (Live event),445,423,22
41761,1592201976,wahoo,Zwift - 2x20 SST,"Infocrank (Primary, to Zwift)","Kickr (Secondary, to Wahoo App)",387,375,12
67554,1604422876,wahoo,Zwift - Watopia,Infocrank ,Wahoo Kickr v5,422,411,11
68046,1604569998,neo,Zwift - Anaerobic 30s,Infocrank ,Tacx Neo 2T,382,377,5
68265,1604602815,neo, Flanders The BZR Ronde ,Infocrank ,Tacx Neo 2T (to Zwift),421,407,14
70091,1605082665,neo,Zwift - 1-Minuters,Infocrank ,Tacx Neo 2T,405,406,-1
70256,1605117597,neo,Zwift - MIDWEEK Autumn Series by SZR (A),"Infocrank (Primary, to Zwift)","Tacx Neo 2T (Secondary, to Bolt)",387,377,10
74117,1606039847,neo,Failed workout,Infocrank ,Tacx Neo 2T ,435,425,10
77521,1606726084,neo,PRE-RACE SPIN,Infocrank ,Tacx Neo 2T,396,382,14
78430,1606905905,neo,Zwift - USA Cycling Race League by Indoor Specialist (A),"Infocrank (Secondary, to Bolt)",Tacx Neo 2T (to Zwift),412,394,18
78907,1607012096,neo,Zwift - OH MY CRIT! - The Double Race 1/2 (A),"Infocrank (Secondary, to Bolt)",Tacx Neo 2T (to Zwift),433,412,21
80018,1607245186,neo,Zwift - Podcast Recon Ride: Episode 6 (E),"Infocrank (Secondary, to Bolt)",Tacx Neo 2T (to Zwift),273,265,8
80270,1607273999,neo,Zwift - Nations Challenge // Belgium (E),"Infocrank (Secondary, to Bolt)",Tacx Neo 2T (to Zwift),411,397,14
80761,1607442011,neo,PRE-RACE DAY SPIN,"Infocrank (Secondary, to Bolt)",Tacx Neo 2T (to Zwift),402,384,18
81342,1607525107,neo,Zwift - Men&#039;s Elite // 2020 UCI Cycling Esports World Championships,"Infocrank (Secondary, to Bolt)",Tacx Neo 2T (to Zwift),442,422,20
5405,1575402199,wahoo,Zwift - NYC,quarq ,Wahoo Kickr 2018,0,0,0
5492,1575486298,wahoo,Zwift - DBR HEINO CUP (A),quarq ,Wahoo Kickr 2018,0,0,0
6046,1576091102,wahoo,Zwift - DBR HEINO CUP (A),quarq ,Wahoo Kickr 2018,394,390,4
9587,1579115703,wahoo,Kickr18 Primary Source Zwift - Tour de Zwift // Pro-Am Invitational (A),quarq ,Wahoo Kickr 2018,426,419,7
10184,1579549201,wahoo,Zwift - Tour de Zwift: Stage 3 Race (A),Infocrank,Wahoo Kickr 2018,444,467,-23
10670,1579806900,wahoo,Zwift - Tour de Zwift // Pro-Am Invitational,Infocrank secondary,Wahoo kickr 18 primary ,401,393,8
11897,1580498121,wahoo,Zwift - Tour de Zwift // Pro-Am Invitational (A),Infocrank secondary,Wahoo kickr 18 primary ,391,420,-29
13087,1580846398,wahoo,KISS at Race - EU PM (A) 1st,Infocrank secondary,Wahoo kickr 18 primary ,319,339,-20
14764,1582129799,wahoo,Sydkysten Cycling - Carl Ras Race (A) 2nd,Infocrank secondary,Wahoo kickr 18 primary ,364,381,-17
15310,1582462197,wahoo,Rats,Infocrank secondary,Wahoo kickr 18 primary ,347,349,-2
15311,1582462197,wahoo,Rats,Infocrank secondary,Wahoo kickr 18 primary ,347,349,-2
15882,1582830002,wahoo,KALAS Cup - Round 5,Infocrank secondary,Wahoo kickr 18 primary ,409,404,5
16822,1583350200,wahoo,Zwift - Zwift Beta Race (A),Infocrank secondary,Wahoo kickr 18 primary ,403,404,-1
19969,1585328400,wahoo,Zwift -  KALAS Indoor EFCT race series #iTT (A),Infocrank secondary,Wahoo kickr 18 primary ,395,374,21
49098,1596705419,wahoo,Zwift - The Lamb Chop p/b Black Sheep (A) 8th,Infocrank,Wahoo Kickr 2018,413,382,31
51060,1598002500,wahoo,Zwift - TBR Burrito Race (A),Infocrank,Wahoo Kickr 2018,357,345,12
52943,1598983194,wahoo,Zwift - RHYS HOWELL [CANYON]&#039;s Meetup - Astoria Line 8,Infocrank,Wahoo Kickr 2018,389,385,4
55060,1600106398,wahoo,Zwift - Invitational League // Qualifying Race #1,Infocrank secondary,Wahoo kickr 18 primary ,405,394,11
55850,1600367399,wahoo,Zwift - Invitational League // Qualifying Race #2 (Men) ,Infocrank secondary,Wahoo kickr 18 primary ,386,373,13
57223,1600960498,wahoo,Zwift - OH MY CRIT! - The Double Race 1/2 (A),Infocrank,Wahoo Kickr 2018,361,239,122
61241,1602529200,wahoo,Zwift - EVR Europe Race (A),Infocrank secondary,Wahoo kickr 18 primary ,323,318,5
61764,1602666299,wahoo,Zwift - 3R Watopia Flat Route Race - 3 Laps (30.3km/18.8mi 162m) (A) rat,Infocrank secondary,Wahoo kickr 18 primary ,364,356,8
62815,1603004813,wahoo,3 sisters zada test,Infocrank secondary,Wahoo kickr 18 primary ,388,384,4
65219,1603742399,wahoo,Premier Division // Zwift Racing League (men),Infocrank,Wahoo Kickr 2018,376,365,11
67533,1604409299,wahoo,Zwift - 3R Figure 8 Hilly Reverse Race - 1 Lap (29.2km/18.1mi 234m ) (A),Infocrank,Wahoo Kickr 2018,366,358,8
72511,1605696300,wahoo,Zwift - USA Cycling Race League by Indoor Specialist (A),Infocrank,Wahoo Kickr 2018,401,386,15
73421,1605871199,wahoo,Zwift - 3R LaGuardia Loop Reverse Flat Race - 8 Laps (24.5km/15.2mi 216m) (A),Infocrank,Wahoo Kickr 2018,376,360,16
74440,1606118699,wahoo,Zwift - 3R Sand & Sequoias - 1 Lap (20km/12.5mi 173m) (A),Infocrank,Wahoo Kickr 2018,338,331,7
77502,1606719899,wahoo,Zwift - 3R Watopia Flat Route Race - 3 Laps (30.3km/18.8mi 162m) (A),Infocrank,Wahoo Kickr 2018,362,344,18
77916,1606821599,wahoo,Zwift - British Cycling Race Series (A),Infocrank,Wahoo Kickr 2018,343,325,18
78945,1607018100,wahoo,Zwift - Team Italy Superveloce Race (A),Infocrank,Wahoo Kickr 2018,371,369,2
82825,1607873099,wahoo,Zwift - 3R Watopia 65km Race - 6 laps (40mi 324m) (A),Infocrank,Wahoo Kickr 2018,331,324,7
84351,1608221701,wahoo,Zwift - OH MY CRIT! - The Double Race 1/2 (A),Infocrank,Wahoo Kickr 2018,413,410,3
84354,1608224699,wahoo,Zwift - OH MY CRIT! - The Double Race 2/2 (A),Infocrank,Wahoo Kickr 2018,404,401,3
88481,1609239600,wahoo,Zwift - KISS Race Series - Americas AM (A),quarq ,Wahoo Kickr 2018,361,369,-8
89651,1609431298,wahoo,Zwift - OH MY CRIT! - The Double Race 1/2 (A),quarq ,Wahoo Kickr 2018,353,369,-16
89652,1609434300,wahoo,Zwift - OH MY CRIT! - The Double Race 2/2 (A),quarq ,Wahoo Kickr 2018,378,393,-15
22582,1586192289,neo,Zwift - SCF Road Challenge 1 (A),Favero Assioma Duo to Garmin,NEO1 Zwift,379,372,7
23448,1586448294,neo,Zwift - OH CRIT!! - The Double Race - Race 2/2 (A),Favero Assioma Duo to Garmin,NEO1 Zwift,378,371,7
24971,1586969785,neo,Zwift - Swedish Zwift Racing Cup by SZR (A),Favero Assioma Duo to Garmin,NEO1 Zwift,383,372,11
25244,1587056273,neo,Zwift - SCF MTB Challenge 1 (A),Favero Assioma Duo to Garmin,NEO1 Zwift,389,379,10
25887,1587219176,neo,Zwift - OH CRIT!! - Saturday Smash Series (A),Favero Assioma Duo to Garmin,NEO1 Zwift,410,402,8
26480,1587401948,neo,Zwift - SCF Road Challenge 2 (A),Favero Assioma Duo to Garmin,NEO1 Zwift,406,409,-3
26990,1587574774,neo,Zwift - Swedish Zwift Racing Cup by SZR (A),Favero Assioma Duo to Garmin,NEO1 Zwift,373,375,-2
34814,1589476932,neo,Zwift - WTRL Team Time Trial Premier League (C),Favero Assioma Duo to Zwift,NEO1 to Garmin,390,382,8
48168,1596045206,neo,Zwift - USA Cycling Race League by Indoor Specialist (A),Favero Assioma Duo to Zwift,NEO1 to Garmin,394,381,13
57307,1600973222,neo,Zwift - Espresso,Favero Assioma Duo to Garmin,NEO1 Zwift,360,354,6
62232,1602785563,neo,Zwift - Pre Event Ride // Swedish Cycling Federation,Favero Assioma Duo to Garmin,NEO1 Zwift,375,362,13
70312,1605117376,neo,Zwift - MIDWEEK Autumn Series by SZR (A),Favero Assioma Duo to Garmin,NEO1 Zwift,406,401,5
76184,1606419658,neo,Zwift - WTRL NOPINZ WORLD TTT CHAMPIONSHIPS - Zone 10 (C),Favero Assioma Duo to Garmin,NEO1 Zwift,406,400,6
81100,1607536695,neo,Zwift - MIDWEEK Winter Series by SZR (A),Favero Assioma Duo to Garmin,NEO1 Zwift,410,411,-1
86649,1608746361,neo,Zwift - MIDWEEK Winter Series by SZR (A),Favero Assioma Duo to Garmin,NEO1 Zwift,362,358,4
87243,1608920670,neo,Zwift - KIRCHMAIR Race Series (A),Favero Assioma Duo to Garmin,NEO1 Zwift,320,325,-5
87246,1608919164,neo,Zwift - KIRCHMAIR Race Series (A),Favero Assioma Duo to Garmin,NEO1 Zwift,360,363,-3
89882,1609525348,neo,Zwift - KIRCHMAIR Race Series (A),Favero Assioma Duo to Garmin,NEO1 Zwift,319,326,-7
92307,1609956019,neo,Zwift - MIDWEEK Winter Series by SZR (A),Favero Assioma Duo to Garmin,NEO1 Zwift,397,399,-2
92776,1610038679,neo,Zwift - OH MY CRIT! - The Double Race 2/2 (A),Favero Assioma Duo to Garmin,NEO1 Zwift,393,385,8
94909,1610386987,neo,Zwift - SCF SWE Cup (A),Favero Assioma Duo to Garmin,NEO1 Zwift,370,368,2
99085,1610996271,neo,Zwift -  SCF SWE Cup Men (A),Favero Assioma Duo to Garmin,NEO1 Zwift,411,421,-10
100970,1611253686,neo,Zwift - FUSION WINTER CUP (A),Favero Assioma Duo to Garmin,NEO1 Zwift,388,383,5
101460,1611338385,neo,Zwift - KIRCHMAIR Race Series (A),Favero Assioma Duo to Garmin,NEO1 Zwift,376,376,0
101465,1611339884,neo,Zwift - KIRCHMAIR Race Series (A),Favero Assioma Duo to Garmin,NEO1 Zwift,389,392,-3
102814,1611595555,neo,Zwift -  SCF SWE Cup Men (A),Favero Assioma Duo to Garmin,NEO1 Zwift,389,393,-4
104109,1611770349,neo,Zwift - MIDWEEK Winter Series by SZR (A),Favero Assioma Duo to Garmin,NEO1 Zwift,367,372,-5
110924,1612805366,neo,Zwift - SCF SWE Cup Men (A),Favero Assioma Duo to Garmin,NEO1 Zwift,399,395,4
112243,1612979843,neo,Zwift - MIDWEEK Winter Series by SZR (A),Favero Assioma Duo to Garmin,NEO1 Zwift,379,380,-1
115312,1613415258,wahoo,Zwift -  SCF SWE Cup Men (A),Favero Assioma Duo to Garmin,Wahoo Kickr bike,427,427,0
116606,1613584302,neo,Zwift - MIDWEEK Winter Series by SZR (A),Favero Assioma Duo to Garmin,NEO1 Zwift,391,392,-1
122443,1614625220,neo,Zwift -  SCF SWE Cup Men (A) started a little late,Favero Assioma Duo to Garmin,NEO1 Zwift,397,395,2
123537,1614794138,neo,Zwift - MIDWEEK Crit Race Series by SZR (A),Favero Assioma Duo to Garmin,NEO1 Zwift,398,397,1
126520,1615399081,neo,Zwift - MIDWEEK Crit Race Series by SZR (A),Favero Assioma Duo to Garmin,NEO1 Zwift,377,389,-12
6662,1576695897,wahoo,Zwift - DBR HEINO CUP (A),Assiomo PM,Wahoo Kickr,427,422,5
8486,1578510002,wahoo,Zwift - FIETS Magazine Race Series (A),Assiomo PM,Wahoo Kickr,463,461,2
13030,1581174890,wahoo,OH CRIT!! - Saturday Smash Series,Assiomo PM,Wahoo Kickr,337,337,0
13789,1581620410,wahoo,KALAS Cup - Round 3,Assiomo PM,Wahoo Kickr,383,378,5
13791,1577620800,wahoo,ZRG-Race-Series-10/10,Assiomo PM,Wahoo Kickr,431,441,-10
15103,1582308037,wahoo,Tour of Innsbruck // Stage 1,Assiomo PM,Wahoo Kickr,444,442,2
15633,1582653617,wahoo,ZRG Winter Race Series 7/10 - Muir and the Mountain,Assiomo PM,Wahoo Kickr,415,414,1
15858,1582823115,wahoo,Zwift - OH CRIT!! - The Double Race - Race 2/2 (A),Assiomo PM,Wahoo Kickr,362,359,3
15887,1582829995,wahoo,Zwift - KALAS Cup - Round 5 (A),Assiomo PM,Wahoo Kickr,384,380,4
16190,1582981796,wahoo,Zwift - The BMTR Fundo (A),Assiomo PM,Wahoo Kickr,348,347,1
16238,1583049602,wahoo,Zwift - Zwift Gran Fondo,Assiomo PM,Wahoo Kickr,362,365,-3
17554,1583867701,wahoo,Feltet.dk Race Series,Assiomo PM,Wahoo Kickr,385,387,-2
19841,1585249202,wahoo,KALAS Cup - Round 9,Assiomo PM,Wahoo Kickr,364,365,-1
31815,1588703994,wahoo,3R Spring Loaded Race Series - Round 6of6,Assiomo PM,Wahoo Kickr,428,435,-7
34409,1589392520,wahoo,USA Cycling Race League p/b Saris+TheProsCloset,Assiomo PM,Wahoo Kickr,371,371,0
43552,1593021294,wahoo,USA Cycling Race League by Saris/Pros Closet,Assiomo PM,Wahoo Kickr,464,458,6
71276,1605344726,wahoo,e-liga | eCycling league Austria Race 1,Assiomo PM,Wahoo Kickr,431,436,-5
76220,1606420057,wahoo,WTRL NOPINZ WORLD TTT CHAMPIONSHIPS - Zone 10,Assiomo PM,Wahoo Kickr,401,392,9
76786,1606554296,wahoo,e-liga I eCycling league Austria Race 2,Assiomo PM,Wahoo Kickr,375,394,-19
77356,1606659297,wahoo,KISS 100 Race Series - Americas,Assiomo PM,Wahoo Kickr,328,333,-5
101697,1611392665,wahoo,e-liga I eCycling league Austria Race 5,Assiomo PM,Wahoo Kickr,404,406,-2
109664,1612602303,wahoo,e-liga | eCycling league Austria Race 6,Assiomo PM,Wahoo Kickr,362,363,-1
124882,1615021476,wahoo,e-liga I eCycling league Austria Race 8,Assiomo PM,Wahoo Kickr,410,408,2
127800,1615626330,wahoo,e-liga I eCycling league Austria Race 9,Assiomo PM,Wahoo Kickr,376,375,1
93730,1610183995,wahoo,Zwift - NYC,Power Tap G3,Wahoo KICKR 2020/06,236,201,35
93736,1610183995,wahoo,Zwift - NYC,Power Tap G3,Wahoo KICKR 2020/06,236,201,35
93761,1610183995,wahoo,Zwift - DBR SufferDay League III (A),Power Tap G3,Wahoo KICKR 2020/06,0,418,-418
93887,1610183995,wahoo,Zwift - DBR SufferDay League III (A),Power Tap G3,Wahoo KICKR 2020/06,442,432,10
93893,1610183995,wahoo,Zwift - DBR SufferDay League III (A),Garmin Vector 2 Pedals,Wahoo KICKR 2020/06,442,432,10
95573,1610183922,wahoo,Power Tap G3 / Wahoo KICKR 2020/06,Power Tap G3,Wahoo KICKR 2020/06,442,434,8
97025,1610643262,wahoo,Zwift - OH MY CRIT! - The Double Race 2/2 (A),Power Tap G3,Wahoo KICKR 2020/06,412,412,0
97039,1610647132,wahoo,Zwift - Renegade Race (A),Power Tap G3,Wahoo KICKR 2020/06,415,394,21
97898,1610789308,wahoo,Zwift - DBR SufferDay League III (A),Power Tap G3,Wahoo KICKR 2020/06,420,422,-2
101684,1611389972,wahoo,Zwift - TEAM VEGAN Tofu Tornado XL (A),Power Tap G3,Wahoo KICKR 2020/06,460,451,9
114538,1613290771,wahoo,Zwift - Team Italy & Frenchy Fuzion Endurance Race (A),Power Tap G3,Wahoo KICKR 2020/06,452,441,11
127319,1615481672,wahoo,Zwift - OH MY CRIT!! - The Double Race 2/2 (A),Garmin Vector 2 Pedals,Wahoo KICKR 2020/06,419,412,7
127785,1615626299,wahoo,Zwift - 3R Endurance Series p/b OTE Sports (E),Garmin Vector 2 Pedals,Wahoo KICKR 2020/06,468,482,-14
53553,1599315296,wahoo,Test ,4iiii Precision L (Primary),Wahoo KICKR Snap (Secondary),365,343,22
54003,1599590633,wahoo,Zwift - 3R Sundown Race Series  (E),4iiii Precision L (Primary),Wahoo KICKR Snap (Secondary),348,339,9
54202,1599674689,wahoo,Zwift - DBR Wednesday Race (A),4iiii Precision L (Primary to Zwift),Wahoo KICKR Snap (Secondary to Elemnt Bolt),314,303,11
54389,1599753890,wahoo,Zwift - OH MY CRIT! - The Double Race 2/2 (A),4iiii Precision L (Primary to Zwift),Wahoo KICKR Snap (Secondary to Elemnt Bolt),324,323,1
55635,1600275580,wahoo,Zwift - MIDWEEK Autumn Series by SZR (A),4iiii Precision L (Primary to Zwift),Wahoo KICKR Snap (Secondary to Elemnt Bolt),345,340,5
56676,1600708473,wahoo,Zwift - DBR Ride´N´Roll League (A),4iiii Precision L (Primary to Zwift),Wahoo KICKR Snap (Secondary to Elemnt Bolt),328,313,15
57119,1600883072,wahoo,Zwift - DCU powered by Feltet.dk (A),4iiii Precision L (Primary to Zwift),Wahoo KICKR Snap (Secondary to Elemnt Bolt),338,319,19
61022,1602422095,wahoo,Zwift - KISS at Race 100 - Americas (A),4iiii Precision L (Primary to Zwift),Wahoo KICKR Snap (Secondary to Elemnt Bolt),314,321,-7
61632,1602614695,wahoo,"Zwift - Zwift Racing League | WTRL - Trainer took a little while to warm up, hence 20-minute being out. Numbers match from thereon in. ",4iiii Precision L (Primary to Zwift),Wahoo KICKR Snap (Secondary to Elemnt Bolt),357,360,-3
62885,1603026892,wahoo,Zwift - KISS at Race 100 - Americas (A),4iiii Precision L (Primary to Zwift),Wahoo KICKR Snap (Secondary to Elemnt Bolt),333,347,-14
63595,1603219706,wahoo,Zwift - Zwift Racing League | WTRL - EMEA (MEN) - TTT Grp 2 (A),4iiii Precision L (Primary to Zwift),Wahoo KICKR Snap (Secondary to Elemnt Bolt),343,333,10
66262,1603988095,wahoo,Zwift - OH MY CRIT! - The Double Race 1/2 (A),4iiii Precision L (Primary to Zwift),Wahoo KICKR Snap (Secondary to Elemnt Bolt),364,357,7
66263,1603991096,wahoo,Zwift - OH MY CRIT! - The Double Race 2/2 (A),4iiii Precision L (Primary to Zwift),Wahoo KICKR Snap (Secondary to Elemnt Bolt),318,310,8
69162,1604862229,wahoo,Zwift -  Tour De Spartacus  (E),4iiii Precision L (Primary to Zwift),Wahoo KICKR Snap (Secondary to Elemnt Bolt),401,375,26
80549,1607364887,wahoo,Zwift -  DBR Monday Race (A),4iiii Precision L (Primary to Zwift),Wahoo KICKR Snap (Secondary to Elemnt Bolt),334,329,5
80550,1607368796,wahoo,Zwift - Team TFC Mad Monday Races (A),4iiii Precision L (Primary to Zwift),Wahoo KICKR Snap (Secondary to Elemnt Bolt),339,331,8
83666,1608062025,wahoo,Zwift - Zwift Racing League | WTRL - Men&#039;s EMEA W1 DIVISION 1 (A),4iiii Precision L (Primary to Zwift),Wahoo KICKR Snap (Secondary to Elemnt Bolt),335,328,7
94949,1610388905,wahoo,Zwift -  DBR Monday Race (A),4iiii Precision L (Primary to Zwift),Wahoo KICKR Snap (Secondary to Elemnt Bolt),342,337,5
98102,1610810098,wahoo,Zwift - OH MY CRIT - Saturday Smash Race (A),4iiii Precision L (Primary to Zwift),Wahoo KICKR Snap (Secondary to Elemnt Bolt),367,352,15
99040,1610993701,wahoo,Zwift -  DBR Monday Race (A),4iiii Precision L (Primary to Zwift),Wahoo KICKR Snap (Secondary to Elemnt Bolt),379,364,15
109428,1612547996,wahoo,Zwift - KIRCHMAIR Race Series (A),4iiii Precision L (Primary to Zwift),Wahoo KICKR Snap (Secondary to Elemnt Bolt),383,382,1
109435,1612549804,wahoo,Zwift - KIRCHMAIR Race Series (A),4iiii Precision L (Primary to Zwift),Wahoo KICKR Snap (Secondary to Elemnt Bolt),345,338,7
111604,1612894943,wahoo,Zwift - Zwift Racing League | WTRL - Men&#039;s/Mixed EMEA E1 DIVISION 1 (A),4iiii Precision L (Primary to Zwift),Wahoo KICKR Snap (Secondary to Elemnt Bolt),359,345,14
55917,1600367399,wahoo,Zwift - Invitational League // Qualifying Race #2 (Men) ,Favero assioma UNO,Wahoo kickr V5,387,401,-14
58584,1601398797,wahoo,Zwift - Oivind Loining Bjerkseth (KALAS eSRT)&#039;s Meetup,Favero assioma UNO,Wahoo kickr V5,397,407,-10
65880,1603909796,wahoo,Zwift - NCF Vinter Cup 2020 - Runde 6 - Herrer (A),Favero assioma UNO,Wahoo kickr V5,385,409,-24
76001,1606414436,wahoo,Zwift - WTRL NOPINZ WORLD TTT CHAMPIONSHIPS - Zone 4 (C),Favero assioma UNO,Wahoo kickr V5,376,408,-32
77708,1606756908,wahoo,Zwift - Watopia,Favero assioma DUO,Wahoo kickr V5,323,335,-12
78064,1606842765,wahoo,Zwift - New Workout,Favero assioma DUO,Wahoo kickr V5,353,374,-21
80016,1607244592,wahoo,Zwift - Watopia,Favero assioma DUO,Wahoo kickr V5,278,284,-6
80228,1607274024,wahoo,Zwift - Nations Challenge // Norway (E),Favero assioma DUO,Wahoo kickr V5,344,350,-6
84030,1608145464,wahoo,Zwift - NCF 2020 TTT Challenge (E),Favero assioma DUO,Wahoo kickr V5,404,432,-28
84446,1608229796,wahoo,Zwift - FUSION DECEMBER CUP (A),Favero assioma DUO,Wahoo kickr V5,396,399,-3
19709,1584533415,neo,Quarq Dzero / Tacx Neo 2t,Quarq Dzero,Tacx Neo 2t,0,0,0
19829,1585245433,neo,Tacx Neo 2t / Quarq Dzero,Quarq Dzero,Tacx Neo 2t,422,416,6
19831,1585249821,neo,Tacx Neo 2t / Quarq Dzero,Quarq Dzero,Tacx Neo 2t,411,404,7
20921,1585674902,neo,Tacx Neo 2t / Quarq Dzero,Quarq Dzero,Tacx Neo 2t,430,420,10
23322,1586456994,neo,Zwift - Yorkshire Grand Prix Race (A),Quarq Dzero,Tacx Neo 2t,391,378,13
24960,1586969581,neo,Zwift - Swedish Zwift Racing Cup by SZR (A),Quarq Dzero,Tacx Neo 2t,443,469,-26
24962,1586973006,neo,Zwift - USA Cycling Race League by Indoor Specialist  (A),Quarq Dzero,Tacx Neo 2t,413,437,-24
27069,1587578063,neo,Zwift - USA Cycling Race League by Indoor Specialist  (A),Quarq Dzero,Tacx Neo 2t,462,481,-19
27398,1587661207,neo,Zwift - WTRL Team Time Trial Premier League (C),Quarq Dzero,Tacx Neo 2t,432,451,-19
27887,1587810585,neo,Zwift - 3R Volcano Climb Race - 1 Lap (22.4km/14mi 204m) (A),Quarq Dzero,Tacx Neo 2t,438,419,19
29353,1588182861,neo,Zwift - USA Cycling Race League by Indoor Specialist  (A),Quarq Dzero,Tacx Neo 2t,414,389,25
31512,1588500564,neo,Zwift - New Workout,Quarq Dzero,Tacx Neo 2t,419,407,12
31516,1588670320,neo,Zwift - The After Party Race (A),Quarq Dzero,Tacx Neo 2t,409,393,16
31735,1588702453,neo,Zwift - UNO X CUP powered by DCU & Feltet.dk (A),Quarq Dzero,Tacx Neo 2t,437,423,14
32535,1588874060,neo,Zwift - Team Italy Superveloce Race (A),Quarq Dzero,Tacx Neo 2t,388,375,13
32539,1588876189,neo,Zwift - ZHR Up & Down Race (A),Quarq Dzero,Tacx Neo 2t,431,417,14
32993,1589013008,neo,Zwift - DBR Sufferday League (A),Quarq Dzero,Tacx Neo 2t,478,462,16
33836,1589013008,neo,Zwift - DBR Sufferday League (A),Quarq Dzero,Tacx Neo 2t,478,462,16
33837,1589274272,neo,Zwift - 3R & Wahoo Ride Real Race Series - Round 1 of 7 (A),Quarq Dzero,Tacx Neo 2t,388,370,18
34085,1589307155,neo,Zwift - UNO X CUP powered by DCU & Feltet.dk (A),Quarq Dzero,Tacx Neo 2t,457,443,14
34767,1589477257,neo,Zwift - WTRL Team Time Trial Premier League (C),Quarq Dzero,Tacx Neo 2t,433,420,13
34937,1589455035,neo,Zwift ZADA Test - Three Sisters,Quarq Dzero,Tacx Neo 2t,492,477,15
36157,1589912085,neo,Zwift - UNO X CUP powered by DCU & Feltet.dk (A),Quarq Dzero,Tacx Neo 2t,449,426,23
36160,1589710211,neo,Zwift - 3R Sand & Sequoias - 1 Lap (20km/12.5mi 173m) (A),Quarq Dzero,Tacx Neo 2t,422,405,17
36701,1590081895,neo,Zwift - WTRL Team Time Trial Premier League (C),Quarq Dzero,Tacx Neo 2t,446,425,21
36704,1590084615,neo,Zwift - Team 3R&#039;s Choice: Stage 5 Longer Race A/B,Quarq Dzero,Tacx Neo 2t,473,458,15
37058,1590222574,neo,Zwift - DBR Sufferday League (A),Quarq Dzero,Tacx Neo 2t,437,423,14
37880,1590516912,neo,Zwift - UNO X CUP powered by DCU & Feltet.dk (A),Quarq Dzero,Tacx Neo 2t,496,480,16
37937,1590516912,neo,Zwift - UNO X CUP powered by DCU & Feltet.dk (A),Quarq Dzero,Tacx Neo 2t,496,480,16
38383,1590686786,neo,Zwift - WTRL Team Time Trial Premier League (C),Quarq Dzero,Tacx Neo 2t,421,396,25
38384,1590689715,neo,Zwift - Tour for All 2020: Stage 2 Longer Race A/B,Quarq Dzero,Tacx Neo 2t,385,369,16
40568,1591726465,neo,Zwift - UNO X CUP powered by DCU & Feltet.dk (A),Quarq Dzero,Tacx Neo 2t,452,428,24
42000,1592331312,neo,Zwift - UNO X CUP powered by DCU & Feltet.dk (A),Quarq Dzero,Tacx Neo 2t,409,391,18
42238,1592416485,neo,Zwift - 2 s�et 10 x 1/1,Quarq Dzero,Tacx Neo 2t,416,395,21
43264,1592936077,neo,Zwift - UNO X CUP powered by DCU & Feltet.dk (A),Quarq Dzero,Tacx Neo 2t,486,463,23
43419,1593017996,neo,Zwift - MIDWEEK Summer Series by SZR (A),Quarq Dzero,Tacx Neo 2t,400,378,22
43420,1593021608,neo,Zwift - Zwift NL League - The Watopia Series  (A),Quarq Dzero,Tacx Neo 2t,436,418,18
43995,1593364810,neo,Zwift - 3R Greater London 8 Hilly Race - 1 Lap (23.8km/14.8mi 238m) (A),Quarq Dzero,Tacx Neo 2t,432,412,20
44194,1593508183,neo,Zwift - SRAM Send it Series - Race 8 - Men&#039;s (E),Quarq Dzero,Tacx Neo 2t,436,428,8
44195,1593511187,neo,Zwift - KISS at Race - Americas AM (A),Quarq Dzero,Tacx Neo 2t,427,406,21
44196,1593368150,neo,Zwift - Chasing Cancellara ,Quarq Dzero,Tacx Neo 2t,471,448,23
44443,1593626080,neo,Zwift - USA Cycling Race League by Indoor Specialist (A),Quarq Dzero,Tacx Neo 2t,406,382,24
44444,1593629871,neo,Zwift - MINI CRIT by WKG (A),Quarq Dzero,Tacx Neo 2t,368,344,24
44708,1593799186,neo,Zwift - TeamPTz Friday&#039;s Race League (A),Quarq Dzero,Tacx Neo 2t,414,374,40
44822,1593853192,neo,Zwift - Cycling Ireland Yorkshire Classic (A),Quarq Dzero,Tacx Neo 2t,400,374,26
44823,1593858607,neo,Zwift - 3R Volcano Climb Race - 1 Lap (22.4km/14mi 204m) (A),Quarq Dzero,Tacx Neo 2t,422,400,22
44824,1593860982,neo,Zwift - DIRT Dadurday Chase Race  (A),Quarq Dzero,Tacx Neo 2t,342,327,15
45313,1594147181,neo,Zwift - 3R NYC Gotham Grind - 4 Laps (A),Quarq Dzero,Tacx Neo 2t,409,384,25
45400,1594201495,neo,Zwift - USA Cycling Race League by Indoor Specialist (A),Quarq Dzero,Tacx Neo 2t,377,360,17
46178,1594664391,neo,Zwift - TFC Mad Monday Summer Series (1 of 9) (A),Quarq Dzero,Tacx Neo 2t,409,395,14
46179,1594664391,neo,Zwift - TFC Mad Monday Summer Series (1 of 9) (A),Quarq Dzero,Tacx Neo 2t,409,395,14
46495,1594835685,neo,Zwift - USA Cycling Race League by Indoor Specialist (A),Quarq Dzero,Tacx Neo 2t,430,413,17
47447,1595520297,neo,Zwift - OH MY CRIT! - The Double Race 2/2 (A),Quarq Dzero,Tacx Neo 2t,410,389,21
48021,1595769305,neo,Zwift - KISS at Race 100 - Americas (A),Quarq Dzero,Tacx Neo 2t,451,435,16
48022,1595955593,neo,Zwift - Norseman Festival of Climbing: Ride #2 (E),Quarq Dzero,Tacx Neo 2t,448,430,18
48023,1595958893,neo,Zwift - Team Italy & Frenchy Fuzion League (A),Quarq Dzero,Tacx Neo 2t,422,405,17
48024,1595958893,neo,Zwift - Team Italy & Frenchy Fuzion League (A),Quarq Dzero,Tacx Neo 2t,422,405,17
48174,1596045303,neo,Zwift - USA Cycling Race League by Indoor Specialist (A),Quarq Dzero,Tacx Neo 2t,426,413,13
50168,1597485597,neo,Zwift - Longer Ride - 7 Days of Tarmac SL7: Stage 3,Quarq Dzero,Tacx Neo 2t,410,394,16
50430,1597573326,neo,Zwift - Shorter Ride - 7 Days of Tarmac SL7: Stage 3,Quarq Dzero,Tacx Neo 2t,442,425,17
50432,1597575597,neo,Zwift - Longer Ride - 7 Days of Tarmac SL7: Stage 1,Quarq Dzero,Tacx Neo 2t,410,392,18
50434,1597579913,neo,Zwift - Shorter Ride - 7 Days of Tarmac SL7: Stage 2,Quarq Dzero,Tacx Neo 2t,418,400,18
54329,1599638366,neo,Zwift - Giant Crit Crushers Race 1 (A),Quarq Dzero,Tacx Neo 2t,408,387,21
54330,1599639870,neo,Zwift - New Workout,Quarq Dzero,Tacx Neo 2t,414,400,14
54331,1599567872,neo,Zwift - EMU Japan Race (A),Quarq Dzero,Tacx Neo 2t,418,404,14
54336,1598612381,neo,Zwift - Off The MAAP Stage 1 Race (A),Quarq Dzero,Tacx Neo 2t,410,395,15
55146,1600106367,neo,Zwift - Invitational League // Qualifying Race #1,Quarq Dzero,Tacx Neo 2t,425,411,14
55153,1599906568,neo,Zwift - 3R Volcano Climb Race - 1 Lap (22.4km/14mi 204m) (A),Quarq Dzero,Tacx Neo 2t,406,392,14
56854,1600800232,neo,Zwift - 3R Sundown Race Series  (E),Quarq Dzero,Tacx Neo 2t,425,411,14
57053,1600883093,neo,Zwift - DCU powered by Feltet.dk (A),Quarq Dzero,Tacx Neo 2t,492,476,16
57234,1600960494,neo,Zwift - OH MY CRIT! - The Double Race 1/2 (A),Quarq Dzero,Tacx Neo 2t,389,372,17
57235,1600963491,neo,Zwift - OH MY CRIT! - The Double Race 2/2 (A),Quarq Dzero,Tacx Neo 2t,392,380,12
58545,1601487893,neo,Zwift - DCU powered by Feltet.dk (A),Quarq Dzero,Tacx Neo 2t,392,378,14
61319,1602528581,neo,Zwift - Premier Division // Zwift Racing League (men) ,Quarq Dzero,Tacx Neo 2t,482,466,16
63213,1603131706,neo,Zwift Racing League | WTRL - PREMIER DIVISION (MEN) - TTT,Quarq Dzero,Tacx Neo 2t,439,420,19
63967,1603299593,neo,Zwift - MIDWEEK Autumn Series by SZR (A),Quarq Dzero,Tacx Neo 2t,392,377,15
63969,1603303488,neo,Zwift - DBR HEINO CUP III (A),Quarq Dzero,Tacx Neo 2t,431,417,14
65242,1603742382,neo,Zwift - Premier Division // Zwift Racing League (men) (A),Quarq Dzero,Tacx Neo 2t,456,443,13
65243,1603387665,neo,Zwift - Espresso,Quarq Dzero,Tacx Neo 2t,430,411,19
65244,1603390971,neo,Zwift -  Kiss Racing Team / FastFitnessTips iTT series (E),Quarq Dzero,Tacx Neo 2t,430,415,15
65911,1603916837,wahoo,Zwift - Watopia - Three Sisters Test,Quarq Dzero,Wahoo Kickr v5,461,459,2
66243,1603995888,wahoo,Zwift - WTRL Team Time Trial Platinum League (C),Quarq Dzero,Wahoo Kickr v5,459,457,2
66244,1603999186,neo,Zwift - BRT Criterium Racing League (A),Quarq Dzero,Tacx Neo 2t,382,378,4
67266,1604344361,wahoo,Zwift - Premier Division // Zwift Racing League (men) (A),Quarq Dzero,Wahoo Kickr v5,438,437,1
68232,1604516387,wahoo,Zwift - DCU – Feltet.dk November series,Quarq Dzero,Wahoo Kickr v5,487,483,4
68233,1604602393,wahoo,Zwift - Espresso,Quarq Dzero,Wahoo Kickr v5,437,433,4
69508,1604951975,wahoo,Zwift - Premier Division // Zwift Racing League (men) (A),Quarq Dzero,Wahoo Kickr v5,486,488,-2
70372,1605121187,neo,Zwift - DCU – Feltet.dk November series (A),Quarq Dzero,Tacx Neo 2t,449,448,1
70788,1605207407,neo,Zwift - Espresso,Quarq Dzero,Tacx Neo 2t,423,417,6
73176,1605553706,wahoo,Zwift - Premier Division // Zwift Racing League (men) (A),Quarq Dzero,Wahoo Kickr v5,447,447,0
73179,1605814162,neo,Zwift - World Championships Experience // Danish Cycling Federation - Victory - DreamTeam - Ready to chase the Rainbowjersey!,Quarq Dzero,Tacx Neo 2t,404,404,0
73983,1605877850,neo,Zwift - New Workout,Quarq Dzero,Tacx Neo 2t,344,338,6
73984,1605955439,neo,Zwift - Into the Red by RELENTLESS (A),Quarq Dzero,Tacx Neo 2t,457,445,12
74699,1606161560,wahoo,Zwift - Premier Division // Zwift Racing League (men) (A),Quarq Dzero,Wahoo Kickr v5,476,473,3
75655,1606327168,neo,Zwift - MIDWEEK Autumn Series by SZR (A),Quarq Dzero,Tacx Neo 2t,402,396,6
75656,1606330771,neo,Zwift - DCU – Feltet.dk November series (A),Quarq Dzero,Tacx Neo 2t,438,435,3
76521,1606416208,wahoo,Zwift - WTRL NOPINZ WORLD TTT CHAMPIONSHIPS - Zone 6 (C),Quarq Dzero,Wahoo Kickr 2018,448,443,5
77740,1606763606,wahoo,Zwift - Premier Division // Zwift Racing League (men) (A),Quarq Dzero,Wahoo Kickr v5,444,442,2
84516,1608229766,neo,Zwift - 15&#039; sweetspot,Quarq Dzero,Tacx Neo 2t,417,405,12
93793,1610184585,wahoo,Zwift - DBR SufferDay League III (A),Quarq Dzero,Wahoo Kickr v5,459,452,7
95080,1610392469,wahoo,Zwift - Premier Division // Zwift Racing League (men) (A),Quarq Dzero,Wahoo Kickr v5,408,403,5
97116,1610648978,wahoo,Zwift - FUSION WINTER CUP (A),Quarq Dzero,Wahoo Kickr v5,446,444,2
97933,1610789383,wahoo,Zwift - DBR SufferDay League III (A),Quarq Dzero,Wahoo Kickr v5,464,464,0
99282,1610999013,wahoo,Zwift - Premier Division // Zwift Racing League (men) (A),Quarq Dzero,Wahoo Kickr v5,453,458,-5
100424,1611168267,wahoo,Zwift - Danmarks Cykle Union & Partners 2/6 (A),Quarq Dzero,Wahoo Kickr v5,441,438,3
101042,1611253771,wahoo,FUSION WINTER CUP // victory,Quarq Dzero,Wahoo Kickr v5,419,417,2
103018,1611601469,wahoo,Zwift - Premier Division // Zwift Racing League (men) (A),Quarq Dzero,Wahoo Kickr v5,459,453,6
104264,1611773073,wahoo,Zwift - Danmarks Cykle Union & Partners 3/6 (A),Quarq Dzero,Wahoo Kickr v5,442,440,2
104786,1611858575,wahoo,Zwift - FUSION WINTER CUP (A),Quarq Dzero,Wahoo Kickr v5,447,441,6
106952,1612209997,wahoo,Zwift - Premier Division // Zwift Racing League (men) (A),Quarq Dzero,Wahoo Kickr v5,412,407,5
108371,1612377893,wahoo,Zwift - Danmarks Cykle Union & Partners 4/6 (A),Quarq Dzero,Wahoo Kickr v5,431,420,11
110567,1612707283,wahoo,Zwift - KISS 100 Race Series - Americas (A),Quarq Dzero,Wahoo Kickr v5,465,452,13
111065,1612812240,wahoo,Zwift - Premier Division // Zwift Racing League (men) (A),Quarq Dzero,Wahoo Kickr v5,452,451,1
112294,1612982688,wahoo,Zwift - Danmarks Cykle Union & Partners 5/6 (A),Quarq Dzero,Wahoo Kickr v5,457,456,1
115397,1613419305,wahoo,Zwift - Premier Division // Zwift Racing League (men) (A),Quarq Dzero,Wahoo Kickr v5,468,455,13
116740,1613587493,wahoo,Zwift - Danmarks Cykle Union & Partners 6/6 (A),Quarq Dzero,Wahoo Kickr v5,405,405,0
122622,1614630064,wahoo,Zwift - Premier Division // Zwift Racing League (men) (A),Quarq Dzero,Wahoo Kickr v5,428,429,-1
125437,1615131014,wahoo,Zwift - Absa Cape Epic Stage 1 pb Oakley - Open (A),Quarq Dzero,Wahoo Kickr v5,444,426,18
125438,1615132800,wahoo,Zwift - 3R Super Six Sunday Race (A),Quarq Dzero,Wahoo Kickr v5,449,432,17
129194,1615919389,wahoo,Zwift - CeramicSpeed Race Series: Open Race (A),Quarq Dzero,Wahoo Kickr v5,466,442,24
14780,1582156853,wahoo,Zwift - BRT Wednesday Night Race (A),Garmin Vector 2,Wahoo Kickr,317,314,3
70848,1605214423,neo,Zwift - Watopia,Garmin Vector 2,Neo 2T,275,272,3
72585,1605715787,neo,3R Tick Tock Flat Race - 2 Lap (36km/22.4mi 100m),Garmin Vector 2,Neo 2T,366,366,0
78628,1606935895,neo,Zwift - DBR Wednesday Race (A),Garmin Vector 2,Neo 2T,380,374,6
78829,1606993179,neo,Zwift - KISS Race Series - Americas AM (A),Garmin Vector 2,Neo 2T,347,346,1
79185,1607039997,neo,Zwift - Kinetic Group Ride (B),Garmin Vector 2,Neo 2T,225,223,2
81036,1607525060,neo,Zwift - Men&#039;s Elite // 2020 UCI Cycling Esports World Championships,Garmin Vector 2,Neo 2T,379,381,-2
106237,1612081799,wahoo,Zwift - Flanders Endurance Race League (A),power,wahoo kickr core,489,491,-2
107526,1612289702,wahoo,Zwift - Zwift Racing League | WTRL - Men&#039;s/Mixed EMEA E1 DIVISION 1 (A),power,wahoo kickr,482,487,-5
109590,1612547998,wahoo,Zwift - KIRCHMAIR Race Series (A),power,Wahoo core,463,463,0
114310,1613239197,wahoo,Zwift - TDZ Stage 1: Longer Ride,power,Wahoo core,427,425,2
114555,1613293498,wahoo,Zwift - Newbury Velo Road Race (A),power,Wahoo core,504,504,0
116617,1613584796,wahoo,Zwift - MIDWEEK Winter Series by SZR (A),power,Wahoo core,438,438,0
121631,1614439796,wahoo,Zwift - Team Draft Crit City Race (A),stages power,wahoo kickr core,494,493,1
124985,1615039203,wahoo,Zwift - The P Race (A),stages power,Wahoo core,428,427,1
125294,1615104296,wahoo,Zwift - 3R Volcano Circuit - 6 Laps (A),stages power,Wahoo core,466,470,-4
126185,1615310996,wahoo,Zwift - WTRL Racing (A),stages power,Wahoo core,537,537,0
126551,1615399197,wahoo,Zwift - MIDWEEK Crit Race Series by SZR (A),stages power,Wahoo core,460,462,-2
127563,1615571999,wahoo,Zwift - KIRCHMAIR Race Series (A),stages power,Wahoo core,432,434,-2
127566,1615573797,wahoo,Zwift - KIRCHMAIR Race Series (A),stages power,Wahoo core,437,436,1
127982,1615648497,wahoo,Zwift - OH MY CRIT!! - Saturday Smash Race (A),stages power,Wahoo core,478,477,1
129111,1615915802,wahoo,Zwift - WTRL Racing (A),stages power,Wahoo core,402,400,2
48038,1595961616,wahoo,Zwift - 3R Turbocharged Team Race Series - Round 3 (A) 1st mini V,Quarq Dzero,Wahoo Kickr 18,438,428,10
50563,1597776005,wahoo,Zwift - 3R Turbocharged Team Race Series - Round 6 (A) mini V,Quarq Dzero,Wahoo Kickr 18,391,386,5
58053,1601311202,wahoo,Zwift - Team Italy PISSEI Race (A) mini V win,39D4C5E1,Wahoo Kickr 18,377,375,2
59626,1601921999,wahoo,Zwift - TFC Mad Monday Autumn Series (A) mini V WIN!,Quarq Dzero,Wahoo Kickr 18,363,363,0
60314,1602173117,wahoo,Zwift - OH MY CRIT! - The Double Race 2/2 (A) mini V,Quarq Dzero,Wahoo Kickr 18,394,399,-5
61182,1602522898,wahoo,Zwift - DBR Ride´N´Roll League  mini V,Quarq Dzero,Wahoo Kickr 18,357,357,0
61183,1602522898,wahoo,Zwift - DBR Ride´N´Roll League  mini V,Quarq Dzero,Wahoo Kickr 18,357,357,0
61874,1602694801,wahoo,Zwift - MIDWEEK Autumn Series by SZR (A) mini V 2nd p/b sprinting at 500m to go,39E9E290,Wahoo Kickr 18,404,415,-11
68576,1604689182,wahoo,Zwift -  Tour De Spartacus  (E) mini V,Quarq Dzero,Wahoo Kickr 18,459,478,-19
68860,1604775838,wahoo,Zwift -  Tour De Spartacus  (E) mini V,Quarq Dzero 3 sec,Wahoo Kickr 18,388,397,-9
76067,1606416548,wahoo,Zwift - WTRL NOPINZ WORLD TTT CHAMPIONSHIPS - Zone 7 (C) mini V owww,Quarq Dzero,Wahoo Kickr 18,429,411,18
121674,1614438606,wahoo,Zwift - OH MY CRIT!! - Saturday Smash Race (A) mini V,Quarq Dzero,Wahoo Kickr 18,395,375,20
121676,1614444297,wahoo,Zwift - 02/27/2021,Quarq Dzero,Wahoo Kickr 18,399,385,14
123968,1614874344,wahoo,Zwift - OH MY CRIT!! - The Double Race 1/2 (A) mini V,Quarq Dzero,Wahoo Kickr 18,418,410,8
123979,1614877523,wahoo,Zwift - OH MY CRIT!! - The Double Race 2/2 (A) mini V,Evening_ride_dr2,Wahoo Kickr 18,427,420,7
126994,1615482316,wahoo,Zwift - OH MY CRIT!! - The Double Race 2/2 (A) mini V felt better than race 1,Quarq Dzero,Wahoo Kickr 18,410,410,0
126995,1615482316,wahoo,Zwift - OH MY CRIT!! - The Double Race 2/2 (A) mini V felt better than race 1,Quarq Dzero,Wahoo Kickr 18,0,0,0
127009,1615482316,wahoo,Zwift - OH MY CRIT!! - The Double Race 2/2 (A) mini V felt better than race 1,Quarq Dzero,Wahoo Kickr 18,423,410,13
63944,1603299596,wahoo,Zwift - MIDWEEK Autumn Series by SZR (A),PowerTap P1 Dual,Wahoo Kickr,359,358,1
64206,1603387018,wahoo,Zwift - Espresso,PowerTap P1 Dual,Wahoo Kickr,355,360,-5
64576,1603475394,wahoo,Zwift - Team CLS Hills &#039;n&#039; Thrills Racing S4 (E),PowerTap P1 Dual,Wahoo Kickr,314,304,10
65540,1603825197,wahoo,Zwift - KISS at Race - EU PM (A),PowerTap P1 Dual,Wahoo Kickr,381,375,6
65547,1603819798,wahoo,Zwift - WTRL Racing (A),PowerTap P1 Dual,Wahoo Kickr,389,377,12
65881,1603907994,wahoo,Zwift - MIDWEEK Autumn Series by SZR (A),PowerTap P1 Dual,Wahoo Kickr,360,353,7
66721,1604157296,wahoo,Zwift - OH MY CRIT - Saturday Smash Race (A),PowerTap P1 Dual,Wahoo Kickr,349,345,4
67023,1597138228,wahoo,Zwift - Stages of DIRT (A),PowerTap P1 Dual,Wahoo Kickr,364,362,2
67306,1604344435,wahoo,Zwift - Premier Division // Zwift Racing League (men) (A),PowerTap P1 Dual,Wahoo Kickr,370,373,-3
67629,1604426732,wahoo,Zwift - Zwift Time Trial Tuesday: Bologna (E),PowerTap P1 Dual,Wahoo Kickr,367,372,-5
67630,1604426732,wahoo,Zwift - Zwift Time Trial Tuesday: Bologna (E),PowerTap P1 Dual,Wahoo Kickr,367,372,-5
68067,1604573990,wahoo,Zwift - KISS at Race - Americas AM (A),PowerTap P1 Dual,Wahoo Kickr,336,339,-3
68247,1604602019,wahoo,Zwift - 11/05/2020,PowerTap P1 Dual,Wahoo Kickr,354,355,-1
68884,1604775836,wahoo,Zwift - 11/07/2020,PowerTap P1 Dual,Wahoo Kickr,351,346,5
69130,1604862226,wahoo,Zwift -  Tour De Spartacus  (E),PowerTap P1 Dual,Wahoo Kickr,393,389,4
69420,1604951987,wahoo,Premier Division // Zwift Racing League (men),PowerTap P1 Dual,Wahoo Kickr,406,396,10
69794,1605029396,wahoo,Zwift - WTRL Racing (A),PowerTap P1 Dual,Wahoo Kickr,360,363,-3
71050,1605269095,wahoo,Zwift - 3R Greater London 8 Hilly Race - 1 Lap (23.8km/14.8mi 238m) (A),PowerTap P1 Dual,Wahoo Kickr,399,396,3
72022,1605553502,wahoo,Zwift - Premier Division // Zwift Racing League (men) (A),PowerTap P1 Dual,Wahoo Kickr,343,354,-11
72239,1605634200,wahoo,Zwift - WTRL Racing (A),PowerTap P1 Dual,Wahoo Kickr,397,397,0
72695,1605722396,wahoo,Zwift - MIDWEEK Autumn Series by SZR (A),PowerTap P1 Dual,Wahoo Kickr,347,342,5
73686,1605898796,wahoo,Zwift - Team IRL Without Borders Race (A),PowerTap P1 Dual,Wahoo Kickr,375,372,3
74706,1606161592,wahoo,Zwift - Premier Division // Zwift Racing League (men) (A),PowerTap P1 Dual,Wahoo Kickr,388,398,-10
75066,1606238994,wahoo,Zwift - WTRL Racing (A),PowerTap P1 Dual,Wahoo Kickr,384,383,1
75592,1606327191,wahoo,Zwift - Watopia,PowerTap P1 Dual,Wahoo Kickr,355,350,5
76098,1606416414,wahoo,WTRL NOPINZ WORLD TTT CHAMPIONSHIPS - Zone 7,PowerTap P1 Dual,Wahoo Kickr,367,371,-4
76705,1606501792,wahoo,Zwift - KIRCHMAIR Race Series (A),PowerTap P1 Dual,Wahoo Kickr,343,336,7
77684,1606763600,wahoo,Zwift - Premier Division // Zwift Racing League (men) (A),PowerTap P1 Dual,Wahoo Kickr,345,358,-13
78157,1606846196,wahoo,SZR iTT Winter Racing League,PowerTap P1 Dual,Wahoo Kickr,354,349,5
78828,1606932011,wahoo,Zwift - MIDWEEK Winter Series by SZR- Dual dropout (A),PowerTap P1 Dual,Wahoo Kickr,359,341,18
79050,1607021941,wahoo,BENELIGA 2020-2021,PowerTap P1 Dual,Wahoo Kickr,383,368,15
84402,1608231594,wahoo,BENELIGA 2020-2021,PowerTap P1 Dual,Wahoo Kickr,377,388,-11
93025,1610045683,wahoo,BENELIGA 2020-2021,2021-01-07-19-54-43,Wahoo Kickr,364,369,-5
95000,1610392488,wahoo,Zwift - Premier Division // Zwift Racing League (men) (A),PowerTap P1 Dual,Wahoo Kickr,364,369,-5
95721,1610477693,wahoo,Zwift - Team Italy & Frenchy Fuzion League (A),PowerTap P1 Dual,Wahoo Kickr,361,371,-10
97081,1610650450,wahoo,BENELIGA 2020-2021,PowerTap P1 Dual,Wahoo Kickr,388,377,11
98117,1610814591,wahoo,Zwift - TEAM VEGAN Tofu Tornado (A),PowerTap P1 Dual,Wahoo Kickr,405,392,13
99171,1610999652,wahoo,Zwift - Premier Division // Zwift Racing League (men) (A) Dropouts!!!,PowerTap P1 Dual,Wahoo Kickr,350,379,-29
99703,1611081295,wahoo,Team Sportslab UK Road Race League,PowerTap P1 Dual,Wahoo Kickr,334,333,1
102880,1611601490,wahoo,Zwift - Premier Division // Zwift Racing League (men) (A),PowerTap P1 Dual,Wahoo Kickr,401,401,0
105693,1612024196,wahoo,Zwift - Veganuary21 Stage 5 iTT (A),PowerTap P1 Dual,Wahoo Kickr,365,379,-14
106890,1612210013,wahoo,Zwift - Premier Division // Zwift Racing League (men) (A),PowerTap P1 Dual,Wahoo Kickr,356,361,-5
111080,1612808059,wahoo,Zwift -  DBR Monday Race (A),PowerTap P1 Dual,Wahoo Kickr,387,381,6
112926,1613067227,wahoo,BRT TTT,PowerTap P1 Dual,Wahoo Kickr,380,377,3
115359,1613419270,wahoo,Zwift - Premier Division // Zwift Racing League (men) (A),PowerTap P1 Dual,Wahoo Kickr,381,386,-5
119119,1614020963,wahoo,Zwift - Premier Division // Zwift Racing League (men) (A),PowerTap P1 Dual,Wahoo Kickr,352,337,15
122565,1614629816,wahoo,Zwift - Premier Division // Zwift Racing League (men) (A),PowerTap P1 Dual,Wahoo Kickr,376,361,15
55021,1600104892,wahoo,Zwift - 09/14/2020,Power2Max,Wahoo Kickr,350,358,-8
55302,1600164000,wahoo,Zwift - 09/15/2020,Power2Max,Wahoo Kickr,392,405,-13
56396,1600605053,wahoo,Invitational League // Qualifying Race #3 (Men),Power2Max,Wahoo Kickr,354,366,-12
56840,1600798702,wahoo,Zwift - 3R Sundown Race Series  (E),Power2Max,Wahoo Kickr,364,380,-16
57181,1600884600,wahoo,3 SISTERS TEST,Power2Max,Wahoo Kickr,395,405,-10
57670,1601116270,wahoo,Zwift - Into the Red by RELENTLESS (A),Power2Max,Wahoo Kickr,361,367,-6
57912,1601212389,wahoo,Zwift - KISS at Race 100 - Americas (A),Power2Max,Wahoo Kickr,393,405,-12
58190,1601372214,wahoo,Zwift - KISS at Race - Americas AM (A),Power2Max,Wahoo Kickr,344,349,-5
58430,1601457473,wahoo,Zwift - USA Cycling Race League by Indoor Specialist (A),Power2Max,Wahoo Kickr,362,373,-11
59020,1601631647,wahoo,Zwift - 3R Innsbruckring Flat Race - 4 Laps (35.2km/21.9mi 308m) (A),Power2Max,Wahoo Kickr,353,360,-7
59215,1601720534,wahoo,Zwift - Into the Red by RELENTLESS (A),Power2Max,Wahoo Kickr,370,380,-10
59747,1601977176,wahoo,Zwift - KISS at Race - Americas AM (A),Power2Max,Wahoo Kickr,354,366,-12
60317,1602168566,wahoo,Zwift - OH MY CRIT! - The Double Race 1/2 (A),Power2Max,Wahoo Kickr,320,333,-13
60319,1602168566,wahoo,Zwift - OH MY CRIT! - The Double Race 2/2 (A),Power2Max,Wahoo Kickr,365,381,-16
60546,1602237881,wahoo,Zwift - 3R Innsbruckring Flat Race - 4 Laps (35.2km/21.9mi 308m) (A),Power2Max,Wahoo Kickr,384,382,2
60759,1602324797,wahoo,Zwift - Into the Red by RELENTLESS (A),Power2Max,Wahoo Kickr,387,400,-13
61437,1602577644,wahoo,Zwift - 10/13/2020,Power2Max,Wahoo Kickr,385,392,-7
61793,1602668943,wahoo,Zwift - 3R Road To Ruins Hilly Race - 1 Lap (29..2km/18.1mi 275m) (A),Power2Max,Wahoo Kickr,382,393,-11
62127,1602776322,wahoo,Zwift - OH MY CRIT! - The Double Race 2/2 (A),Power2Max,Wahoo Kickr,334,349,-15
62380,1602841807,wahoo,Zwift - 3R Innsbruckring Flat Race - 4 Laps (35.2km/21.9mi 308m) (A),Power2Max,Wahoo Kickr,369,380,-11
63325,1603182299,wahoo,Zwift - Zwift Racing League | WTRL - APAC (MEN) - TTT (B),Power2Max,Wahoo Kickr,386,395,-9
64084,1603359669,wahoo,Zwift - KISS at Race - Americas AM (A),Power2Max,Wahoo Kickr,382,385,-3
65334,1603787256,wahoo,Zwift - 10/27/2020,Power2Max,Wahoo Kickr,371,382,-11
65992,1603965557,wahoo,Zwift - KISS at Race - Americas AM (A),Power2Max,Wahoo Kickr,399,414,-15
68110,1604486713,wahoo,Zwift - USA Cycling Race League by Indoor Specialist (A),Power2Max,Wahoo Kickr,367,371,-4
68582,1604687290,wahoo,Zwift -  Tour De Spartacus  (E),Power2Max,Wahoo Kickr,405,409,-4
68852,1604774418,wahoo,Zwift -  Tour De Spartacus  (E),Power2Max,Wahoo Kickr,367,375,-8
69192,1604862175,wahoo,Zwift -  Tour De Spartacus  (E),Power2Max,Wahoo Kickr,400,407,-7
69590,1604997689,wahoo,Zwift - Zwift Racing League | WTRL - APAC (MEN) -  Division 1 (A),Power2Max,Wahoo Kickr,410,425,-15
70583,1605178519,wahoo,Zwift - KISS at Race - Americas AM (A),Power2Max,Wahoo Kickr,379,384,-5
71300,1605350692,wahoo,Zwift - Into the Red by RELENTLESS (A),Power2Max,Wahoo Kickr,369,378,-9
72051,1605603313,wahoo,Zwift - 11/17/2020,Power2Max,Wahoo Kickr,377,384,-7
72900,1605782416,wahoo,Zwift - KISS Race Series - Americas AM (A),Power2Max,Wahoo Kickr,327,336,-9
74891,1606207514,wahoo,Zwift - Zwift Racing League | WTRL - Men&#039;s APAC DIVISION 1,Power2Max,Wahoo Kickr,377,389,-12
124574,1614970985,wahoo,Zwift - 03/05/2021,Favero Assioma Duo,Wahoo Kickr,369,369,0
125146,1615059974,wahoo,Zwift - Zwift Racing League | WTRL Battle Royale Playoff - Men&#039;s TTT (A),Favero Assioma Duo,Wahoo Kickr,376,373,3
126021,1615287299,wahoo,Zwift - KISS Race Series - Americas AM (A),Favero Assioma Duo,Wahoo Kickr,363,363,0
126886,1615460332,wahoo,Zwift - KISS Race Series - Americas AM (A),Favero Assioma Duo,Wahoo Kickr,380,377,3
129066,1615906204,wahoo,Zwift - Watopia,Favero Assioma Duo,Wahoo Kickr,399,404,-5
55203,1600107597,neo,Zwift - TFC Mad Monday Autumn Series (1 of 9) (A),Shimano Dura Ace power meter,Tacx Neo T2,389,380,9
66891,1604228716,neo,Zwift - 3R Innsbruckring Sprint Race - 1 Lap (8.8km/5.5mi 77m) (A),Shimano Dura Ace power meter,Tacx Neo T2,364,352,12
89051,1609344590,neo,Zwift - 3R Tick Tock Flat Race - 2 Lap (36km/22.4mi 100m) (A),Favero Assioma duo,Tacx Neo T2,377,363,14
89345,1609414309,neo,Zwift - EMU Japan Short Race (A),Favero Assioma duo,Tacx Neo T2,362,342,20
3445,1572376200,wahoo,Zwift - WORLDOFFUSION Racing League (A),Shimano dura ace power meter,Wahoo kicker 2018,458,452,6
8382,1578423430,wahoo,Zwift - 3R Ultimate Racing League - Round 1 (A) Dobbel KALAS,Shimano dura ace power meter,Wahoo kicker 2018,395,392,3
8529,1578504600,wahoo,Zwift - FIETS Magazine Race Series (A),Shimano dura ace power meter,Wahoo kicker 2018,440,429,11
12776,1581015600,wahoo,Zwift - KALAS Cup - Round 2 (A) #hammeren,Shimano dura ace power meter,Wahoo kicker 2018,451,446,5
13839,1581620403,wahoo,Zwift - KALAS Cup - Round 3 (A),Shimano dura ace power meter,Wahoo kicker 2018 to Wahoo Bolt,415,403,12
19511,1585073257,wahoo,Zwift - Tour of Watopia Pro-Am Men&#039;s Race #3 (A),Shimano dura ace power meter,Wahoo kicker 2018,399,391,8
25834,1587142506,wahoo,Zwift - Richmond Challenge // Zwift Classic (A),Shimano dura ace power meter,Assioma duo 2018 to Wahoo Bolt,449,438,11
48049,1595961714,wahoo,Zwift - KISS at Race - EU PM (A),Assioma duo 2018 to Wahoo roam,Wahoo Kickrbike 2020,390,393,-3
48186,1596044524,wahoo,Zwift - USA Cycling Race League by Indoor Specialist (A),Assioma duo to Wahoo roam,Wahoo Kickrbike 2020,400,399,1
54740,1599924674,wahoo,Zwift - 3R Classique Flat Race - 4 Laps (26.9km/16.7mi 76m) (A),Assioma duo to Wahoo roam,Wahoo Kickrbike 2020,385,389,-4
55096,1600104672,wahoo,Zwift - Invitational League // Qualifying Race #1,Assioma duo to Wahoo roam,Wahoo Kickrbike 2020,416,411,5
55828,1600364726,wahoo,Zwift - Invitational League // Qualifying Race #2 (Men) ,Assioma duo to Wahoo roam,Wahoo Kickrbike 2020,405,402,3
57059,1600881315,wahoo,Zwift - NCF Vinter Cup 2020 - Runde 1 - Herrer (A),Assioma duo to Wahoo roam,Wahoo Kickrbike 2020,403,405,-2
58602,1601485022,wahoo,Zwift - NCF Vinter Cup 2020 - Runde 2 - Herrer (A),Assioma duo 2018 to Wahoo roam,Wahoo Kickrbike 2020,397,396,1
58980,1601571366,wahoo,Zwift - Espresso,Assioma duo to Wahoo roam,Wahoo kicker 2018,384,385,-1
60144,1602089884,wahoo,Zwift - NCF Vinter Cup 2020 - Runde 3 - Herrer (A),Assioma duo to Wahoo roam,Wahoo Kickrbike 2020,381,383,-2
60370,1602175551,wahoo,Zwift - Espresso TTT,Assioma duo to Wahoo roam,Wahoo Kickrbike 2020,378,379,-1
61271,1602526039,wahoo,Zwift - Premier Division // Zwift Racing League (men) ,Assioma duo to Wahoo roam,Wahoo Kickrbike 2020,449,445,4
63066,1603128960,wahoo,Zwift - Premier Division // Zwift Racing League (men) ,Assioma duo to Wahoo roam,Wahoo Kickrbike 2020,416,418,-2
63868,1603300362,wahoo,Zwift - NCF Vinter Cup 2020 - Runde 5 - Herrer (A),Assioma duo to Wahoo roam,Wahoo Kickrbike 2020,410,407,3
63953,1603300362,wahoo,Zwift - NCF Vinter Cup 2020 - Runde 5 - Herrer (A),Assioma duo 2018 to Wahoo roam,Wahoo Kickrbike 2020,410,407,3
65166,1603739869,wahoo,Zwift - Premier Division // Zwift Racing League (men) (A),Assioma duo to Wahoo roam,Wahoo Kickrbike 2020,416,416,0
65960,1603908241,wahoo,Zwift - NCF Vinter Cup 2020 - Runde 6 - Herrer (A),Assioma duo to Wahoo roam,Wahoo Kickrbike 2020,456,450,6
67264,1604341905,wahoo,Zwift - Premier Division // Zwift Racing League (men) (A),Assioma duo to Wahoo roam,Wahoo Kickrbike 2020,422,422,0
69419,1604950135,wahoo,Zwift - Premier Division // Zwift Racing League (men) (A),Assioma duo to Wahoo roam,Wahoo Kickrbike 2020,459,455,4
70385,1605116722,wahoo,Zwift - NCF Vinter Cup 2020 - Runde 8 - Herrer (A),Assioma duo to Wahoo roam,Wahoo Kickrbike 2020,415,417,-2
72147,1605551579,wahoo,Zwift - Premier Division // Zwift Racing League (men) (A),Assioma duo to Wahoo roam,Wahoo Kickrbike 2020,415,415,0
74684,1606158106,wahoo,Zwift - Premier Division // Zwift Racing League (men) (A),Assioma duo to Wahoo roam,Wahoo Kickrbike 2020,439,443,-4
92595,1609954138,wahoo,Zwift - MIDWEEK Winter Series by SZR (A),Assioma duo to Wahoo roam,Wahoo Kickrbike 2020,390,377,13
94975,1610392491,wahoo,Zwift - Premier Division // Zwift Racing League (men) (A),Assioma duo to Wahoo roam,Wahoo Kickrbike 2020,427,405,22
96466,1610560753,wahoo,Zwift - NCF Vintercup 2021 - Runde 1 - Herrer (A),Assioma duo to Wahoo roam,Wahoo Kickrbike 2020,405,392,13
100360,1611165325,wahoo,Zwift - NCF Vintercup 2021 - Runde 2 - Herrer (A),Assioma duo to Wahoo roam,Wahoo Kickrbike 2020,355,348,7
102921,1611597628,wahoo,Zwift - Premier Division // Zwift Racing League (men) (A),Assioma duo to Wahoo roam,Wahoo Kickrbike 2020,416,409,7
104173,1611770224,wahoo,Zwift - NCF Vintercup 2021 - Runde 3 - Herrer (A),Assioma duo to Wahoo roam,Wahoo Kickrbike 2020,460,452,8
106898,1612208064,wahoo,Zwift - Premier Division // Zwift Racing League (men) (A),Assioma duo to Wahoo roam,Wahoo Kickrbike 2020,410,402,8
108212,1612375055,wahoo,Zwift - NCF Vintercup 2021 - Runde 4 - Herrer (A),Assioma duo to Wahoo roam,Wahoo Kickrbike 2020,423,411,12
112363,1612980774,wahoo,Zwift - Movistar Team Challenge // Round 1 (A),Assioma duo to Wahoo roam,Wahoo Kickrbike 2020,403,395,8
113587,1613154969,wahoo,Zwift - Movistar Team Challenge // Round 1 (men) #2,Assioma duo to Wahoo roam,Wahoo Kickrbike 2020,466,456,10
115362,1613417541,wahoo,Zwift - Premier Division // Zwift Racing League (men) (A),Assioma duo to Wahoo roam,Wahoo Kickrbike 2020,437,427,10
116794,1613586098,wahoo,Zwift - Movistar Team Challenge // Round 2 (men) - Race 3/4 Bad leg day!,Assioma duo to Wahoo roam,Wahoo Kickrbike 2020,413,405,8
117895,1613759334,wahoo,Zwift - Movistar Team Challenge // Round 2 (men),Assioma duo to Wahoo roam,Wahoo Kickrbike 2020,458,451,7
119126,1614017209,wahoo,Zwift - Premier Division // Zwift Racing League (men) (A),Assioma duo to Wahoo roam,Wahoo Kickrbike 2020,415,403,12
124169,1614886114,wahoo,Zwift - Movistar Team Challenge // Points Race (men),Assioma duo to Wahoo roam,Wahoo Kickrbike 2020,398,387,11
126606,1615393079,wahoo,Zwift - Scandinavian Cup 2021 - Round 3 - Men (A),Assioma duo to Wahoo roam,Wahoo Kickrbike 2020,440,429,11
129203,1615917369,wahoo,Zwift - CeramicSpeed Race Series: Open Race (A),Assioma duo to Wahoo roam,Wahoo Kickrbike 2020,452,444,8
14580,1582053298,wahoo,Zwift - Feltet.dk Race Series,Quarq DFour,Wahoo Kickr 2018,359,337,22
16637,1583262897,wahoo,Zwift - Feltet.dk Race Series (A),Quarq DFour,Wahoo Kickr 2018,385,365,20
19518,1585076827,wahoo,Zwift - Feltet.dk Race Series (A),Quarq DFour,Wahoo Kickr 2018,381,360,21
21130,1585678512,wahoo,Zwift - Feltet.dk Race Series (A),Quarq DFour,Wahoo Kickr 2018,387,370,17
22219,1586077199,wahoo,Zwift - Ronde van Zwift (A),Quarq DFour,Wahoo Kickr 2018,380,360,20
25008,1586889385,wahoo,Zwift - 3R Spring Loaded Race Series - Round 3of6 (A),Quarq DFour,Wahoo Kickr 2018,405,378,27
25627,1587057851,wahoo,Zwift - WTRL Team Time Trial (C),Quarq DFour,Wahoo Kickr 2018,368,358,10
25630,1587148295,wahoo,Zwift - Newbury Velo Crit (A),Quarq DFour,Wahoo Kickr 2018,384,367,17
29137,1588181282,wahoo,Zwift - Danmarks Cykle Union – mid-week racing  (A),Quarq DFour,Wahoo Kickr 2018,391,361,30
29608,1588242760,wahoo,Zwift - Watopia,Quarq DFour to Garmin 1030,Wahoo Kickr 2018 to Zwift,345,340,5
30655,1588434531,wahoo,Zwift - Watopia,Quarq DFour to Zwift,Wahoo Kickr 2018 to Garmin 1030,325,307,18
31747,1588701456,wahoo,Zwift - UNO X CUP powered by DCU & Feltet.dk (A),Quarq DFour to Zwift,Wahoo Kickr 2018 to Garmin 1030,399,399,0
34064,1589307003,wahoo,Zwift - UNO X CUP powered by DCU & Feltet.dk (A),Quarq DFour to Zwift,Wahoo Kickr 2018 to Garmin 1030,413,393,20
34779,1589477011,wahoo,Zwift - FUSION ECT BEUNSTOPPABLE Racing Series (A),Quarq DFour to Zwift,Wahoo Kickr 2018 to Garmin 1030,417,407,10
36149,1589911864,wahoo,Zwift - UNO X CUP powered by DCU & Feltet.dk (A),Quarq DFour to Zwift,Wahoo Kickr 2018 to Garmin 1030,421,409,12
37997,1590516404,wahoo,Zwift - UNO X CUP powered by DCU & Feltet.dk (A),Quarq DFour to Zwift,Wahoo Kickr 2018 to Garmin 1030,438,422,16
39252,1591121279,wahoo,Zwift - UNO X CUP powered by DCU & Feltet.dk (A),Quarq DFour to Zwift,Wahoo Kickr 2018 to Garmin 1030,405,400,5
39730,1591291800,wahoo,Zwift - FUSION ECT BEUNSTOPPABLE Racing Series (A),Quarq DFour to Zwift,Wahoo Kickr 2018 to Garmin 1030,385,369,16
40572,1591726223,wahoo,Zwift - UNO X CUP powered by DCU & Feltet.dk (A),Quarq DFour to Zwift,Wahoo Kickr 2018 to Garmin 1030,398,380,18
42273,1592331038,wahoo,Zwift - UNO X CUP powered by DCU & Feltet.dk (A),Quarq DFour to Zwift,Wahoo Kickr 2018 to Garmin 1030,396,369,27
44696,1593788033,wahoo,Zwift - Watopia,Quarq DFour to Zwift,Wahoo Kickr 2018 to Garmin 1030,265,263,2
51866,1598377575,wahoo,Zwift - RHYS HOWELL [CANYON]&#039;s Meetup - Big Foot Hills,Quarq DFour to Zwift,Wahoo Kickr 2018 to Garmin 1030,403,381,22
52337,1598536996,wahoo,Zwift - 3R Classique Flat Race - 6 Laps (37.7km/23.4mi 114m) (A),Quarq DFour to Zwift,Wahoo Kickr 2018 to Garmin 1030,367,335,32
55983,1600367113,wahoo,Zwift - Invitational League // Qualifying Race #2 (Men) ,Quarq DZero to Garmin 1030,Wahoo Kickr 2018 to Zwift,379,371,8
58472,1600882656,wahoo,Zwift - DCU powered by Feltet.dk (A),Quarq DFour to Zwift,Wahoo Kickr 2018 to Garmin 1030,394,383,11
58744,1601487240,wahoo,Zwift - DCU powered by Feltet.dk (A),Quarq DFour to Zwift,Wahoo Kickr 2018 to Garmin 1030,383,360,23
61565,1602608677,wahoo,Zwift - Zwift Racing League | WTRL,Quarq DFour to Zwift,Wahoo Kickr 2018 to Garmin 1030,405,381,24
63438,1603214007,wahoo,Zwift - Zwift Racing League | WTRL - EMEA E (MEN) - TTT Grp 1,Quarq DFour to Zwift,Wahoo Kickr 2018 to Garmin 1030,377,356,21
64461,1603475872,wahoo,Zwift - Team IRL Without Borders Race (A),Quarq DFour to Zwift,Wahoo Kickr 2018 to Garmin 1030,382,356,26
65467,1603822240,wahoo,Zwift - Zwift Racing League | WTRL - EMEA E (MEN) -  Division 1 (A),Quarq DFour to Zwift,Wahoo Kickr 2018 to Garmin 1030,385,359,26
66223,1603996132,wahoo,Zwift - FUSION ECT BEUNSTOPPABLE Racing Series (A),Quarq DFour to Zwift,Wahoo Kickr 2018 to Garmin 1030,366,349,17
67621,1604428245,wahoo,Zwift - Zwift Racing League | WTRL - Men&#039;s EMEA E1 DIVISION 1 (A),Quarq DFour to Zwift,Wahoo Kickr 2018 to Garmin 1030,383,369,14
68057,1604516351,wahoo,Zwift - DCU – Feltet.dk November series,Quarq DFour to Zwift,Wahoo Kickr 2018 to Garmin 1030,384,353,31
69795,1605032000,wahoo,Zwift - Zwift Racing League | WTRL - EMEA E1 (MEN) -  Division 1 (A),Quarq DFour to Zwift,Wahoo Kickr 2018 to Garmin 1030,426,398,28
70348,1605121446,wahoo,Zwift - DBR HEINO CUP III (A),Quarq DFour to Zwift,Wahoo Kickr 2018 to Garmin 1030,368,343,25
72260,1605637137,wahoo,Zwift - Zwift Racing League | WTRL - Men&#039;s EMEA E1 DIVISION 1 (A),Quarq DFour to Zwift,Wahoo Kickr 2018 to Garmin 1030,396,385,11
74557,1606149887,wahoo,Zwift - Crit City Race (A),Quarq DFour to Zwift,Wahoo Kickr 2018 to Garmin 1030,406,347,59
75602,1606330528,wahoo,Zwift - DCU – Feltet.dk November series (A),Quarq DFour to Zwift,Wahoo Kickr 2018 to Garmin 1030,383,369,14
76194,1606415389,wahoo,Zwift - FUSION ECT BEUNSTOPPABLE Racing Series (A),Quarq DFour to Zwift,Wahoo Kickr 2018 to Garmin 1030,372,357,15
78123,1606846751,wahoo,Zwift - Zwift Racing League | WTRL - Men&#039;s EMEA E1 DIVISION 1 (A),Quarq DFour to Zwift,Wahoo Kickr 2018 to Garmin 1030,377,364,13
79091,1607020190,wahoo,Zwift - FUSION DECEMBER CUP (A),Quarq DFour to Zwift,Wahoo Kickr 2018 to Garmin 1030,378,361,17
79865,1607186520,wahoo,Zwift - Crit City Race (A),Quarq DFour to Zwift,Wahoo Kickr 2018 to Garmin 1030,391,334,57
80853,1607451290,wahoo,Zwift - Zwift Racing League | WTRL - Men&#039;s EMEA E1 DIVISION 1 (A),Quarq DFour to Zwift,Wahoo Kickr 2018 to Garmin 1030,377,356,21
82057,1607713124,wahoo,Zwift - Team IRL Without Borders Race (A),Quarq DFour to Zwift,Wahoo Kickr 2018 to Garmin 1030,362,342,20
83604,1608048283,wahoo,Zwift - 3R Volcano Circuit Flat Race - 8 Laps (35.2km/21.9mi 160m) (A),Quarq DFour to Zwift,Wahoo Kickr 2018 to Garmin 1030,382,339,43
84473,1608229795,wahoo,FUSION DECEMBER CUP,Quarq DFour to Zwift,Wahoo Kickr 2018 to Wahoo Fitness App,369,358,11
86217,1608663281,wahoo,Zwift - Team Italy & Frenchy Fuzion League (A),Quarq DFour to Zwift,Wahoo Kickr 2018 to Wahoo Fitness App,388,374,14
89121,1609351156,wahoo,Zwift - MIDWEEK Winter Series by SZR (A),Quarq DFour to Zwift,Wahoo Kickr 2018 to Wahoo Fitness App,388,375,13
92996,1610044173,wahoo,Zwift - FUSION WINTER CUP (A),Quarq DZero(secondary bike) to Zwift,Wahoo Kickr 2018 to Wahoo Fitness App,392,383,9
95725,1610475274,wahoo,Zwift - Zwift Racing League | WTRL - Men&#039;s/Mixed EMEA E1 DIVISION 1 (A),Quarq DFour to Zwift,Wahoo Kickr 2018 to Wahoo Fitness App,367,358,9
96367,1610553589,wahoo,Zwift - Sydkysten Race (A),Quarq DFour to Zwift,Wahoo Kickr 2018 to Wahoo Fitness App,374,363,11
97119,1610648957,wahoo,Zwift - FUSION WINTER CUP (A),Quarq DFour to Zwift,Wahoo Kickr 2018 to Wahoo Fitness App,391,379,12
98221,1610795662,wahoo,Zwift - 3R Tick Tock Flat Race - 2 Lap (36km/22.4mi 100m) (A),Quarq DFour to Zwift,Wahoo Kickr 2018 to Wahoo Fitness App,357,346,11
98224,1610787849,wahoo,Zwift - 3R Weekend Race Club - Race 2 (A),Quarq DFour to Zwift,Wahoo Kickr 2018 to Wahoo Fitness App,345,338,7
99737,1611080537,wahoo,Zwift - Zwift Racing League | WTRL - Men&#039;s/Mixed EMEA E1 DIVISION 1 (A),Quarq DFour to Zwift,Wahoo Kickr 2018 to Wahoo Fitness App,367,356,11
101059,1611253761,wahoo,Zwift - FUSION WINTER CUP (A),Quarq DFour to Zwift,Wahoo Kickr 2018 to Wahoo Fitness App,382,371,11
103538,1611684843,wahoo,Zwift - Zwift Racing League | WTRL - Men&#039;s/Mixed EMEA E1 DIVISION 1 (A),Quarq DFour to Zwift,Wahoo Kickr 2018 to Wahoo Fitness App,381,369,12
119625,1614104012,wahoo,Zwift - Zwift Racing League | WTRL - Men&#039;s/Mixed EMEA E1 DIVISION 1 (A),Quarq DFour to Zwift,Kickr V5 to Wahoo Fitness App,382,373,9
120328,1614192248,wahoo,Zwift - Scandinavian Cup 2021 - Round 1 - Men (A),Kickr V5 to Zwift,Quarq DFour to Wahoo Fitness App,345,355,-10
120809,1614279127,wahoo,Zwift - Watopia,Quarq DZero(secondary bike) to Zwift,Kickr V5 to Wahoo Fitness App,362,352,10
122968,1614709187,wahoo,Zwift - Zwift Racing League | WTRL - Men&#039;s/Mixed EMEA E1 DIVISION 1 (A),Quarq DFour to Zwift,Kickr V5 to Wahoo Fitness App,402,383,19
124581,1614971010,wahoo,Zwift - Zwift Racing League | WTRL Battle Royale Playoff - Men&#039;s Points Race (A),Kickr V5 to Zwift,Quarq DFour to Wahoo Fitness App,382,403,-21
125168,1615060523,wahoo,Zwift - Zwift Racing League | WTRL Battle Royale Playoff - Men&#039;s TTT (A),Kickr V5 to Zwift,Quarq DFour to Wahoo Fitness App,387,405,-18
126070,1615294409,wahoo,Zwift - Watopia,Quarq DZero(secondary bike) to Zwift,Kickr V5 to Wahoo Fitness App,401,393,8
84066,1608140562,wahoo,Zwift - MIDWEEK Winter Series by SZR (A) #2,SRM,Wahoo,378,371,7
84070,1608054260,wahoo,Zwift - KISS Race Series - EU PM (A),SRM,Wahoo,375,391,-16
84452,1608229755,wahoo,Zwift - FUSION DECEMBER CUP (A) #3,SRM,Wahoo,373,368,5
87169,1608900196,wahoo,Zwift - zada 3 sister test,SRM,Wahoo,429,435,-6
94997,1610392447,wahoo,Zwift - Premier Division // Zwift Racing League (men) (A) #14,SRM,Wahoo,407,393,14
100316,1611168303,wahoo,Zwift - Danmarks Cykle Union & Partners 2/6 (A) #4,SRM,Wahoo,388,388,0
102935,1611601484,wahoo,Zwift - Premier Division // Zwift Racing League (men) (A),SRM,Wahoo,389,397,-8
106906,1612209976,wahoo,Zwift - Premier Division // Zwift Racing League (men) (A) #15,SRM,Wahoo,386,390,-4
110994,1612812040,wahoo,Zwift - Premier Division // Zwift Racing League (men) (A),SRM,Wahoo,397,397,0
112377,1612983530,wahoo,Zwift - Movistar Team Challenge // Round 1 (A),SRM,Wahoo,367,370,-3
113593,1613156343,wahoo,Zwift - Movistar Team Challenge // Round 1 (men),SRM,Wahoo,411,426,-15
113933,1613206739,wahoo,Zwift - Team WEz Race (E) #1,SRM,Wahoo,438,401,37
115454,1613419234,wahoo,Zwift - Premier Division // Zwift Racing League (men) (A) #7,SRM,Wahoo,402,413,-11
116758,1613588292,wahoo,Zwift - Movistar Team Challenge // Round 2 (men) - Race 3/4 #12,SRM,Wahoo,384,381,3
117909,1613761166,wahoo,Zwift - Movistar Team Challenge // Round 2 (men),SRM,Wahoo,426,424,2
119092,1614020944,wahoo,Zwift - Premier Division // Zwift Racing League (men) (A),SRM,Wahoo,378,382,-4
120258,1614189533,wahoo,Zwift - MIDWEEK Winter Series by SZR (A),SRM,Wahoo,385,381,4
124133,1614886639,wahoo,Zwift - Movistar Team Challenge // Points Race (men) #2 ,SRM,Wahoo,376,372,4
124142,1614884240,wahoo,Ramp Test,SRM,Wahoo,394,393,1
84373,1608221201,wahoo,Zwift - OH MY CRIT! - The Double Race 1/2 (A),Hammer to Zwift,Stages to Wahoo,409,397,12
84375,1608221201,wahoo,Zwift - OH MY CRIT! - The Double Race 2/2 (A),Hammer to Zwift,Stages to Wahoo,393,381,12
85131,1608390826,wahoo,Zwift - OH MY CRIT - Saturday Smash Race (A),Hammer to Zwift,Stages to Wahoo,415,405,10
86988,1608825845,wahoo,Zwift - OH MY CRIT! - The Double Race 1/2 (A),Hammer to Zwift,Stages to Wahoo,392,384,8
86989,1608825845,wahoo,Zwift - OH MY CRIT! - The Double Race 2/2 (A),Hammer to Zwift,Stages to Wahoo,376,384,-8
89552,1609430317,wahoo,Zwift - OH MY CRIT! - The Double Race 1/2 (A),Hammer to Zwift,Stages to Wahoo,357,367,-10
89554,1609430317,wahoo,Zwift - OH MY CRIT! - The Double Race 2/2 (A),Hammer to Zwift,Stages to Wahoo,389,401,-12
90304,1609603518,wahoo,Zwift - TEAM VEGAN Tofu Tornado (A),Hammer to Zwift,Stages to Wahoo,392,386,6
92803,1610038061,wahoo,Zwift - OH MY CRIT! - The Double Race 2/2 (A),Hammer to Zwift,Stages to Wahoo,390,381,9
93990,1610209088,wahoo,Zwift - TEAM VEGAN Tofu Tornado (A),Hammer to Zwift,Stages to Wahoo,405,390,15
96015,1610497198,wahoo,Zwift - Zwift Racing League | WTRL - Men&#039;s/Mixed AMERICAS E DIVISION 4 (A),Hammer to Zwift,Stages to Wahoo,348,339,9
96927,1610640190,wahoo,Zwift - OH MY CRIT! - The Double Race 1/2 (A),Hammer to Zwift,Stages to Wahoo,389,382,7
98059,1610809527,wahoo,Zwift - OH MY CRIT - Saturday Smash Race (A),Hammer to Zwift,Stages to Wahoo,378,352,26
98581,1610892265,wahoo,Zwift - KISS 100 Race Series - Americas (A),Hammer to Zwift,Stages to Wahoo,343,335,8
100459,1611102323,wahoo,Zwift - Zwift Racing League | WTRL - Men&#039;s/Mixed AMERICAS E DIVISION 4 (A),Hammer to Zwift,Stages to Wahoo,354,347,7
100815,1611245234,wahoo,Zwift - OH MY CRIT! - The Double Race 1/2 (A),Hammer to Zwift,Stages to Wahoo,382,373,9
104376,1611794821,wahoo,Zwift - TDZ Stage 5: Shorter Ride,Hammer to Zwift,Stages to Wahoo,313,311,2
106467,1612111498,wahoo,Bigger Loop with a few longer efforts,Hammer to Zwift,Stages to Wahoo,353,348,5
107732,1612311969,wahoo,Zwift - Zwift Racing League | WTRL - Men&#039;s/Mixed AMERICAS E DIVISION 4 (A),Hammer to Zwift,Stages to Wahoo,372,355,17
108780,1612457790,wahoo,Zwift - OH MY CRIT!! - The Double Race 2/2 (A),Hammer to Zwift,Stages to Wahoo,395,370,25
109126,1612485512,wahoo,Crit City Race,Hammer to Zwift,Stages to Wahoo,370,353,17
109899,1612624012,wahoo,Zwift - OH MY CRIT!! - Saturday Smash Race (A),Hammer to Zwift,Stages to Wahoo,347,339,8
109994,631065600,wahoo,Zwift - Watopia,Hammer to Zwift,SRM to Wahoo,326,0,326
111255,1612829415,wahoo,Zwift - The Bump Sprint Race (A),Hammer to Zwift,Stages to Wahoo,377,360,17
112877,1613062005,wahoo,Zwift - 02/11/2021,Hammer to Zwift,Stages to Wahoo,391,376,15
118347,1613836259,wahoo,Zwift - 3R Endurance Series p/b OTE Sports- Stage 1 (E),Hammer to Zwift,Stages to Wahoo,360,346,14
118749,1613921093,wahoo,Dropped the guy trying to work shame us.**chef&#039;s kiss**,Hammer to Zwift,SRM to Wahoo,387,382,5
119321,1614038635,wahoo,Zwift - The Bump Sprint Race (A),Hammer to Zwift,Pioneer LR to Wahoo,369,349,20
120716,1614271756,wahoo,Zwift - OH MY CRIT!! - The Double Race 2/2 (A),Hammer to Zwift,Pioneer LR to Wahoo,391,362,29
122710,1614643363,wahoo,Zwift - The Bump Sprint Race (A),Hammer to Zwift,Pioneer LR to Wahoo,329,352,-23
123248,1614731119,wahoo,Zwift - 03/02/2021,Hammer to Zwift,Pioneer LR to Wahoo,369,371,-2
125106,1615047246,wahoo,Zwift - BRT&#039;s Thunder & Lightning (A),Hammer to Zwift,Quarq to Wahoo,329,331,-2
125443,1615129161,wahoo,Zwift - Matt Curbeau &#039;s Meetup - Big Foot Hills,Hammer to Zwift,Quarq to Wahoo,303,303,0
126317,1615332078,wahoo,Zwift - SweatFest Fall/Winter Series 2020/21 (A),Hammer to Zwift,Quarq to Wahoo,366,363,3
128525,1615746666,wahoo,Zwift - XRS Races Crit (A),Hammer to Zwift,Quarq to Wahoo,363,360,3
75993,1606415173,wahoo,Zwift - WTRL NOPINZ WORLD TTT CHAMPIONSHIPS - Zone 5 (C),rotor 2inpower,wahoo kickr,430,432,-2
92421,1609960200,wahoo,Zwift - XRS Races: Wednesday iTT series (A),rotor 2inpower,wahoo kickr,329,313,16
93055,1610045976,wahoo,BENELIGA 2020-2021,rotor 2inpower,wahoo kickr,494,493,1
97145,1610650779,wahoo,BENELIGA 2020-2021,rotor 2inpower,wahoo kickr,461,460,1
97518,1610733271,wahoo,Zwift - KIRCHMAIR Race Series (A),rotor 2inpower,wahoo kickr,411,379,32
98520,1610894149,wahoo,Zwift - Herd Beginner Racing Series,rotor 2inpower,wahoo kickr,487,464,23
99014,1610993746,wahoo,Zwift - TRI247 Manic Monday Time Trial (E),rotor 2inpower,wahoo kickr,446,467,-21
99732,1611082204,wahoo,Zwift - AHDR Bacon Rolls with Caffeine  (B),rotor 2inpower,wahoo kickr,261,251,10
100286,1611165013,wahoo,"Zwift - 3R 100 Steady Ride [~3.0w/kg, ~2.5w/kg, ~2w/kg avg] (C)",rotor 2inpower,wahoo kickr,250,237,13
100962,1611253867,wahoo,BENELIGA 2020-2021,rotor 2inpower,wahoo kickr,455,448,7
101494,1611339194,wahoo,Zwift - KIRCHMAIR Race Series (A),rotor 2inpower,wahoo kickr,454,442,12
104811,1611860342,wahoo,BENELIGA 2020-2021,rotor 2inpower,wahoo kickr,484,424,60
105213,1611944975,wahoo,Zwift - KIRCHMAIR Race Series (A),rotor 2inpower,wahoo kickr,453,459,-6
105220,1611943178,wahoo,Zwift - KIRCHMAIR Race Series (A),rotor 2inpower,wahoo kickr,422,414,8
113505,1613152033,wahoo,Zwift - KIRCHMAIR Race Series (A),rotor 2inpower,wahoo kickr,470,462,8
115150,1613402730,wahoo,zada three sisterst stest,rotor 2inpower,wahoo kickr V5,475,441,34
94745,1610193601,wahoo,Zwift - WKG Winter League 2020 / 2021  (A),Assomia Favero Duo,Wahoo Kickr Core,388,395,-7
94990,1610392499,wahoo,Zwift - Premier Division // Zwift Racing League (men) (A),Assomia Favero Duo,Wahoo Kickr Core,417,403,14
96795,1610564401,wahoo,Zwift - Zwift NL Race Day (A),Assomia Favero Duo,Wahoo Kickr Core,416,423,-7
97918,1610789388,wahoo,Zwift - DBR SufferDay League III (A),Assomia Favero Duo,Wahoo Kickr Core,421,427,-6
99215,1610999850,wahoo,Zwift - Premier Division // Zwift Racing League (men) (A),Assomia Favero Duo,Wahoo Kickr Core,413,401,12
102903,1611601500,wahoo,Zwift - Premier Division // Zwift Racing League (men) (A),Assomia Favero Duo,Wahoo Kickr Core,418,425,-7
104403,1611601500,wahoo,Zwift - Zwift NL Race Day (A),Assomia Favero Duo,Wahoo Kickr Core,379,385,-6
105680,1612019696,wahoo,Zwift - OH MY CRIT!! - Saturday Smash Race (A),Favero Assioma Duo to Garmin 830,Wahoo Kickr Core,370,373,-3
105824,1612029901,wahoo,Zwift - 3R Three Sisters Hilly Race (47km/29.2mi 879m) (A),Favero Assioma Duo to Garmin 830,Wahoo Kickr Core,398,401,-3
106064,1612083899,wahoo,Zwift - Newbury Velo Road Race (A),Favero Assioma Duo to Garmin 830,Wahoo Kickr Core,364,367,-3
106886,1612210022,wahoo,Zwift - Premier Division // Zwift Racing League (men) (A),Assomia Favero Duo,Wahoo Kickr Core,408,410,-2
108284,1612378800,wahoo,Zwift - Zwift NL Race Day (A),Favero Assioma Duo to Garmin 830,Wahoo Kickr Core,426,430,-4
109929,1612624501,wahoo,Zwift - OH MY CRIT!! - Saturday Smash Race (A),Favero Assioma Duo to Garmin 830,Wahoo Kickr Core,423,422,1
111026,1612812206,wahoo,Zwift - Premier Division // Zwift Racing League (men) (A),Favero Assioma Duo to Garmin 830,Wahoo Kickr Core,411,413,-2
112383,1612983602,wahoo,Zwift - Movistar Team Challenge // Round 1 (A),Favero Assioma Duo to Garmin 530,Wahoo Kickr Core,376,375,1
113308,1613070007,wahoo,Zwift - BENELIGA 2020-2021 (E),Favero Assioma Duo to Garmin 530,Wahoo Kickr Core,445,446,-1
113602,1613156402,wahoo,Zwift - Movistar Team Challenge // Round 1 (men),Favero Assioma Duo to Garmin 530,Wahoo Kickr Core,442,442,0
115392,1613419320,wahoo,Zwift - Premier Division // Zwift Racing League (men) (A),Favero Assioma Duo to Garmin 530,Wahoo Kickr Core,438,440,-2
116770,1613588401,wahoo,Zwift - Movistar Team Challenge // Round 2 (men) - Race 3/4,Favero Assioma Duo to Garmin 530,Wahoo Kickr Core,394,397,-3
117894,1613761201,wahoo,Zwift - Movistar Team Challenge // Round 2 (men),Favero Assioma Duo to Garmin 530,Wahoo Kickr Core,430,447,-17
119143,1614021001,wahoo,Zwift - Premier Division // Zwift Racing League (men) (A),Favero Assioma Duo to Garmin 530,Wahoo Kickr Core,383,390,-7
120722,1614272701,wahoo,Zwift - OH MY CRIT!! - The Double Race 2/2 (A),Favero Assioma Duo to Garmin 530,Wahoo Kickr Core,413,421,-8
121233,1614364201,wahoo,Zwift - KIRCHMAIR Race Series (A),Favero Assioma Duo to Garmin 530,Wahoo Kickr Core,414,410,4
121234,1614362401,wahoo,Zwift - KIRCHMAIR Race Series (A),Favero Assioma Duo to Garmin 530,Wahoo Kickr Core,363,373,-10
122597,1614630054,wahoo,Zwift - Premier Division // Zwift Racing League (men) (A),Favero Assioma Duo to Garmin 530,Wahoo Kickr Core,424,419,5
124159,1614886799,wahoo,Zwift - Movistar Team Challenge // Points Race (men),Favero Assioma Duo to Garmin 530,Wahoo Kickr Core,389,391,-2
124248,1614884402,wahoo,Zwift - Ramp Test,Favero Assioma Duo to Garmin 530,Wahoo Kickr Core,465,479,-14
127136,1615489201,wahoo,Zwift - Flanders The BZR Ronde Spring Classics League (A),Favero Assioma Duo to Garmin 530,Wahoo Kickr Core,421,428,-7
127771,1615626300,wahoo,Zwift - 3R Endurance Series p/b OTE Sports (E),Favero Assioma Duo to Garmin 530,Wahoo Kickr Core,443,440,3
128422,1615731305,wahoo,Zwift - KISS 100 Race Series (Americas) (A),Favero Assioma Duo to Garmin 530,Wahoo Kickr Core,390,388,2
129141,1615919402,wahoo,Zwift - CeramicSpeed Race Series: Open Race (A),Favero Assioma Duo to Garmin 530,Wahoo Kickr Core,433,430,3
36630,1590053394,wahoo,Zwift - ZHR Up & Down Race (A),Quarq  dual sided  crank ,wahoo kickr g3,379,388,-9
39273,1591177498,neo,Zwift - USA Cycling Race League by Indoor Specialist (A),Quarq  dual sided  crank uarq  dual sided  crank ,taco neo 2 T,351,366,-15
39391,1591206895,neo,Zwift - USA Cycling Race League by Indoor Specialist (A),Quarq  dual sided  crank ,taco neo 2 T,333,390,-57
39842,1591379999,neo,Zwift - TeamPTz Friday&#039;s Race League (A),Quarq  dual sided  crank ,taco neo 2 T,401,415,-14
40207,1591535698,neo,Zwift - KISS at Race 100 - Americas (A),Quarq  dual sided  crank ,tacx neo 2 T,347,355,-8
40589,1591727996,neo,Zwift - 3R & Wahoo Ride Real Race Series - Round 4 of 7 (A),Quarq  dual sided  crank ,tacx neo 2 T,399,401,-2
40802,1591811699,neo,Zwift - USA Cycling Race League by Indoor Specialist (A),Quarq  dual sided  crank ,tacx neo 2 T,424,434,-10
41293,1591984798,neo,Zwift - TeamPTz Friday&#039;s Race League (A),Quarq  dual sided  crank ,tacx neo 2 T,376,387,-11
42024,1592332798,neo,Zwift - 3R & Wahoo Ride Real Race Series - Round 5 of 7 (A),Quarq  dual sided  crank ,tacx neo 2 T,375,379,-4
42227,1592416499,neo,Zwift - USA Cycling Race League by Indoor Specialist (A),Quarq  dual sided  crank ,tacx neo 2 T,394,400,-6
42446,1592499953,neo,Zwift - Espresso,Quarq  dual sided  crank ,tacx neo 2 T,367,373,-6
42643,1592589598,neo,Zwift - TeamPTz Friday&#039;s Race League (A),Quarq  dual sided  crank ,tacx neo 2 T,381,390,-9
42962,1592744698,neo,Zwift - 3R Watopia Flat Route Race - 4 Laps (40.5km/25.1mi 216m) (A),Quarq  dual sided  crank ,tacx neo 2 T,405,412,-7
43261,1592937598,neo,Zwift - 3R & Wahoo Ride Real Race Series - Round 6 of 7 (A),Quarq  dual sided  crank ,tacx neo 2 T,440,448,-8
43410,1593021298,neo,Zwift - USA Cycling Race League by Indoor Specialist (A),Quarq  dual sided  crank ,tacx neo 2 T,432,439,-7
43574,1593105782,neo,Zwift - WTRL Team Time Trial Premier League (C),Quarq  dual sided  crank ,tacx neo 2 T,385,391,-6
43722,1593194398,neo,Zwift - TeamPTz Friday&#039;s Race League (A),Quarq  dual sided  crank ,tacx neo 2 T,368,372,-4
44274,1593542398,neo,Zwift - 3R & Wahoo Ride Real Race Series - Round 7 of 7 (A),Quarq  dual sided  crank ,tacx neo 2 T,377,379,-2
44427,1593626099,neo,Zwift - USA Cycling Race League by Indoor Specialist (A),Quarq  dual sided  crank ,tacx neo 2 T,384,399,-15
44568,1593710757,neo,Zwift - Espresso,Quarq  dual sided  crank ,tacx neo 2 T,365,370,-5
44711,1593799197,neo,Zwift - TeamPTz Friday&#039;s Race League (A),Quarq  dual sided  crank ,tacx neo 2 T,354,358,-4
45324,1594147198,neo,Zwift - 3R NYC Gotham Grind - 4 Laps (A),Quarq  dual sided  crank ,tacx neo 2 T,359,365,-6
45472,1594230899,neo,Zwift - USA Cycling Race League by Indoor Specialist (A),Quarq  dual sided  crank ,tacx neo 2 T,351,355,-4
45657,1594315617,neo,Zwift - Espresso,Quarq  dual sided  crank ,tacx neo 2 T,352,360,-8
46339,1594752000,neo,Zwift - 3R Turbocharged Team Race Series - Round 1 (A),Quarq  dual sided  crank ,tacx neo 2 T,361,372,-11
46481,1594835699,neo,Zwift - USA Cycling Race League by Indoor Specialist (A),Quarq  dual sided  crank ,tacx neo 2 T,399,404,-5
46638,1594920417,neo,Zwift - Espresso,Quarq  dual sided  crank ,tacx neo 2 T,374,374,0
49849,1597339618,neo,Zwift -  Espresso,4iiii L,tacx neo 2 T,377,373,4
51527,1598284795,neo,Zwift - Off The MAAP Stage 4 Race (A),4iiii L,tacx neo 2 T,424,398,26
52192,1598548940,neo,Zwift - Espresso,4iiii L,tacx neo 2 T,383,375,8
52531,1598722188,neo,Zwift - Off The MAAP Stage 4 - Longer Ride,4iiii L,tacx neo 2 T,377,377,0
52779,1598897991,neo,Zwift - TFC Mad Monday Summer Series (9 of 10) (A),4iiii L,tacx neo 2 T,362,355,7
52915,1598981386,neo,Zwift - 09/01/2020,4iiii L,tacx neo 2 T,445,437,8
54407,1599758576,neo,Zwift - Espresso,4iiii L,tacx neo 2 T,384,382,2
55102,1600106396,neo,Zwift - Invitational League // Qualifying Race #1,4iiii L,tacx neo 2 T,388,374,14
55923,1600367394,neo,Zwift - Invitational League // Qualifying Race #2 (Men) ,4iiii L,tacx neo 2 T,365,364,1
56456,1600606794,neo,Zwift - Invitational League // Qualifying Race #3 (Men) (A),4iiii L,tacx neo 2 T,403,396,7
61303,1602528613,neo,Zwift - Premier Division // Zwift Racing League (men) ,4iiii L,tacx neo 2 T,411,412,-1
63133,1603131297,neo,Zwift - Premier Division // Zwift Racing League (men) ,4iiii L,tacx neo 2 T,383,378,5
65229,1603742395,neo,Zwift - Premier Division // Zwift Racing League (men) (A),4iiii L,tacx neo 2 T,410,415,-5
66756,1604167496,neo,Zwift - 3R Three Sisters Hilly Race (47km/29.2mi 879m) (A),4iiii L,tacx neo 2 T,384,389,-5
67303,1604343975,neo,Zwift - Premier Division // Zwift Racing League (men) (A),4iiii L,tacx neo 2 T,386,379,7
69478,1604951997,neo,Zwift - Premier Division // Zwift Racing League (men) (A),4iiii L,tacx neo 2 T,435,428,7
71421,1605366892,neo,Zwift - OH MY CRIT - Saturday Smash Race (A),4iiii L,tacx neo 2 T,387,379,8
72031,1605553426,neo,Zwift - Premier Division // Zwift Racing League (men) (A),4iiii L,tacx neo 2 T,381,379,2
74726,1606161596,neo,Zwift - Premier Division // Zwift Racing League (men) (A),4iiii L,tacx neo 2 T,409,409,0
76118,1606417476,neo,Zwift - WTRL NOPINZ WORLD TTT CHAMPIONSHIPS - Zone 8 (C),4iiii L,tacx neo 2 T,390,382,8
77687,1606763297,neo,Zwift - Premier Division // Zwift Racing League (men) (A),4iiii L,tacx neo 2 T,384,367,17
82477,1607794187,neo,Zwift - EVR Summer Series (A),4iiii L,tacx neo 2 T,415,421,-6
84834,1608317976,neo,Zwift - Team IRL Without Borders Race (A),4iiii L,tacx neo 2 T,378,377,1
86712,1608746373,neo,Zwift - MIDWEEK Winter Series by SZR (A),4iiii L,tacx neo 2 T,393,382,11
88353,1609183180,neo,Zwift - Team TFC Mad Monday Winter Series (A),4iiii L,tacx neo 2 T,359,359,0
88725,1609268082,neo,Zwift - Team Italy & Frenchy Fuzion League (A),4iiii L,tacx neo 2 T,409,418,-9
90372,1609600486,neo,Zwift - OH MY CRIT - Saturday Smash Race (A),4iiii L,tacx neo 2 T,387,383,4
91952,1609872875,neo,Zwift - Team Italy & Frenchy Fuzion League (A),4iiii L,tacx neo 2 T,415,398,17
92897,1610045075,neo,Zwift - XRS - ZTR Thursday Night Race (A),4iiii L,tacx neo 2 T,345,342,3
95065,1610392478,neo,Zwift - Premier Division // Zwift Racing League (men) (A),4iiii L,tacx neo 2 T,391,377,14
98136,1610814576,neo,Zwift - TEAM VEGAN Tofu Tornado (A),4iiii L,tacx neo 2 T,405,401,4
99245,1610999681,neo,Zwift - Premier Division // Zwift Racing League (men) (A),4iiii L,tacx neo 2 T,382,387,-5
101998,1611419376,neo,Zwift - TEAM VEGAN Tofu Tornado (A),4iiii L,tacx neo 2 T,434,425,9
102946,1611601445,neo,Zwift - Premier Division // Zwift Racing League (men) (A),4iiii L,tacx neo 2 T,406,414,-8
106936,1612209997,neo,Zwift - 02/01/2021,4iiii L,tacx neo 2 T,404,407,-3
111044,1612812019,neo,Zwift - Premier Division // Zwift Racing League (men) (A),4iiii L,tacx neo 2 T,399,405,-6
112386,1612983573,neo,Zwift - Movistar Team Challenge // Round 1 (A),4iiii L,tacx neo 2 T,438,436,2
113621,1613156380,neo,Zwift - Movistar Team Challenge // Round 1 (men),4iiii L,tacx neo 2 T,417,419,-2
115406,1613419294,neo,Zwift - Premier Division // Zwift Racing League (men) (A),4iiii L,tacx neo 2 T,418,411,7
116792,1613588373,neo,Zwift - Movistar Team Challenge // Round 2 (men) - Race 3/4,4iiii L,tacx neo 2 T,366,369,-3
117905,1613761173,neo,Zwift - Movistar Team Challenge // Round 2 (men),4iiii L,tacx neo 2 T,426,428,-2
119161,1614020973,neo,Zwift - Premier Division // Zwift Racing League (men) (A),4iiii L,tacx neo 2 T,381,380,1
122665,1614629949,neo,Zwift - Premier Division // Zwift Racing League (men) (A),4iiii L,tacx neo 2 T,406,396,10
124152,1614886773,neo,Zwift - Movistar Team Challenge // Points Race (men),4iiii L,tacx neo 2 T,406,407,-1
124160,1614884400,neo,Zwift - Ramp Test,4iiii L,tacx neo 2 T,352,350,2
39208,1591144890,wahoo,***Dual Recording TEST***,Pioneer Crank,2018 Wahoo Kickr (Zwift),263,260,3
39378,1591206722,wahoo,Zwift - USA Cycling Race League by Indoor Specialist (A),Pioneer Dual Crank (R),2018 Wahoo Kickr (Zwift),414,412,2
39632,1591290887,wahoo,Zwift - Espresso,Pioneer Dual Crank (R),2018 Wahoo Kickr (Zwift),401,399,2
40583,1591727688,wahoo,Zwift - 3R & Wahoo Ride Real Race Series - Round 4 of 7 (A),Pioneer Dual Crank (R),2018 Wahoo Kickr (Zwift),432,432,0
40786,1591808309,wahoo,Zwift - MIDWEEK Summer Series by SZR (A),Pioneer Dual Crank (R),2018 Wahoo Kickr (Zwift),442,443,-1
42021,1592332584,wahoo,Zwift - 3R & Wahoo Ride Real Race Series - Round 5 of 7 (A),Pioneer Dual Crank (R),2018 Wahoo Kickr (Zwift),432,433,-1
43720,1593194377,wahoo,Zwift - TeamPTz Friday&#039;s Race League (A),Pioneer Dual Crank (R),2018 Wahoo Kickr (Zwift),434,436,-2
50565,1597775717,wahoo,Zwift - 3R Turbocharged Team Race Series - Round 6 (A),Pioneer Dual Crank (R),2018 Wahoo Kickr (Zwift),387,406,-19
50932,1597936378,wahoo,Zwift - OH MY CRIT! - The Double Race 1/2 (A),Pioneer Dual Crank (R),2018 Wahoo Kickr (Zwift),390,401,-11
50934,1597939450,wahoo,Zwift - OH MY CRIT! - The Double Race 2/2 (A),Pioneer Dual Crank (R),2018 Wahoo Kickr (Zwift),365,372,-7
51856,1598377715,wahoo,Zwift - 3R Turbocharged Team Race Series - Bonus Round (A),Pioneer Dual Crank (R),2018 Wahoo Kickr (Zwift),395,407,-12
52024,1598459095,wahoo,Zwift - MIDWEEK Summer Series by SZR (A),Pioneer Dual Crank (R),2018 Wahoo Kickr (Zwift),418,424,-6
52175,1598543290,wahoo,Zwift - OH MY CRIT! - The Double Race 2/2 (A),Pioneer Dual Crank (R),2018 Wahoo Kickr (Zwift),371,382,-11
52193,1598548909,wahoo,Zwift - WTRL Team Time Trial (C),Pioneer Dual Crank (R),2018 Wahoo Kickr (Zwift),419,428,-9
54005,1599588753,wahoo,Zwift - 3R Sundown Race Series  (E),Pioneer Dual Crank (R),2018 Wahoo Kickr (Zwift),367,415,-48
54018,1599590658,wahoo,Power Meter sprint testing,Pioneer Dual Crank (R),2018 Wahoo Kickr (Zwift),0,0,0
54026,1599599988,wahoo,Zwift - London,Pioneer Dual Crank (R),2018 Wahoo Kickr (Zwift),212,217,-5
54127,1599664159,wahoo,Zwift - Watopia,Pioneer Crank ANT+,2018 Wahoo Kickr (Zwift),260,259,1
55245,1600123900,wahoo,Kickr 18 vs Favero Test,Favero Assioma Duo Pedals (Secondary),2018 Wahoo Kickr (Zwift),295,301,-6
55404,1600195197,wahoo,Zwift - 3R Sundown Race Series  (E),Favero Assioma Duo Pedals (Secondary),2018 Wahoo Kickr (Zwift),425,432,-7
55545,1600266446,wahoo,2018 Wahoo Kickr (Zwift) / Favero Assioma Duo Pedals (Secondary),Favero Assioma Duo Pedals (Secondary),2018 Wahoo Kickr (Zwift),221,232,-11
55909,1600364331,wahoo,Zwift - Invitational League // Qualifying Race #2 (Men) ,Favero Assioma Duo Pedals (Secondary),2018 Wahoo Kickr (Zwift),397,434,-37
56034,1600386171,wahoo,Favero Test - Cranks were previously set to 172.5mm and now adjusted to 175mm on bike - Wish I&#039;d known that earlier...,Favero Assioma Duo Pedals (Secondary),2018 Wahoo Kickr (Zwift),239,239,0
56659,1600708424,wahoo,Zwift - DBR Ride´N´Roll League (A),Favero Assioma Duo Pedals (Secondary),2018 Wahoo Kickr (Zwift),401,404,-3
56860,1600796144,wahoo,3R Sundown Race Series ,Favero Assioma Duo Pedals (Secondary),2018 Wahoo Kickr (Zwift),441,461,-20
57021,1600879654,wahoo,Zwift - MIDWEEK Autumn Series by SZR (A),Favero Assioma Duo Pedals (Secondary),2018 Wahoo Kickr (Zwift),416,413,3
57240,1600959317,wahoo,Zwift - OH MY CRIT! - The Double Race 1/2 (A),Favero Assioma Duo Pedals (Secondary),2018 Wahoo Kickr (Zwift),409,412,-3
57242,1600963107,wahoo,Zwift - OH MY CRIT! - The Double Race 2/2 (A),Favero Assioma Duo Pedals (Secondary),2018 Wahoo Kickr (Zwift),369,372,-3
57510,1601049360,wahoo,Zwift - Team WEZ Friday Race (A),Favero Assioma Duo Pedals (Secondary),2018 Wahoo Kickr (Zwift),415,402,13
58056,1601309702,wahoo,Scott Gleason [R3R] ZADA - Three Sisters,Favero Assioma Duo Pedals (Secondary),2018 Wahoo Kickr (Zwift),420,411,9
58379,1601420434,wahoo,Zwift - Midweek Criterium Race (A),Favero Assioma Duo Pedals (Secondary),2018 Wahoo Kickr (Zwift),386,380,6
58515,1601483953,wahoo,Zwift - MIDWEEK Autumn Series by SZR (A),Favero Assioma Duo Pedals (Secondary),2018 Wahoo Kickr (Zwift),407,406,1
58769,1601563881,wahoo,Zwift - OH MY CRIT! - The Double Race 1/2 (A),Favero Assioma Duo Pedals (Secondary),2018 Wahoo Kickr (Zwift),411,410,1
58778,1601568047,wahoo,Zwift - OH MY CRIT! - The Double Race 2/2 (A),Favero Assioma Duo Pedals (Secondary),2018 Wahoo Kickr (Zwift),405,403,2
59645,1601924103,wahoo,Zwift - EVR Europe Race (A),Favero Assioma Duo Pedals (Secondary),2018 Wahoo Kickr (Zwift),372,385,-13
59847,1602006641,wahoo,Zwift - Team Italy & Frenchy Fuzion League (A),Favero Assioma Duo Pedals (Secondary),2018 Wahoo Kickr (Zwift),439,448,-9
62341,1602808573,wahoo,Zwift - The Gorby,Favero Assioma Duo Pedals (Secondary),2018 Wahoo Kickr (Zwift),374,386,-12
62637,1602943827,wahoo,Zwift - OH MY CRIT - Saturday Smash Race (A),Favero Assioma Duo Pedals (Secondary),2018 Wahoo Kickr (Zwift),400,415,-15
63102,1603128994,wahoo,Zwift - Premier Division // Zwift Racing League (men) ,Favero Assioma Duo Pedals (Secondary),2018 Wahoo Kickr (Zwift),431,445,-14
63109,1603128994,wahoo,Zwift - Premier Division // Zwift Racing League (men) ,Favero Assioma Duo Pedals (Secondary),2018 Wahoo Kickr (Zwift),431,445,-14
63813,1603299196,wahoo,Zwift - MIDWEEK Autumn Series by SZR (A),Favero Assioma Duo Pedals (Secondary),2018 Wahoo Kickr (Zwift),0,0,0
63814,1603299196,wahoo,Zwift - MIDWEEK Autumn Series by SZR (A),Favero Assioma Duo Pedals (Secondary),2018 Wahoo Kickr (Zwift),406,419,-13
64159,1603382409,wahoo,Zwift - 10/22/2020,Favero Assioma Duo Pedals (Secondary),2018 Wahoo Kickr (Zwift),405,414,-9
65207,1603739514,wahoo,Zwift - Premier Division // Zwift Racing League (men) (A),Favero Assioma Duo Pedals (Secondary),2018 Wahoo Kickr (Zwift),430,438,-8
65789,1603901280,wahoo,Tempo with Sprints,Favero Assioma Duo Pedals (Secondary),2018 Wahoo Kickr (Zwift),322,332,-10
66095,1603985987,wahoo,Zwift - OH MY CRIT! - The Double Race 1/2 (A),Favero Assioma Duo Pedals (Secondary),2018 Wahoo Kickr (Zwift),417,427,-10
66098,1603985987,wahoo,Zwift - OH MY CRIT! - The Double Race 2/2 (A),Favero Assioma Duo Pedals (Secondary),2018 Wahoo Kickr (Zwift),412,417,-5
67285,1604339254,wahoo,Zwift - Premier Division // Zwift Racing League (men) (A),Favero Assioma Duo Pedals (Secondary),2018 Wahoo Kickr (Zwift),435,453,-18
69325,1604944164,wahoo,Zwift - Watopia,Favero Assioma Duo Pedals (Secondary),2018 Wahoo Kickr (Zwift),216,214,2
69451,1604948787,wahoo,Zwift - Premier Division // Zwift Racing League (men) (A),Favero Assioma Duo Pedals (Secondary),2018 Wahoo Kickr (Zwift),468,465,3
70642,1605196638,wahoo,Zwift - OH MY CRIT! - The Double Race 1/2 (A),Favero Assioma Duo Pedals (Secondary),2018 Wahoo Kickr (Zwift),414,399,15
72140,1605550578,wahoo,Zwift - Premier Division // Zwift Racing League (men) (A),Favero Assioma Duo Pedals (Secondary),2018 Wahoo Kickr (Zwift),427,430,-3
72182,1605630574,wahoo,Zwift - TEAM VEGAN Tofu Tornado (A),Favero Assioma Duo Pedals (Secondary),2018 Wahoo Kickr (Zwift),389,393,-4
72997,1605801833,wahoo,Zwift - 11/19/2020,Favero Assioma Duo Pedals (Secondary),2018 Wahoo Kickr (Zwift),432,432,0
73081,1605805185,wahoo,Zwift - Espresso,Favero Assioma Duo Pedals (Secondary),2018 Wahoo Kickr (Zwift),409,407,2
74218,1606055927,wahoo,Zwift - Rick Wenger [Finesse Wahoo]&#039;s Meetup - Tempus Fugit,Favero Assioma Duo Pedals (Secondary),2018 Wahoo Kickr (Zwift),151,162,-11
74397,1606098645,wahoo,2018 Wahoo Kickr (Zwift) / Favero Assioma Duo Pedals (Secondary),Favero Assioma Duo Pedals (Secondary),2018 Wahoo Kickr (Zwift),0,0,0
74733,1606161338,wahoo,Zwift - Premier Division // Zwift Racing League (men) (A),Favero Assioma Duo Pedals (Secondary),2018 Wahoo Kickr (Zwift),464,465,-1
75559,1606329792,wahoo,Dropout with 3k to go...,Favero Assioma Duo Pedals (Secondary),2018 Wahoo Kickr (Zwift),402,407,-5
76041,1606410283,wahoo,Zwift - WTRL NOPINZ WORLD TTT CHAMPIONSHIPS - Zone 6 (C),Favero Assioma Duo Pedals (Secondary),2018 Wahoo Kickr (Zwift),437,440,-3
77667,1606760095,wahoo,Premier Division // Zwift Racing League (men),Favero Assioma Duo Pedals (Secondary),2018 Wahoo Kickr (Zwift),408,414,-6
78917,1607009890,wahoo,Zwift - OH MY CRIT! - The Double Race 1/2 (A),Favero Assioma Duo Pedals (Secondary),2018 Wahoo Kickr (Zwift),419,423,-4
79926,1607181316,wahoo,Zwift - OH MY CRIT - Saturday Smash Race (A),Favero Assioma Duo Pedals (Secondary),2018 Wahoo Kickr (Zwift),434,441,-7
80499,1607362957,wahoo,Zwift -  DBR Monday Race (A),Favero Assioma Duo Pedals (Secondary),2018 Wahoo Kickr (Zwift),409,416,-7
81175,1607536362,wahoo,Zwift - DBR Wednesday Race (A),Favero Assioma Duo Pedals (Secondary),2018 Wahoo Kickr (Zwift),385,384,1
81761,1607640459,wahoo,Zwift - Koa Sports League Warrior Race (A),Favero Assioma Duo Pedals (Secondary),2018 Wahoo Kickr (Zwift),432,428,4
81998,1607703675,wahoo,Zwift - KIRCHMAIR Race Series (A),Favero Assioma Duo Pedals (Secondary),2018 Wahoo Kickr (Zwift),435,430,5
83187,1607969077,wahoo,Zwift - Team TFC Mad Monday Winter Series (A),2018 Wahoo Kickr (Zwift),2018 Wahoo Kickr (Zwift),0,0,0
83188,1607969077,wahoo,Zwift - Team TFC Mad Monday Winter Series (A),Favero Assioma Duo Pedals (Secondary),2018 Wahoo Kickr (Zwift),0,0,0
83189,1607969077,wahoo,Zwift - Team TFC Mad Monday Winter Series (A),Favero Assioma Duo Pedals (Secondary),2018 Wahoo Kickr (Zwift),422,423,-1
84785,1608285560,wahoo,Zwift - KIRCHMAIR Race Series (A),Favero Assioma Duo Pedals (Secondary),2018 Wahoo Kickr (Zwift),434,436,-2
84792,1608285560,wahoo,Zwift - KIRCHMAIR Race Series (A),Favero Assioma Duo Pedals (Secondary),2018 Wahoo Kickr (Zwift),430,429,1
85185,1608398542,wahoo,Zwift - EVR Summer Series (A),Favero Assioma Duo Pedals (Secondary),2018 Wahoo Kickr (Zwift),415,417,-2
85778,1608568927,wahoo,Zwift - FZR Segment Killer Race (A),Favero Assioma Duo Pedals (Secondary),2018 Wahoo Kickr (Zwift),370,372,-2
86993,1608825612,wahoo,Zwift - OH MY CRIT! - The Double Race 2/2 (A),Favero Assioma Duo Pedals (Secondary),2018 Wahoo Kickr (Zwift),409,416,-7
88308,1609179922,wahoo,Zwift - Team TFC Mad Monday Winter Series (A),Favero Assioma Duo Pedals (Secondary),2018 Wahoo Kickr (Zwift),399,397,2
88406,1609201493,wahoo,Zwift - Crit City Race (A),Favero Assioma Duo Pedals (Secondary),2018 Wahoo Kickr (Zwift),408,391,17
88641,1609262664,wahoo,Zwift - 12/29/2020,Favero Assioma Duo Pedals (Secondary),2018 Wahoo Kickr (Zwift),403,406,-3
89161,1609355046,wahoo,Zwift - DBR Wednesday Race (A),Favero Assioma Duo Pedals (Secondary),2018 Wahoo Kickr (Zwift),397,396,1
89564,1609428631,wahoo,Zwift - OH MY CRIT! - The Double Race 1/2 (A),Favero Assioma Duo Pedals (Secondary),2018 Wahoo Kickr (Zwift),396,399,-3
89567,1609428631,wahoo,Zwift - OH MY CRIT! - The Double Race 2/2 (A),Favero Assioma Duo Pedals (Secondary),2018 Wahoo Kickr (Zwift),396,398,-2
90302,1609602337,wahoo,Zwift - TEAM VEGAN Tofu Tornado (A),Favero Assioma Duo Pedals (Secondary),2018 Wahoo Kickr (Zwift),411,408,3
90341,1609608587,wahoo,Zwift - ZHQ FutureWorks Circuit Race - Anti-sandbagging (A),Favero Assioma Duo Pedals (Secondary),2018 Wahoo Kickr (Zwift),396,393,3
93433,1610128786,wahoo,Zwift - KIRCHMAIR Race Series (A),Favero Assioma Duo Pedals (Secondary),2018 Wahoo Kickr (Zwift),445,436,9
93436,1610130623,wahoo,Zwift - KIRCHMAIR Race Series (A),Favero Assioma Duo Pedals (Secondary),2018 Wahoo Kickr (Zwift),409,402,7
94003,1610208135,wahoo,Zwift - TEAM VEGAN Tofu Tornado (A),Favero Assioma Duo Pedals (Secondary),2018 Wahoo Kickr (Zwift),430,426,4
94004,1610208135,wahoo,Zwift - TEAM VEGAN Tofu Tornado (A),Favero Assioma Duo Pedals (Secondary),2018 Wahoo Kickr (Zwift),430,426,4
95012,1610389234,wahoo,Zwift - Premier Division // Zwift Racing League (men) (A),Favero Assioma Duo Pedals (Secondary),2018 Wahoo Kickr (Zwift),422,415,7
99157,1610999049,wahoo,Zwift - Premier Division // Zwift Racing League (men) (A),Favero Assioma Duo Pedals (Secondary),2018 Wahoo Kickr (Zwift),419,425,-6
100785,1611082104,wahoo,Zwift - New Workout,Favero Assioma Duo Pedals (Secondary),2018 Wahoo Kickr (Zwift),393,397,-4
100817,1611244058,wahoo,Zwift - OH MY CRIT! - The Double Race 1/2 (A),Favero Assioma Duo Pedals (Secondary),2018 Wahoo Kickr (Zwift),410,411,-1
100839,1611248592,wahoo,Zwift - OH MY CRIT! - The Double Race 2/2 (A),Favero Assioma Duo Pedals (Secondary),2018 Wahoo Kickr (Zwift),387,392,-5
101990,1611418441,wahoo,Zwift - TEAM VEGAN Tofu Tornado (A),Favero Assioma Duo Pedals (Secondary),2018 Wahoo Kickr (Zwift),354,363,-9
102957,1611599545,wahoo,Zwift - Premier Division // Zwift Racing League (men) (A),Favero Assioma Duo Pedals (Secondary),2018 Wahoo Kickr (Zwift),424,428,-4
104922,1611881672,wahoo,Zwift - KISS Race Series - Americas PM (A),Favero Assioma Duo Pedals (Secondary),2018 Wahoo Kickr (Zwift),406,397,9
106915,1612209345,wahoo,Zwift - Premier Division // Zwift Racing League (men) (A),Favero Assioma Duo Pedals (Secondary),2018 Wahoo Kickr (Zwift),436,434,2
112329,1612978044,wahoo,Zwift - GTR GRINGO(nopinzR3R)&#039;s Meetup - Cobbled Climbs,Favero Assioma Duo,2018 Wahoo Kickr (Zwift),357,357,0
112863,1613059544,wahoo,Zwift - OH MY CRIT!! - The Double Race 1/2 (A),Favero Assioma Duo Pedals (Secondary),2018 Wahoo Kickr (Zwift),423,411,12
112869,1613059544,wahoo,Zwift - OH MY CRIT!! - The Double Race 2/2 (A),Favero Assioma Duo Pedals (Secondary),2018 Wahoo Kickr (Zwift),398,401,-3
115195,1613407821,wahoo,Zwift - TDZ Stage 5: Shorter Ride,Favero Assioma Duo Pedals (Secondary),2018 Wahoo Kickr (Zwift),412,420,-8
117862,1613760308,wahoo,Zwift - Ramp Test,Favero Assioma Duo Pedals (Secondary),2018 Wahoo Kickr (Zwift),478,472,6
118333,1613836605,wahoo,Zwift - 3R Endurance Series p/b OTE Sports- Stage 1 (E),Favero Assioma Duo Pedals (Secondary),2018 Wahoo Kickr (Zwift),426,425,1
119108,1614018989,wahoo,Zwift - Premier Division // Zwift Racing League (men) (A),Favero Assioma Duo Pedals (Secondary),2018 Wahoo Kickr (Zwift),406,412,-6
120264,1614186836,wahoo,Zwift - MIDWEEK Winter Series by SZR (A),Favero Assioma Duo Pedals (Secondary),2018 Wahoo Kickr (Zwift),448,451,-3
121240,1614360913,wahoo,Zwift - KIRCHMAIR Race Series (A),Favero Assioma Duo Pedals (Secondary),2018 Wahoo Kickr (Zwift),429,430,-1
121242,1614360913,wahoo,Zwift - KIRCHMAIR Race Series (A),Favero Assioma Duo Pedals (Secondary),2018 Wahoo Kickr (Zwift),441,442,-1
126992,1615476201,wahoo,Zwift - OH MY CRIT!! - The Double Race 1/2 (A),Favero Assioma Duo Pedals (Secondary),2018 Wahoo Kickr (Zwift),409,409,0
24948,1586974982,neo,Zwift - Maico Voets [DTCH]&#039;s Meetup - Greater London 8,4iiii Left Crank Arm only,Tacx Neo 2T,207,203,4
27169,1587576561,neo,Zwift - Watopia met Nike & Nikki (Neo2T,4iiii Left Crank Arm only,Tacx Neo 2T,168,169,-1
27518,1587662101,neo,Zwift - Maico Voets [DTCH]&#039;s Meetup - 2018 UCI Worlds Short Lap,4iiii Left Crank Arm only (garmin),Tacx Neo 2T (Zwift),391,391,0
27817,1587740414,neo,Zwift - ZHQ Beta Crit City Race,4iiii Left Crank Arm only (garmin),Tacx Neo 2T (Zwift),404,405,-1
28137,1587838137,neo,Zwift - Crit City Slam // Zwift Classic (A),4iiii Left Crank Arm only (garmin),Tacx Neo 2T (Zwift),414,422,-8
30448,1588086263,neo,Zwift - 3R Spring Loaded Race Series - Round 5of6,4iiii Left Crank Arm only (garmin),Tacx Neo 2T (Zwift),451,452,-1
31130,1588499117,neo,Zwift - Points Race League by Team DIRT #1st,4iiii Left Crank Arm only (garmin),Tacx Neo 2T (Zwift),413,407,6
31675,1588691114,neo,Zwift - 3R Spring Loaded Race Series - Round 6of6 #2nd,4iiii Left Crank Arm only (garmin),Tacx Neo 2T (Zwift),446,441,5
34536,1589390725,neo,Zwift - Zwift NL League - Woensdagavond Competitie #1st,4iiii Left Crank Arm only (garmin),Tacx Neo 2T (Zwift),429,412,17
36427,1589997548,neo,Zwift - Zwift NL League - Woensdagavond Competitie (A),4iiii Left Crank Arm only (garmin),Tacx Neo 2T (Zwift),418,407,11
36790,1590085017,neo,Zwift - Tour for All Invitational Race // Men (A),4iiii Left Crank Arm only (garmin),Tacx Neo 2T (Zwift),411,414,-3
37390,1590313515,neo,Zwift - Points Race League by Team DIRT (A),4iiii Left Crank Arm only (garmin),Tacx Neo 2T (Zwift),399,405,-6
38225,1590602297,neo,Zwift - Zwift NL League - Woensdagavond Competitie (A),4iiii Left Crank Arm only (garmin),Tacx Neo 2T (Zwift),443,440,3
38643,1590826491,neo,ZADA Three Sisters Route Verification,4iiii Left Crank Arm only (garmin),Tacx Neo 2T (Zwift),460,455,5
39409,1591207100,neo,Zwift - Zwift NL League - Woensdagavond Competitie (A),4iiii Left Crank Arm only (garmin),Tacx Neo 2T (Zwift),414,418,-4
40143,1591514416,wahoo,Zwift - Team Italy & Frenchy Fuzion Endurance Race #1st,4iiii Left Crank Arm only (garmin),Wahoo KICKR,411,419,-8
40942,1591811962,wahoo,Zwift - Zwift NL League - Woensdagavond Competitie (A),4iiii Left Crank Arm only (garmin),Wahoo KICKR,415,436,-21
49667,1597168650,wahoo,Zwift - ZWIFT NL - WAHOO Kickr Social Race,4iiii Left Crank Arm only (garmin),Wahoo KICKR V5,387,385,2
55050,1600106244,wahoo,Zwift - Invitational League // Qualifying Race #1,4iiii Left Crank Arm only (garmin),Wahoo KICKR V5,399,406,-7
55885,1600367251,wahoo,Zwift - Invitational League // Qualifying Race #2 (Men) ,4iiii Left Crank Arm only (garmin),Wahoo KICKR V5,380,399,-19
69036,1604838940,wahoo,Zwift - NYC Recon & Calibration Ride,4iiii Left Crank Arm only (garmin),Wahoo KICKR V5,275,302,-27
69501,1604951989,wahoo,Zwift - Premier Division // Zwift Racing League,4iiii Left Crank Arm only (garmin),Wahoo KICKR V5,460,459,1
71978,1605553171,wahoo,Zwift - Premier Division // Zwift Racing League (men) (A),4iiii Left Crank Arm only (garmin),Wahoo KICKR V5,409,401,8
74711,1606161444,wahoo,Zwift - Premier Division // Zwift Racing League (men) (A),4iiii Left Crank Arm only (garmin),Wahoo KICKR V5,471,447,24
76952,1606570061,neo,Zwift - Watopia met Jeff,4iiii Left Crank Arm only (garmin),Tacx Neo 2T (Zwift),320,324,-4
77694,1606763103,wahoo,Zwift - Premier Division // Zwift Racing League (men) (A),4iiii Left Crank Arm only (garmin),Wahoo KICKR V5,412,405,7
79231,1607021836,wahoo,BENELIGA 2020-2021,4iiii Left Crank Arm only (garmin),Wahoo KICKR V5,425,398,27
81819,1607626732,wahoo,Zwift - BENELIGA 2020-2021 (E) #39e + 13 Points,4iiii Left Crank Arm only (garmin),Wahoo KICKR V5,429,418,11
84499,1608231376,wahoo,Zwift - BENELIGA 2020-2021 #24 + 1 point..,4iiii Left Crank Arm only (garmin),Wahoo KICKR V5,438,433,5
86176,1608657905,wahoo,Zwift - Anaerobic efforts,4iiii Left Crank Arm only (garmin),Wahoo KICKR V5,349,334,15
93667,1610045901,wahoo,Zwift - BENELIGA 2020-2021,4iiii Left Crank Arm only (garmin),Wahoo KICKR V5,432,429,3
95026,1610390923,wahoo,Zwift - Premier Division // Zwift Racing League (men) (A),4iiii Left Crank Arm only (garmin),Wahoo KICKR V5,409,401,8
99266,1610999851,wahoo,Zwift - Premier Division // Zwift Racing League,4iiii Left Crank Arm only (garmin),Wahoo KICKR V5,407,400,7
101236,1611255390,wahoo,Zwift - BENELIGA 2020-2021 (E) +8 points,4iiii Left Crank Arm only (garmin),Wahoo KICKR V5,414,424,-10
104962,1611859798,wahoo,Wahoo KICKR V5 / 4iiii Left Crank Arm only (garmin),4iiii Left Crank Arm only (garmin),Wahoo KICKR V5,413,396,17
106937,1612209821,wahoo,Zwift - Premier Division // Zwift Racing League (men) (A),4iiii Left Crank Arm only (garmin),Wahoo KICKR V5,396,397,-1
111074,1612811997,wahoo,Zwift - Premier Division // Zwift Racing League (men) (A),4iiii Left Crank Arm only (garmin),Wahoo KICKR V5,427,425,2
115424,1613419299,wahoo,Zwift - Premier Division // Zwift Racing League ,4iiii Left Crank Arm only (garmin),Wahoo KICKR V5,433,433,0
117574,1613674733,wahoo,Zwift - BENELIGA 2020-2021 (E),4iiii Left Crank Arm only (garmin),Wahoo KICKR V5,399,409,-10
119133,1614021009,wahoo,Zwift - Premier Division // Zwift Racing League (men) (A),4iiii Left Crank Arm only (garmin),Wahoo KICKR V5,422,404,18
85880,1608578398,wahoo,Team TFC Mad Monday Winter Series,Wattbike Atom,Favero Assioma Dua / Wahoo Element Bolt,386,383,3
87979,1609099199,wahoo,Wattbike Atom / Favero Assioma Duo / Wahoo Element Bolt,Wattbike Atom,Favero Assioma Duo / Wahoo Element Bolt,384,380,4
88305,1609183198,wahoo,Wattbike Atom / Favero Assioma Duo / Wahoo Element Bolt,Wattbike Atom,Favero Assioma Duo / Wahoo Element Bolt,387,384,3
91374,1609787997,wahoo,Wattbike Atom / Favero Assioma Duo / Wahoo Element Bolt,Wattbike Atom,Favero Assioma Duo / Wahoo Element Bolt,398,400,-2
95023,1610392277,wahoo,Wattbike Atom / Favero Assioma Duo / Wahoo Element Bolt,Wattbike Atom,Favero Assioma Duo / Wahoo Element Bolt,378,396,-18
99219,1610999484,wahoo,Wattbike Atom / Favero Assioma Duo / Wahoo Element Bolt,Wattbike Atom,Favero Assioma Duo / Wahoo Element Bolt,389,385,4
102927,1611601290,wahoo,Zwift - Premier Division // Zwift Racing League (men) (A),Wattbike Atom,Favero Assioma Duo / Wahoo Element Bolt,400,404,-4
111059,1612811829,wahoo,Wattbike Atom / Favero Assioma Duo / Wahoo Element Bolt,Wattbike Atom,Favero Assioma Duo / Wahoo Element Bolt,403,400,3
119113,1614020691,wahoo,Zwift - Premier Division // Zwift Racing League (men) (A),Wattbike Atom,Favero Assioma Duo / Wahoo Element Bolt,401,404,-3
73628,1605747913,wahoo,Zwift - Cycling Canada Wednesday Night Race Series (A),Quarq DZero,Wahoo Kickr,358,375,-17
73632,1605832197,wahoo,Zwift - ZA Road - Race #2 (A),Quarq DZero,Wahoo Kickr,338,354,-16
73924,1605978000,wahoo,Zwift - Cycling Canada Pre-Worlds Showdown Series (A),Quarq DZero,Wahoo Kickr,365,372,-7
74804,1606186499,wahoo,Zwift - 3R Knickerbocker Climbing Race - 1 Lap (22.4km/13.9mi 365m) (A),Quarq DZero,Wahoo Kickr,370,386,-16
75263,1606261473,wahoo,Zwift - Watopia,Quarq DZero,Wahoo Kickr,104,108,-4
75713,1606352697,wahoo,Zwift - Cycling Canada Wednesday Night Race Series (A),Quarq DZero,Wahoo Kickr,336,346,-10
76326,1606433398,wahoo,Zwift - ZHQ FutureWorks Circuit Race - Anti-sandbagging (A),Quarq DZero,Wahoo Kickr,329,342,-13
76678,1606522271,wahoo,Zwift - Watopia,Quarq DZero,Wahoo Kickr,173,172,1
77057,1606582799,wahoo,Zwift - Cycling Canada Pre-Worlds Showdown Series (A),Quarq DZero,Wahoo Kickr,349,359,-10
77824,1606778790,wahoo,Zwift - Watopia,Quarq DZero,Wahoo Kickr,158,161,-3
78275,1606867303,wahoo,Zwift - Watopia,Quarq DZero,Wahoo Kickr,160,165,-5
78742,1606957495,wahoo,Zwift - Cycling Canada Wednesday Night Race Series (A),Quarq DZero,Wahoo Kickr,341,353,-12
79169,1607033482,wahoo,Zwift - Watopia,Quarq DZero,Wahoo Kickr,161,166,-5
79497,1607106644,wahoo,Zwift - ZADA 3 Sisters Verification,Quarq DZero,Wahoo Kickr,387,377,10
79880,1607187597,wahoo,Zwift - Nations Challenge // Canada (E),Quarq DZero,Wahoo Kickr,330,344,-14
79973,1607219809,wahoo,Zwift - Innsbruck,Quarq DZero,Wahoo Kickr,105,107,-2
80646,1607416408,wahoo,Zwift - Zwift Racing League | WTRL - Men&#039;s APAC DIVISION 1 (A),Quarq DZero,Wahoo Kickr,373,389,-16
81129,1607536206,wahoo,Zwift - MIDWEEK Winter Series by SZR (A),Quarq DZero,Wahoo Kickr,371,387,-16
81140,1607477286,wahoo,Zwift - Watopia,Quarq DZero,Wahoo Kickr,156,161,-5
81309,1607567367,wahoo,Zwift - Watopia,Quarq DZero,Wahoo Kickr,157,161,-4
82122,1607734797,wahoo,Zwift - Watopia,Quarq DZero,Wahoo Kickr,163,166,-3
82432,1607785633,wahoo,Zwift - OH MY CRIT - Saturday Smash Race (A),Quarq DZero,Wahoo Kickr,392,407,-15
83202,1607972711,wahoo,Zwift - Team TFC Mad Monday Winter Series (A),Quarq DZero,Wahoo Kickr,329,343,-14
83295,1607994808,wahoo,Zwift - Watopia,Quarq DZero,Wahoo Kickr,165,175,-10
83757,1608080704,wahoo,Zwift - Watopia,Quarq DZero,Wahoo Kickr,103,105,-2
84012,1608140938,wahoo,Zwift - MIDWEEK Winter Series by SZR (A),Quarq DZero,Wahoo Kickr,338,353,-15
84572,1608257055,wahoo,Zwift - Watopia,Quarq DZero,Wahoo Kickr,98,99,-1
85142,1608390289,wahoo,OH MY CRIT - Saturday Smash Race,Quarq DZero,Wahoo Kickr,392,412,-20
85885,1608577935,wahoo,Zwift - Team TFC Mad Monday Winter Series (A),Quarq DZero,Wahoo Kickr,346,366,-20
86574,1608745696,wahoo,MIDWEEK Winter Series by SZR,Quarq DZero,Wahoo Kickr,342,353,-11
86995,1608825847,wahoo,OH MY CRIT! - The Double Race 1/2,Quarq DZero,Wahoo Kickr,397,408,-11
86996,1608828833,wahoo,OH MY CRIT! - The Double Race 2/2,Quarq DZero,Wahoo Kickr,333,346,-13
87510,1608995180,wahoo,OH MY CRIT - Saturday Smash Race,Quarq DZero,Wahoo Kickr,354,365,-11
88316,1609182507,wahoo,Team TFC Mad Monday Winter Series,Quarq DZero,Wahoo Kickr,340,353,-13
88721,1609267503,wahoo,Team Italy & Frenchy Fuzion League,Quarq DZero,Wahoo Kickr,410,420,-10
89527,1609430432,wahoo,OH MY CRIT! - The Double Race 1/2,Quarq DZero,Wahoo Kickr,337,348,-11
90282,1609600237,wahoo,OH MY CRIT - Saturday Smash Race,Quarq DZero,Wahoo Kickr,349,359,-10
91400,1609786845,wahoo,Team TFC Mad Monday Winter Series,Quarq DZero,Wahoo Kickr,342,353,-11
93573,1610144656,wahoo,Zwift - Watopia,Quarq DZero,Wahoo Kickr,161,159,2
95264,1610391833,wahoo,Premier Division // Zwift Racing League (men),Quarq DZero,Wahoo Kickr,367,355,12
95954,1610492328,wahoo,Zwift - Watopia,Quarq DZero,Wahoo Kickr,167,160,7
96979,1610647414,wahoo,WTRL Team Time Trial Platinum League,Quarq DZero,Wahoo Kickr,377,367,10
98057,1610809492,wahoo,OH MY CRIT - Saturday Smash Race,Quarq DZero,Wahoo Kickr,354,337,17
99253,1610997677,wahoo,Premier Division // Zwift Racing League (men),Quarq DZero,Wahoo Kickr,374,361,13
100301,1611164745,wahoo,MIDWEEK Winter Series by SZR,Quarq DZero,Wahoo Kickr,340,340,0
101590,1611361630,wahoo,Zwift - Muir And The Mountain,Quarq DZero,Wahoo Kickr,216,209,7
102054,1611426440,wahoo,Zwift - Watopia,Quarq DZero,Wahoo Kickr,183,174,9
102899,1611599440,wahoo,Premier Division // Zwift Racing League (men),Quarq DZero,Wahoo Kickr,372,363,9
104108,1611769604,wahoo,MIDWEEK Winter Series by SZR,Quarq DZero,Wahoo Kickr,363,352,11
105322,1611966493,wahoo,Zwift - NYC,Power2Max,Wahoo Kickr,179,177,2
105639,1612019097,wahoo,OH MY CRIT!! - Saturday Smash Race,Quarq DZero,Wahoo Kickr,363,340,23
106298,1612110527,wahoo,London,Quarq DZero,Wahoo Kickr,161,156,5
106872,1612207272,wahoo,Zwift - Premier Division // Zwift Racing League (men) (A),Quarq DZero,Wahoo Kickr,395,381,14
108166,1612374526,wahoo,MIDWEEK Winter Series by SZR,Quarq DZero,Wahoo Kickr,351,339,12
109975,1612623645,wahoo,OH MY CRIT!! - Saturday Smash Race,Quarq DZero,Wahoo Kickr,398,383,15
110207,1612663117,wahoo,Zwift - Watopia,Quarq DZero,Wahoo Kickr,162,157,5
110473,1612709900,wahoo,Team TTT Recon Ride,Quarq DZero,Wahoo Kickr,290,282,8
110568,1612715013,wahoo,Watopia,Quarq DZero,Wahoo Kickr,161,157,4
110973,1612810780,wahoo,Zwift - Premier Division // Zwift Racing League (men) (A),Quarq DZero,Wahoo Kickr,375,371,4
111883,1612917293,wahoo,Watopia,Quarq DZero,Wahoo Kickr,104,108,-4
112566,1613006858,wahoo,Watopia,Quarq DZero,Wahoo Kickr,168,166,2
112814,1613059127,wahoo,OH MY CRIT!! - The Double Race 1/2,Quarq DZero,Wahoo Kickr,334,327,7
113249,1613105812,wahoo,Zwift - Zwift Fast Fridays: Tempus Fugit Time Trial (E),Quarq DZero,Wahoo Kickr,372,361,11
114281,1613237131,wahoo,Zwift - Chasing Cancellara Time Trial,Quarq DZero,Wahoo Kickr,381,370,11
114827,1613321959,wahoo,Zwift - Watopia,Quarq DZero,Wahoo Kickr,217,216,1
115334,1613417353,wahoo,Zwift - Premier Division // Zwift Racing League (men) (A),Quarq DZero,Wahoo Kickr,400,395,5
116607,1613584028,wahoo,Zwift - MIDWEEK Winter Series by SZR (A),Quarq DZero,Wahoo Kickr,345,321,24
118393,1613844008,wahoo,Zwift - Watopia,Quarq DZero,Wahoo Kickr,163,156,7
118799,1613927829,wahoo,Zwift - France,Quarq DZero,Wahoo Kickr,204,197,7
119078,1614019424,wahoo,Zwift - Premier Division // Zwift Racing League (men) (A),Quarq DZero,Wahoo Kickr,353,348,5
120371,1614189027,wahoo,Zwift - MIDWEEK Winter Series by SZR (A),Quarq DZero,Wahoo Kickr,361,350,11
121358,1614389239,wahoo,TFC Xmas Smash Fest,Quarq DZero,Wahoo Kickr,353,346,7
122573,1614627939,wahoo,Zwift - Premier Division // Zwift Racing League (men) (A),Quarq DZero,Wahoo Kickr,375,360,15
124276,1614900112,wahoo,Zwift - ZHQ FutureWorks Circuit Race - Anti-sandbagging (A),Quarq DZero,Wahoo Kickr,413,403,10
125925,1615254890,wahoo,Zwift - Watopia,Quarq DZero,Wahoo Kickr,116,116,0
126250,1615316818,wahoo,WEz Team Race,Quarq DZero,Wahoo Kickr,366,362,4
126781,1615424734,wahoo,Zwift - France,Quarq DZero,Wahoo Kickr,154,150,4
127054,1615485652,wahoo,WTRL Team Time Trial Platinum League,Quarq DZero,Wahoo Kickr,365,355,10
128181,1615672396,wahoo,Recovery Ride,Quarq DZero,Wahoo Kickr,200,197,3
128386,1615731598,wahoo,Zwift - Team Draft Libby Hill After Party Race (A),Quarq DZero,Wahoo Kickr,316,309,7
129127,1615918041,wahoo,Zwift - CeramicSpeed Race Series: Open Race (A),Quarq DZero,Wahoo Kickr,400,394,6
1021,1567208998,wahoo,Zwift - Japan Weekend Hill Climb Race - Richmond Hilly 8laps (A),Favero Assioma DUO Right Axle Replaced,Wahoo Kickr Core (without ANT+ Control),281,278,3
2605,1569494099,wahoo,Zwift - Japan ZWIFT Hillclimb Race (A),Favero Assioma DUO New One,Wahoo Kickr Core (without ANT+ Control),325,323,2
10957,1580018346,wahoo,Zwift - 01/26/2020,Favero Assioma DUO New One,Wahoo Kickr Core (without ANT+ Control),337,335,2
18095,1584259676,wahoo,Zwift - 03/15/2020,Favero Assioma DUO New One,Wahoo Kickr Core (without ANT+ Control),337,338,-1
21657,1585904396,wahoo,Zwift -  Haute Route Watopia Stage 1 (E),Favero Assioma DUO New One,Wahoo Kickr Core (without ANT+ Control),331,331,0
21926,1585990795,wahoo, Haute Route Watopia Stage 2,Favero Assioma DUO New One,Wahoo Kickr Core (without ANT+ Control),322,322,0
22184,1586077196,wahoo,Zwift -  Haute Route Watopia Stage 3 (E),Favero Assioma DUO New One,Wahoo Kickr Core (without ANT+ Control),340,334,6
25801,1587196796,wahoo,Zwift - Matando O Corpo ZESP by SARIS (A),Favero Assioma DUO New One,Wahoo Kickr Core (without ANT+ Control),324,324,0
40113,1591513193,wahoo,Zwift - Virtual Mt.Fuji Hill Climb Race ,Favero Assioma DUO New One,Wahoo Kickr Core (without ANT+ Control),311,314,-3
43882,1593307796,wahoo,Zwift - Clubteam Weekend Race (A),Favero Assioma DUO New One,Wahoo Kickr Core (without ANT+ Control),328,330,-2
61435,1602578699,wahoo,Zwift - 10/13/2020,Favero Assioma DUO New One,Wahoo Kickr Core (without ANT+ Control),322,322,0
63323,1603183781,wahoo,Zwift - Zwift Racing League | WTRL - APAC (MEN) - TTT (A),Favero Assioma DUO New One,Wahoo Kickr Core (without ANT+ Control),322,323,-1
65318,1603788278,wahoo,Zwift - 10/27/2020,Favero Assioma DUO New One,Wahoo Kickr Core (without ANT+ Control),301,311,-10
67497,1604394234,wahoo,Zwift - Zwift Racing League | WTRL - Men&#039;s APAC DIVISION 1 (A),Favero Assioma DUO New One,Wahoo Kickr Core (without ANT+ Control),322,343,-21
68926,1604797201,wahoo,Zwift - Road to Okinawa Race (A),Favero Assioma DUO New One,Wahoo Kickr Core (without ANT+ Control),315,329,-14
69586,1604997894,wahoo,Zwift - Zwift Racing League | WTRL - APAC (MEN) -  Division 1 (A),Favero Assioma DUO New One,Wahoo Kickr Core (without ANT+ Control),329,342,-13
72070,1605603314,wahoo,Zwift - Zwift Racing League | WTRL - Men&#039;s APAC DIVISION 1 (A),Favero Assioma DUO New One,Wahoo Kickr Core (without ANT+ Control),322,327,-5
74847,1606207499,wahoo,Zwift - Zwift Racing League | WTRL - Men&#039;s APAC DIVISION 1,Favero Assioma DUO New One,Wahoo Kickr Core (without ANT+ Control),351,365,-14
77888,1606812913,wahoo,Zwift - Zwift Racing League | WTRL - Men&#039;s APAC DIVISION 1 (A),Favero Assioma DUO New One,Wahoo Kickr Core (without ANT+ Control),322,333,-11
80651,1607417096,wahoo,Zwift - Zwift Racing League | WTRL - Men&#039;s APAC DIVISION 1 (A),Favero Assioma DUO New One,Wahoo Kickr Core (without ANT+ Control),333,346,-13
83359,1608022188,wahoo,Zwift - Zwift Racing League | WTRL - Men&#039;s APAC DIVISION 1 (A),Favero Assioma DUO New One,Wahoo Kickr Core (without ANT+ Control),310,328,-18
87711,1609059714,wahoo,ZADA Three Sisters Test,Favero Assioma DUO New One,Wahoo Kickr Core,319,315,4
88106,1609152636,wahoo,Zwift - Watopia,Favero Assioma DUO New One (Dirty Chain),Wahoo Kickr Core,226,225,1
88116,1609154805,wahoo,Zwift - Watopia,Favero Assioma DUO New One,Wahoo Kickr Core,239,236,3
88447,1609232384,wahoo,Zwift - I PIROSHIKI�(c i)&#039;s Meetup - Road to Sky,Favero Assioma DUO New One,Wahoo Kickr Core,313,308,5
88916,1609322244,wahoo,Zwift - Watopia,Favero Assioma DUO New One,Wahoo Kickr Core,208,209,-1
89277,1609397083,wahoo,Zwift - Kanji Abeki STINGER [ZWC]&#039;s Meetup - Three Sisters,Favero Assioma DUO New One,Wahoo Kickr Core,336,328,8
89323,1609400298,wahoo,Zwift - Watopia,Favero Assioma DUO New One,Wahoo Kickr Core,292,289,3
89741,1609492051,wahoo,Zwift - Watopia,Favero Assioma DUO New One,Wahoo Kickr Core,228,228,0
92701,1610015607,wahoo,Zwift - Japan ZWIFT Hill Climb Race (A),Favero Assioma DUO New One,Wahoo Kickr Core,308,306,2
94978,1610390747,wahoo,Zwift - Premier Division // Zwift Racing League (men) (A),Favero Assioma DUO New One,Wahoo Kickr Core,319,309,10
97346,1610706126,wahoo,Zwift - Watopia,Favero Assioma DUO New One,Wahoo Kickr Core,215,215,0
99190,1610999631,wahoo,Zwift - Premier Division // Zwift Racing League (men) (A),Favero Assioma DUO New One,Wahoo Kickr Core,315,321,-6
101633,1611383417,wahoo,Zwift - XRS Races - The Saturday Classic (A),Favero Assioma DUO New One,Wahoo Kickr Core,340,335,5
102885,1611601485,wahoo,Zwift - Premier Division // Zwift Racing League (men) (A),Favero Assioma DUO New One,Wahoo Kickr Core,334,345,-11
104442,1611825681,wahoo,Zwift - London,Favero Assioma DUO New One,Wahoo Kickr Core,365,368,-3
106884,1612210018,wahoo,Zwift - 02/02/2021,Favero Assioma DUO New One,Wahoo Kickr Core,307,314,-7
112414,1612983601,wahoo,Zwift - Movistar Team Challenge // Round 1 (A),Favero Assioma DUO New One,Wahoo Kickr Core,280,281,-1
113634,1613156396,wahoo,Zwift - Movistar Team Challenge // Round 1 (men),Favero Assioma DUO New One,Wahoo Kickr Core,341,340,1
115365,1613419313,wahoo,Zwift - Premier Division // Zwift Racing League (men) (A),Favero Assioma DUO New One,Wahoo Kickr Core,317,318,-1
116782,1613588399,wahoo,Zwift - Movistar Team Challenge // Round 2 (men) - Race 3/4,Favero Assioma DUO New One,Wahoo Kickr Core,277,280,-3
117898,1613761191,wahoo,Zwift - Movistar Team Challenge // Round 2 (men),Favero Assioma DUO New One,Wahoo Kickr Core,336,331,5
119131,1614020996,wahoo,Zwift - Premier Division // Zwift Racing League (men) (A),Favero Assioma DUO New One,Wahoo Kickr Core,274,277,-3
122691,1614629936,wahoo,Zwift - Premier Division // Zwift Racing League (men) (A),Favero Assioma DUO New One,Wahoo Kickr Core,326,315,11
123788,1614827460,wahoo,Zwift - Watopia,Favero Assioma DUO New One,Wahoo Kickr Core,209,208,1
124104,1614884380,wahoo,Zwift - Ramp Test,Favero Assioma DUO New One,Wahoo Kickr Core,367,359,8
124125,1614886785,wahoo,Zwift - Movistar Team Challenge // Points Race (men),Favero Assioma DUO New One,Wahoo Kickr Core,299,293,6
125689,1615200045,wahoo,Zwift - ZWC Hill Climb Battle (A),4iiii Precision Dual Sided,Wahoo Kickr Core,332,336,-4
60191,1602113401,wahoo,Zwift - Alex TenElshof [Finesse Wahoo]&#039;s Meetup - Big Foot Hills,Quarq SRAM Red,Wahoo Kickr,333,325,8
60811,1602339298,wahoo,Zwift - OH MY CRIT - Saturday Smash Race (A),Quarq SRAM Red,Wahoo Kickr,346,338,8
61678,1602632691,wahoo,Zwift - Zwift Racing League | WTRL (A),Quarq DZero AXS,Wahoo Kickr (Zwift),382,377,5
62002,1602718195,wahoo,Zwift - Austin Driveway Series Criterium (A),Quarq DZero AXS,Wahoo Kickr (Zwift),356,347,9
62635,1602944096,wahoo,OH MY CRIT - Saturday Smash Race,Quarq DZero AXS,Wahoo Kickr (Zwift),352,349,3
63996,1603322315,wahoo,Zwift - Austin Driveway Series Criterium (A),Quarq DZero AXS,Wahoo Kickr (Zwift),364,355,9
64638,1603547939,wahoo,Zwift - The P Race (A),Quarq DZero AXS,Wahoo Kickr (Zwift),365,354,11
66057,1603927317,wahoo,Zwift - Austin Driveway Series Criterium (A),Quarq DZero AXS,Wahoo Kickr (Zwift),347,343,4
66709,1604157148,wahoo,Zwift - OH MY CRIT - Saturday Smash Race (A),Quarq DZero AXS,Wahoo Kickr (Zwift),350,340,10
66972,1604236479,wahoo,Zwift - KISS at Race 100 - Americas (A),Quarq DZero AXS,Wahoo Kickr (Zwift),344,337,7
67761,1604451489,wahoo,Zwift - Zwift Racing League | WTRL - Men&#039;s AMERICAS E DIVISION 1 (A),Quarq DZero AXS,Wahoo Kickr (Zwift),358,353,5
68807,1604762035,wahoo,Zwift - OH MY CRIT - Saturday Smash Race (A),Quarq DZero AXS,Wahoo Kickr (Zwift),359,350,9
70005,1605055437,wahoo,Zwift - Zwift Racing League | WTRL - AMERICAS E (MEN) -  Division 1 (A),Quarq DZero AXS,Wahoo Kickr (Zwift),418,409,9
75288,1606265068,wahoo,Zwift - Zwift Racing League | WTRL - Men&#039;s AMERICAS E DIVISION 1,Quarq DZero AXS,Wahoo Kickr (Zwift),352,343,9
75943,1606407004,wahoo,Zwift - OH MY CRIT! - The Double Race 1/2 (A),Quarq DZero AXS,Wahoo Kickr (Zwift),372,361,11
75944,1606407004,wahoo,Zwift - OH MY CRIT! - The Double Race 2/2 (A),Quarq DZero AXS,Wahoo Kickr (Zwift),345,337,8
78292,1606870310,wahoo,Zwift - Zwift Racing League | WTRL - Men&#039;s AMERICAS E DIVISION 1 (A),Quarq DZero AXS,Wahoo Kickr (Zwift),349,346,3
78936,1607012037,wahoo,Zwift - OH MY CRIT! - The Double Race 1/2 (A),Quarq DZero AXS,Wahoo Kickr (Zwift),360,355,5
78937,1607012037,wahoo,Zwift - OH MY CRIT! - The Double Race 2/2 (A),Quarq DZero AXS,Wahoo Kickr (Zwift),358,355,3
81068,1607474639,wahoo,Zwift - Zwift Racing League | WTRL - Men&#039;s AMERICAS E DIVISION 1 (A),Quarq DZero AXS,Wahoo Kickr (Zwift),358,350,8
81785,1607643840,wahoo,Zwift - Crit City Race (A),Quarq DZero AXS,Wahoo Kickr (Zwift),342,334,8
82417,1607786038,wahoo,Zwift - OH MY CRIT - Saturday Smash Race (A),Quarq DZero AXS,Wahoo Kickr (Zwift),410,403,7
83759,1608079902,wahoo,Zwift - Zwift Racing League | WTRL - Men&#039;s AMERICAS E DIVISION 1 (A),Quarq DZero AXS,Wahoo Kickr (Zwift),349,344,5
84783,1608314371,wahoo,Zwift - KIRCHMAIR Race Series (A),Quarq DZero AXS,Wahoo Kickr (Zwift),363,348,15
84784,1608316172,wahoo,Zwift - KIRCHMAIR Race Series (A),Quarq DZero AXS,Wahoo Kickr (Zwift),377,356,21
85490,1608482101,wahoo,Data comparison tests,Quarq DZero AXS,Wahoo Kickr (Zwift),316,311,5
85881,1608578385,wahoo,Zwift - Team TFC Mad Monday Winter Series (A),Quarq DZero AXS,Wahoo Kickr (Zwift),370,360,10
86567,1608746366,wahoo,Zwift - MIDWEEK Winter Series by SZR (A),Quarq DZero AXS,Wahoo Kickr (Zwift),358,348,10
87541,1609002624,wahoo,Three Sisters ZADA Test 12/26/20,Quarq DZero AXS,Wahoo Kickr (Zwift),389,380,9
89112,1609351187,wahoo,Zwift - MIDWEEK Winter Series by SZR (A),Quarq DZero AXS,Wahoo Kickr (Zwift),375,363,12
89523,1609431269,wahoo,Zwift - OH MY CRIT! - The Double Race 1/2 (A),Quarq DZero AXS,Wahoo Kickr (Zwift),356,344,12
90308,1609604976,wahoo,Zwift - TEAM VEGAN Tofu Tornado (A),Quarq DZero AXS,Wahoo Kickr (Zwift),381,369,12
93936,1610205266,wahoo,Zwift - OH MY CRIT - Saturday Smash Race (A),Quarq DZero AXS,Wahoo Kickr (Zwift),387,373,14
96497,1610560766,wahoo,Zwift - MIDWEEK Winter Series by SZR (A),Quarq DZero AXS,Wahoo Kickr (Zwift),390,377,13
96875,1610640873,wahoo,Zwift - OH MY CRIT! - The Double Race 1/2 (A),Quarq DZero AXS,Wahoo Kickr (Zwift),403,391,12
98054,1610810070,wahoo,Zwift - OH MY CRIT - Saturday Smash Race (A),Quarq DZero AXS,Wahoo Kickr (Zwift),374,361,13
98597,1610892879,wahoo,Zwift - KISS 100 Race Series - Americas (A),Quarq DZero AXS,Wahoo Kickr (Zwift),372,361,11
100292,1611165567,wahoo,Zwift - MIDWEEK Winter Series by SZR (A),Quarq DZero AXS,Wahoo Kickr (Zwift),369,360,9
100811,1611245689,wahoo,Zwift - OH MY CRIT! - The Double Race 1/2 (A),Quarq DZero AXS,Wahoo Kickr (Zwift),378,368,10
104131,1611770378,wahoo,Zwift - MIDWEEK Winter Series by SZR (A),Quarq DZero AXS,Wahoo Kickr (Zwift),376,368,8
104615,1611853459,wahoo,Zwift - NYC,Quarq DZero AXS,Wahoo Kickr (Zwift),375,363,12
105664,1612019676,wahoo,Zwift - OH MY CRIT!! - Saturday Smash Race (A),Quarq DZero AXS,Wahoo Kickr (Zwift),387,375,12
108181,1612375169,wahoo,Zwift - NYC,Quarq DZero AXS,Wahoo Kickr (Zwift),351,341,10
108764,1612455270,wahoo,Zwift - OH MY CRIT!! - The Double Race 1/2 (A),Quarq DZero AXS,Wahoo Kickr (Zwift),384,375,9
10576,1578590778,wahoo,Zwift - SCF SWE Cup Racing League (A),4424698922[1],Wahoo Kickr 2016,435,454,-19
94934,1610387109,wahoo,Zwift - SCF SWE Cup (A),Stages Power gen 3,Wahoo Kickr 2016,428,422,6
98974,1610986168,wahoo,Zwift - Rull innan core,4iiii Power,Wahoo Kickr 2016,366,365,1
99091,1610996401,wahoo,Zwift -  SCF SWE Cup Men (A),4iiii Power,Wahoo Kickr 2016,504,506,-2
102839,1611595815,wahoo,Zwift -  SCF SWE Cup Men (A),4iiii Power,Wahoo Kickr 2016,479,491,-12
104601,1611853493,wahoo,Zwift - OH MY CRIT!! - The Double Race 2/2 (A),4iiii Power,Wahoo Kickr 2016,453,448,5
105146,1611934186,wahoo,Zwift - BST Mountaingoat Race (A),4iiii Power,Wahoo Kickr 2016,471,465,6
106757,1612205999,wahoo,Zwift -  SCF SWE Cup Men (A),4iiii Power,Wahoo Kickr 2016,473,475,-2
108766,1612453858,wahoo,Zwift - 2x20 SS,4iiii Power,Wahoo Kickr 2016,390,374,16
109321,1612532625,wahoo,Zwift - 20 min free ride,4iiii Power,Wahoo Kickr 2016,399,379,20
110928,1612805400,wahoo,Zwift -  SCF SWE Cup Men (A),Stages Power gen 3,Wahoo Kickr 2016,454,448,6
112279,1612977823,wahoo,Zwift - UKAFC Race Night (A),Stages Power gen 3,Wahoo Kickr 2016,454,442,12
112283,1612977564,wahoo,Zwift - London,Stages Power gen 3,Wahoo Kickr 2016,454,413,41
115571,1613415591,wahoo,Zwift -  SCF SWE Cup Men (A),Stages Power gen 3,Wahoo Kickr 2016,468,472,-4
117244,1613667909,wahoo,Zwift - OH MY CRIT!! - The Double Race 2/2 (A),Stages Power gen 3,Wahoo Kickr 2016,451,450,1
119041,1614014995,wahoo,Zwift -  SCF SWE Cup Men (A),4iiii Power,Wahoo Kickr 2016,527,540,-13
120384,1614192300,wahoo,Zwift - Scandinavian Cup 2021 - Round 1 - Men (A),4iiii Power,Wahoo Kickr 2016,437,436,1
31472,1588515012,neo,Zwift - 3R Alpe Du Zwift KOM Race (20km 1444m) (A),FSA Powerbox (Power2max NG Eco),Tacx Neo 2,333,333,0
31475,1588178077,neo,Zwift - Swedish Zwift Racing Cup by SZR (A),Favero Assioma Duo,Tacx Neo,382,375,7
31479,1587489113,neo,Zwift - Richmond Challenge Race // Zwift Classic (A),Favero Assioma Duo,Tacx Neo 2,380,376,4
39501,1591206040,neo,Zwift - Zwift NL League - Woensdagavond Competitie (A),Favero Assioma Duo,Tacx Neo 2,384,384,0
40941,1591811010,neo,Zwift - Zwift NL League - Woensdagavond Competitie (A),Favero Assioma Duo,Tacx Neo 2,391,386,5
67575,1604427874,neo,Zwift - Zwift Racing League | WTRL - Men&#039;s EMEA E1 DIVISION 2 (A),Favero Assioma Duo,Tacx Neo 2,380,384,-4
69747,1605032097,neo,Zwift - Zwift Racing League | WTRL - EMEA E1 (MEN) -  Division 1 (A),Favero Assioma Duo,Tacx Neo 2,419,423,-4
70243,1605117604,neo,Zwift - MIDWEEK Autumn Series by SZR (A),Favero Assioma Duo,Tacx Neo 2,360,359,1
71680,1605452854,neo,Zwift - The Alpe Dash by Herd Racing League (A),Favero Assioma Duo,Tacx Neo 2,377,379,-2
72213,1605637513,neo,Zwift Racing League | WTRL - Mens EMEA E1 DIVISION 2,Favero Assioma Duo,Tacx Neo 2,384,383,1
74221,1606054202,neo,Zwift - ZA Road - Race #2 (A),Favero Assioma Duo,Tacx Neo 2,358,360,-2
75009,1606241721,neo,Zwift - Zwift Racing League | WTRL - Men&#039;s EMEA E1 DIVISION 1,Favero Assioma Duo,Tacx Neo 2,401,405,-4
77300,1606660513,neo,Zwift - 3R Alpe Du Zwift KOM Race (20km 1444m) (A),4IIII,Tacx Neo 2,400,391,9
79016,1607021991,neo,BENELIGA 2020-2021,4iiii,Tacx Neo 2,382,391,-9
80028,1607247023,neo,Zwift -  SloZl - Slovenian Zwift League - Weekly Race  (A),4iiii,Tacx Neo 2,382,396,-14
81627,1607625350,neo,BENELIGA 2020-2021,Favero Assioma Duo,Tacx Neo 2,390,399,-9
82745,1607867102,neo,Zwift - Crit City Race (A),Favero Assioma Duo,Tacx Neo 2,360,362,-2
83526,1608056703,neo,Zwift - Zwift Racing League | WTRL - Men&#039;s EMEA E1 DIVISION 2 (A),Favero Assioma Duo,Tacx Neo 2,379,377,2
84418,1608230515,neo,Zwift - BENELIGA 2020-2021 (E),Favero Assioma Duo,Tacx Neo 2,401,408,-7
85092,1608389674,neo,Zwift - Tour of New York Stage 2 - Open Longer,Favero Assioma Duo,Tacx Neo 2,397,404,-7
86096,1608642900,neo,Zwift - 3R Figure 8 Hilly Reverse Race - 1 Lap (29.2km/18.1mi 234m ) (A),Favero Assioma Duo,Tacx Neo 2,375,376,-1
86097,1608642956,neo,Zwift - 3R LaGuardia Super Sprint Race - 1 Lap (3.7km/2.6mi 27m) (A),Favero Assioma Duo,Tacx Neo 2,370,370,0
86909,1608812699,neo,Zwift - EMU Japan Race (A),Favero Assioma Duo,Tacx Neo 2,350,350,0
87483,1608995705,neo,Zwift - OH MY CRIT - Saturday Smash Race (A),Favero Assioma Duo,Tacx Neo 2,372,377,-5
89400,1609419889,neo,Zwift - 3R Knickerbocker Climbing Race - 1 Lap (22.4km/13.9mi 365m) (A),Favero Assioma Duo,Tacx Neo 2,388,396,-8
89815,1609513995,neo,Zwift - 3R Sand and Sequoias Race (A),Favero Assioma Duo,Tacx Neo 2,387,393,-6
90588,1609664693,neo,Zwift - Newbury Velo Road Race (A),Favero Assioma Duo,Tacx Neo 2,346,348,-2
92980,1610045148,neo,BENELIGA 2020-2021,Favero Assioma Duo,Tacx Neo 2,413,419,-6
99640,1611079057,neo,Zwift - Zwift Racing League | WTRL - Men&#039;s/Mixed EMEA E1 DIVISION 1 (A),Favero Assioma Duo,Tacx Neo 2,396,396,0
100947,1611254170,neo,BENELIGA 2020-2021,Favero Assioma Duo,Tacx Neo 2,386,389,-3
101365,1610647598,wahoo,Zwift - BENELIGA 2020-2021 (E),Favero Assioma Duo,Wahoo Kickr,394,394,0
103439,1611684291,neo,Zwift - Zwift Racing League | WTRL - Men&#039;s/Mixed EMEA E1 DIVISION 1 (A),Favero Assioma Duo,Tacx Neo 2,409,417,-8
104729,1611858078,neo,Zwift - BENELIGA 2020-2021 (E),Favero Assioma Duo,Tacx Neo 2,383,384,-1
108953,1612464878,neo,Zwift - BENELIGA 2020-2021 (E),Favero Assioma Duo,Tacx Neo 2,413,421,-8
113016,1613070014,neo,Zwift - BENELIGA 2020-2021 (E),Favero Assioma Duo,Tacx Neo 2,452,463,-11
117309,1613673058,neo,BENELIGA 2020-2021,Favero Assioma Duo,Tacx Neo 2,376,377,-1
119567,1614103509,neo,Zwift - Zwift Racing League | WTRL - Men&#039;s/Mixed EMEA E1 DIVISION 1 (A),Favero Assioma Duo,Tacx Neo 2,370,371,-1
124571,1614707173,neo,Zwift - Zwift Racing League | WTRL - Men&#039;s/Mixed EMEA E1 DIVISION 1 (A),Favero Assioma Duo,Tacx Neo 2,410,410,0
124572,1614969296,neo,Zwift - Zwift Racing League | WTRL Battle Royale Playoff - Men&#039;s Points Race (A),Favero Assioma Duo,Tacx Neo 2,389,388,1
125160,1615059144,neo,Zwift - 03/06/2021,Favero Assioma Duo,Tacx Neo 2,383,410,-27
28859,1588097248,wahoo,Zwift - 3R Spring Loaded Race Series - Round 5of6 (Reverse) (A),Quarq dZero,Wahoo Kicker,400,400,0
28861,1588097248,wahoo,Zwift - 3R Spring Loaded Race Series - Round 5of6 (Reverse) (A),Quarq dZero,Wahoo Kicker,400,400,0
29213,1588179598,wahoo,Zwift - Swedish Zwift Racing Cup by SZR (A),Quarq dZero,Wahoo Kicker,398,407,-9
29214,1588182894,wahoo,Zwift - USA Cycling Race League by Indoor Specialist  (A),Quarq dZero,Wahoo Kicker,356,367,-11
32100,1588788164,wahoo,Zwift - DBR Sprinthooligan Cup (A),Quarq dZero,Wahoo Kicker,357,356,1
55138,1600106376,wahoo,Zwift - Invitational League // Qualifying Race #1,Quarq dZero,Wahoo Kicker core,391,386,5
55965,1600367400,wahoo,Zwift - Invitational League // Qualifying Race #2 (Men) ,Quarq dZero,Wahoo Kicker core,375,380,-5
57102,1600883095,wahoo,Zwift - DCU powered by Feltet.dk (A),Quarq dZero,Wahoo Kicker core,440,436,4
58264,1601385910,wahoo,ZADA 3 sister test,2020-09-29-15-25-14,Wahoo Kicker core,432,431,1
58580,1601487899,wahoo,Zwift - DCU powered by Feltet.dk (A),Quarq dZero,Wahoo Kicker core,402,412,-10
61318,1602528600,wahoo,Zwift - Premier Division //  Zwift Racing League,Quarq dZero,Wahoo Kicker core,413,431,-18
65214,1603742398,wahoo,Zwift - Premier Division // Zwift Racing League (men) (A),Quarq dZero,Wahoo Kicker core,391,400,-9
67326,1604344394,wahoo,Zwift - Premier Division // Zwift Racing League (men) (A),Quarq dZero,Wahoo Kicker core,381,394,-13
69109,1604858167,neo,Zwift Academy Road: Workout 7 | VO2 Development,Quarq dZero,Tacx Neo 2t,376,364,12
69482,1604951992,wahoo,Zwift - Premier Division // Zwift Racing League (men) (A),Quarq dZero,Wahoo Kicker core,440,457,-17
70220,1605111302,neo,Zwift Academy Road: Workout 8 | Anaerobic Depletion,Quarq dZero,Tacx Neo 2t,305,312,-7
70801,1605207432,neo,Zwift - Espresso,Quarq dZero,Tacx Neo 2t,380,369,11
72023,1605553006,wahoo,Zwift - Premier Division // Zwift Racing League (men) (A),Quarq dZero,Wahoo Kicker core,393,406,-13
73268,1605814182,neo,Zwift - World Championships Experience // Danish Cycling Federation,Quarq dZero,Tacx Neo 2t,390,373,17
73566,1605888599,wahoo,Zwift - ZA Road Race #1: 4 - 5 w/kg,Quarq dZero,Wahoo Kicker core,376,388,-12
74372,1606064395,wahoo,Zwift - ZA Road 2020 - Segment Ride #1: Innsbruck Course,Quarq dZero,Wahoo Kicker core,373,386,-13
74728,1606161576,wahoo,Zwift - Premier Division // Zwift Racing League (men) (A),Quarq dZero,Wahoo Kicker core,409,420,-11
75550,1606325391,wahoo,Zwift - ZA Road - Race #2 (A),Quarq dZero,Wahoo Kicker core,368,379,-11
76031,1606416234,wahoo,Zwift - WTRL NOPINZ WORLD TTT CHAMPIONSHIPS - Zone 6 (C),Quarq dZero,Wahoo Kicker v4,383,379,4
77706,1606763191,wahoo,Zwift - Premier Division // Zwift Racing League (men) (A),Quarq dZero,Wahoo Kicker core,397,410,-13
78560,1606925400,neo,Zwift - 3R Tick Tock Flat Race - 2 Lap (36km/22.4mi 100m) (A),Quarq dZero,Tacx Neo 2t,326,324,2
80114,1607259900,neo,Zwift - 3R Watopia Flat Route Race - 4 Laps (40.5km/25.1mi 216m) (A),Quarq dZero,Tacx Neo 2t,381,370,11
95058,1610391832,wahoo,Zwift - Premier Division // Zwift Racing League (men) (A),Quarq dZero,Wahoo Kicker core,372,381,-9
96473,1610563411,wahoo,Zwift - Danmarks Cykle Union & Partners 1/6 (A),Quarq dZero,Wahoo Kicker core,408,427,-19
97926,1610788336,wahoo,Zwift - DBR SufferDay League III (A),Quarq dZero,Wahoo Kicker core,414,403,11
99294,1610999963,wahoo,Zwift - Premier Division // Zwift Racing League (men) (A),Quarq dZero,Wahoo Kicker core,402,394,8
100371,1611166305,wahoo,Zwift - Danmarks Cykle Union & Partners 2/6 (A),Quarq dZero,Wahoo Kicker core,397,384,13
102312,1611488496,wahoo,Zwift - Innsbruck,Quarq dZero,Wahoo kicker v5,259,255,4
102313,1611489899,wahoo,Zwift - 3R Whole Lotta Lava Hilly Race - 1 Lap (16.9km/10.5mi 183m) (A),Quarq dZero,Wahoo kicker v5,352,352,0
102940,1611600484,wahoo,Zwift - Premier Division // Zwift Racing League (men) (A),Quarq dZero,Wahoo kicker v5,427,419,8
104218,1611771776,wahoo,Zwift - Danmarks Cykle Union & Partners 3/6 (A),Quarq dZero,Wahoo kicker v5,417,410,7
106932,1612207979,wahoo,Zwift - Premier Division // Zwift Racing League (men) (A),Quarq dZero,Wahoo kicker v5,424,402,22
108252,1612376257,wahoo,Zwift - Danmarks Cykle Union & Partners 4/6 (A),Quarq dZero,Wahoo kicker v5,386,388,-2
109802,1612603245,wahoo,3 sister test,Quarq dZero,Wahoo kicker v5,417,410,7
111064,1612812170,wahoo,Zwift - Premier Division // Zwift Racing League (men) (A),Quarq dZero,Wahoo kicker v5,408,404,4
112494,1612982685,wahoo,Zwift - Danmarks Cykle Union & Partners 5/6 (A),Quarq dZero,Wahoo kicker v5,406,399,7
115427,1613419313,wahoo,Zwift - Premier Division // Zwift Racing League (men) (A),Quarq dZero,Wahoo kicker v5,406,407,-1
124871,1615022971,wahoo,Zwift - DBR SufferDay League III (A),Quarq dZero,Wahoo kicker v5,336,334,2
126658,1615400539,wahoo,Zwift - Scandinavian Cup 2021 - Round 3 - Men (A),Quarq dZero,Wahoo kicker v5,401,401,0
129201,1615917642,wahoo,Zwift - CeramicSpeed Race Series: Open Race (A),Quarq dZero,Wahoo kicker v5,420,421,-1
30490,1588406215,wahoo,Zwift - DBR Sufferday League (A),SRM ,WAHOO Kickr Core,479,455,24
34070,1589307321,wahoo,(Only part of race due to corrupted datafile) ,SRM ,WAHOO Kickr Core,462,460,2
34743,1589474604,wahoo,Zwift - WTRL Team Time Trial Premier League,SRM,WAHOO Kickr Core,470,446,24
36662,1590081522,wahoo,Zwift - WTRL Team Time Trial Premier League,SRM,WAHOO Kickr Core,453,434,19
37848,1590515293,wahoo,Zwift - UNO X CUP powered by DCU & Feltet.dk (A),Zwift/SRM,WAHOO Kickr Core,513,491,22
38633,1590827128,wahoo,DBR Sufferday League,Zwift/SRM,WAHOO Kickr Core,471,458,13
39121,1591120564,wahoo,Zwift - UNO X CUP powered by DCU & Feltet.dk (A),Zwift/SRM,WAHOO Kickr Core,485,460,25
40577,1591724300,wahoo,Zwift - UNO X CUP powered by DCU & Feltet.dk (A),Zwift / SRM,WAHOO Kickr Core,462,444,18
55038,1600103732,wahoo,Zwift - Invitational League // Qualifying Race #1,SRM,WAHOO Kickr Core,436,440,-4
56430,1600604371,wahoo,Zwift - Invitational League // Qualifying Race #3 (Men) (A) - Dropout with 1000 meters to the finish....,SRM to Garmin 510,WAHOO Kickr Core to Zwift,451,453,-2
57043,1600881338,wahoo,DCU powered by Feltet.dk,SRM,WAHOO Kickr Core,409,414,-5
58181,1601367766,wahoo,Zwift - Three Sisters Test ,SRM to Garmin 520 Plus,WAHOO Kickr Core to Zwift,521,499,22
60122,1602090284,wahoo,Zwift - DCU powered by Feltet.dk (A),SRM,WAHOO Kickr Core,457,441,16
62260,1602783188,wahoo,WTRL Team Time Trial - Zone 5,SRM to Garmin 520 Plus,WAHOO Kickr Core,434,437,-3
63124,1603128612,wahoo,Zwift - Premier Division // Zwift Racing League (men) ,2inPower to Garmin 520,WAHOO Kickr Core,424,450,-26
65204,1603740126,wahoo,Zwift - Premier Division // Zwift Racing League (men) (A),Garmin/SRM,WAHOO Kickr Core,478,449,29
66169,1603993138,wahoo,WTRL Team Time Trial Platinum League,Garmin/SRM,Wahoo Kickr v5,436,430,6
66401,1604059234,wahoo,Zwift - 3R Greater London 8 Hilly Race - 1 Lap (23.8km/14.8mi 238m) (A),SRM,Wahoo Kickr v5,450,448,2
67294,1604341793,wahoo,Zwift - Premier Division // Zwift Racing League (men) (A),Garmin / SRM,Wahoo Kickr v5,459,452,7
67959,1604514873,wahoo,DCU – Feltet.dk November series,SRM / Garmin,Wahoo Kickr v5,498,493,5
68246,1604600607,wahoo,Zwift - TTT Premier League,SRM / Garmin,Wahoo Kickr v5,448,436,12
69443,1604949812,wahoo,Premier Division // Zwift Racing League (men),SRM / Garmin,Wahoo Kickr v5,503,491,12
70752,1605206904,neo,Zwift - WTRL Platinium League - Boooom! PO Auto-toget!,SRM / Garmin,Tacx Neo 2T (WC) ,443,423,20
71604,1605431999,wahoo,Zwift - Open: 2020 El Giro de Rigo - Official Route,SRM / Garmin,Wahoo Kickr v5,457,449,8
71965,1605550880,wahoo,Zwift - Premier Division // Zwift Racing League (men) (A),SRM / Garmin,Wahoo Kickr v5,459,448,11
72661,1605723458,wahoo,Zwift - DCU – Feltet.dk November series (A),SRM / Garmin,Wahoo Kickr v5,431,423,8
73190,1605811490,neo,Zwift - World Championships Experience // Danish Cycling Federation,SRM / Garmin,Tacx Neo 2T (WC) ,421,410,11
73807,1605946184,neo,Zwift - TEAM VEGAN Tofu Tornado XL (A),SRM / Garmin,Tacx Neo 2T (UCI WC) ,481,465,16
76478,1606413762,wahoo,Zwift - WTRL NOPINZ WORLD TTT CHAMPIONSHIPS - Zone 6 (C),Garmin / SRM,Wahoo Kickr &#039;18,462,455,7
77031,1606571906,neo,Zwift - CCBoucherville-V2000 FUN Races (A),Garmin/SRM,Tacx Neo 2T (UCI WC) ,428,415,13
77032,1606571906,neo,Zwift - OH MY CRIT - Saturday Smash Race (A),Garmin/SRM,Tacx Neo 2T (UCI WC) ,392,383,9
77696,1606761097,wahoo,Zwift - Premier Division // Zwift Racing League (men) (A),Garmin / SRM,Wahoo Kickr v5,452,454,-2
78583,1606930142,neo,Zwift - MIDWEEK Winter Series by SZR (A),SRM / Garmin ,Tacx Neo 2T ,445,438,7
84464,1608227510,wahoo,FUSION DECEMBER CUP,Zwift / SRM,Wahoo Kickr v5,432,428,4
85054,1608379014,wahoo,Zwift - DIRT Dadurday Chase Race  (A),SRM,Wahoo Kickr v5,401,397,4
87403,1608972545,wahoo,Zwift - DBR Saturday Race (A),SRM ,Wahoo Kicker v5,457,452,5
87410,1608972545,wahoo,Zwift - 3R Tick Tock Flat Race - 2 Lap (36km/22.4mi 100m) (A),SRM,Wahoo Kickr v5,419,414,5
88495,1609231506,wahoo,Zwift - Three Sisters Performance Test,SRM to Garmin 520,Wahoo Kickr v5 to Zwift,501,498,3
88503,1609231506,wahoo,Zwift - Japan Zwift Tuesday Race (A),SRM to Garmin 520,Wahoo Kickr v5 to Zwift,370,367,3
92979,1610042569,wahoo,Zwift - FUSION WINTER CUP (A),SRM to Garmin 520,Wahoo Kickr v5 to Zwift,406,404,2
95009,1610389780,wahoo,Zwift - Premier Division // Zwift Racing League (men) (A),SRM to Garmin 520,Wahoo Kickr v5 to Zwift,430,427,3
96463,1610560950,wahoo,Zwift - Danmarks Cykle Union & Partners 1/6 (A),SRM to Garmin 520,Wahoo Kickr v5 to Zwift,477,475,2
97942,1610788401,wahoo,Zwift - DBR SufferDay League III (A),SRM to Garmin 520,Wahoo Kickr v5 to Zwift,477,477,0
99240,1610997170,wahoo,Zwift - Premier Division // Zwift Racing League (men) (A),SRM to Garmin 520,Wahoo Kickr v5 to Zwift,454,455,-1
99542,1611040995,wahoo,Zwift - ZHQ FutureWorks Crit City Race - Anti-sandbagging (A),SRM to Garmin 520,Wahoo Kickr v5 to Zwift,498,498,0
99551,1611040995,wahoo,Zwift - DBR Morning Race (A),SRM to Garmin 520,Wahoo Kickr v5 to Zwift,498,393,105
100345,1611166420,wahoo,Zwift - Danmarks Cykle Union & Partners 2/6 (A),SRM to Garmin 520,Wahoo Kickr v5 to Zwift,452,455,-3
101774,1611388816,wahoo,Zwift - DBR SufferDay League III (A),SRM to Garmin 520,Wahoo Kickr v5 to Zwift,429,433,-4
102933,1611599188,wahoo,Zwift - Premier Division // Zwift Racing League (men) (A),SRM to Garmin 520,Wahoo Kickr v5 to Zwift,460,475,-15
104195,1611770850,wahoo,Zwift - Danmarks Cykle Union & Partners 3/6 (A),SRM to Garmin 520,Wahoo Kickr v5 to Zwift,479,476,3
104756,1611856664,wahoo,Zwift - FUSION WINTER CUP (A),SRM to Garmin 520,Wahoo Kickr v5 to Zwift,474,468,6
105158,1611931241,wahoo,Zwift - BST Mountaingoat Race (A),SRM to Garmin 520,Wahoo Kickr v5 to Zwift,464,460,4
109857,1612602451,wahoo,Zwift - DBR SufferDay League III - Vanvittigt projekt! ,SRM to Garmin 520,Wahoo Kickr v5 to Zwift,430,426,4
111067,1612809615,wahoo,Zwift - Premier Division // Zwift Racing League (men) (A),SRM to Garmin 520,Wahoo Kickr v5 to Zwift,467,470,-3
112307,1612979395,wahoo,Zwift - Danmarks Cykle Union & Partners 5/6 (A),SRM to Garmin 520,Wahoo Kickr v5 to Zwift,480,485,-5
115400,1613416953,wahoo,Zwift - Premier Division // Zwift Racing League (men) (A),SRM to Garmin 520,Wahoo Kickr v5 to Zwift,457,458,-1
115713,1613470542,wahoo,Zwift - 3R Volcano Circuit Flat Race - 8 Laps (35.2km/21.9mi 160m) (A),SRM to Garmin 520,Wahoo Kickr v5 to Zwift,453,399,54
115717,1613470542,wahoo,Zwift - ZHQ FutureWorks Crit City Race - Anti-sandbagging (A),SRM to Garmin 520,Wahoo Kickr v5 to Zwift,453,450,3
116716,1613584871,wahoo,Zwift - Danmarks Cykle Union & Partners 6/6 (A),SRM to Garmin 520,Wahoo Kickr v5 to Zwift,452,451,1
119151,1614018451,wahoo,Zwift - Premier Division // Zwift Racing League (men) (A),SRM to Garmin 520,Wahoo Kickr v5 to Zwift,446,442,4
127146,1615486126,wahoo,Zwift - FUSION SPRING CUP (A),SRM to Garmin 520,Wahoo Kickr v5 to Zwift,429,424,5
129223,1615916603,wahoo,Zwift - CeramicSpeed Race Series: Open Race (A),SRM to Garmin 520,Wahoo Kickr v5 to Zwift,466,462,4
115983,1613496451,wahoo,Zwift - Zwift Racing League | WTRL - Men&#039;s/Mixed EMEA E1 DIVISION 1 (A),SRAM Quarq DZero (Garmin),Wahoo Kickr V5 (Zwift),481,467,14
117405,1613667263,wahoo,Zwift - FUSION WINTER CUP (A),SRAM Quarq DZero (Garmin),Wahoo Kickr V5 (Zwift),415,403,12
120399,1614190554,wahoo,Zwift - Scandinavian Cup 2021 - Round 1 - Men (A),SRAM Quarq DZero (Garmin),Wahoo Kickr V5 (Zwift),407,395,12
121064,1614275950,wahoo,Zwift - FUSION WINTER CUP (A),SRAM Quarq DZero (Garmin),Wahoo Kickr V5 (Zwift),451,441,10
123059,1614706027,wahoo,Zwift - Zwift Racing League | WTRL - Men&#039;s/Mixed EMEA E1 DIVISION 1 (A),SRAM Quarq DZero (Garmin),Wahoo Kickr V5 (Zwift),404,400,4
123715,1614792140,wahoo,Zwift - Scandinavian Cup 2021 - Round 2 - Men (A),SRAM Quarq DZero (Garmin),Wahoo Kickr V5 (Zwift),422,410,12
125163,1615057169,wahoo,Zwift - Zwift Racing League | WTRL Battle Royale Playoff - Men&#039;s TTT (A),SRAM Quarq DZero (Garmin),Wahoo Kickr V5 (Zwift),432,425,7
126700,1615395064,wahoo,Zwift - Scandinavian Cup 2021 - Round 3 - Men (A),Specialized Power Crank Arm (TT bike) (Garmin),Wahoo Kickr V5 (Zwift),432,423,9
127245,1615478603,wahoo,Zwift - FUSION SPRING CUP (A),Specialized Power Crank Arm (TT bike) (Garmin),Wahoo Kickr V5 (Zwift),418,415,3
129368,1615917830,wahoo,Zwift - CeramicSpeed Race Series: Open Race (A),SRAM Quarq DZero (Garmin),Wahoo Kickr V5 (Zwift),443,442,1
95420,1610441094,wahoo,Zwift - Zwift Racing League | WTRL - Men&#039;s/Mixed APAC DIVISION 1 (A),Powertap P1S,Wahoo Kickr,337,350,-13
96202,1610534694,wahoo,Zwift - The Morning Grind by STPC (A),Powertap P1S,Wahoo Kickr,344,345,-1
98121,1610810122,wahoo,Zwift - OH MY CRIT - Saturday Smash Race (A),Powertap P1S,Wahoo Kickr,332,339,-7
101495,1611340151,wahoo,Zwift - KIRCHMAIR Race Series (A),Powertap P1S,Wahoo Kickr,335,354,-19
108133,1612255474,wahoo,Zwift - Zwift Racing League | WTRL - Men&#039;s/Mixed APAC DIVISION 1 (A),Morning_Ride,Wahoo Kickr,333,347,-14
108276,1612378724,wahoo,Movistar Team Challenge Community Qualifier Race #1,Powertap P1S,Wahoo Kickr,368,373,-5
111319,1612860718,wahoo,Zwift - Zwift Racing League | WTRL - Men&#039;s/Mixed APAC DIVISION 1 (A),Powertap P1S,Wahoo Kickr,354,369,-15
112248,1612978947,wahoo,Zwift - MIDWEEK Winter Series by SZR (A),Powertap P1S,Wahoo Kickr,344,356,-12
112862,1613063036,wahoo,Zwift - OH MY CRIT!! - The Double Race 2/2 (A),Powertap P1S,Wahoo Kickr,359,366,-7
115597,1613465060,wahoo,Zwift - Zwift Racing League | WTRL - Men&#039;s/Mixed APAC DIVISION 1 (A),Powertap P1S,Wahoo Kickr,352,364,-12
116612,1613584796,wahoo,Zwift - MIDWEEK Winter Series by SZR (A),Powertap P1S,Wahoo Kickr,346,361,-15
117190,1613664861,wahoo,Zwift - OH MY CRIT!! - The Double Race 1/2 (A),Powertap P1S,Wahoo Kickr,359,377,-18
117197,1613667811,wahoo,Zwift - OH MY CRIT!! - The Double Race 2/2 (A),Powertap P1S,Wahoo Kickr,363,378,-15
119401,1614069820,wahoo,Zwift - Zwift Racing League | WTRL - Men&#039;s/Mixed APAC DIVISION 1 (A),Powertap P1S,Wahoo Kickr,292,304,-12
40919,1591831815,wahoo,Zwift - Austin Driveway Series Criterium (A),power2Max NG eco,Wahoo Kickr,301,310,-9
41364,1592037014,wahoo,Zwift - DBR Saturday Race  (A),power2Max NG eco,Wahoo Kickr,275,290,-15
41365,1592037014,wahoo,Zwift - DBR Saturday Race  (A),power2Max NG eco,Wahoo Kickr,275,290,-15
41916,1592298597,wahoo,Zwift - SRAM Send it Series - Race 6 - Men&#039;s (E),power2Max NG eco,Wahoo Kickr,342,326,16
42132,1592387109,wahoo,Zwift - USA Cycling Race League by Indoor Specialist (A),power2Max NG eco,Wahoo Kickr,304,320,-16
45591,1594290896,wahoo,Zwift - Japan ZWIFT Hill Climb Race (A),power2Max NG eco,Wahoo Kickr,315,329,-14
45592,1594290896,wahoo,Zwift - Japan ZWIFT Hill Climb Race (A),power2Max NG eco,Wahoo Kickr,315,329,-14
46265,1594720804,wahoo,Zwift - KISS at Race - Americas AM (A),power2Max NG eco,Wahoo Kickr,284,296,-12
46266,1594725001,wahoo,Zwift - Japan Zwift Tuesday Race (A),power2Max NG eco,Wahoo Kickr,275,290,-15
46583,1594895697,wahoo,Zwift - Japan ZWIFT Hill Climb Race (A),power2Max NG eco,Wahoo Kickr,314,319,-5
46812,1595060994,wahoo,Zwift - DBR Saturday Race  (A),power2Max NG eco,Wahoo Kickr,306,308,-2
49654,1597205081,wahoo,Zwift - 3R Watopia Flat Route Reverse Race - 3 Laps (30.8km/19.1mi 162m) (A),power2Max NG eco,Wahoo Kickr,278,288,-10
58716,1601548513,wahoo,Zwift - Japan ZWIFT Hill Climb Race (A),power2Max NG eco,Wahoo Kickr,335,340,-5
64748,1603602007,wahoo,Zwift - KISS at Race 100 - EU (A),power2Max NG eco,Wahoo Kickr,234,263,-29
64762,1603613100,wahoo,Zwift - 3R Volcano Circuit - 6 Laps (A),power2Max NG eco,Wahoo Kickr,307,323,-16
65002,1603706426,wahoo,Zwift - ZA Road 2020 - Segment Ride #1: Innsbruck Course,power2Max NG eco,Wahoo Kickr,316,324,-8
65346,1603792787,wahoo,Zwift - KISS at Race - Americas AM (A),power2Max NG eco,Wahoo Kickr,340,353,-13
65990,1603965603,wahoo,Zwift - KISS at Race - Americas AM (A),power2Max NG eco,Wahoo Kickr Core,346,357,-11
66524,1604095825,wahoo,Zwift - ZA Road - Race #2 (A),power2Max NG eco,Wahoo Kickr Core,284,295,-11
67479,1604394221,wahoo,Zwift - Zwift Racing League | WTRL - Men&#039;s APAC DIVISION 1 (A),power2Max NG eco,Wahoo Kickr Core,318,337,-19
67495,1604365211,wahoo,Zwift - ZA Road 2020 - Segment Ride #1: Three Sisters Course,power2Max NG eco,Wahoo Kickr Core,312,327,-15
68113,1604486714,wahoo,Zwift - USA Cycling Race League by Indoor Specialist (A),power2Max NG eco,Wahoo Kickr Core,308,329,-21
68787,1604712619,wahoo,Zwift - TFC Autumn Race Series (A),power2Max NG eco,Wahoo Kickr Core,308,321,-13
68928,1604797204,wahoo,Zwift - Road to Okinawa Race (A),power2Max NG eco,Wahoo Kickr Core,314,338,-24
69593,1604997899,wahoo,Zwift - Zwift Racing League | WTRL - APAC (MEN) -  Division 1 (A),power2Max NG eco,Wahoo Kickr Core,343,368,-25
70165,1605091513,wahoo,Zwift - USA Cycling Race League by Indoor Specialist (A),power2Max NG eco,Wahoo Kickr Core,314,340,-26
72101,1605610790,wahoo,Zwift - KISS Race Series - Americas AM (A),power2Max NG eco,Wahoo Kickr Core,323,339,-16
72911,1605696288,wahoo,Zwift - USA Cycling Race League by Indoor Specialist (A),power2Max NG eco,Wahoo Kickr Core,350,368,-18
72913,1605783594,wahoo,Zwift - KISS Race Series - Americas AM (A),power2Max NG eco,Wahoo Kickr Core,317,345,-28
74875,1606207513,wahoo,Zwift - Zwift Racing League | WTRL - Men&#039;s APAC DIVISION 1,power2Max NG eco,Wahoo Kickr Core,336,355,-19
75422,1606301112,wahoo,Zwift - USA Cycling Race League by Indoor Specialist (A),power2Max NG eco,Wahoo Kickr Core,325,339,-14
77953,1606820394,wahoo,Zwift - KISS Race Series - Americas AM (A),power2Max NG eco,Wahoo Kickr Core,301,320,-19
78439,1606905904,wahoo,Zwift - USA Cycling Race League by Indoor Specialist (A),power2Max NG eco,Wahoo Kickr Core,296,313,-17
80673,1606993185,wahoo,Zwift - KISS Race Series - Americas AM (A),power2Max NG eco,Wahoo Kickr Core,314,339,-25
80674,1607417113,wahoo,Zwift - Zwift Racing League | WTRL - Men&#039;s APAC DIVISION 1 (A),power2Max NG eco,Wahoo Kickr Core,311,328,-17
85322,1608443997,wahoo,Zwift - KISS 100 Race Series - EU (A),power2Max NG eco,Wahoo Kickr Core,296,317,-21
89279,1609397039,wahoo,ZADA TEST - THREE SISTERS,power2Max NG eco,Wahoo Kickr Core,336,337,-1
89706,1609488897,wahoo,Zwift - ZADA Test WahooKickrCore:Power2max - 1min,power2Max NG eco,Wahoo Kickr Core,220,225,-5
89707,1609489851,wahoo,Zwift - ZADA Test WahooKickrCore:Power2max - 15sec,power2Max NG eco,Wahoo Kickr Core,151,154,-3
93576,1610143496,wahoo,Zwift - 3R Volcano Flat 50k Race - 4 Laps (48.8km/30.7mi 184m) (A),power2Max NG eco,Wahoo Kickr Core,303,312,-9
94716,1610326799,wahoo,Zwift - TDZ Stage 2: Longer Ride,power2Max NG eco,Wahoo Kickr Core,281,290,-9
94971,1610392471,wahoo,Zwift - Premier Division // Zwift Racing League (men) (A),power2Max NG eco,Wahoo Kickr Core,319,313,6
96176,1610534703,wahoo,Zwift - The Morning Grind by STPC (A),power2Max NG eco,Wahoo Kickr Core,281,296,-15
96808,1610627089,wahoo,Zwift - EMU Japan Race (A),power2Max NG eco,Wahoo Kickr Core,281,294,-13
99222,1610999568,wahoo,Zwift - Premier Division // Zwift Racing League (men) (A),power2Max NG eco,Wahoo Kickr Core,336,329,7
102987,1611601462,wahoo,Zwift - Premier Division // Zwift Racing League (men) (A),power2Max NG eco,Wahoo Kickr Core,318,322,-4
103955,1611744270,wahoo,Zwift - The Morning Grind by STPC (A),power2Max NG eco,Wahoo Kickr Core,347,354,-7
104478,1611831575,wahoo,Zwift - KISS Race Series - Americas AM (A),power2Max NG eco,Wahoo Kickr Core,322,327,-5
105383,1611993918,wahoo,Zwift - 3R Weekend Race Club - Race 1 (A),power2Max NG eco,Wahoo Kickr Core,309,309,0
106908,1612209991,wahoo,Zwift - Premier Division // Zwift Racing League (men) (A),power2Max NG eco,Wahoo Kickr Core,321,328,-7
107954,1612349095,wahoo,Zwift - The Morning Grind by STPC (A),power2Max NG eco,Wahoo Kickr Core,288,295,-7
109788,1612607414,wahoo,Zwift - Zwift Fondo Series: Gran Fondo,power2Max NG eco,Wahoo Kickr Core,307,315,-8
111034,1612812129,wahoo,Zwift - Premier Division // Zwift Racing League (men) (A),power2Max NG eco,Wahoo Kickr Core,332,332,0
113812,1613203491,wahoo,Zwift - 3R Weekend Race Club - Race 1 (A),power2Max NG eco,Wahoo Kickr Core,285,296,-11
114504,1613282385,wahoo,Zwift - KISS 100 Race Series - EU (A),power2Max NG eco,Wahoo Kickr Core,278,285,-7
115390,1613419295,wahoo,Zwift - Premier Division // Zwift Racing League (men) (A),power2Max NG eco,Wahoo Kickr Core,337,345,-8
116424,1613558687,wahoo,Zwift - The Morning Grind by STPC (A),power2Max NG eco,Wahoo Kickr Core,309,318,-9
117075,1613645987,wahoo,Zwift - KISS Race Series - Americas AM (A),power2Max NG eco,Wahoo Kickr Core,345,355,-10
119164,1614020984,wahoo,Zwift - Premier Division // Zwift Racing League (men) (A),power2Max NG eco,Wahoo Kickr Core,310,315,-5
120130,1614163498,wahoo,Zwift - The Morning Grind by STPC (A),power2Max NG eco,Wahoo Kickr Core,324,328,-4
122635,1614629913,wahoo,Zwift - Premier Division // Zwift Racing League (men) (A),power2Max NG eco,Wahoo Kickr Core,339,333,6
123889,1614854117,wahoo,Zwift - Japan ZWIFT Hill Climb Race (A),power2Max NG eco,Wahoo Kickr Core,0,0,0
123890,1614854117,wahoo,Zwift - Japan ZWIFT Hill Climb Race (A),power2Max NG eco,Wahoo Kickr Core,326,327,-1
77896,1606812846,wahoo,Zwift - Zwift Racing League | WTRL - Men&#039;s APAC DIVISION 1 (A),Favero Assioma Duo,Wahoo Kickr Core,379,387,-8
78674,1606933797,wahoo,Zwift - Frenchy Fuzion Watopia Tour - Etape 3 (A),Favero Assioma Duo,Wahoo Kickr Core,402,407,-5
80523,1607368765,wahoo,Zwift - Team TFC Mad Monday Races (A),Favero Assioma Duo,Wahoo Kickr Core,337,344,-7
80948,1607457598,wahoo,Zwift - KISS Race Series - EU PM (A),Favero Assioma Duo,Wahoo Kickr Core,415,424,-9
83235,1607973584,wahoo,Zwift - Team TFC Mad Monday Winter Series (A),Favero Assioma Duo,Wahoo Kickr Core,385,392,-7
83238,1607973584,wahoo,Zwift - Team TFC Mad Monday Winter Series (A),Favero Assioma Duo,Wahoo Kickr Core,385,392,-7
83598,1608058524,wahoo,Zwift - Team Italy & Frenchy Fuzion League (A),Favero Assioma Duo,Wahoo Kickr Core,416,423,-7
84423,1608229765,wahoo,Zwift - FUSION DECEMBER CUP (A),Favero Assioma Duo,Wahoo Kickr Core,321,328,-7
85875,1608578370,wahoo,Zwift - Team TFC Mad Monday Winter Series (A),Favero Assioma Duo,Wahoo Kickr Core,339,352,-13
86206,1608663283,wahoo,Zwift - Team Italy & Frenchy Fuzion League (A),Favero Assioma Duo,Wahoo Kickr Core,0,0,0
86208,1608663283,wahoo,Zwift - Team Italy & Frenchy Fuzion League (A),Favero Assioma Duo,Wahoo Kickr Core,391,401,-10
91827,1609872861,wahoo,Zwift - Team Italy & Frenchy Fuzion League (A),Favero Assioma Duo,Wahoo Kickr Core,376,391,-15
95395,1610441056,wahoo,Zwift - Zwift Racing League | WTRL - Men&#039;s/Mixed APAC DIVISION 2 (A),Favero Assioma Duo,Wahoo Kickr Core,349,352,-3
97069,1610648946,wahoo,Zwift - FUSION WINTER CUP (A),Favero Assioma Duo,Wahoo Kickr Core,392,398,-6
103242,1611650585,wahoo,Zwift - Zwift Racing League | WTRL - Men&#039;s/Mixed APAC DIVISION 2 (A),Favero Assioma Duo,Wahoo Kickr Core,402,408,-6
107722,1612313135,wahoo,Zwift - Zwift Racing League | WTRL - Men&#039;s/Mixed AMERICAS E DIVISION 1 (A),Favero Assioma Duo,Wahoo Kickr Core,384,383,1
116686,1613587433,wahoo,Zwift - Danmarks Cykle Union & Partners 6/6 (A),Favero Assioma Duo,Wahoo Kickr Core,344,352,-8
121428,1614416666,wahoo,Zwift - 3R Endurance Series p/b OTE Sports (E),Favero Assioma Duo,Wahoo Kickr Core,321,331,-10
126018,1615287562,wahoo,Zwift - KISS Race Series - Americas AM (A),Favero Assioma Duo,Wahoo Kickr Core,365,375,-10
126421,1615373065,wahoo,Zwift - The Morning Grind by STPC (A),Favero Assioma Duo,Wahoo Kickr Core,345,355,-10
126882,1615460365,wahoo,Zwift - KISS Race Series - Americas AM (A),Favero Assioma Duo,Wahoo Kickr Core,318,323,-5
128978,1615888758,wahoo,Zwift - KISS Race Series - Americas AM (A),Favero Assioma Duo,Wahoo Kickr Core,374,381,-7
9495,1579107684,wahoo,Zwift - Tour de Zwift: Stage 1 Race (A),garmin pedals,wahoo bike ,421,375,46
9844,1579290846,wahoo,Zwift - endurance,garmin pedals,endurance garmin1000 wahoopwr,274,273,1
98985,1610988245,wahoo,before ttt,Garmin Vector 3,Wahoo Kickr 19,226,229,-3
99285,1610997273,wahoo,Zwift - Premier Division // Zwift Racing League (men) (A),Garmin Vector 3,Wahoo Kickr 19,396,403,-7
100444,1611173463,wahoo,Zwift - Watopia,Assioma Duo,Wahoo Kickr 19 BLE,378,375,3
100554,1611187145,wahoo,Zwift - EVR Definitely Not the WTNC (A) Nice to do an evening tussle with the squad!,Assioma Duo,Wahoo Kickr 19 ANT+,399,398,1
101194,1611277662,wahoo,consistency feels good,Assioma Duo,Wahoo Kickr 19 BLE companion app,347,347,0
104338,1611787496,wahoo,Zwift - 3R Volcano Flat Reverse 50k Race - 4 Laps (48.8km/30.7mi 184m) (A),Assioma Duo,Wahoo Kickr 19 BLE companion app,383,381,2
104937,1611881812,wahoo,Zwift - Watopia,Assioma Duo,Wahoo Kickr 19 BLE PC,310,309,1
105678,1612019028,wahoo,Zwift - OH MY CRIT!! - Saturday Smash Race (A),Garmin Vector 3,Wahoo Kickr Gen 4 BLE PC,392,415,-23
106361,1612115021,wahoo,Zwift - Watopia,Garmin Vector 3,Wahoo Kickr Gen 4 BLE PC,258,262,-4
106970,1612208176,wahoo,Zwift - Premier Division // Zwift Racing League (men) (A) 3 laps OF DOOM,Garmin Vector 3,Wahoo Kickr Gen 4 BLE PC,397,414,-17
107248,1612281840,wahoo,Zwift - Watopia,Garmin Vector 3 on 830,Wahoo Kickr Gen 4 BLE PC,154,158,-4
107554,1612295794,wahoo,Zwift - Watopia,Garmin Vector 3 on 830,Wahoo Kickr Gen 4 BLE PC,215,224,-9
108135,1612366728,wahoo,Zwift - Innsbruck,Assioma Duo to 830,Wahoo Kickr Gen 4 BLE PC,302,297,5
108529,1612395723,wahoo,Zwift - Open - Movistar Team Challenge Community Qualifier Race #2,Assioma Duo to 830,Wahoo Kickr Gen 4 BLE PC,420,415,5
109153,1612483698,wahoo,Zwift - Watopia,Assioma Duo to 830,Wahoo Kickr Gen 4 BLE PC,278,277,1
110517,1612707889,wahoo,Team Draft Libby Hill After Party Race,Assioma Duo to 830,Wahoo Kickr Gen 4 BLE PC,372,368,4
111838,1612903225,wahoo,sector smashing. onward.,Assioma Duo to 830,Wahoo Kickr Gen 4 BLE PC,409,406,3
113233,1613098918,wahoo,Zwift - Watopia,Assioma Duo to 830,Wahoo Kickr Gen 4 BLE PC,386,382,4
113761,1613171461,wahoo,Zwift - recovery,Garmin Vector 3 on 830,Wahoo Kickr Gen 4 BLE PC,226,223,3
114219,1613228665,wahoo,Zwift - OH MY CRIT!! - Saturday Smash Race (A),Garmin Vector 3 on 830,Wahoo Kickr Gen 4 BLE PC,422,443,-21
115438,1613417505,wahoo,Zwift - Premier Division // Zwift Racing League (men) (A),Garmin Vector 3 on 1000,Wahoo Kickr Gen 4 BLE PC,426,430,-4
116627,1613583920,wahoo,Zwift - MIDWEEK Winter Series by SZR (A),Garmin Vector 3 on 830,Wahoo Kickr Gen 4 BLE PC,390,383,7
117208,1613667821,wahoo,Zwift - OH MY CRIT!! - The Double Race 2/2 (A),Assioma Duo to 830,Wahoo Kickr Gen 4 BLE PC,417,412,5
117361,1613673238,wahoo,Zwift - FLANDERS The BZR Ronde Watopian League (A),Assioma Duo to 830,Wahoo Kickr Gen 4 BLE companion app,417,413,4
118312,1613837061,wahoo,Zwift - 3R Endurance Series p/b OTE Sports- Stage 1 (E),Assioma Duo to 830,Wahoo Kickr Gen 4 BLE PC,372,368,4
119986,1614125086,wahoo,Zwift - Midweek Crit: Downtown Dolphin (A),Assioma Duo to 830,Wahoo Kickr Gen 4 BLE PC,385,372,13
121004,1614267963,wahoo,Zwift - power meter erg test v2,New Garmin Vector 3 on 830,Wahoo Kickr Gen 4 BLE PC,302,292,10
121671,1614438500,wahoo,Zwift - OH MY CRIT!! - Saturday Smash Race (A),Assioma Duo to 830,Wahoo Kickr Gen 4 BLE PC,400,399,1
125259,1615041056,wahoo,Zwift - OH MY CRIT!! - Saturday Smash Race (A),Assioma Duo to 830,Wahoo Kickr Gen 4 BLE PC,380,380,0
125509,1615126520,wahoo,Zwift - KISS 100 Race Series (Americas) - The Uber Pretzel Edition (A),Assioma Duo to 830,Wahoo Kickr Gen 4 BLE PC,436,435,1
127005,1615477711,wahoo,Zwift - OH MY CRIT!! - The Double Race 1/2 (A),Assioma Duo to 830,Wahoo Kickr Gen 4 BLE PC,391,383,8
127652,1615593515,neo,Zwift - London,Assioma Duo to 830,Neo 2T,292,299,-7
128113,1615645507,neo,Zwift - OH MY CRIT!! - Saturday Smash Race (A),Assioma Duo to 830,Neo 2T,450,458,-8
128115,1615652989,neo,Zwift - TEAM VEGAN Tofu Tornado (A),Assioma Duo to 830,Neo 2T,371,373,-2
107495,1612289722,neo,Zwift Racing League | WTRL - Men&#039;s/Mixed EMEA E1 DIVISION 1 (A),Powertap1 pedals,Tacx neo 2T,381,425,-44
117813,1613759361,wahoo,Zwift - KIRCHMAIR Race Series (A),Quarq DZero Dub - ANT+ to Garmin,Wahoo Kickr BLE to Zwift,359,358,1
120702,1614272685,wahoo,OH MY CRIT!! - The Double Race 2/2,Quarq DZero Dub - ANT+ to Garmin,Wahoo Kickr BLE to Zwift,348,348,0
124611,1614971117,wahoo,Zwift - Zwift Racing League | WTRL Battle Royale Playoff - Men&#039;s Points Race (A),Quarq DZero Dub - ANT+ to Garmin,Wahoo Kickr BLE to Zwift,352,376,-24
3831,1572980945,wahoo,Zwift - WORLDOFFUSION Racing League (A),Garmin Vector 2,Wahoo Kickr 2018,0,0,0
3930,1573067113,wahoo,Zwift - DBR HEINO CUP  (A),Garmin Vector 2,Wahoo Kickr 2018,0,0,0
4141,1573585731,wahoo,Zwift - WORLDOFFUSION Racing League (A),Garmin Vector 2,Wahoo Kickr 2018,0,0,0
6999,1577005155,wahoo,Zwift - Danmarks Cykle Union Racing League (A),Garmin Vector 2,Wahoo Kickr 2018,360,340,20
7260,1577299457,wahoo,Zwift - Crit City Race (A),Garmin Vector 2,Wahoo Kickr 2018,345,329,16
7427,1577469545,wahoo,Zwift - ZA Tri 2020 TT Race - Open A,Garmin Vector 2,Wahoo Kickr 2018,379,373,6
7589,1577644150,wahoo,Zwift - XRS Races Crit (A),Garmin Vector 253,Wahoo Kickr 2018,364,352,12
7807,1577905449,wahoo,Zwift - DBR Wednesday Race (A),Garmin Vector 2,Wahoo Kickr 2018,365,353,12
7893,1577989754,wahoo,Zwift - FUSION ECT BEUNSTOPPABLE Racing Series (A),Garmin Vector 2,Wahoo Kickr 2018,315,305,10
8036,1578139159,wahoo,Zwift - HBR17 by Herd Racing League (Europe) (E),Garmin Vector 2,Wahoo Kickr 2018,399,390,9
8219,1578334444,wahoo,Zwift - DBR Caresport Crit Cup  (A),Garmin Vector 2,Wahoo Kickr 2018,369,359,10
8342,1578425944,wahoo,Zwift - 3R Ultimate Racing League - Round 1 (A),Garmin Vector 2,Wahoo Kickr 2018,376,362,14
8613,1578590703,wahoo,Zwift - Danmarks Cykle Union 2020 Cup (A),Garmin Vector 2,Wahoo Kickr 2018,394,384,10
8927,1578819520,wahoo,Zwift - Danmarks Cykle Union 2020 Cup (A),Garmin Vector 2,Wahoo Kickr 2018,341,332,9
9159,1578939258,wahoo,Zwift - DBR Caresport Crit Cup  (A),Garmin Vector 2,Wahoo Kickr 2018,382,372,10
9808,1579287576,wahoo,Zwift - The Friday Criterium Winter Race Series  (32 mi / 51 km) (A),Garmin Vector 2,Wahoo Kickr 2018,345,356,-11
9888,1579349320,wahoo,Zwift - DIRT DADurday Chase Race (A),Garmin Vector 2,Wahoo Kickr 2018,346,359,-13
10308,1579630187,wahoo,Zwift - Tour de Zwift: Stage 3 Race (A),Garmin Vector 2,Wahoo Kickr 2018,366,374,-8
10472,1579719860,wahoo,Zwift - DBR HEINO CUP (A),Garmin Vector 2,Wahoo Kickr 2018,365,369,-4
10859,1579889392,wahoo,Zwift - 3R Lutscher CCW Climbing Race - 1 Lap (22.1km/13.9mi 827m) (A),Garmin Vector 2,Wahoo Kickr 2018,375,388,-13
11418,1580245454,wahoo,Zwift - 3R Volcano Flat Reverse Race - 3 Laps (36.6km/22.7mi 138m) (A),Garmin Vector 2,Wahoo Kickr 2018,333,338,-5
11896,1580498031,wahoo,Zwift - Tour de Zwift // Pro-Am Invitational (A),Garmin Vector 2,Wahoo Kickr 2018,403,424,-21
12038,1580580592,wahoo,Zwift - Tour de Zwift: Stage 6 Race (A),Garmin Vector 2,Wahoo Kickr 2018,315,326,-11
12262,1580750982,wahoo,Zwift - baby woke up,Garmin Vector 2,Wahoo Kickr 2018,363,382,-19
12621,1580929334,wahoo,Zwift - DBR Wednesday Race (A),Garmin Vector 2,Wahoo Kickr 2018,326,339,-13
12799,1581018344,wahoo,Zwift - WTRL Team Time Trial ,Garmin Vector 2,Wahoo Kickr 2018,354,369,-15
13288,1581360702,wahoo,Zwift ,Garmin Vector 2,Wahoo Kickr 2018,367,375,-8
13576,1581534272,wahoo,Zwift - DBR Wednesday Race (A),Garmin Vector 2,Wahoo Kickr 2018,371,368,3
13736,1581620372,wahoo,Zwift - KALAS Cup - Round 3 (A),Garmin Vector 2,Wahoo Kickr 2018,351,365,-14
14210,1581855576,wahoo,Zwift - Ottawa TopSpeed Race (A),Garmin Vector 2,Wahoo Kickr 2018,348,353,-5
14560,1582053263,wahoo,Zwift - Feltet.dk Race Series,Garmin Vector 2,Wahoo Kickr 2018,358,360,-2
15218,1582397961,wahoo,Zwift - Vatternrundan E-Sportive 6 (E),Garmin Vector 2,Wahoo Kickr 2018,378,386,-8
15610,1582658057,wahoo,Zwift - Feltet.dk Race Series (A),Garmin Vector 2,Wahoo Kickr 2018,377,395,-18
15892,1582829324,wahoo,Zwift ,Garmin Vector 2,Wahoo Kickr 2018,329,339,-10
16192,1583004042,wahoo,Zwift - ZHR Weekend Group Ride (C),Garmin Vector 2,Wahoo Kickr 2018,327,332,-5
16193,1583004089,wahoo,Zwift - sst,Garmin Vector 2,Wahoo Kickr 2018,328,332,-4
16381,1583089403,wahoo,Zwift - SST,Garmin Vector 2,Wahoo Kickr 2018,307,309,-2
16650,1583262839,wahoo,Zwift - Feltet.dk Race Series (A),Garmin Vector 2,Wahoo Kickr 2018,392,386,6
16841,1583354366,wahoo,Zwift ,Garmin Vector 2,Wahoo Kickr 2018,243,243,0
16891,1583405150,wahoo,Zwift - O/U FTP,Garmin Vector 2,Wahoo Kickr 2018,333,338,-5
17533,1583867658,wahoo,Feltet.dk Race Series,Garmin Vector 2,Wahoo Kickr 2018,369,366,3
17859,1584040452,wahoo,Zwift - Tour of Watopia Pro-Am Men&#039;s Race #1 (A),Garmin Vector 2,Wahoo Kickr 2018,397,392,5
18035,1584184441,wahoo,Zwift - 3R Tick Tock Flat Race - 2 Lap (36km/22.4mi 100m) (A),Garmin Vector 2,Wahoo Kickr 2018,389,380,9
18137,1584271032,wahoo,Zwift ,Garmin Vector 2,Wahoo Kickr 2018,257,253,4
18441,1584473936,wahoo,Zwift ,Garmin Vector 2,Wahoo Kickr 2018,339,356,-17
18914,1584731652,wahoo,Zwift - Tour of Watopia Pro-Am Men&#039;s Race #2 (A),Garmin Vector 2,Wahoo Kickr 2018,420,414,6
19035,1584799149,wahoo,Zwift ,Garmin Vector 2,Wahoo Kickr 2018,344,341,3
19842,1585250913,wahoo,Zwift - VO2 ,Assioma duo,Wahoo Kickr 2018,325,317,8
20122,1585395358,wahoo,Zwift ,Assioma duo,Wahoo Kickr 2018,343,331,12
20403,1585484070,wahoo,Zwift - Stage 2 Race (A) - Tour of Watopia 2020,Assioma duo,Wahoo Kickr 2018,351,350,1
20412,1585487114,wahoo,Zwift - 3R Watopia Flat Route Race - 4 Laps (40.5km/25.1mi 216m) (A),Assioma duo,Wahoo Kickr 2018,364,357,7
20864,1585678509,wahoo,Zwift - Feltet.dk Race Series (A),Assioma duo,Wahoo Kickr 2018,384,374,10
21684,1585912786,wahoo,Zwift - 3R LaGuardia Loop Reverse Flat Race - 8 Laps (24.5km/15.2mi 216m) (A),Assioma duo,Wahoo Kickr 2018,377,373,4
21688,1585915484,wahoo,Zwift ,Assioma duo,Wahoo Kickr 2018,317,317,0
21970,1585990766,wahoo,Zwift ,Assioma duo,Wahoo Kickr 2018,358,357,1
22378,1586112184,wahoo,Zwift - The Alpe Dash by Herd Racing League (A),Assioma duo,Wahoo Kickr 2018,364,363,1
23053,1586369103,wahoo,Zwift - DBR Sprinthooligan Cup (A),Assioma duo,Wahoo Kickr 2018,369,358,11
23526,1586530747,wahoo,Zwift - ZHQ Beta Crit City Race (A),Assioma duo,Wahoo Kickr 2018,360,354,6
24324,1586801975,wahoo,Zwift - TFC Mad Monday World Series (1 of 6) (A),Assioma duo,Wahoo Kickr 2018,392,381,11
25601,1587150004,wahoo,Zwift - KIRCHMAIR April Series (A),Assioma duo,Wahoo Kickr 2018,347,342,5
25641,1587151786,wahoo,Zwift - KIRCHMAIR April Series (A),Assioma duo,Wahoo Kickr 2018,371,363,8
27018,1587578693,wahoo,Zwift - DBR Sprinthooligan Cup (A),Assioma duo,Wahoo Kickr 2018,388,378,10
27995,1587838188,wahoo,Zwift ,Assioma duo,Wahoo Kickr 2018,389,384,5
28816,1588097198,wahoo,Zwift - ZHR Masters (A),Assioma duo,Wahoo Kickr 2018,398,391,7
30891,1588500604,wahoo,Zwift - 3R Innsbruckring Sprint Race - 1 Lap (8.8km/5.5mi 77m) (A),Assioma duo,Wahoo Kickr 2018,381,364,17
31727,1588702506,wahoo,Zwift - UNO X CUP powered by DCU & Feltet.dk (A),Assioma duo,Wahoo Kickr 2018,406,396,10
34029,1589307262,wahoo,Zwift - UNO X CUP powered by DCU & Feltet.dk (A),Assioma duo,Wahoo Kickr 2018,398,393,5
35301,1589627698,wahoo,3R Tick Tock Flat Race - 2 Lap (36km/22.4mi 100m),Assioma duo,Wahoo Kickr 2018,385,373,12
35302,1589627700,wahoo,Team ODZ RACE,Assioma duo,Wahoo Kickr 2018,357,349,8
35604,1589714207,wahoo,Zwift - STPC Gravel Grinder (A),Assioma duo,Wahoo Kickr 2018,373,367,6
36100,1589912071,wahoo,Zwift - UNO X CUP powered by DCU & Feltet.dk (A),Assioma duo,Wahoo Kickr 2018,422,405,17
36321,1589967609,wahoo,Zwift - 05/20/2020,Assioma duo,Wahoo Kickr 2018,368,351,17
36586,1590053905,wahoo,Zwift - Koa Sports League Race (A),Assioma duo,Wahoo Kickr 2018,397,383,14
37025,1590224729,wahoo,Zwift - 3R Watopia Out and Back Again - 1 Lap (42k/26.1mi 334m) (A),Assioma duo,Wahoo Kickr 2018,409,400,9
37644,1590429532,wahoo,Zwift - Team IRL Without Borders Race (A),Assioma duo,Wahoo Kickr 2018,373,364,9
40809,1591811767,wahoo,Zwift - DBR Boerkop Cykler Cup (A),Assioma duo,Wahoo Kickr 2018,366,361,5
41414,1592046427,wahoo,Zwift - 3R Tick Tock Flat Race - 2 Lap (36km/22.4mi 100m) (A),Assioma duo,Wahoo Kickr 2018,387,374,13
41999,1592329801,wahoo,Zwift - UNO X CUP powered by DCU & Feltet.dk (A),Assioma duo,Wahoo Kickr 2018,391,376,15
42235,1592416292,wahoo,Zwift - USA Cycling Race League by Indoor Specialist (A),Assioma duo,Wahoo Kickr 2018,367,353,14
43718,1593193366,wahoo,Zwift - 06/26/2020,Assioma duo,Wahoo Kickr 2018,374,356,18
44435,1593625421,wahoo,Zwift - USA Cycling Race League by Indoor Specialist (A),Assioma duo,Wahoo Kickr 2018,386,368,18
44438,1593625421,wahoo,Zwift - 07/01/2020,Assioma duo,Wahoo Kickr 2018,349,331,18
44707,1593798041,wahoo,Zwift - TeamPTz Friday&#039;s Race League (A),Assioma duo,Wahoo Kickr 2018,380,364,16
45312,1594146048,wahoo,Zwift - 3R NYC Gotham Grind - 4 Laps (A),Assioma duo,Wahoo Kickr 2018,378,364,14
45471,1594230528,wahoo,Zwift - USA Cycling Race League by Indoor Specialist (A),Assioma duo,Wahoo Kickr 2018,383,368,15
45562,1594285596,wahoo,Zwift - 07/09/2020,Assioma duo,Wahoo Kickr 2018,372,354,18
45765,1594375195,wahoo,Zwift - 3R Innsbruckring Flat Race - 4 Laps (35.2km/21.9mi 308m) (A),Assioma duo,Wahoo Kickr 2018,376,356,20
46834,1595080839,wahoo,Zwift - OH MY CRIT!! - Saturday Smash Race (A),Assioma duo,Wahoo Kickr 2018,342,331,11
47157,1595343429,wahoo,Zwift - 3R Turbocharged Team Race Series - Round 2 (A),Assioma duo,Wahoo Kickr 2018,345,336,9
47278,1595153140,wahoo,Zwift - USA Cycling Race League by Indoor Specialist (A),Assioma duo,Wahoo Kickr 2018,369,362,7
47327,1595439689,wahoo,Zwift - USA Cycling Race League by Indoor Specialist (A),Assioma duo,Wahoo Kickr 2018,381,365,16
47742,1595757624,wahoo,Zwift - 3R Sand & Sequoias - 1 Lap (20km/12.5mi 173m) (A),Assioma duo,Wahoo Kickr 2018,376,365,11
47890,1595873048,wahoo,Zwift - TFC Mad Monday Summer Series (4 of 10) (A),Assioma duo,Wahoo Kickr 2018,389,379,10
48104,1596015182,wahoo,Zwift - USA Cycling Race League by Indoor Specialist (A),Assioma duo,Wahoo Kickr 2018,394,382,12
48171,1596044777,wahoo,Zwift - USA Cycling Race League by Indoor Specialist (A),Assioma duo,Wahoo Kickr 2018,393,385,8
48400,1596121551,wahoo,Zwift - OH MY CRIT! - The Double Race 1/2 (A),Assioma duo,Wahoo Kickr 2018,396,391,5
48401,1596121551,wahoo,Zwift - OH MY CRIT! - The Double Race 2/2 (A),Assioma duo,Wahoo Kickr 2018,382,370,12
48678,1596477959,wahoo,Zwift - TFC Mad Monday Summer Series (5 of 10) (A),Assioma duo,Wahoo Kickr 2018,391,370,21
48799,1596565831,wahoo,Zwift - 3R Turbocharged Team Race Series - Round 4 (A),Assioma duo,Wahoo Kickr 2018,377,367,10
48942,1596650071,wahoo,Zwift - DBR Wednesday Race (A),Assioma duo,Wahoo Kickr 2018,369,362,7
49362,1596967390,wahoo,Zwift - 3R Sand & Sequoias - 1 Lap (20km/12.5mi 173m) (A),Assioma duo,Wahoo Kickr 2018,348,343,5
49592,1597170591,wahoo,Zwift - 3R Turbocharged Team Race Series - Round 5 (A),Assioma duo,Wahoo Kickr 2018,397,390,7
50152,1597499792,wahoo,Zwift - OH MY CRIT - Saturday Smash Race (A),Assioma duo,Wahoo Kickr 2018,427,418,9
51624,1598346046,wahoo,Zwift - 3R Turbocharged Team Race Series - Bonus Round (A),Assioma duo,Wahoo Kickr 2018,364,349,15
51855,1598380151,wahoo,Zwift - 3R Turbocharged Team Race Series - Bonus Round (A),Assioma duo,Wahoo Kickr 2018,369,356,13
52031,1598460676,wahoo,Zwift - MIDWEEK Summer Series by SZR (A),Assioma duo,Wahoo Kickr 2018,400,376,24
52777,1598897314,wahoo,Zwift - TFC Mad Monday Summer Series (9 of 10) (A),Assioma duo,Wahoo Kickr 2018,391,376,15
53208,1599146039,wahoo,Zwift - OH MY CRIT! - The Double Race 1/2 (A),Assioma duo,Wahoo Kickr 2018,391,375,16
53210,1599146039,wahoo,Zwift - OH MY CRIT! - The Double Race 2/2 (A),Assioma duo,Wahoo Kickr 2018,356,345,11
53778,1599501848,wahoo,Zwift - TFC Mad Monday Summer Series (10 of 10) (A),Assioma duo,Wahoo Kickr 2018,375,354,21
53976,1599590157,wahoo,Zwift - 3R Sundown Race Series  (E),Assioma duo,Wahoo Kickr 2018,385,370,15
54196,1599673978,wahoo,Zwift - DBR Wednesday Race (A),Assioma duo,Wahoo Kickr 2018,373,364,9
54378,1599753517,wahoo,Zwift - OH MY CRIT! - The Double Race 2/2 (A),Assioma duo,Wahoo Kickr 2018,376,361,15
54700,1599907983,neo,Zwift - NYC,Assioma duo,Neo,251,248,3
54702,1599908754,neo,Zwift - test,Assioma duo,Neo,333,338,-5
54703,1599910981,wahoo,Zwift - kickr test 5 min,Assioma duo,Wahoo Kickr 2018,303,296,7
54844,1599991953,neo,Zwift ,Assioma duo,Neo,199,205,-6
55019,1600105558,neo,Zwift - Invitational League // Qualifying Race #1,Assioma duo,Neo,380,381,-1
55294,1600159317,neo,Zwift ,Assioma duo,Neo,199,198,1
55395,1600194952,neo,Zwift - 3R Sundown Race Series  (E),Assioma duo,Neo,379,388,-9
55926,1600367313,neo,Zwift - Invitational League // Qualifying Race #2 (Men) ,Assioma duo,Neo,382,375,7
57684,1601116789,neo,Zwift - Into the Red by RELENTLESS (A),Assioma duo,Neo,386,378,8
57883,1601207164,neo,Zwift - Peel Cycling - Sunday Chase (A),Assioma duo,Neo,347,341,6
81230,1607450416,wahoo,Zwift - Zwift Racing League | WTRL - Men&#039;s EMEA E1 DIVISION 1 (A),Assioma duo,Kickr V5 to wahoo app,398,388,10
81885,1607682904,wahoo,Zwift - 12/11/2020,Assioma duo,Kickr V5 to wahoo app,362,354,8
89009,1609336018,wahoo,Zwift - KISS Race Series - Pacific AM (A),Assioma duo,Kickr V5 to wahoo app,345,334,11
89762,1609503468,wahoo,Zwift - Peak-PTY Climb Challenge Fridays (A),Assioma duo,Kickr V5 to wahoo app,376,368,8
90680,1609674996,wahoo,Zwift 7 x 10 min SST,Assioma duo,Kickr V5 to wahoo app,329,325,4
91369,1609787313,wahoo,Zwift - Team TFC Mad Monday Winter Series (A),Assioma duo,Kickr V5 to wahoo app,382,369,13
92922,1610043561,wahoo,Zwift - FUSION WINTER CUP (A),Assioma duo,Kickr V5 to wahoo app,413,405,8
94399,1610270733,wahoo,Zwift - DBR Sunday Race (A),Assioma duo,Kickr V5 to wahoo app,349,335,14
95671,1610474342,wahoo,Zwift - Zwift Racing League | WTRL - Men&#039;s/Mixed EMEA E1 DIVISION 1 (A),Assioma duo,Kickr V5 to wahoo app,383,381,2
97456,1610726621,wahoo,Zwift - 01/15/2021,Assioma duo,Kickr V5 to wahoo app,364,357,7
98185,1610809574,wahoo,Zwift - OH MY CRIT - Saturday Smash Race (A),Assioma duo,Kickr V5 to wahoo app,370,363,7
98851,1610885925,wahoo,Zwift ,Assioma duo,Kickr V5 to wahoo app,358,355,3
99647,1611079191,wahoo,Zwift Racing League | WTRL - Mens/Mixed EMEA E1 DIVISION 1,Assioma duo,Kickr V5 to wahoo app,382,374,8
103456,1611683919,wahoo,Zwift - Zwift Racing League | WTRL - Men&#039;s/Mixed EMEA E1 DIVISION 1 (A),Assioma duo,Kickr V5 to wahoo app,395,381,14
108319,1612378171,wahoo,Zwift - Open - Movistar Team Challenge Community Qualifier Race #1,Assioma duo,Kickr V5 to wahoo app,401,391,10
110902,1612773742,wahoo,Zwift - Crit City Race (A),Assioma duo,Kickr V5 to wahoo app,412,396,16
111807,1612897991,wahoo,Zwift - British Cycling Race Series (A),Assioma duo,Kickr V5 to wahoo app,393,374,19
113116,1613067645,wahoo,Zwift - FUSION WINTER CUP (A),Assioma duo,Kickr V5 to wahoo app,398,381,17
114391,1613242550,wahoo,Zwift - TBR Pancake Chase Race! (A),Assioma duo,Kickr V5 to wahoo app,362,354,8
116860,1613587054,wahoo,Zwift - Danmarks Cykle Union & Partners 6/6 (A),Assioma duo,Kickr V5 to wahoo app,393,382,11
19595,1585077315,wahoo,Zwift - Tour of Watopia Pro-Am Men&#039;s Race #3 (A),Vectors 3s,Wahoo Kickr ,405,405,0
22170,1586077218,wahoo,Zwift - Ronde van Zwift (A),Vectors 3s (Secondary),Wahoo Kickr 18 (Zwift),414,418,-4
23333,1586457016,wahoo,Zwift - Yorkshire Grand Prix Race (A) - 3rd,Infocrank (Secondary),Wahoo Kickr 18 (Zwift),390,377,13
26120,1587283518,wahoo,Zwift - 3R Watopia Flat Route Race - 4 Laps (40.5km/25.1mi 216m) (A),Infocrank (Secondary),Wahoo Kickr 18 (Zwift),407,389,18
26563,1587450316,wahoo,Zwift - 3R Watopia Flat Route Race - 3 Laps (30.3km/18.8mi 162m) (A) - 1st,Infocrank (Secondary),Wahoo Kickr 18 (Zwift),382,361,21
26884,1587542722,wahoo,Zwift - 3R Tempus Fugit Flat Race - 1 Lap (19.8km/12.3mi 20m) (A) - 5th,Infocrank (Secondary),Wahoo Kickr 18 (Zwift),406,387,19
27177,1587625215,wahoo,Zwift - ZHQ Beta Crit City Race (A) - 1st,Infocrank (Zwift),Wahoo Kickr 18 (Secondary),389,367,22
27532,1587711615,wahoo,Zwift - ZHQ Beta Crit City Race (A) - 1st,Infocrank (Zwift),Wahoo Kickr 18 (Secondary),405,382,23
28038,1587838217,wahoo,Zwift - Crit City Slam // Zwift Classic (A),Infocrank (Zwift),Wahoo Kickr 18 (Secondary),420,393,27
29379,1588227015,wahoo,Zwift - 3R Watopia Flat Route Race - 3 Laps (30.3km/18.8mi 162m) (A) - 1st,Infocrank (Zwift),Wahoo Kickr 18 (Secondary),418,399,19
30605,1588435220,wahoo,Zwift - YANA Pro/AM Invitiational (A) - 25th,Infocrank (Zwift),Wahoo Kickr 18 (Secondary),420,396,24
31145,1588573817,wahoo,Zwift - ZHQ Beta Crit City Race (A) - 1st,Infocrank (Zwift),Wahoo Kickr 18 (Secondary),454,435,19
31908,1588746615,wahoo,Zwift - Cycling Southland Wednesday Worlds p/b GreenMonkey - 3rd,Infocrank (Zwift),Wahoo Kickr 18 (Secondary),370,351,19
33519,1589178615,wahoo,Zwift - ZHQ Beta Crit City Race (A) - 1st,Infocrank (Zwift),Wahoo Kickr 18 (Secondary),394,374,20
35755,1589783417,wahoo,Zwift - ZHQ Beta Crit City Race (A) - 1st,Infocrank (Zwift),Wahoo Kickr 18 (Secondary),386,374,12
35956,1589869516,wahoo,Zwift - 3R Watopia Flat Route Race - 3 Laps (30.3km/18.8mi 162m) (A),Infocrank (Zwift),Wahoo Kickr 18 (Secondary),428,409,19
36706,1590085036,wahoo,Zwift - Tour for All Invitational Race // Men (A),Infocrank (Zwift),Wahoo Kickr 18 (Secondary),372,354,18
37670,1590433517,neo,Zwift - Tour for All 2020: Stage 1 Longer Race A/B - 1st,Infocrank (Zwift),Tax Neo 2t (Secondary),380,381,-1
38223,1590646215,wahoo,Zwift - 3R Watopia Flat Route Race - 3 Laps (30.3km/18.8mi 162m) (A) - 1st,Infocrank (Zwift),Wahoo Kickr 18 (Secondary),431,433,-2
38494,1590733816,wahoo,Zwift - ZHQ Beta Crit City Race (A) - 1st,Infocrank (Zwift),Wahoo Kickr 18 (Secondary),390,390,0
39011,1591079122,wahoo,Zwift - 3R Watopia Flat Route Race - 3 Laps (30.3km/18.8mi 162m) (A) - 1st,Infocrank (Zwift),Wahoo Kickr 18 (Secondary),396,383,13
40553,1591723832,wahoo,Zwift - UKAF Cycling Community Race Night - 3rd,Infocrank (Zwift),Wahoo Kickr 18 (Secondary),395,380,15
40728,1591788014,wahoo,Zwift - British Cycling Crit City Series (A) - 2nd,Infocrank (Secondary),Wahoo Kickr Core,382,388,-6
40943,1591855815,wahoo,Zwift - 3R Watopia Flat Route Race - 3 Laps (30.3km/18.8mi 162m) (A) - 4th,Infocrank (Zwift),Wahoo Kickr Core (Secondary),433,430,3
41181,1591943415,wahoo,Zwift - ZHQ Beta Crit City Race (A) - 1st,Infocrank (Secondary),Wahoo Kickr Core (Primary),383,394,-11
49758,1597259715,wahoo,Zwift - 3R Tick Tock Flat Race - 2 Lap (36km/22.4mi 100m) (A) - 3rd,Infocrank (Zwift),Wahoo Kickr 18 (Secondary),328,317,11
50721,1597852825,wahoo,Zwift - Off The MAAP Stage 2 Race (A) -1st,Infocrank (Zwift),Wahoo Kickr 18 (Secondary),382,376,6
50990,1597957227,wahoo,Zwift - Off The MAAP Stage 2 Race (A) - 1st,Infocrank (Zwift),Wahoo Kickr 18 (Secondary),363,360,3
52793,1598898020,wahoo,Zwift - TFC Mad Monday Summer Series (9 of 10) (A) - 7th,Infocrank (Zwift),Wahoo Kickr 18 (Secondary),410,404,6
53462,1599244515,wahoo,Zwift - Newbury Velo Crit (A) - 1st,Infocrank (Zwift),Wahoo Kickr 18 (Secondary),432,432,0
53818,1599502820,wahoo,Zwift - TFC Mad Monday Summer Series (10 of 10) (A),Infocrank (Zwift),Wahoo Kickr 18 (Secondary),395,394,1
54465,1599762618,wahoo,Zwift - Cycling Ireland Zwift Sprint Race (A) - 1st,Infocrank (Zwift),Wahoo Kickr 18 (Secondary),365,364,1
55210,1600106393,wahoo,Zwift - Invitational League // Qualifying Race #1,Infocrank (Secondary),Wahoo Kickr 18 (Zwift),405,386,19
56896,1600800263,wahoo,Zwift - 3R Sundown Race Series  (E),Infocrank (Zwift),Wahoo Kickr 18 (Secondary),419,410,9
57351,1600974015,wahoo,Zwift - KISS at Race - EU PM (A) ,Infocrank (Secondary),Wahoo Kickr 18 (Zwift),438,418,20
58606,1601490614,wahoo,Zwift - British Cycling Crit City Series (A) - 2nd,Infocrank (Secondary),Wahoo Kickr 18 (Zwift),403,378,25
58896,1601578816,wahoo,Zwift - KISS at Race - EU PM (A) - 2nd,Infocrank (Secondary),Wahoo Kickr 18 (Zwift),384,362,22
59646,1601922022,wahoo,Zwift - TFC Mad Monday Autumn Series (A) - 5th,Infocrank (Secondary),Wahoo Kickr 18 (Zwift),414,392,22
59904,1602010817,wahoo,Zwift - KISS at Race - EU PM (A) - 2nd,Vector 3s (Secondary),Wahoo Kickr 18 (Zwift),418,390,28
60449,1602183619,wahoo,Zwift - KISS at Race - EU PM (A) - 1st,Infocrank (Secondary),Wahoo Kickr 18 (Zwift),448,421,27
61338,1602529216,wahoo,Zwift - EVR Europe Race (A) - 2nd,Infocrank (Secondary),Wahoo Kickr 18 (Zwift),401,363,38
61650,1602615614,wahoo,Zwift - KISS at Race - EU PM (A) - 3rd,Infocrank (Secondary),Wahoo Kickr 18 (Zwift),396,364,32
62128,1602774917,wahoo,Zwift - OH MY CRIT! - The Double Race 1/2 (A) - 6th,Infocrank (Secondary),Wahoo Kickr 18 (Zwift),428,397,31
63175,1603131618,wahoo,Zwift - TFC Mad Monday Autumn Series (A) - 3rd,Infocrank (Secondary),Wahoo Kickr 18 (Zwift),427,391,36
63583,1603218616,wahoo,Zwift - ZHR Masters Britain (A) - 1st,Infocrank (Secondary),Wahoo Kickr 18 (Zwift),431,397,34
64462,1603478114,wahoo,Zwift - Newbury Velo Crit (A) - 1st,Infocrank (Secondary),Wahoo Kickr 18 (Zwift),386,360,26
66622,1604135716,wahoo,Zwift - ZHR Audax (D),Infocrank (Secondary),Wahoo Kickr 18 (Zwift),442,415,27
67079,1604216103,wahoo,Zwift - Watopia,Infocrank (Secondary),Wahoo Kickr 18 (Zwift),429,405,24
67739,1604417413,wahoo,Zwift - Sydkysten Cycling - Carl Ras Race (A) - 3rd,Infocrank (Secondary),Wahoo Kickr 18 (Zwift),427,394,33
67991,1604520027,wahoo,Zwift - EVR Definitely Not the WTNC (A) - 1st,Infocrank (Secondary),Wahoo Kickr 18 (Zwift),352,333,19
68144,1604585115,wahoo,Zwift - 3R Classique Flat Race - 6 Laps (37.7km/23.4mi 114m) (A),Infocrank (Secondary),Wahoo Kickr 18 (Zwift),404,384,20
72529,1605696313,wahoo,Zwift - USA Cycling Race League by Indoor Specialist (A),Infocrank (Zwift),Wahoo Kickr 18 (Secondary),427,405,22
73452,1605871213,wahoo,Zwift - 3R LaGuardia Loop Reverse Flat Race - 8 Laps (24.5km/15.2mi 216m) (A) - 4th,Infocrank (Zwift),Wahoo Kickr 18 (Secondary),400,380,20
74987,1606233922,wahoo,Zwift - 3R Volcano Circuit Flat Race - 8 Laps (35.2km/21.9mi 160m) (A) - 1st,Infocrank (Zwift),Wahoo Kickr 18 (Secondary),415,396,19
75878,1606393527,wahoo,Zwift - EMU Japan Race (A) - 7th,Infocrank (Zwift),Wahoo Kickr 18 (Secondary),432,411,21
77952,1606821614,wahoo,Zwift - British Cycling Race Series (A) - 1 st,Infocrank (Zwift),Wahoo Kickr 18 (Secondary),380,365,15
67461,1604384625,wahoo,Favero Assioma Uno / Wahoo Kickr 2020,Favero Assioma Uno,Wahoo Kickr 2020,208,204,4
67615,1604428494,wahoo,Favero Assioma Uno / Wahoo Kickr 2020,Favero Assioma Uno,Wahoo Kickr 2020,336,328,8
69784,1605032111,wahoo,Favero Assioma Uno / Wahoo Kickr 2020,Favero Assioma Uno,Wahoo Kickr 2020,360,350,10
70823,1605205810,wahoo,Favero Assioma Uno / Wahoo Kickr 2020,Favero Assioma Uno,Wahoo Kickr 2020,340,330,10
75088,1606241721,wahoo,Favero Assioma Uno / Wahoo Kickr 2020,Favero Assioma Uno,Wahoo Kickr 2020,344,338,6
75611,1606330822,wahoo,Favero Assioma Uno / Wahoo Kickr 2020,Favero Assioma Uno,Wahoo Kickr 2020,367,364,3
79078,1607020197,wahoo,Favero Assioma Uno / Wahoo Kickr 2020,Favero Assioma Uno,Wahoo Kickr 2020,353,344,9
81673,1607625010,wahoo,Wahoo Kickr 2020 / Favero Assioma Uno,Favero Assioma Uno,Wahoo Kickr 2020,336,325,11
84480,1608228527,wahoo,Wahoo Kickr 2020 / Favero Assioma Uno,Favero Assioma Uno,Wahoo Kickr 2020,343,340,3
87423,1608971632,wahoo,Wahoo Kickr 2020 / Favero Assioma Uno,Favero Assioma Uno,Wahoo Kickr 2020,361,352,9
90200,1609578347,wahoo,Wahoo Kickr 2020 / Favero Assioma Uno,Favero Assioma Uno,Wahoo Kickr 2020,374,367,7
92986,1610042849,wahoo,Wahoo Kickr 2020 / Favero Assioma Uno,Favero Assioma Uno,Wahoo Kickr 2020,338,336,2
95710,1610472639,wahoo,Wahoo Kickr 2020 / Favero Assioma Uno,Favero Assioma Uno,Wahoo Kickr 2020,321,317,4
96479,1610561203,wahoo,Wahoo Kickr 2020 / Favero Assioma Uno,Favero Assioma Uno,Wahoo Kickr 2020,355,342,13
100411,1611165898,wahoo,Wahoo Kickr 2020 / Favero Assioma Uno,Favero Assioma Uno,Wahoo Kickr 2020,352,345,7
103553,1611682638,wahoo,Wahoo Kickr 2020 / Favero Assioma Uno,Favero Assioma Uno,Wahoo Kickr 2020,372,373,-1
104229,1611770635,wahoo,Wahoo Kickr 2020 / Favero Assioma Uno,Favero Assioma Uno,Wahoo Kickr 2020,375,374,1
107448,1612287777,wahoo,Wahoo Kickr 2020 / Favero Assioma Uno,Favero Assioma Uno,Wahoo Kickr 2020,361,355,6
108334,1612373501,wahoo,Wahoo Kickr 2020 / Favero Assioma Uno,Favero Assioma Uno,Wahoo Kickr 2020,361,355,6
111663,1612891910,wahoo,Wahoo Kickr 2020 / Favero Assioma Uno,Favero Assioma Uno,Wahoo Kickr 2020,349,348,1
112421,1612980136,wahoo,Wahoo Kickr 2020 / Favero Assioma Uno,Favero Assioma Uno,Wahoo Kickr 2020,370,356,14
115928,1613496751,wahoo,Wahoo Kickr 2020 / Favero Assioma Uno,Favero Assioma Uno,Wahoo Kickr 2020,376,381,-5
116805,1613584894,wahoo,Wahoo Kickr 2020 / Favero Assioma Uno,Favero Assioma Uno,Wahoo Kickr 2020,336,331,5
119701,1614102315,wahoo,Wahoo Kickr 2020 / Favero Assioma Uno,Favero Assioma Uno,Wahoo Kickr 2020,347,340,7
123038,1614706992,wahoo,Wahoo Kickr 2020 / Favero Assioma Uno,Favero Assioma Uno,Wahoo Kickr 2020,342,343,-1
124640,1614969063,wahoo,Zwift - Zwift Racing League | WTRL Battle Royale Playoff - Men&#039;s Points Race (A),Favero Assioma Uno,Wahoo Kickr 2020,343,344,-1
127883,1615623358,wahoo,Wahoo Kickr 2020 / Favero Assioma Uno,Favero Assioma Uno,Wahoo Kickr 2020,331,326,5
79898,1607181286,wahoo,Zwift - OH MY CRIT - Saturday Smash Race (A),Assioma Duo,Wahoo Kickr,341,347,-6
80689,1607425182,wahoo,Zwift - KISS Race Series - Americas AM (A),Assioma Duo,Wahoo Kickr,372,383,-11
81130,1607536796,wahoo,Zwift - MIDWEEK Winter Series by SZR (A),Assioma duo,Wahoo kickr,376,385,-9
82396,1607786092,wahoo,Zwift - 12/12/2020,Assioma Duo,Wahoo Kickr,380,386,-6
83388,1608029987,wahoo,Zwift - KISS Race Series - Americas AM (A),Assioma Duo,Wahoo Kickr,366,375,-9
84073,1608141597,wahoo,Zwift - MIDWEEK Winter Series by SZR (A),Assioma duo,Wahoo Kickr,328,332,-4
85137,1608390892,wahoo,Zwift - OH MY CRIT - Saturday Smash Race (A),Assioma Duo,Wahoo Kickr,388,394,-6
85186,1608390892,wahoo,Zwift - OH MY CRIT - Saturday Smash Race (A),Assioma Duo,Wahoo Kickr,388,394,-6
86786,1608746380,wahoo,Zwift - MIDWEEK Winter Series by SZR (A),Assioma Duo,Wahoo Kickr,343,342,1
87475,1608995685,wahoo,Zwift - OH MY CRIT - Saturday Smash Race (A),Assioma Duo,Wahoo Kickr,370,376,-6
89128,1609351198,wahoo,Zwift - MIDWEEK Winter Series by SZR (A),Assioma Duo,Wahoo Kickr,354,362,-8
90327,1609600491,wahoo,Zwift - OH MY CRIT - Saturday Smash Race (A),Assioma Duo,Wahoo Kickr,330,337,-7
91881,1609844385,wahoo,Zwift - KISS Race Series - Americas AM (A),Assioma Duo,Wahoo Kickr,359,362,-3
92552,1609955990,wahoo,Zwift - MIDWEEK Winter Series by SZR (A),Assioma Duo,Wahoo Kickr,306,312,-6
93953,1610205281,wahoo,Zwift - OH MY CRIT - Saturday Smash Race (A),Assioma Duo,Wahoo Kickr,377,376,1
95374,1610441157,wahoo,Zwift - Zwift Racing League | WTRL - Men&#039;s/Mixed APAC DIVISION 2 (A),Assioma Duo,Wahoo Kickr,314,317,-3
96382,1610560788,wahoo,Zwift - MIDWEEK Winter Series by SZR (A),Assioma duo,Wahoo Kickr,349,354,-5
100340,1611165574,wahoo,Zwift - MIDWEEK Winter Series by SZR (A),Assioma Duo,Wahoo Kickr,316,319,-3
100707,1611226793,wahoo,Zwift - KISS Race Series - Americas AM (A),Assioma Duo,Wahoo Kickr,330,332,-2
101924,1611414885,wahoo,Zwift - OH MY CRIT!! - Saturday Smash Race (A),ASSIOMA DUO,Wahoo Kickr,349,351,-2
103801,1611708357,wahoo,Zwift - Zwift Racing League | WTRL - Men&#039;s/Mixed AMERICAS E DIVISION 1 (A),Assioma duo,Wahoo Kickr ,338,340,-2
105788,1612019695,wahoo,Zwift - OH MY CRIT!! - Saturday Smash Race (A),Assioma duo,Wahoo Kickr,351,352,-1
109940,1612624473,wahoo,Zwift - OH MY CRIT!! - Saturday Smash Race (A),Assioma Duo,Wahoo Kickr,365,383,-18
111367,1612868986,wahoo,Zwift - Japan Zwift Tuesday Race (A),Assioma Duo,WahooKickr,333,344,-11
112617,1612979986,wahoo,Zwift - MIDWEEK Winter Series by SZR (A),Assioma Duo,Wahoo Kickr,330,333,-3
114196,1613229293,wahoo,Zwift - OH MY CRIT!! - Saturday Smash Race (A),Assioma Duo,Wahoo Kickr,365,379,-14
118292,1613834080,wahoo,Zwift - OH MY CRIT!! - Saturday Smash Race (A),Assioma Duo,Wahoo Kickr,363,373,-10
125193,1615043684,wahoo,Zwift - OH MY CRIT!! - Saturday Smash Race (A),Assioma Duo,Wahoo Kickr,336,340,-4
126104,1615287593,wahoo,Zwift - KISS Race Series - Americas AM (A),Assioma Duo,Wahoo Kickr,318,329,-11
126890,1615460386,wahoo,Zwift - KISS Race Series - Americas AM (A),Assioma Duo,Wahoo Kickr,347,353,-6
40886,1591809719,wahoo,Zwift - Zwift NL League - Woensdagavond Competitie (A),Quarq Sram Red AXS,Wahoo Kickr E-racing tv on stage,394,395,-1
113146,1613069902,wahoo,Zwift - BENELIGA 2020-2021 (E),Quarq Sram Red AXS 21397 (secondary),Wahoo Kickr E-racing tv on stage,445,427,18
54604,1599842980,neo,Zwift - KIRCHMAIR Race Series (A),Rotor 2inpower,TACX Neo,373,333,40
55094,1600105643,neo,Zwift - Invitational League // Qualifying Race #1,Rotor 2inpower,TACX Neo,365,350,15
63406,1603213549,neo,Zwift - Zwift Racing League | WTRL - EMEA E (MEN) - TTT Grp 2 (A),Rotor 2inpower,TACX Neo,335,313,22
65663,1603821637,neo,Zwift - Zwift Racing League | WTRL - EMEA E (MEN) -  Division 1 (A),Rotor 2inpower,TACX Neo,353,332,21
70285,1605032154,neo,Zwift - Zwift Racing League | WTRL - EMEA E1 (MEN) -  Division 2 (A),Rotor 2inpower,TACX Neo,391,373,18
73573,1605896993,neo,Zwift - Team WEZ Friday Race,Rotor 2inpower,TACX Neo,399,390,9
76569,1606501793,neo,Zwift - Team WEZ Friday Race (E),Rotor 2inpower,TACX Neo,348,334,14
78034,1606847102,neo,Zwift - Zwift Racing League | WTRL - Men&#039;s EMEA E1 DIVISION 2 (A),Rotor 2inpower,TACX Neo,347,335,12
79041,1607021989,neo,BENELIGA 2020-2021,Rotor 2inpower,TACX Neo,359,343,16
97060,1610650799,neo,BENELIGA 2020-2021,Rotor 2inpower,TACX Neo,394,389,5
100949,1611255598,neo,BENELIGA 2020-2021,Rotor 2inpower,TACX Neo,390,392,-2
104465,1611831620,neo,Zwift - KISS Race Series - Americas AM (A),Rotor 2inpower,TACX Neo,373,362,11
124579,1614971075,neo,Zwift - Zwift Racing League | WTRL Battle Royale Playoff - Men&#039;s Points Race (A),Rotor 2inpower,TACX Neo,362,346,16
70108,1605037480,wahoo,Zwift - Zwift Racing League | WTRL - EMEA W1 (MEN) -  Division 1 (A),4iiii Precision,Wahoo Kickr,419,419,0
70999,1605197952,wahoo,Wahoo Kickr / 4iiii Precision,4iiii Precision,Wahoo Kickr,393,374,19
83980,1608061854,wahoo,Zwift - Zwift Racing League | WTRL - Men&#039;s EMEA W1 DIVISION 1 (A),4iiii Precision,Wahoo Kickr,369,373,-4
84525,1608230508,wahoo,Zwift - WTRL Team Time Trial - Zone 6 (C),4iiii Precision,Wahoo Kickr,376,369,7
87160,1608385980,wahoo,3 sisters test,4iiii Precision,Wahoo Kickr,353,347,6
99264,1610999414,wahoo,Zwift - Premier Division // Zwift Racing League (men) (A),4iiii Precision,Wahoo Kickr,398,395,3
103082,1611601380,wahoo,Zwift - Premier Division // Zwift Racing League (men) (A),4iiii Precision,Wahoo Kickr,408,404,4
104492,1611835104,wahoo,12min max,4iiii Precision,Wahoo Kickr,407,400,7
105494,1611995422,wahoo,Zwift - London Lockdown eRace Series: Race 1 (A),4iiii Precision,Wahoo Kickr,413,411,2
106991,1612209959,wahoo,Zwift - Premier Division // Zwift Racing League (men) (A),4iiii Precision,Wahoo Kickr,405,403,2
111083,1612811679,wahoo,Zwift - Premier Division // Zwift Racing League (men) (A),4iiii Precision,Wahoo Kickr,400,390,10
112342,1612983620,wahoo,Zwift - Movistar Team Challenge // Round 1 (A),4iiii Precision,Wahoo Kickr,372,362,10
113612,1613156396,wahoo,Zwift - Movistar Team Challenge // Round 1 (men),4iiii Precision,Wahoo Kickr,412,412,0
115465,1613419306,wahoo,Zwift - Premier Division // Zwift Racing League (men) (A),4iiii Precision,Wahoo Kickr,395,392,3
116762,1613588339,wahoo,Zwift - Movistar Team Challenge // Round 2 (men) - Race 3/4,4iiii Precision,Wahoo Kickr,376,367,9
117929,1613761179,wahoo,Zwift - Movistar Team Challenge // Round 2 (men),4iiii Precision,Wahoo Kickr,420,415,5
119177,1614021020,wahoo,Zwift - Premier Division // Zwift Racing League (men) (A),4iiii Precision,Wahoo Kickr,410,397,13
121121,1614278221,wahoo,Zwift - WTRL Team Time Trial - Zone 7 (C),4iiii Precision,Wahoo Kickr,376,363,13
122664,1614629518,wahoo,Zwift - Premier Division // Zwift Racing League (men) (A),4iiii Precision,Wahoo Kickr,402,396,6
124150,1614884383,wahoo,Zwift - Ramp Test,4iiii Precision,Wahoo Kickr,430,432,-2
124155,1614886778,wahoo,Zwift - Movistar Team Challenge // Points Race (men),4iiii Precision,Wahoo Kickr,397,387,10
127809,1615624192,wahoo,Zwift - London Lockdown eRace Series: Race 4 (A),4iiii Precision,Wahoo Kickr,380,372,8
45302,1594142123,neo,Zwift - Flanders Ronde Race (A),Shimano R9100-P dual sided ,Tacx Neo 2,385,374,11
45469,1594230431,neo,Zwift - USA Cycling Race League by Indoor Specialist (A),Shimano R9100-P dual sided ,Tacx Neo 2,420,405,15
46349,1594751828,neo,Zwift - 3R Turbocharged Team Race Series - Round 1 (A),Shimano R9100-P dual sided ,Tacx Neo 2,381,364,17
68808,1604762093,neo,Zwift - OH MY CRIT - Saturday Smash Race (A),Rotor Powermeter (Zwift),Loaner Tacx Neo 2T,455,441,14
14994,1582218329,wahoo,Zwift - Watopia,Power2Max ,Wahoo Kickr power CPi,350,326,24
30359,1588359348,wahoo,Reprise 25 - Recovery Legs after running of the morning,Power2Max (Zwift source),Wahoo Kickr Power,150,147,3
31058,1588483801,wahoo,Zwift - XRS Races: a Longer and Hard race (A),Power2Max (Zwift source),Wahoo Kickr Power,323,302,21
31811,1588701297,wahoo,Zwift - Team Italy & Frenchy Fuzion League (A) - 19th... grooupe de tete pour mon retour ! Content... ,Power2Max (Zwift source),Wahoo Kickr Power,326,309,17
32079,1588787999,wahoo,Zwift - Zwift NL League - Woensdagavond Competitie (A),Power2Max (Zwift source),Wahoo Kickr Power,327,309,18
33404,1589095212,wahoo,Zwift - Team Italy & Frenchy Fuzion Endurance Race (A),Power2Max (Zwift source),Wahoo Kickr Power,298,285,13
36749,1589910898,wahoo,Zwift - Team Italy & Frenchy Fuzion League (A),Power2Max (Zwift source),Wahoo Kickr Power,324,314,10
38161,1590602096,wahoo,Zwift - USA Cycling Race League by Indoor Specialist (A),Power2Max (Zwift source),Wahoo Kickr Power,352,339,13
38889,1590901201,wahoo,Zwift - KISS at Race 100 - EU (A) - 4th,Power2Max (Zwift source),Wahoo Kickr Power,305,287,18
39381,1591206886,wahoo,Zwift - USA Cycling Race League by Indoor Specialist (A),Power2Max (Zwift source),Wahoo Kickr Power,320,315,5
40768,1591725300,wahoo,Zwift - Team Italy & Frenchy Fuzion League (A),Power2Max ,Wahoo Kickr Power,316,302,14
41451,1591811702,wahoo,Zwift - USA Cycling Race League by Indoor Specialist (A),Power2Max (Zwift source),Wahoo Kickr Power,363,345,18
42011,1592332808,wahoo,Zwift - 3R & Wahoo Ride Real Race Series - Round 5 of 7 (A),Power2Max (Zwift source),Wahoo Kickr Power,317,303,14
55587,1600106397,wahoo,Zwift - Invitational League // Qualifying Race #1,Power2Max ,Wahoo Kickr Power,326,333,-7
69638,1604997907,wahoo,Zwift - Zwift Racing League | WTRL - APAC (MEN) -  Division 1 (A) - 15th... a shit sprint again ! ,Power2Max ,Wahoo Kickr Power,364,358,6
70748,1605207600,wahoo,Zwift -  Flanders The BZR Ronde  (A),Power2Max (Zwift source),Wahoo Kickr Power,365,288,77
73126,1605812409,wahoo,Zwift -  Flanders The BZR Ronde  (A),Power2Max (Zwift source),Wahoo Kickr Power,304,305,-1
74245,1606054501,wahoo,Zwift - KISS 100 Race Series - Americas (A),Power2Max (Zwift source),Wahoo Kickr Power,329,313,16
74926,1606207499,wahoo,Zwift - Zwift Racing League | WTRL - Men&#039;s APAC DIVISION 1,Power2Max (Zwift source),Wahoo Kickr Power,346,345,1
76102,1606417209,wahoo,Zwift -  Flanders The BZR Ronde  (A) - Day Off ,Power2Max ,Wahoo Kickr Power,336,342,-6
6505,1576606500,wahoo,Zwift - Danmarks Cykle Union Racing League (A),Sram Dzero,Wahoo Kickr,402,388,14
8050,1578145517,wahoo,Zwift - WTRL Winter Racing League,Sram Dzero,Wahoo Kickr,339,324,15
8329,1578423299,wahoo,Zwift - Team Italy Gladiators Race (A),Sram Dzero,Wahoo Kickr,388,370,18
9018,1578838500,wahoo,Zwift - KISS at Race 100 - Americas (A),Sram Dzero,Wahoo Kickr,349,338,11
9558,1579115700,wahoo,Zwift - Tour de Zwift // Pro-Am Invitational (A),Sram Dzero,Wahoo Kickr,441,411,30
10671,1579806899,wahoo,Zwift - Tour de Zwift // Pro-Am Invitational,SRM,Wahoo Kickr,440,427,13
10981,1580018400,wahoo,Zwift - KISS at Race 100 - EU (A),SRM,Wahoo Kickr,390,377,13
11895,1580498100,wahoo,Zwift - Tour de Zwift // Pro-Am Invitational (A),SRM,Wahoo Kickr,397,383,14
12490,1580843698,wahoo,Zwift - Tour de Zwift // Pro-Am Invitational (A),SRM,Wahoo Kickr,421,411,10
12792,1581015599,wahoo,Zwift - KALAS Cup - Round 2 (A),SRM,Wahoo Kickr,423,413,10
13182,1581257694,wahoo,Zwift - KISS at Race 100 - Americas (A),SRM,Wahoo Kickr,388,361,27
13765,1581620399,wahoo,Zwift - KALAS Cup - Round 3 (A),SRM,Wahoo Kickr,390,380,10
14974,1582225199,wahoo,Zwift - KALAS Cup - Round 4 (A),Sram Dzero,Wahoo Kickr,390,384,6
15818,1582658089,wahoo,Zwift - Feltet.dk Race Series (A),Sram Dzero,Wahoo Kickr,339,328,11
15903,1582829999,wahoo,Zwift - KALAS Cup - Round 5 (A),Sram Dzero,Wahoo Kickr,383,379,4
16973,1583434788,wahoo,Zwift - KALAS Cup - Round 6 (A),Sram Dzero,Wahoo Kickr,383,377,6
17860,1584039592,wahoo,KALAS Cup - Round 7,Sram Dzero,Wahoo Kickr,372,371,1
22016,1586004299,wahoo,Zwift - WTRL iTT Series  (A),Sram Dzero,Wahoo Kickr,411,400,11
23317,1586455798,wahoo,Zwift - London International // Zwift Classic (A),Sram Dzero,Wahoo Kickr,432,424,8
25830,1587147051,wahoo,Zwift - Richmond Challenge // Zwift Classic (A),Sram Dzero,Wahoo Kickr,400,390,10
28030,1587838200,wahoo,Zwift - Crit City Slam // Zwift Classic (A),Sram Dzero,Wahoo Kickr,392,386,6
34078,1589307273,wahoo,Zwift - UNO X CUP powered by DCU & Feltet.dk (A),Sram Dzero,Wahoo Kickr,406,400,6
39152,1591121639,wahoo,Zwift - UNO X CUP powered by DCU & Feltet.dk (A),Sram Dzero,Wahoo Kickr,394,384,10
40590,1591726428,wahoo,Zwift - UNO X CUP powered by DCU & Feltet.dk (A),Sram Dzero,Wahoo Kickr,396,386,10
44973,1593925181,wahoo,Zwift - KISS at Race 100 - EU (A),Sram Dzero,Wahoo Kickr,349,341,8
55516,1600255198,wahoo,Zwift - 3R Volcano Circuit Flat Race - 6 Laps (27km/16.8mi 120m) (A),Sram Dzero,Wahoo Kickr,362,356,6
55939,1600367396,wahoo,Zwift - Invitational League // Qualifying Race #2 (Men) ,Sram Dzero,Wahoo Kickr,354,346,8
56459,1600606797,wahoo,Zwift - Invitational League // Qualifying Race #3 (Men) (A),Sram Dzero,Wahoo Kickr,389,378,11
57732,1600883096,wahoo,Zwift - DCU powered by Feltet.dk (A),Sram Dzero,Wahoo Kickr,402,390,12
57733,1601126393,wahoo,Zwift - 3R Innsbruckring Flat Race - 5 Laps (44km/27.3mi 385m) (A),Sram Dzero,Wahoo Kickr,357,336,21
58587,1601487889,wahoo,Zwift - DCU powered by Feltet.dk (A),Sram Dzero,Wahoo Kickr,365,349,16
60221,1602092684,wahoo,Zwift - DCU powered by Feltet.dk (A),Sram Dzero,Wahoo Kickr,381,372,9
62145,1602609286,wahoo,Zwift - Zwift Racing League | WTRL,Sram Dzero,Wahoo Kickr,400,393,7
63557,1603214538,wahoo,Zwift - Zwift Racing League | WTRL - EMEA E (MEN) - TTT Grp 1,Sram Dzero,Wahoo Kickr,386,378,8
67620,1604428462,wahoo,Zwift - Zwift Racing League | WTRL - Men&#039;s EMEA E1 DIVISION 1 (A),Sram Dzero,Wahoo Kickr,391,381,10
69807,1605032081,wahoo,Zwift - Zwift Racing League | WTRL - EMEA E1 (MEN) -  Division 1 (A),Sram Dzero,Wahoo Kickr,434,417,17
70339,1605121497,wahoo,Zwift - DBR HEINO CUP III (A),Sram Dzero,Wahoo Kickr,388,388,0
70875,1605205795,wahoo,Zwift - FUSION ECT BEUNSTOPPABLE Racing Series (A),Sram Dzero,Wahoo Kickr,335,335,0
71330,1605352495,wahoo,Zwift - 3R Tick Tock Flat Race - 2 Lap (36km/22.4mi 100m) (A),Sram Dzero,Wahoo Kickr,334,326,8
72375,1605637402,wahoo,Zwift - Zwift Racing League | WTRL - Men&#039;s EMEA E1 DIVISION 1 (A),Sram Dzero,Wahoo Kickr,379,380,-1
73208,1605814194,wahoo,Zwift - World Championships Experience // Danish Cycling Federation,Sram Dzero,Wahoo Kickr,376,375,1
73529,1605885296,wahoo,Zwift - 3R Sand and Sequoias Race (A),Sram Dzero,Wahoo Kickr,376,377,-1
74250,1606054495,wahoo,Zwift - KISS 100 Race Series - Americas (A),Sram Dzero,Wahoo Kickr,406,412,-6
75028,1606241692,wahoo,Zwift - Zwift Racing League | WTRL - Men&#039;s EMEA E1 DIVISION 1,Sram Dzero,Wahoo Kickr,408,417,-9
77326,1606659285,wahoo,Zwift - KISS 100 Race Series - Americas (A),Sram Dzero,Wahoo Kickr,326,330,-4
78140,1606847063,wahoo,Zwift - Zwift Racing League | WTRL - Men&#039;s EMEA E1 DIVISION 1 (A),Sram Dzero,Wahoo Kickr,388,392,-4
79079,1607020191,wahoo,Zwift - FUSION DECEMBER CUP (A),Sram Dzero,Wahoo Kickr,398,401,-3
80180,1607264093,wahoo,Zwift - KISS 100 Race Series - Americas (A),Sram Dzero,Wahoo Kickr,343,345,-2
80809,1607451292,wahoo,Zwift - Zwift Racing League | WTRL - Men&#039;s EMEA E1 DIVISION 1 (A),Sram Dzero,Wahoo Kickr,395,398,-3
82639,1607839190,wahoo,Zwift - KISS 100 Race Series - EU (A),Sram Dzero,Wahoo Kickr,373,376,-3
83592,1608056664,wahoo,Zwift - Zwift Racing League | WTRL - Men&#039;s EMEA E1 DIVISION 1 (A),Sram Dzero,Wahoo Kickr,380,383,-3
92969,1610044174,wahoo,Zwift - FUSION WINTER CUP (A),Sram Dzero,Wahoo Kickr v5,407,411,-4
97106,1610648985,wahoo,Zwift - FUSION WINTER CUP (A),Sram Dzero,Wahoo Kickr v5,406,404,2
101037,1611253792,wahoo,Zwift - FUSION WINTER CUP (A),Sram Dzero,Wahoo Kickr v5,364,367,-3
103496,1611684888,wahoo,Zwift - Zwift Racing League | WTRL - Men&#039;s/Mixed EMEA E1 DIVISION 1 (A),Sram Dzero,Wahoo Kickr v5,396,401,-5
104753,1611858598,wahoo,Zwift - FUSION WINTER CUP (A),Sram Dzero,Wahoo Kickr v5,356,356,0
107368,1612289692,wahoo,Zwift - Zwift Racing League | WTRL - Men&#039;s/Mixed EMEA E1 DIVISION 1 (A),Sram Dzero,Wahoo Kickr v5,402,410,-8
108992,1612463394,wahoo,Zwift - FUSION WINTER CUP (A),Sram Dzero,Wahoo Kickr v5,400,406,-6
111654,1612894994,wahoo,Zwift - Zwift Racing League | WTRL - Men&#039;s/Mixed EMEA E1 DIVISION 1 (A),Sram Dzero,Wahoo Kickr v5,408,407,1
113056,1613068194,wahoo,Zwift - FUSION WINTER CUP (A),Sram Dzero,Wahoo Kickr v5,363,363,0
116013,1613499288,wahoo,Zwift - Zwift Racing League | WTRL - Men&#039;s/Mixed EMEA E1 DIVISION 1 (A),Sram Dzero,Wahoo Kickr v5,435,439,-4
117863,1613672993,wahoo,Zwift - FUSION WINTER CUP (A),Sram Dzero,Wahoo Kickr v5,357,356,1
119669,1614104087,wahoo,Zwift - Zwift Racing League | WTRL - Men&#039;s/Mixed EMEA E1 DIVISION 1 (A),Sram Dzero,Wahoo Kickr v5,389,388,1
120370,1614192330,wahoo,Zwift - Scandinavian Cup 2021 - Round 1 - Men (A),Sram Dzero,Wahoo Kickr v5,355,358,-3
120840,1614277793,wahoo,Zwift - FUSION WINTER CUP (A),Sram Dzero,Wahoo Kickr v5,410,413,-3
123683,1614797087,wahoo,Zwift - Scandinavian Cup 2021 - Round 2 - Men (A),Sram Dzero,Wahoo Kickr v5,372,379,-7
124653,1614971093,wahoo,Zwift - Zwift Racing League | WTRL Battle Royale Playoff - Men&#039;s Points Race (A),Sram Dzero,Wahoo Kickr v5,386,397,-11
125232,1615060598,wahoo,Zwift - Zwift Racing League | WTRL Battle Royale Playoff - Men&#039;s TTT (A),Sram Dzero,Wahoo Kickr v5,399,400,-1
127577,1615401890,wahoo,Zwift - Scandinavian Cup 2021 - Round 3 - Men (A),Sram Dzero,Wahoo Kickr v5,368,380,-12
129258,1615919380,wahoo,Zwift - CeramicSpeed Race Series: Open Race (A),Sram Dzero,Wahoo Kickr v5,416,424,-8
100498,1611164964,wahoo,Zwift - Danmarks Cykle Union & Partners 2/6 (A),Giant Power Pro Ultegra 2020,Wahoo Kickr v5,477,457,20
104182,1611770109,wahoo,Zwift - Danmarks Cykle Union & Partners 3/6 (A),Giant Power Pro Ultegra 2020,Wahoo Kickr v5,492,473,19
107098,1612254133,wahoo,Zwift - DBR Morning Race (A) #1 ,Giant Power Pro Ultegra 2020,Wahoo Kickr v5,431,432,-1
107156,1612259392,wahoo,Zwift - Japan Zwift Tuesday Race (A),Giant Power Pro Ultegra 2020,Wahoo Kickr v5,476,437,39
108202,1612377189,wahoo,4. plads - endelig et fladt race,Giant Power Pro Ultegra 2020,Wahoo Kickr v5,0,0,0
108203,1612377189,wahoo,4. plads - endelig et fladt race,Giant Power Pro Ultegra 2020,Wahoo Kickr v5,478,453,25
112286,1612981126,wahoo,Zwift - Danmarks Cykle Union & Partners 5/6 (A),Giant Power Pro Ultegra 2020,Wahoo Kickr v5,478,471,7
116664,1613586350,wahoo,Zwift - Danmarks Cykle Union & Partners 6/6 (A),Giant Power Pro Ultegra 2020,Wahoo Kickr v5,441,424,17
118131,1613816434,wahoo,Zwift - 02/20/2021,Giant Power Pro Ultegra 2020,Wahoo Kickr v5,432,386,46
118151,1613816434,wahoo,Missing last 3 km ??,Giant Power Pro Ultegra 2020,Wahoo Kickr v5,432,386,46
120233,1614184811,wahoo,Zwift - Guayaba Race by PETA-Z (A),Giant Power Pro Ultegra 2020,Wahoo Kickr v5,465,453,12
120320,1614192204,wahoo,Zwift - Scandinavian Cup 2021 - Round 1 - Men (A),Giant Power Pro Ultegra 2020,Wahoo Kickr v5,438,433,5
120814,1614276479,wahoo,Zwift - FUSION WINTER CUP (A),Giant Power Pro Ultegra 2020,Wahoo Kickr v5,499,488,11
123594,1614797098,wahoo,Zwift - Scandinavian Cup 2021 - Round 2 - Men (A),Giant Power Pro Ultegra 2020,Wahoo Kickr v5,448,440,8
126603,1615401851,wahoo,Zwift - Scandinavian Cup 2021 - Round 3 - Men (A),Giant Power Pro Ultegra 2020,Wahoo Kickr v5,451,437,14
127972,1615647312,wahoo,Zwift - OH MY CRIT!! - Saturday Smash Race (A),Giant Power Pro Ultegra 2020,Wahoo Kickr v5,512,501,11
28683,1588072222,wahoo,Zwift - Crit City Slam Race // Zwift Classic (A),garmin vector 3,Wahoo kickr (zwift),407,394,13
30960,1588515020,wahoo,Garmin vector 3 / Wahoo kickr,Garmin vector 3,Wahoo kickr,0,0,0
31582,1588685032,wahoo,Zwift - Crit City Race (A),Garmin vector 3,Wahoo kickr,408,418,-10
48286,1596107390,wahoo,Zwift - EMU Japan Short Race (A),Stages,Wahoo kickr,409,413,-4
51400,1598202800,wahoo,Zwift - 3R Greater London 8 Hilly Race - 1 Lap (23.8km/14.8mi 238m) (A),Stages,Wahoo kickr,435,436,-1
99036,1610992356,wahoo,Zwift -  DBR Monday Race (A),Stages,Wahoo kickr,380,406,-26
119076,1614016514,wahoo,Zwift -  DBR Monday Race (A),power2max,Wahoo kickr,380,390,-10
126925,1615459098,wahoo,Zwift - KISS Race Series - Americas AM (A),power2max,Wahoo kickr,391,405,-14
127932,1615639495,wahoo,Zwift - WTRL Racing (A),power2max,Wahoo kickr,429,446,-17
50382,1597657801,neo,Zwift - Off the MAAP Invitational Race // Stage 2 (Men) (A),Garmin Vector 3 - Garmin Edge 820,Tacx Neo 2T - Zwift,437,423,14
50877,1597913396,neo,Zwift - Off the MAAP Invitational Race // Stage 3 (men) ,Garmin Vector 3 - Garmin 820 Edge,Tacx Neo 2T - Zwift,424,406,18
55211,1600106390,wahoo,Zwift - Invitational League // Qualifying Race #1,Garmin Vector 3 - Garmin 820 Edge,Wahoo Kickr 5 - Zwift,373,378,-5
56582,1600606791,wahoo,Zwift - Invitational League // Qualifying Race #3 (Men) (A),Garmin Vector 3 - Garmin 820 Edge,Wahoo Kickr 5 - Zwift,428,420,8
58639,1601491499,wahoo,ZADA - Three Sisters Test,Garmin Vector 3 - Garmin 820 Edge,Wahoo Kickr 5 - Zwift,449,454,-5
62313,1602785697,wahoo,Zwift - Pre Event Ride // Swedish Cycling Federation,Garmin Vector 3 - Garmin 820 Edge,Wahoo Kickr 5 - Zwift,366,366,0
63163,1603131617,wahoo,Zwift - Premier Division // Zwift Racing League (men) ,Garmin Vector 3 - Garmin Edge 820,Wahoo Kickr 5 - Zwift,422,416,6
67392,1604344542,wahoo,Zwift - Premier Division // Zwift Racing League (men) (A),Garmin Vector 3 - Garmin Edge 820,Wahoo Kickr 5 - Zwift,398,393,5
69519,1604951989,wahoo,Zwift - Premier Division // Zwift Racing League (men) (A),Garmin Vector 3 - Garmin Edge 820,Wahoo Kickr 5 - Zwift,435,436,-1
72392,1605553642,wahoo,Zwift - Premier Division // Zwift Racing League (men) (A),Garmin Vector 3 - Garmin Edge 820,Wahoo Kickr 5 - Zwift,407,404,3
73263,1605814191,neo,Zwift - 11/19/2020,Garmin Vector 3 - Garmin Edge 820,Tacx Neo 2T - Zwift,361,355,6
73995,1605886196,neo,Zwift - BST Mountaingoat Race (A),Garmin Vector 3 - Garmin Edge 820,Tacx Neo 2T - Zwift,428,433,-5
74755,1606161591,wahoo,Zwift - Premier Division // Zwift Racing League (men) (A),Garmin Vector 3 - Garmin Edge 820,Wahoo Kickr 5 - Zwift,443,438,5
76558,1606420071,wahoo,Zwift - WTRL NOPINZ WORLD TTT CHAMPIONSHIPS - Zone 10 (C),Garmin Vector 3 - Garmin Edge 820,Wahoo Kickr 5 - Zwift,396,399,-3
77805,1606763542,wahoo,Zwift - Premier Division // Zwift Racing League (men) (A),Garmin Vector 3 - Garmin Edge 820,Wahoo Kickr 5 - Zwift,431,431,0
80515,1607285695,neo,Zwift - 3R Greater London Flat Race - 3 Laps (40.2km/25mi 135m) (A),Garmin Vector 3 - Garmin Edge 820,Tacx Neo 2T - Zwift,354,353,1
95192,1610392487,wahoo,Zwift - Premier Division // Zwift Racing League (men) (A),Garmin Vector 3 - Garmin Edge 820,Wahoo Kickr 5 - Zwift,363,368,-5
97187,1610653855,wahoo,Zwift - WTRL Team Time Trial - Zone 9 (C),Garmin Vector 3 - Garmin Edge 820,Wahoo Kickr 5 - Zwift,417,412,5
99329,1610999476,wahoo,Zwift - Premier Division // Zwift Racing League (men) (A),Garmin Vector 3 - Garmin Edge 820,Wahoo Kickr 5 - Zwift,424,423,1
101117,1611258472,wahoo,Zwift - WTRL Team Time Trial - Zone 9 (C),Garmin Vector 3 - Garmin Edge 820,Wahoo Kickr 5 - Zwift,416,415,1
103089,1611601490,wahoo,Zwift - Premier Division // Zwift Racing League (men) (A),Garmin Vector 3 - Garmin Edge 820,Wahoo Kickr 5 - Zwift,449,444,5
106988,1612210011,wahoo,Zwift - Premier Division // Zwift Racing League (men) (A),Garmin Vector 3 - Garmin Edge 820,Wahoo Kickr 5 - Zwift,381,389,-8
109077,1612467833,wahoo,Zwift - WTRL Team Time Trial - Zone 9 (C),Garmin Vector 3 - Garmin Edge 820,Wahoo Kickr 5 - Zwift,401,409,-8
109511,1612538996,wahoo,Zwift - BST Mountaingoat Race (A),Garmin Vector 3 - Garmin Edge 820,Wahoo Kickr 5 - Zwift,430,430,0
111215,1612811900,wahoo,Zwift - Premier Division // Zwift Racing League (men) (A),Garmin Vector 3 - Garmin Edge 820,Wahoo Kickr 5 - Zwift,427,427,0
112506,1612983594,wahoo,Zwift - Movistar Team Challenge // Round 1 (A),Garmin Vector 3 - Garmin Edge 820,Wahoo Kickr 5 - Zwift,369,356,13
113721,1613156389,wahoo,Zwift - Movistar Team Challenge // Round 1 (men),Garmin Vector 3 - Garmin Edge 820,Wahoo Kickr 5 - Zwift,460,455,5
115475,1613419313,wahoo,Zwift - Premier Division // Zwift Racing League (men) (A),Garmin Vector 3 - Garmin Edge 820,Wahoo Kickr 5 - Zwift,435,429,6
116880,1613588394,wahoo,Zwift - Movistar Team Challenge // Round 2 (men) - Race 3/4,Garmin Vector 3 - Garmin Edge 820,Wahoo Kickr 5 - Zwift,370,367,3
117942,1613761194,wahoo,Zwift - Movistar Team Challenge // Round 2 (men),Garmin Vector 3 - Garmin Edge 820,Wahoo Kickr 5 - Zwift,444,441,3
119306,1614020991,wahoo,Zwift - Premier Division // Zwift Racing League (men) (A),Garmin Vector 3 - Garmin Edge 820,Wahoo Kickr 5 - Zwift,365,369,-4
122679,1614629747,wahoo,Zwift - Premier Division // Zwift Racing League (men) (A),Garmin Vector 3 - Garmin Edge 820,Wahoo Kickr 5 - Zwift,422,410,12
124234,1614886797,wahoo,Zwift - Movistar Team Challenge // Points Race (men),Garmin Vector 3 - Garmin Edge 820,Wahoo Kickr 5 - Zwift,367,368,-1
124235,1614884399,wahoo,Zwift - Ramp Test,Garmin Vector 3 - Garmin Edge 820,Wahoo Kickr 5 - Zwift,449,449,0
126751,1615401891,wahoo,Zwift - Scandinavian Cup 2021 - Round 3 - Men (A),Garmin Vector 3 - Garmin Edge 820,Wahoo Kickr 5 - Zwift,417,412,5
128942,1615834804,wahoo,Zwift -  SCF SWE Cup Men (A),Garmin Vector 3 - Garmin Edge 820,Wahoo Kickr 5 - Zwift,377,393,-16
129394,1615921373,wahoo,Zwift - 3R Omnium Event - Race 2 - iTT (E),Garmin Vector 3 - Garmin Edge 820,Wahoo Kickr 5 - Zwift,446,442,4
48885,1596620694,wahoo,Zwift - USA Cycling Race League by Indoor Specialist (A),Garmin Vector 3&#039;s,Wahoo Kickr 14&#039;,442,458,-16
50699,1597830194,wahoo,Zwift - USA Cycling Race League by Indoor Specialist (A),Garmin Vector 3 (Dual),Wahoo Kickr 14&#039;,439,453,-14
50949,1597943326,wahoo,Zwift -  Espresso,Garmin Vector 3 (Dual),Wahoo Kickr 14&#039;,429,435,-6
51111,1598029496,wahoo,Zwift - Team WEZ Friday Race (A),Garmin Vector 3 (Dual),Wahoo Kickr 14&#039;,443,441,2
51362,1598193296,wahoo,Zwift - 3R Alpe Du Zwift KOM Race (20km 1444m) (A),Garmin Vector 3 (Dual),Wahoo Kickr 14&#039;,468,473,-5
51640,1598349595,wahoo,Zwift - Off The MAAP Stage 4 Race (A),Garmin Vector 3 (Dual),Wahoo Kickr 14&#039;,442,458,-16
51957,1598435110,wahoo,Zwift - USA Cycling Race League by Indoor Specialist (A),Garmin Vector 3 (Dual),Wahoo Kickr 14&#039;,446,434,12
52188,1598548918,wahoo,WTRL Team Time Trial PREMIER LEAGUE,Garmin Vector 3 (Dual),Wahoo Kickr 14&#039;,439,463,-24
52481,1598699394,wahoo,Zwift - DIRT Dadurday Chase Race  (A),Garmin Vector 3 (Dual),Wahoo Kickr 14&#039;,394,401,-7
52608,1598778293,wahoo,Zwift - Newbury Velo Road Race,Garmin Vector 3 (Dual),Wahoo Kickr 14&#039;,445,455,-10
52868,1598955723,wahoo,ZADA 3 Sisters Test 9.1.20,Garmin Vector 3 (Dual),Wahoo Kickr 14&#039;,444,454,-10
53021,1599040792,wahoo,Zwift - EVR Definitely Not the WTNC (A),Garmin Vector 3 (Dual),Wahoo Kickr 14&#039;,421,428,-7
54090,1599644699,wahoo,Zwift - USA Cycling Race League by Indoor Specialist,Garmin Vector 3 (Dual),Wahoo Kickr 14&#039;,396,416,-20
54397,1599758583,wahoo,Zwift - WTRL TTT ,Garmin Vector 3 (Dual),Wahoo Kickr 14&#039;,447,459,-12
54610,1599843906,wahoo,Zwift - Team WEZ Friday Race,Garmin Vector 3 (Dual),Wahoo Kickr 14&#039;,419,442,-23
54864,1600002899,wahoo,Zwift - KISS at Race 100 - America,Garmin Vector 3 (Dual),Wahoo Kickr 14&#039;,468,477,-9
55311,1600164522,wahoo,Zwift - Watopia,Garmin Vector 3 (Dual),Wahoo Kickr 14&#039;,283,288,-5
55974,1600367349,wahoo,Zwift - Invitational League // Qualifying Race #2 (Men) ,Garmin Vector 3 (Dual),Wahoo Kickr 14&#039;,402,406,-4
56166,1600448684,wahoo,Zwift - Team WEZ Friday Race (A),Garmin Vector 3 (Dual),Wahoo Kickr 14&#039;,464,480,-16
56403,1600606737,wahoo,Zwift - Invitational League // Qualifying Race #3 (Men) (A),Garmin Vector 3 (Dual),Wahoo Kickr 14&#039;,446,465,-19
56787,1600769120,wahoo,New KICKR accuracy test,Garmin Vector 3,Wahoo KICKR v5,420,425,-5
57276,1600968418,wahoo,Zwift - Espresso,Garmin Vector 3,Wahoo KICKR v5,436,442,-6
57560,1601059417,wahoo,ZADA 3 Sisters Test 9.25.20,Garmin Vector 3,Wahoo KICKR v5,439,450,-11
58011,1601129700,wahoo,Bike MS - #BikeMSInsideOut,Garmin Vector 3,Wahoo KICKR v5,386,395,-9
58431,1601459093,wahoo,Zwift - USA Cycling Race League by Indoor Specialist (A),Garmin Vector 3,Wahoo KICKR v5,430,437,-7
59102,1601662191,wahoo,3R Lutscher CCW Climbing Race,Garmin Vector 3,Wahoo KICKR v5,415,436,-21
59260,1601734500,wahoo,Zwift - OH MY CRIT - Saturday Smash Race (A),Garmin Vector 3,Wahoo KICKR v5,461,480,-19
59376,1601806182,wahoo,Zwift - 3R Sand & Sequoias - 1 Lap (20km/12.5mi 173m) (A),Garmin Vector 3,Wahoo KICKR v5,409,421,-12
59754,1601978375,wahoo,Zwift - KISS at Race - Americas AM (A),Garmin Vector 3,Wahoo KICKR v5,410,424,-14
60261,1602153292,wahoo,Zwift - Japan ZWIFT Hill Climb Race (A),Garmin Vector 3,Wahoo KICKR v5,431,430,1
60549,1602239164,wahoo,Zwift - Watopia,Garmin Vector 3,Wahoo KICKR v5,282,278,4
60761,1602326603,wahoo,Zwift - Into the Red by RELENTLESS,Garmin Vector 3,Wahoo KICKR v5,487,468,19
60993,1602422067,wahoo,Zwift - KISS at Race 100 - Americas (A),Garmin Vector 3,Wahoo KICKR v5,411,411,0
61785,1602669887,wahoo,Zwift - 3R Road To Ruins Hilly Race - 1 Lap (29..2km/18.1mi 275m) (A),Garmin Vector 3,Wahoo KICKR v5,439,440,-1
63319,1603183914,wahoo,Zwift - Zwift Racing League | WTRL - APAC (MEN) - TTT (B),Garmin Vector 3,Wahoo KICKR v5,421,410,11
63742,1603274596,wahoo,Zwift - Richmond,Garmin Vector 3,Wahoo KICKR v5,291,287,4
64090,1603360778,wahoo,Zwift - KISS at Race - Americas AM (A),Garmin Vector 3,Wahoo KICKR v5,420,419,1
64594,1603536270,wahoo,Zwift - Into the Red by RELENTLESS (A),Garmin Vector 3,Wahoo KICKR v5,427,425,2
65003,1603706399,wahoo,Zwift - Brian Duffy Jr  (RELENTLESS)&#039;s Meetup - 2015 UCI Worlds Course,Garmin Vector 3,Wahoo KICKR v5,323,321,2
65322,1603788231,wahoo,Zwift - Zwift Racing League | WTRL - APAC (MEN) -  Division 1 (A),Garmin Vector 3,Wahoo KICKR v5,450,450,0
65998,1603965589,wahoo,Zwift - KISS at Race - Americas AM (A),Garmin Vector 3,Wahoo KICKR v5,460,456,4
66630,1604141081,wahoo,Zwift - Into the Red by RELENTLESS (A),Garmin Vector 3,Wahoo KICKR v5,447,437,10
67482,1604394251,wahoo,Zwift - Zwift Racing League | WTRL - Men&#039;s APAC DIVISION 1 (A),Garmin Vector 3,Wahoo KICKR v5,434,431,3
67866,1604486719,wahoo,USA Cycling Race League by STPC,Garmin Vector 3,Wahoo KICKR v5,445,441,4
68594,1604689232,wahoo,Zwift -  Tour De Spartacus,Garmin Vector 3,Wahoo KICKR v5,461,464,-3
68869,1604775784,wahoo,Zwift -  Tour De Spartacus,Garmin Vector 3,Wahoo KICKR v5,421,412,9
69133,1604862211,wahoo,Zwift -  Tour De Spartacus,Garmin Vector 3,Wahoo KICKR v5,484,479,5
69591,1604997777,wahoo,Zwift - Zwift Racing League | WTRL - APAC (MEN) -  Division 1 (A),Garmin Vector 3,Wahoo KICKR v5,470,463,7
70536,1605178777,wahoo,Zwift - KISS at Race - Americas AM (A),Garmin Vector 3,Wahoo KICKR v5,442,450,-8
71048,1605265135,wahoo,Zwift - Adam Otstot (RELENTLESS)&#039;s Meetup,Garmin Vector 3,Wahoo KICKR v5,255,258,-3
71303,1605350668,wahoo,Zwift - Into the Red by RELENTLESS (A),Garmin Vector 3,Wahoo KICKR v5,471,469,2
72052,1605603168,wahoo,Zwift - Zwift Racing League | WTRL - Men&#039;s APAC DIVISION 1 (A),Garmin Vector 3,Wahoo KICKR v5,424,414,10
72895,1605783595,wahoo,Zwift - KISS Race Series - Americas AM (A),Garmin Vector 3,Wahoo KICKR v5,395,382,13
74848,1606207484,wahoo,Zwift - Zwift Racing League | WTRL - Men&#039;s APAC DIVISION 1,Garmin Vector 3,Wahoo KICKR v5,460,452,8
75623,1606330784,wahoo,Zwift - DCU – Feltet.dk November series (A),Garmin Vector 3,Wahoo KICKR v5,399,410,-11
75851,1606388366,wahoo,Zwift - KISS Race Series - Americas AM (A),Garmin Vector 3,Wahoo KICKR v5,443,450,-7
76843,1606560269,wahoo,Zwift - Into the Red by RELENTLESS (A),Garmin Vector 3,Wahoo KICKR v5,453,451,2
77543,1606732243,wahoo,Zwift - Balazs Galambos [RELENTLESS]&#039;s Meetup - Tick Tock,Garmin Vector 3,Wahoo KICKR v5,363,359,4
77892,1606812720,wahoo,Zwift - Zwift Racing League | WTRL - Men&#039;s APAC DIVISION 1 (A),Garmin Vector 3,Wahoo KICKR v5,425,414,11
78842,1606993168,wahoo,Zwift - KISS Race Series - Americas AM (A),Garmin Vector 3,Wahoo KICKR v5,416,414,2
79815,1607181257,wahoo,Zwift - OH MY CRIT - Saturday Smash Race (A),Garmin Vector 3,Wahoo KICKR v5,413,417,-4
81277,1607474636,wahoo,Zwift - Zwift Racing League | WTRL - Men&#039;s AMERICAS E DIVISION 1 (A),Garmin Vector 3,Wahoo KICKR v5,423,426,-3
81890,1607685535,wahoo,Zwift - 3R LaGuardia Loop Reverse Flat Race - 8 Laps (24.5km/15.2mi 216m) (A),Garmin Vector 3,Wahoo KICKR v5,401,399,2
82281,1607771639,wahoo,Zwift - 3R Tick Tock Flat Race - 2 Lap (36km/22.4mi 100m) (A),Garmin Vector 3,Wahoo KICKR v5,404,401,3
83387,1608029985,wahoo,Zwift - KISS Race Series - Americas AM (A),Garmin Vector 3,Wahoo KICKR v5,458,472,-14
83753,1608079887,wahoo,Zwift - Zwift Racing League | WTRL - Men&#039;s AMERICAS E DIVISION 1 (A),Garmin Vector 3,Wahoo KICKR v5,398,403,-5
84225,1608202762,wahoo,Zwift - KISS Race Series - Americas AM (A),Garmin Vector 3,Wahoo KICKR v5,465,466,-1
86027,1608634780,wahoo,Zwift - KISS Race Series - Americas AM (A),Garmin Vector 3,Wahoo KICKR v5,435,445,-10
86434,1608720261,wahoo,Zwift - USA Cycling Race League by Indoor Specialist (A),Garmin Vector 3,Wahoo KICKR v5,452,453,-1
86895,1608812391,wahoo,Zwift - British Cycling Time Trial Series (A),Garmin Vector 3,Wahoo KICKR v5,461,460,1
88479,1609239581,wahoo,Zwift - KISS Race Series - Americas AM (A),Garmin Vector 3,Wahoo KICKR v5,411,406,5
89508,1609431275,wahoo,Zwift - OH MY CRIT! - The Double Race 1/2 (A),Garmin Vector 3,Wahoo KICKR v5,393,395,-2
89545,1609434232,wahoo,Zwift - OH MY CRIT! - The Double Race 2/2 (A),Garmin Vector 3,Wahoo KICKR v5,421,420,1
90266,1609600479,wahoo,Zwift - OH MY CRIT - Saturday Smash Race (A),Garmin Vector 3,Wahoo KICKR v5,412,420,-8
95969,1610498693,wahoo,Zwift - Zwift Racing League | WTRL - Men&#039;s/Mixed AMERICAS E DIVISION 1 (A),Garmin Vector 3,Wahoo KICKR v5,411,404,7
96761,1610621977,wahoo,Zwift - KISS Race Series - Americas AM (A),Garmin Vector 3,Wahoo KICKR v5,373,368,5
99983,1611104058,wahoo,Zwift - Zwift Racing League | WTRL - Men&#039;s/Mixed AMERICAS E DIVISION 1 (A),Garmin Vector 3,Wahoo KICKR v5,422,416,6
100708,1611226785,wahoo,Zwift - KISS Race Series - Americas AM (A),Garmin Vector 3,Wahoo KICKR v5,411,407,4
104477,1611831567,wahoo,Zwift - KISS Race Series - Americas AM (A),Garmin Vector 3,Wahoo KICKR v5,403,399,4
105501,1612004377,wahoo,Zwift - TDZ Stage 6: Longer Ride,Garmin Vector 3,Wahoo KICKR v5,391,391,0
106086,1612091077,wahoo,Zwift - 3R Innsbruckring Sprint Race - 1 Lap (8.8km/5.5mi 77m) (A),Garmin Vector 3,Wahoo KICKR v5,411,406,5
106102,1612093478,wahoo,Zwift - Crit City Race (A),Garmin Vector 3,Wahoo KICKR v5,392,391,1
107158,1612263603,wahoo,Zwift - KISS Race Series - Americas AM (A),Garmin Vector 3,Wahoo KICKR v5,435,440,-5
108484,1612396767,wahoo,Zwift - Open - Movistar Team Challenge Community Qualifier Race #2,Garmin Vector 3,Wahoo KICKR v5,441,448,-7
109748,1612609162,wahoo,Zwift - TDZ Stage 7: Longer Ride,Garmin Vector 3,Wahoo KICKR v5,436,439,-3
110335,1612698267,wahoo,Crit City Race,Garmin Vector 3,Wahoo KICKR v5,397,408,-11
111871,1612917997,wahoo,Zwift - Zwift Racing League | WTRL - Men&#039;s/Mixed AMERICAS E DIVISION 1 (A),Garmin Vector 3,Wahoo KICKR v5,445,459,-14
112339,1612983283,wahoo,Movistar Team Challenge // Round 1,Garmin Vector 3,Wahoo KICKR v5,405,412,-7
113598,1613155449,wahoo,Zwift - Movistar Team Challenge // Round 1 (men),Garmin Vector 3,Wahoo KICKR v5,454,478,-24
113987,1613216628,wahoo,Zwift - TDZ Stage 8: Group Ride,Garmin Vector 3,Wahoo KICKR v5,353,361,-8
114546,1613297099,wahoo,Zwift - TDZ Stage 1: Longer Ride,Garmin Vector 3,Wahoo KICKR v5,285,288,-3
116200,1613522414,wahoo,Zwift - Zwift Racing League | WTRL - Men&#039;s/Mixed AMERICAS E DIVISION 1 (A),Garmin Vector 3,Wahoo KICKR v5,474,492,-18
116700,1613587712,wahoo,Movistar Team Challenge // Round 2 - Race 3/4,Garmin Vector 3,Wahoo KICKR v5,417,425,-8
117869,1613760151,wahoo,Movistar Team Challenge // Round 2,Garmin Vector 3,Wahoo KICKR v5,465,482,-17
120640,1614252616,wahoo,Zwift - EMU Japan Short Race (A),Garmin Vector 3,Wahoo KICKR v5,413,420,-7
121550,1614423419,wahoo,Zwift - Haute Route Watopia 2021 Stage 2 (A),Garmin Vector 3,Wahoo KICKR v5,455,463,-8
123241,1614732038,wahoo,Zwift - Zwift Racing League | WTRL - Men&#039;s/Mixed AMERICAS E DIVISION 1 (A),Garmin Vector 3,Wahoo KICKR v5,384,387,-3
124122,1614886520,wahoo,Zwift - Movistar Team Challenge // Points Race (men),Garmin Vector 3,Wahoo KICKR v5,455,458,-3
124127,1614884112,wahoo,Zwift - Ramp Test,Garmin Vector 3,Wahoo KICKR v5,494,515,-21
124587,1614970589,wahoo,Zwift - Zwift Racing League | WTRL Battle Royale Playoff - Men&#039;s Points Race (A),Garmin Vector 3,Wahoo KICKR v5,447,458,-11
125167,1615059702,wahoo,Zwift - Zwift Racing League | WTRL Battle Royale Playoff - Men&#039;s TTT (A),Garmin Vector 3,Wahoo KICKR v5,449,461,-12
126880,1615460150,wahoo,Zwift - KISS Race Series - Americas AM (A),Garmin Vector 3,Wahoo KICKR v5,460,463,-3
128979,1615888772,wahoo,Zwift - KISS Race Series - Americas AM (A),Garmin Vector 3,Wahoo KICKR v5,444,431,13
57257,1600968597,wahoo,Zwift - British Cycling Time Trial Series (A),Cycleops Hammer,Favero Assioma Uno from Wahoo ELEMNT,411,409,2
57407,1601014193,wahoo,Zwift - 3R Volcano Circuit Flat Race - 4 Laps (18.9km/11.7mi 80m) (A),Cycleops Hammer,Favero Assioma Uno from Wahoo ELEMNT,363,335,28
57408,1601017566,wahoo,Zwift - 3R Innsbruckring Race - 33.2km (A),Cycleops Hammer,Favero Assioma Uno from Wahoo ELEMNT,364,348,16
57917,1601209535,wahoo,Zwift - 3 sisters,Cycleops Hammer,Favero Assioma Uno from Wahoo ELEMNT,393,386,7
61339,1602528600,wahoo,Zwift - Premier Division // Zwift Racing League (men) ,Cycleops Hammer,Favero Assioma Uno from Wahoo ELEMNT,422,405,17
63209,1603131300,wahoo,Zwift - Premier Division // Zwift Racing League (men) ,Cycleops Hammer,Favero Assioma Uno from Wahoo ELEMNT,403,382,21
65162,1603742395,wahoo,Zwift - Premier Division // Zwift Racing League (men) (A),Cycleops Hammer,Favero Assioma Uno from Wahoo ELEMNT,410,397,13
77668,1606763310,wahoo,Zwift - Premier Division // Zwift Racing League (men) (A),Cycleops Hammer,Favero Assioma Uno from Wahoo ELEMNT,390,400,-10
99267,1610999697,wahoo,Zwift - Premier Division // Zwift Racing League (men) (A),Cycleops Hammer,Favero Assioma Uno from Wahoo ELEMNT,423,398,25
33219,1589014178,wahoo,Zwift - CIZL Rd 7 – Sean Lynch Memorial (A),Rotor 2inpower,Wahoo Kickr,437,451,-14
33680,1589216164,wahoo,Zwift - DBR Wahoo League (A),Rotor 2inpower,Wahoo Kickr,400,424,-24
33827,1589274616,wahoo,Zwift - SRAM Send it Series - Race 1 - Men&#039;s (E),Rotor 2inpower,Wahoo Kickr,420,439,-19
34254,1589359906,wahoo,Zwift - AHDR p/b Giant (B),Rotor 2inpower,Wahoo Kickr,464,481,-17
36001,1589879359,wahoo,Zwift - SRAM Send it Series - Race 2 - Men&#039;s (E),Rotor 2inpower,Wahoo Kickr,429,440,-11
38252,1590657173,wahoo,Zwift - Cycling Australia&#039;s The Chop by AHDR (A),Rotor 2inpower,Wahoo Kickr,370,384,-14
38575,1590774682,wahoo,Zwift - TeamPTz Friday&#039;s Race League (A),Rotor 2inpower,Wahoo Kickr,430,429,1
38958,1591031473,wahoo,Zwift - DBR Wahoo League (A) - 3rd,Rotor 2inpower,Wahoo Kickr,385,394,-9
39056,1591088919,wahoo,Zwift - SRAM Send it Series - Race 4 - Men&#039;s (E) - 11th,Rotor 2inpower,Wahoo Kickr,437,445,-8
39270,1591176938,wahoo,Zwift - USA Cycling Race League by Indoor Specialist (A) 1st,Rotor 2inpower,Wahoo Kickr,361,381,-20
39372,1591206800,wahoo,Zwift - USA Cycling Race League by Indoor Specialist (A) evening edition - 14th,Rotor 2inpower,Wahoo Kickr,398,408,-10
39905,1591379359,wahoo,Zwift - TeamPTz Friday&#039;s Race League (A) - 7th,Rotor 2inpower,Wahoo Kickr,417,423,-6
40473,1591693349,wahoo,Zwift - SRAM Send it Series - Race 5 - Men&#039;s (E),Rotor 2inpower,Wahoo Kickr,419,425,-6
40716,1591782051,wahoo,Zwift - USA Cycling Race League by Indoor Specialist (A) - 1st,Rotor 2inpower,Wahoo Kickr,427,432,-5
41026,1591887857,wahoo,Zwift - OH CRIT!! - Lockdown Series - Round 2 Race 1 (A),Rotor 2inpower,Wahoo Kickr,426,449,-23
41291,1591984228,wahoo,Zwift - TeamPTz Friday&#039;s Race League (A) - 4th,Rotor 2inpower,Wahoo Kickr,414,426,-12
41914,1592298328,wahoo,Zwift - SRAM Send it Series - Race 6 - Men&#039;s (E) - 8th,Rotor 2inpower,Wahoo Kickr,400,428,-28
42193,1592409592,wahoo,Zwift - SSAT Ace Cycles Virtual Racing Series (A) - 4th,Rotor 2inpower,Wahoo Kickr,402,415,-13
43207,1592902999,wahoo,Zwift - SRAM Send it Series - Race 7 - Men&#039;s (E),Rotor 2inpower,Wahoo Kickr,454,459,-5
43346,1592991760,wahoo,Zwift - USA Cycling Race League by Indoor Specialist (A) - 1st,Rotor 2inpower,Wahoo Kickr,470,480,-10
43383,1593017496,wahoo,Zwift - FutureWorks Boost Mode Test Race (A) - 2nd,Rotor 2inpower,Wahoo Kickr,398,408,-10
43719,1593193878,wahoo,Zwift - TeamPTz Friday&#039;s Race League (A),Rotor 2inpower,Wahoo Kickr,381,391,-10
43962,1593351975,wahoo,Zwift - Support SA Talent Virtual Racing Series(A) aka Knysna Cycle Tour - 2nd,Rotor 2inpower,Wahoo Kickr,411,422,-11
44199,1593507935,wahoo,Zwift - SRAM Send it Series - Race 8 - Men&#039;s (E) - 12th,Rotor 2inpower,Wahoo Kickr,430,432,-2
44432,1593625658,wahoo,Zwift - USA Cycling Race League by Indoor Specialist (A),Rotor 2inpower,Wahoo Kickr,434,452,-18
45144,1594059332,wahoo,Zwift - TFC Mad Monday Summer Series (1 of 9) (A),Rotor 2inpower,Wahoo Kickr,402,419,-17
45465,1594230336,wahoo,Zwift - USA Cycling Race League by Indoor Specialist (A),Rotor 2inpower,Wahoo Kickr,399,408,-9
45808,1594403815,wahoo,Zwift - World Elite Zwifters Friday&#039;s Race (A),Rotor 2inpower,Wahoo Kickr,421,417,4
46478,1594835421,wahoo,Zwift - USA Cycling Race League by Indoor Specialist (A),Rotor 2inpower,Wahoo Kickr,407,403,4
47191,1595355882,wahoo,Zwift - 3R Turbocharged Team Race Series - Round 2 (A),Rotor 2inpower,Wahoo Kickr,374,376,-2
47333,1595440268,wahoo,Zwift - USA Cycling Race League by Indoor Specialist (A),Rotor 2inpower,Wahoo Kickr,392,394,-2
49828,1597331502,wahoo,Zwift - OH MY CRIT! - The Double Race 1/2 (A),Rotor 2inpower,Wahoo Kickr,380,386,-6
49927,1597395014,wahoo,Zwift - Off the MAAP Invitational Race // Stage 1 (Men) (A) - 19th,Rotor 2inpower,Wahoo Kickr,393,405,-12
50847,1597912614,wahoo,Zwift - Off the MAAP Invitational Race // Stage 3 (men) ,Rotor 2inpower,Wahoo Kickr,401,407,-6
51466,1598260912,wahoo,Zwift - Off the MAAP Invitational Race // Stage 4 (men) ,Rotor 2inpower,Wahoo Kickr,385,390,-5
51669,1598367393,wahoo,Zwift - 3R Turbocharged Team Race Series - Bonus Round (A),Rotor 2inpower,Wahoo Kickr,390,404,-14
52772,1598897228,wahoo,Zwift - TFC Mad Monday Summer Series (9 of 10) (A),Rotor 2inpower,Wahoo Kickr,384,398,-14
52939,1598985107,wahoo,Zwift - 3R Sundown Race Series - Round1 iTT,Rotor 2inpower,Wahoo Kickr,378,395,-17
53774,1599502134,wahoo,Zwift - 09/07/2020,Rotor 2inpower,Wahoo Kickr,320,330,-10
54002,1599589931,wahoo,Zwift - 3R Sundown Race Series  (E),Rotor 2inpower,Wahoo Kickr,393,400,-7
54177,1599673814,wahoo,Zwift - DBR Wednesday Race (A),Rotor 2inpower,Wahoo Kickr,400,415,-15
55099,1600105090,wahoo,Zwift - Invitational League // Qualifying Race #1,Rotor 2inpower,Wahoo Kickr,381,388,-7
55947,1600365773,wahoo,Zwift - Invitational League // Qualifying Race #2 (Men) ,Rotor 2inpower,Wahoo Kickr,370,388,-18
57250,1600963440,wahoo,Zwift - OH MY CRIT! - The Double Race 2/2 (A),Rotor 2inpower,Wahoo Kickr,363,381,-18
62489,1602871519,wahoo,Zwift Academy Road: Workout 1 | Aerobic Power,Rotor 2inpower,Wahoo Kickr,353,353,0
63429,1603214382,wahoo,Zwift - WTRL Racing (A),Rotor 2inpower,Wahoo Kickr,424,435,-11
65185,1603740998,wahoo,Zwift - Premier Division // Zwift Racing League (men) (A),Rotor 2inpower,Wahoo Kickr,389,404,-15
66426,1604064716,wahoo,Zwift Academy Tri: Bike Workout 1 | Endurance Strength Development,Rotor 2inpower,Wahoo Kickr,273,270,3
67277,1604341865,wahoo,Zwift - Premier Division // Zwift Racing League (men) (A),Rotor 2inpower,Wahoo Kickr,408,422,-14
69458,1604951010,wahoo,Zwift - Premier Division // Zwift Racing League (men) (A),Rotor 2inpower,Wahoo Kickr,444,446,-2
72828,1605721183,wahoo,Zwift - MIDWEEK Autumn Series by SZR (A),Rotor 2inpower,Wahoo Kickr,389,402,-13
74724,1606160553,wahoo,Zwift - Premier Division // Zwift Racing League (men) (A),Rotor 2inpower,Wahoo Kickr,415,435,-20
75546,1606324424,wahoo,Zwift - 30-39 years,Rotor 2inpower,Wahoo Kickr,361,385,-24
76095,1606412662,wahoo,Zwift - WTRL NOPINZ WORLD TTT CHAMPIONSHIPS - Zone 4 (C),Rotor 2inpower,Wahoo Kickr,388,406,-18
77731,1606760935,wahoo,Zwift - Premier Division // Zwift Racing League (men) (A),Rotor 2inpower,Wahoo Kickr,390,405,-15
78568,1606931237,wahoo,Zwift - MIDWEEK Winter Series by SZR (A),5904463206_ACTIVITY,Wahoo Kickr,400,418,-18
82018,1607709547,wahoo,Zwift - KIRCHMAIR Race Series (A),Rotor 2inpower,Wahoo Kickr,413,425,-12
82020,1607709547,wahoo,Zwift - KIRCHMAIR Race Series (A),Rotor 2inpower,Wahoo Kickr,413,426,-13
84307,1608221663,wahoo,Zwift - OH MY CRIT! - The Double Race 1/2 (A),Rotor 2inpower,Wahoo Kickr,391,410,-19
94982,1610390850,wahoo,Zwift - Premier Division // Zwift Racing League (men) (A),Rotor 2inpower,Wahoo Kickr,391,401,-10
96902,1610643883,wahoo,Zwift - OH MY CRIT! - The Double Race 2/2 (A),Rotor 2inpower,Wahoo Kickr,385,395,-10
99221,1610998124,wahoo,Zwift - Premier Division // Zwift Racing League (men) (A),Rotor 2inpower,Wahoo Kickr,381,391,-10
100882,1611248481,wahoo,Zwift - OH MY CRIT! - The Double Race 2/2 (A),Rotor 2inpower,Wahoo Kickr,393,410,-17
106130,1612094581,wahoo,Zwift - 3R Whole Lotta Lava Hilly Race - 1 Lap (16.9km/10.5mi 183m) (A),Rotor 2inpower,Wahoo Kickr,375,392,-17
106941,1612209803,wahoo,Zwift - Premier Division // Zwift Racing League (men) (A),Rotor 2inpower,Wahoo Kickr,409,424,-15
111020,1612812275,wahoo,Zwift - Premier Division // Zwift Racing League (men) (A),Rotor 2inpower,Wahoo Kickr,410,421,-11
112239,1612977236,wahoo,Zwift - Masters SA (A),Rotor 2inpower,Wahoo Kickr,396,412,-16
115393,1613418947,wahoo,Zwift - Premier Division // Zwift Racing League (men) (A),Rotor 2inpower,Wahoo Kickr,433,447,-14
119106,1614020995,wahoo,Zwift - Premier Division // Zwift Racing League (men) (A),Rotor 2inpower,Wahoo Kickr,353,371,-18
122604,1614630071,wahoo,Zwift - Premier Division // Zwift Racing League (men) (A),Rotor 2inpower,Wahoo Kickr,388,406,-18
123538,1614794753,wahoo,Zwift - Paris,Rotor 2inpower,Wahoo Kickr,144,143,1
9052,1578856172,wahoo,Tour de Zwift // Pro-Am Invitational,garmin v2,Wahoo Kicker 2018,353,347,6
9514,1579115699,wahoo,Tour de Zwift // Pro-Am Invitational,garmin v2,Wahoo Kicker 2018,402,412,-10
10635,1579806853,wahoo,Tour de Zwift // Pro-Am Invitational,garmin v2,Wahoo Kicker 2018,457,455,2
12429,1580843697,wahoo,Tour de Zwift // Pro-Am Invitational,garmin v2,wahoo kickr 2018,424,430,-6
25660,1587147060,wahoo,Zwift - Richmond Challenge // Zwift Classic (A),vector 3s,Wahoo Kicker 2018,404,414,-10
28021,1587838141,wahoo,Zwift - Crit City Slam // Zwift Classic (A),vector 3s,wahoo kickr 2018,420,418,2
62054,1602750015,wahoo,Zwift - Espresso,Infocrank (Primary),Wahoo Kickr v5.0,414,416,-2
78759,1606968424,neo,Zwift - Watopia,Infocrank (Secondary),Tacx Neo 2T,400,391,9
69153,1604862238,wahoo,Zwift -  Tour De Spartacus  (E),Rotor InPower,Wahoo kickr,420,434,-14
69433,1604951999,wahoo,Zwift - Premier Division // Zwift Racing League (men) (A),Rotor InPower,Wahoo kickr,436,438,-2
72011,1605553526,wahoo,Zwift - Premier Division // Zwift Racing League (men) (A),Rotor InPower,Wahoo kickr,386,388,-2
74825,1606161595,wahoo,Zwift - Premier Division // Zwift Racing League (men) (A),Rotor InPower,Wahoo kickr,411,420,-9
78643,1606937099,wahoo,Zwift - Deeside Thistle and Moray Firth Race (A),Rotor InPower,Wahoo kickr,410,403,7
86506,1608734399,wahoo,Zwift - Ross Fawcett&#039;s ZADA - Three Sisters,Rotor InPower,Wahoo Kickr V5,439,450,-11
94973,1610392497,wahoo,Zwift - Premier Division // Zwift Racing League (men) (A),Rotor InPower,Wahoo Kickr V5,424,416,8
102438,1611497696,wahoo,Zwift - KISS 100 Race Series - Americas (A),Rotor InPower,Wahoo Kickr V5,386,385,1
102953,1611601498,wahoo,Zwift - Premier Division // Zwift Racing League (men) (A),Rotor InPower,Wahoo Kickr V5,415,418,-3
105636,1612020601,wahoo,Zwift - 4wk FTP Booster Week 4 Day 3 - 10min Best effort! ,Rotor InPower,Wahoo Kickr V5,432,433,-1
106905,1612210019,wahoo,Zwift - Premier Division // Zwift Racing League (men) (A),Rotor InPower,Wahoo Kickr V5,419,429,-10
109917,1612624499,wahoo,Zwift - 4wk FTP Booster Week 4 Day 7 - FTP Test,Rotor InPower,Wahoo Kickr V5,425,433,-8
110413,1612703096,wahoo,Zwift - 3R Watopia Flat Route Race - 4 Laps (40.5km/25.1mi 216m) (A),Rotor InPower,Wahoo Kickr V5,408,414,-6
111004,1612811861,wahoo,Zwift - 4wk FTP Booster Week 4 Day 7 - FTP Test,Rotor InPower,Wahoo kickr,424,438,-14
112328,1612983594,wahoo,Zwift - Movistar Team Challenge // Round 1 (A),Rotor InPower,Wahoo Kickr V5,416,424,-8
113617,1613156397,wahoo,Zwift - Movistar Team Challenge // Round 1 (men),Rotor InPower,Wahoo Kickr V5,428,438,-10
116772,1613588398,wahoo,Zwift - Movistar Team Challenge // Round 2 (men) - Race 3/4,Rotor InPower,Wahoo Kickr V5,403,399,4
117927,1613761199,wahoo,Zwift - 02/19/2021,Rotor InPower,Wahoo Kickr V5,444,450,-6
122646,1614629783,wahoo,Zwift - Premier Division // Zwift Racing League (men) (A),Rotor InPower,Wahoo Kickr V5,416,426,-10
124218,1614886801,wahoo,Zwift - Movistar Team Challenge // Points Race (men),Rotor InPower,Wahoo Kickr V5,400,403,-3
124224,1614884399,wahoo,Zwift - Ramp Test,Rotor InPower,Wahoo Kickr V5,447,472,-25
78854,1606991306,wahoo,Zwift - KISS Race Series - Americas AM (A),Shimano FC-R9100-P Dura Ace Powermeter,Wahoo Kickr ,337,331,6
82246,1607765207,wahoo,Zwift - Cycling Ireland Zwift League Rd 5 (A),Shimano FC-R9100-P Dura Ace Powermeter,Wahoo Kickr v5.0,367,372,-5
83427,1608028760,wahoo,Zwift - 3R Volcano Circuit Flat Race - 8 Laps (35.2km/21.9mi 160m) (A),Shimano FC-R9100-P Dura Ace Powermeter,Wahoo Kickr v5.0,346,344,2
84493,1608228370,wahoo,Zwift - FUSION DECEMBER CUP (A),Shimano FC-R9100-P Dura Ace Powermeter,Wahoo Kickr v5.0,348,355,-7
89340,1609410721,wahoo,Zwift - KISS Race Series - Americas AM (A),Shimano FC-R9100-P Dura Ace Powermeter,Wahoo Kickr v5.0,362,380,-18
92990,1610042927,wahoo,Zwift - FUSION WINTER CUP (A),Shimano FC-R9100-P Dura Ace Powermeter,Wahoo Kickr v5.0,354,365,-11
95078,1610356719,wahoo,Zwift - 3R Volcano Flat Race - 3 Laps (36.6km/22.7mi 138m) (A),Shimano FC-R9100-P Dura Ace Powermeter,Wahoo Kickr v5.0,396,399,-3
95086,1610356719,wahoo,Zwift - Crit City Race (A),Shimano FC-R9100-P Dura Ace Powermeter,Wahoo Kickr v5.0,351,349,2
95766,1610474513,wahoo,Zwift - Zwift Racing League | WTRL - Men&#039;s/Mixed EMEA E2 DIVISION 6 (A),Shimano FC-R9100-P Dura Ace Powermeter,Wahoo Kickr v5.0,368,373,-5
97151,1610647099,wahoo,Zwift - FUSION WINTER CUP (A),Shimano FC-R9100-P Dura Ace Powermeter,Wahoo Kickr v5.0,395,394,1
98469,1610876714,wahoo,Zwift - 3R Sand & Sequoias - 1 Lap (20km/12.5mi 173m) (A),Shimano FC-R9100-P Dura Ace Powermeter,Wahoo Kickr v5.0,364,375,-11
98471,1610876714,wahoo,Zwift - 3R Innsbruckring Sprint Race - 1 Lap (8.8km/5.5mi 77m) (A),Shimano FC-R9100-P Dura Ace Powermeter,Wahoo Kickr v5.0,338,347,-9
98474,1610876714,wahoo,Zwift - Crit City Race (A),Shimano FC-R9100-P Dura Ace Powermeter,Wahoo Kickr v5.0,343,352,-9
100471,1611166661,wahoo,Zwift - Danmarks Cykle Union & Partners 2/6 (A),Shimano FC-R9100-P Dura Ace Powermeter,Wahoo Kickr v5.0,372,391,-19
101028,1611252897,wahoo,Zwift - FUSION WINTER CUP (A),Shimano FC-R9100-P Dura Ace Powermeter,Wahoo Kickr v5.0,343,354,-11
102338,1611481858,wahoo,Zwift - 3R Sand & Sequoias - 1 Lap (20km/12.5mi 173m) (A),Shimano FC-R9100-P Dura Ace Powermeter,Wahoo Kickr v5.0,364,375,-11
102341,1611481858,wahoo,Zwift - 3R Innsbruckring Sprint Race - 1 Lap (8.8km/5.5mi 77m) (A),Shimano FC-R9100-P Dura Ace Powermeter,Wahoo Kickr v5.0,345,355,-10
102345,1611481858,wahoo,Zwift - Crit City Race (A),Shimano FC-R9100-P Dura Ace Powermeter,Wahoo Kickr v5.0,343,352,-9
103676,1611689108,wahoo,Zwift - Zwift Racing League | WTRL - Men&#039;s/Mixed EMEA W2 DIVISION 1 (A),Shimano FC-R9100-P Dura Ace Powermeter,Wahoo Kickr v5.0,359,369,-10
104758,1611857085,wahoo,Zwift - FUSION WINTER CUP (A),Shimano FC-R9100-P Dura Ace Powermeter,Wahoo Kickr v5.0,381,385,-4
105411,1611993755,wahoo,Zwift - TEAM VEGAN Tofu Tornado XL (A),Shimano FC-R9100-P Dura Ace Powermeter,Wahoo Kickr v5.0,393,401,-8
107432,1612287987,wahoo,Zwift - Zwift Racing League | WTRL - Men&#039;s/Mixed EMEA E1 DIVISION 1 (A),Shimano FC-R9100-P Dura Ace Powermeter,Wahoo Kickr v5.0,369,383,-14
108969,1612462071,wahoo,Zwift - FUSION WINTER CUP (A),Shimano FC-R9100-P Dura Ace Powermeter,Wahoo Kickr v5.0,375,386,-11
110427,1612691721,wahoo,Zwift - 3R Innsbruckring Sprint Race - 1 Lap (8.8km/5.5mi 77m) (A),Shimano FC-R9100-P Dura Ace Powermeter,Wahoo Kickr v5.0,358,366,-8
110430,1612691721,wahoo,Zwift - Crit City Race (A),Shimano FC-R9100-P Dura Ace Powermeter,Wahoo Kickr v5.0,359,370,-11
110431,1612691721,wahoo,Zwift - Ottawa TopSpeed Race (A),Shimano FC-R9100-P Dura Ace Powermeter,Wahoo Kickr v5.0,370,383,-13
111628,1612891075,wahoo,Zwift - Zwift Racing League | WTRL - Men&#039;s/Mixed EMEA E1 DIVISION 1 (A),Shimano FC-R9100-P Dura Ace Powermeter,Wahoo Kickr v5.0,374,386,-12
113099,1613064726,wahoo,Zwift - FUSION WINTER CUP (A),Shimano FC-R9100-P Dura Ace Powermeter,Wahoo Kickr v5.0,395,403,-8
114603,1613294284,wahoo,Zwift - DBR Sunday Race (A),Shimano FC-R9100-P Dura Ace Powermeter,Wahoo Kickr v5.0,331,345,-14
114611,1613294284,wahoo,Zwift - 3R Innsbruckring Sprint Race - 1 Lap (8.8km/5.5mi 77m) (A),Shimano FC-R9100-P Dura Ace Powermeter,Wahoo Kickr v5.0,330,340,-10
114616,1613294284,wahoo,Zwift - Crit City Race (A),Shimano FC-R9100-P Dura Ace Powermeter,Wahoo Kickr v5.0,342,354,-12
115828,1613496043,wahoo,Zwift - Zwift Racing League | WTRL - Men&#039;s/Mixed EMEA E1 DIVISION 1 (A),Shimano FC-R9100-P Dura Ace Powermeter,Wahoo Kickr v5.0,409,423,-14
117313,1613669533,wahoo,Zwift - FUSION WINTER CUP (A),Shimano FC-R9100-P Dura Ace Powermeter,Wahoo Kickr v5.0,371,367,4
120331,1614189084,wahoo,Zwift - Scandinavian Cup 2021 - Round 1 - Men (A),Shimano FC-R9100-P Dura Ace Powermeter,Wahoo Kickr v5.0,360,364,-4
120816,1614274720,wahoo,Zwift - FUSION WINTER CUP (A),Shimano FC-R9100-P Dura Ace Powermeter,Wahoo Kickr v5.0,398,398,0
122946,1614706853,wahoo,Zwift - Zwift Racing League | WTRL - Men&#039;s/Mixed EMEA E1 DIVISION 1 (A),Shimano FC-R9100-P Dura Ace Powermeter,Wahoo Kickr v5.0,387,395,-8
124595,1614968350,wahoo,Zwift - Zwift Racing League | WTRL Battle Royale Playoff - Men&#039;s Points Race (A),Shimano FC-R9100-P Dura Ace Powermeter,Wahoo Kickr v5.0,401,409,-8
125203,1615057984,wahoo,Zwift - Zwift Racing League | WTRL Battle Royale Playoff - Men&#039;s TTT (A),Shimano FC-R9100-P Dura Ace Powermeter,Wahoo Kickr v5.0,382,392,-10
126618,1615399276,wahoo,Zwift - Scandinavian Cup 2021 - Round 3 - Men (A),Shimano FC-R9100-P Dura Ace Powermeter,Wahoo Kickr v5.0,371,374,-3
127140,1615484308,wahoo,Zwift - FUSION SPRING CUP (A),Shimano FC-R9100-P Dura Ace Powermeter,Wahoo Kickr v5.0,350,354,-4
106288,1612102343,wahoo,Zwift - KISS 100 Race Series - Americas (A),Garmin Vector 3 Dual,Wahoo Kickr Core,469,467,2
107783,1612321074,wahoo,Zwift - Zwift Racing League | WTRL - Men&#039;s/Mixed AMERICAS W DIVISION 1 (A),Garmin Vector 3 Dual,Wahoo Kickr Core,447,442,5
109969,1612624385,wahoo,Zwift - OH MY CRIT!! - Saturday Smash Race (A),Garmin Vector 3 Dual,Wahoo Kickr Core,485,484,1
110531,1612707172,wahoo,Zwift - KISS 100 Race Series - Americas (A),Garmin Vector 3 Dual,Wahoo Kickr Core,473,471,2
111946,1612926390,wahoo,Zwift - Zwift Racing League | WTRL - Men&#039;s/Mixed AMERICAS W DIVISION 1 (A),Garmin Vector 3 Dual,Wahoo Kickr Core,438,444,-6
114225,1613229169,wahoo,Zwift - OH MY CRIT!! - Saturday Smash Race (A),Garmin Vector 3 Dual,Wahoo Kickr Core,448,452,-4
114777,1613312068,wahoo,Zwift - KISS 100 Race Series - Americas (A),Garmin Vector 3 Dual,Wahoo Kickr Core,404,412,-8
120014,1614135540,wahoo,Zwift - Zwift Racing League | WTRL - Men&#039;s/Mixed AMERICAS W DIVISION 1 (A),Garmin Vector 3 Dual,Wahoo Kickr Core,381,382,-1
123314,1614740767,wahoo,Zwift - Zwift Racing League | WTRL - Men&#039;s/Mixed AMERICAS W DIVISION 1 (A),Garmin Vector 3 Dual,Wahoo Kickr Core,404,387,17
124602,1614970987,wahoo,Zwift - Zwift Racing League | WTRL Battle Royale Playoff - Men&#039;s Points Race (A),Garmin Vector 3 Dual,Wahoo Kickr Core,432,432,0
34308,1588702491,wahoo,Zwift - UNO X CUP powered by DCU & Feltet.dk (A),Garmin Vector 3,Wahoo Kickr,401,386,15
36272,1589911929,wahoo,Zwift - UNO X CUP powered by DCU & Feltet.dk (A),Garmin Vector 3,Wahoo Kickr,426,378,48
65719,1603822437,wahoo,Zwift Racing League | WTRL - Mens EMEA E1 DIVISION 1,Garmin Vector 3,Wahoo Kickr v5,387,388,-1
100658,1611168315,wahoo,Zwift - Danmarks Cykle Union & Partners 2/6 (A),Garmin Vector 3,Wahoo Kickr v5,382,383,-1
103445,1611684847,wahoo,Zwift Racing League | WTRL - Mens/Mixed EMEA E1 DIVISION 1,Garmin Vector 3,Wahoo Kickr v5,380,378,2
104184,1611773058,wahoo,Zwift - Danmarks Cykle Union & Partners 3/6 (A),Garmin Vector 3,Wahoo Kickr v5,388,391,-3
107833,1612289715,wahoo,Zwift - Zwift Racing League | WTRL - Men&#039;s/Mixed EMEA E1 DIVISION 1 (A),Garmin Vector 3,Wahoo Kickr v5,386,375,11
108734,1612377916,wahoo,Zwift - Danmarks Cykle Union & Partners 4/6 (A),Garmin Vector 3,Wahoo Kickr v5,393,376,17
111631,1612894976,wahoo,Zwift - Zwift Racing League | WTRL - Men&#039;s/Mixed EMEA E1 DIVISION 1 (A),Garmin Vector 3,Wahoo Kickr v5,404,384,20
112385,1612982686,wahoo,Zwift - Danmarks Cykle Union & Partners 5/6 (A),Garmin Vector 3,Wahoo Kickr v5,399,393,6
116728,1613587466,wahoo,Zwift - Danmarks Cykle Union & Partners 6/6 (A),Garmin Vector 3,Wahoo Kickr v5,370,358,12
124710,1614970896,wahoo,Zwift - Zwift Racing League | WTRL Battle Royale Playoff - Men&#039;s Points Race (A),Garmin Vector 3,Wahoo Kickr v5,378,379,-1
129334,1615919368,wahoo,Zwift - CeramicSpeed Race Series: Open Race (A),Garmin Vector 3,Wahoo Kickr v5,403,393,10
21512,1585850415,wahoo,KALAS Cup - Round 10,Quarq (Zwift),Wahoo17 (garmin 1000),339,345,-6
22607,1586193314,wahoo,DBR Wahoo League,Quarq (Zwift),Wahoo17 (garmin 1000),334,338,-4
22826,1586284814,wahoo,3R Spring Loaded Race Series - Round 2of6,Quarq (Zwift),Wahoo17 (garmin 1000),328,321,7
23209,1586425515,wahoo,Koa Sports League Race,Quarq (Zwift),Wahoo17 (garmin 1000),308,310,-2
23480,1586473214,wahoo,Koa Sports League Warrior Race,Quarq (Zwift),Wahoo17 (garmin 1000),336,338,-2
23811,1586614515,wahoo,OH CRIT!! - Saturday Smash Series,Quarq (Zwift),Wahoo17 (garmin 1000),347,351,-4
24391,1586798115,wahoo,DBR Wahoo League,Quarq (Zwift),Wahoo17 (garmin 1000),336,340,-4
24698,1586889623,wahoo,3R Spring Loaded Race Series - Round 3of6,Quarq (Zwift),Wahoo17 (garmin 1000),377,383,-6
25116,1587030314,wahoo,Koa Sports League Race,Quarq (Zwift),Wahoo17 (garmin 1000),322,321,1
26487,1587402915,wahoo,DBR Wahoo League,Quarq (Zwift),Wahoo17 (garmin 1000),395,405,-10
26761,1587494416,wahoo,3R Spring Loaded Race Series - Round 4of6,Quarq (Zwift),Wahoo17 (garmin 1000),358,362,-4
27222,1587635114,wahoo,Koa Sports League Race,Quarq (Zwift),Wahoo17 (garmin 1000),340,338,2
27943,1587824115,wahoo,OH CRIT!! - Saturday Smash Series,Quarq (Zwift),Wahoo17 (garmin 1000),341,349,-8
28858,1588099215,wahoo,3R Spring Loaded Race Series - Round 5of6 (Reverse),Quarq DZERO (Zwift),Wahoo17 (garmin),367,368,-1
29470,1588239915,wahoo,Koa Sports League Race,Quarq DZERO (Zwift),Wahoo17 (garmin),342,339,3
31305,1588612515,wahoo,DBR Wahoo League,Quarq DZERO (Zwift),Wahoo17 (garmin),342,349,-7
31813,1588704014,wahoo,3R Spring Loaded Race Series - Round 6of6,Quarq DZERO (Zwift),Wahoo17 (garmin),404,414,-10
32335,1588844715,wahoo,Koa Sports League Race,Quarq DZERO (Zwift),Wahoo17 (garmin),373,376,-3
33713,1589217312,wahoo,DBR Wahoo League,Quarq DZERO (Zwift),Wahoo17 (garmin),341,336,5
34131,1589308815,wahoo,3R & Wahoo Ride Real Race Series - Round 1 of 7,Quarq DZERO (Zwift),Wahoo17 (garmin),373,376,-3
34603,1589449514,wahoo,Koa Sports League Race,Quarq DZERO (Zwift),Wahoo17 (garmin),336,342,-6
35867,1589822117,wahoo,DBR Wahoo League,Quarq DZERO (Zwift),Wahoo17 (garmin),355,366,-11
36583,1590054316,wahoo,Koa Sports League Race,Quarq DZERO (Zwift),Wahoo17 (garmin),350,352,-2
36910,1590170423,wahoo,Team PTz Fridays Race League 1of 10,Quarq DZERO (Zwift),Wahoo17 (garmin),330,333,-3
37677,1590426918,wahoo,DBR Wahoo League,Quarq DZERO (Zwift),Wahoo17 (garmin),347,349,-2
37891,1590518414,wahoo,3R & Wahoo Ride Real Race Series - Round 3 of 7,Quarq DZERO (Zwift),Wahoo17 (garmin),374,375,-1
38257,1590659115,wahoo,Koa Sports League Race,Quarq DZERO (Zwift),Wahoo17 (garmin),326,322,4
39506,1591264815,wahoo,Koa Sports League Race,Quarq DZERO (Zwift),Wahoo17 (garmin),373,373,0
41309,1591984820,wahoo,Team PTz & Nutrimania Friday´s Race League 4 of 10,Quarq DZERO (Zwift),Wahoo17 (garmin),322,320,2
43527,1593079216,wahoo,Koa Sports League Race,Quarq DZERO (Zwift),Wahoo17 (garmin),328,326,2
44308,1593542414,wahoo,3R & Wahoo Ride Real Race Series - Round 7 of 7,Quarq DZERO (Zwift),Wahoo17 (garmin),363,360,3
45480,1594227627,wahoo,MIDWEEK Summer Series by SZR,Quarq DZERO (Zwift),Wahoo18 (garmin),312,308,4
46576,1594893616,wahoo,Koa Sports League Race,Quarq DZERO (Zwift),Wahoo18 (garmin),321,320,1
47422,1595498415,wahoo,Koa Sports League Race,Zwift,Wahoo17 (garmin),329,326,3
48047,1595961615,wahoo,3R Turbocharged Team Race Series - Round 3,Zwift,Wahoo18 (garmin),360,362,-2
48810,1596566415,wahoo,3R Turbocharged Team Race Series - Round 4,Zwift,Wahoo18 (garmin),335,334,1
49033,1596708018,wahoo,Koa Sports League Race,Quarq DZERO (Zwift),Wahoo18 (garmin),386,379,7
49215,1596819923,wahoo,World Elite Zwifters Fridays Race Series - Round 2,Quarq DZERO (Zwift),Wahoo18 (garmin),369,366,3
49477,1597083621,wahoo,TFC Mad Monday Summer Series (6 of 10),Quarq DZERO (Zwift),Wahoo18 (garmin),394,396,-2
50145,1597500920,wahoo,OH MY CRIT - Saturday Smash Race,Quarq DZERO (Zwift),Wahoo18 (garmin),372,369,3
50424,1597688424,wahoo,TFC Mad Monday Summer Series (7 of 10),Quarq DZERO (Zwift),Wahoo18 (garmin),308,310,-2
50749,1597860314,wahoo,DBR Wednesday Race,Quarq DZERO (Zwift),Wahoo18 (garmin),352,354,-2
50922,1597936517,wahoo,OH MY CRIT! - The Double Race 1/2,Quarq DZERO (Zwift),Wahoo18 (garmin),356,347,9
51264,1598105717,wahoo,OH MY CRIT - Saturday Smash Race*,Quarq DZERO (Zwift),Wahoo18 (garmin),345,346,-1
51869,1598380813,wahoo,3R Turbocharged Team Race Series - Bonus Round,Quarq DZERO (Zwift),Wahoo18 (garmin),324,321,3
52177,1598544314,wahoo,OH MY CRIT! - The Double Race 2/2,Quarq DZERO (Zwift),Wahoo18 (garmin),317,310,7
52519,1598710527,wahoo,OH MY CRIT - Saturday Smash Race*,Quarq DZERO (Zwift),Wahoo18 (garmin),325,323,2
52785,1598898021,wahoo,TFC Mad Monday Summer Series (9 of 10),Quarq DZERO (Zwift),Wahoo18 (garmin),341,342,-1
53104,1599066015,wahoo,MIDWEEK Autumn Series by SZR,Quarq DZERO (Zwift),Wahoo18 (garmin),354,351,3
53559,1599315315,wahoo,OH MY CRIT - Saturday Smash Race,Quarq DZERO (Zwift),Wahoo18 (garmin),321,321,0
54738,1599920116,wahoo,OH MY CRIT - Saturday Smash Race,Quarq DZERO (Zwift),Wahoo18 (garmin),319,317,2
55399,1600195463,wahoo,3R Sundown Race Series ,Quarq DZERO (Zwift),Wahoo18 (garmin),331,330,1
56285,1600524917,wahoo,OH MY CRIT - Saturday Smash Race,Quarq DZERO (Zwift),Wahoo18 (garmin),384,381,3
56697,1600712423,wahoo,TFC Mad Monday Autumn Series,Quarq DZERO (Zwift),Wahoo18 (garmin),380,379,1
58318,1601405062,wahoo,Zwift - 3R Sundown Race Series  (E),Zwift,Wahoo18 (garmin),331,329,2
59269,1601734520,wahoo,Zwift - OH MY CRIT - Saturday Smash Race (A),Quarq DZERO (Zwift),Wahoo18 (garmin),383,380,3
59631,1601922022,wahoo,Zwift - TFC Mad Monday Autumn Series (A),Quarq DZERO (Zwift),Wahoo18 (garmin),322,315,7
60819,1602339317,wahoo,Zwift - OH MY CRIT - Saturday Smash Race (A),Quarq DZERO (Zwift),Wahoo18 (garmin),334,328,6
63820,1603299625,wahoo,Zwift - MIDWEEK Autumn Series by SZR (A),Quarq DZERO (Zwift),Wahoo18 (garmin),334,332,2
64145,1603379717,wahoo,Zwift - OH MY CRIT! - The Double Race 1/2 (A),Quarq DZERO (Zwift),Wahoo18 (garmin),313,309,4
70234,1605117621,wahoo,Zwift - MIDWEEK Autumn Series by SZR (A),Quarq DZERO (Zwift),Wahoo18 (garmin),329,328,1
72662,1605726027,wahoo,Zwift - DCU – Feltet.dk November series (A),Quarq DZERO (Zwift),Wahoo18 (garmin),349,343,6
75589,1606330815,wahoo,Zwift - DCU – Feltet.dk November series (A),Quarq DZERO (Zwift),Wahoo18 (garmin),338,335,3
76567,1606501816,wahoo,Zwift - Team WEZ Friday Race (E),Quarq DZERO (Zwift),Wahoo18 (garmin),374,361,13
76980,1606576522,wahoo,Zwift - OH MY CRIT - Saturday Smash Race (A),Quarq DZERO (Zwift),Wahoo18 (garmin),316,307,9
78592,1606932032,wahoo,Zwift - MIDWEEK Winter Series by SZR (A),Quarq DZERO,Wahoo18 ,331,325,6
81112,1607536816,wahoo,Zwift - MIDWEEK Winter Series by SZR (A),Quarq DZERO,Wahoo18 ,371,366,5
81959,1607700618,wahoo,Zwift - BST Mountaingoat Race (A),Quarq DZERO,Wahoo18 ,385,379,6
82422,1607786129,wahoo,Zwift - OH MY CRIT - Saturday Smash Race (A),Quarq DZERO,Wahoo18 ,379,375,4
85824,1608574525,wahoo,Zwift -  DBR Monday Race (A),Quarq DZERO,Wahoo18 ,369,365,4
91767,1609866623,wahoo,Zwift - 3R Volcano KOM After Party Race - 2 laps + climb (40.2km/25mi 286m) (A),Quarq DZERO,Wahoo17 ,394,391,3
97534,1610734221,wahoo,Zwift - 3R Lutscher CCW Climbing Race - 1 Lap (22.1km/13.9mi 827m) (A),Quarq DZERO,Wahoo17 ,388,382,6
100318,1611168329,wahoo,Zwift - Danmarks Cykle Union & Partners 2/6 (A),Quarq DZERO,Wahoo17 ,373,366,7
104170,1611773121,wahoo,Zwift - Danmarks Cykle Union & Partners 3/6 (A),Quarq DZERO,Wahoo17 ,393,394,-1
105652,1612019722,wahoo,Zwift - OH MY CRIT!! - Saturday Smash Race (A),Quarq DZERO,Wahoo17 ,324,318,6
38651,1590826425,wahoo,Zwift - Cycling Ireland Zwift League Rd 10 (A),4iiii left hand crank,Wahoo Kickr Core,371,377,-6
38652,1590826425,wahoo,Zwift - Cycling Ireland Zwift League Rd 10 (A),4iiii left hand crank,Wahoo Kickr Core,371,377,-6
38653,1590826425,wahoo,Zwift - Cycling Ireland Zwift League Rd 10 (A),4iiii left hand crank,Wahoo Kickr Core,371,377,-6
39407,1591209233,wahoo,Wexford Zwift League. ,4iiii left hand crank,Wahoo Kickr Core,352,364,-12
39487,1591256908,wahoo,Roll on June 8th,4iiii left hand crank,Wahoo Kickr Core,285,304,-19
39931,1591430342,wahoo,Zwift - Cycling Ireland Zwift League Rd 11 (A),4iiii left hand crank,Wahoo Kickr Core,340,358,-18
41374,1592034621,wahoo,Zwift - Cycling Ireland Zwift League Rd 12 (A),4iiii left hand crank,Wahoo Kickr Core,357,360,-3
42790,1592639869,wahoo,Zwift - Cycling Ireland Innsbruck Classic (A),4iiii left hand crank,Wahoo Kickr Core,343,357,-14
43777,1593248357,wahoo,Zwift - Cycling Ireland Watopia Classic (A),4iiii left hand crank,Wahoo Kickr Core,342,363,-21
71361,1605346370,wahoo,Zwift - Cycling Ireland Zwift League Rd 1 (A),4iiii left hand crank,Wahoo Kickr Core,337,339,-2
74620,1605949432,wahoo,Zwift - Cycling Ireland Zwift League Rd 2,4iiii left hand crank,Wahoo Kickr Core,343,365,-22
76782,1606554299,wahoo,Zwift - Cycling Ireland Zwift League Rd 3 (A),4iiii left hand crank,Wahoo Kickr Core,327,355,-28
83828,1606554299,wahoo,Zwift - Cycling Ireland Zwift League Rd 4 (A),4iiii left hand crank to wahoo bolt,Wahoo Kickr Core to zwift,327,346,-19
84794,1608313254,wahoo,Zwift - Richard Barry &#039;s Meetup - Park Perimeter Loop,4iii to wahoo bolt,Wahoo Kickr Core to zwift,293,261,32
84973,1608371772,wahoo,Zwift - Cycling Ireland Zwift League Rd 6 (A),4iii to wahoo bolt,Wahoo Kickr Core to zwift,347,349,-2
93707,1610186271,wahoo,Zwift - Cycling Ireland Zwift League Rd 7 (A),Assioma duo to garmin,Wahoo Kickr Core to zwift,330,341,-11
97811,1610787897,wahoo,Zwift - Cycling Ireland Zwift League Rd 8 (A),Assioma duo to garmin,Wahoo Kickr Core to zwift,335,346,-11
97812,1610791219,wahoo,Zwift - Cycling Ireland Zwift League Rd 8 (A),Assioma duo to garmin,Wahoo Kickr Core to zwift,346,346,0
107146,1612254254,wahoo,Zwift - Zwift Racing League | WTRL - Men&#039;s/Mixed APAC DIVISION 1 (A),Assioma duo to bolt,Wahoo Kickr Core to zwift,358,366,-8
112308,1612979256,wahoo,Zwift - MIDWEEK Winter Series by SZR (A),Assioma duo to bolt,Wahoo Kickr Core to zwift,320,333,-13
113918,1613208168,wahoo,Zwift - Cycling Ireland One Day Classic - Scratch Race (A),Assioma duo to bolt,Wahoo Kickr Core to zwift,371,383,-12
115606,1613463276,wahoo,Zwift - Zwift Racing League | WTRL - Men&#039;s/Mixed APAC DIVISION 1 (A),Assioma duo to bolt,Wahoo Kickr Core to zwift,356,368,-12
127894,1615627660,wahoo,Zwift - Cycling Ireland eRacing Spring League Rd 3 (A),Assioma duo to bolt,Wahoo Kickr Core to zwift,361,368,-7
79941,1606382686,wahoo,Zwift -Four Horsemen,Power2max,Wahoo kickr,322,329,-7
81550,1607614060,wahoo,Zwift - OH MY CRIT! - The Double Race 1/2 (A),Power2max,Wahoo KICKR Core,395,410,-15
81552,1607614060,wahoo,Zwift - OH MY CRIT! - The Double Race 2/2 (A),Power2max,Wahoo KICKR Core,395,412,-17
83438,1608027717,wahoo,KISS Race Series - Americas AM (A),Power2max,Wahoo KICKR Core,465,475,-10
84248,1608199677,wahoo,Zwift - KISS Race Series - Americas AM (A),Power2max,Wahoo KICKR Core,444,458,-14
84327,1608219589,wahoo,Zwift - OH MY CRIT! - The Double Race 1/2 (A),Power2max,Wahoo KICKR Core,412,420,-8
84329,1608219589,wahoo,Zwift - OH MY CRIT! - The Double Race 2/2 (A),Power2max,Wahoo KICKR Core,412,429,-17
86405,1608715325,wahoo,USA Cycling Race League by STPC,Power2max,Wahoo KICKR Core,427,446,-19
89919,1609521081,wahoo,Zwift - KIRCHMAIR Race Series (A),danturek.2021-01-01-18-54-47-134Z.GarminPush.77431247287,Wahoo KICKR Core,374,380,-6
89924,1609521081,wahoo,Zwift - KIRCHMAIR Race Series (A),Power2max,Wahoo KICKR Core,341,341,0
95559,1610439409,neo,Zwift - Zwift Racing League | WTRL - Men&#039;s/Mixed APAC DIVISION 2 (A),Power2max,test Tacx Neo 2  yesterday 100% same. Today tacx show less ,453,428,25
95562,1610360546,neo,test Tacx neo 2,Power2max,first test Tacx neo 2,196,190,6
107197,1612253283,wahoo,Zwift - Zwift Racing League | WTRL - Men&#039;s/Mixed APAC DIVISION 2 (A),Power2max,Wahoo KICKR Core,390,400,-10
35010,1588435180,wahoo,Zwift - YANA Pro/AM Invitiational (A) - 12th,4IIII PRECISION 2.0 3D POWER METER,Wahoo Kickr Core,476,474,2
36803,1590084989,wahoo,Zwift - Tour for All Invitational Race // Men (A) - 16th,4IIII PRECISION 2.0 3D POWER METER,Wahoo Kickr Core,441,446,-5
38374,1590689759,wahoo,Zwift - Tour for All Invitational Race // Men (A) - 12th,4IIII PRECISION 2.0 3D POWER METER,Wahoo Kickr Core,484,486,-2
49953,1597395015,wahoo,Zwift - Off the MAAP Invitational Race // Stage 1 (Men) (A) - 14th,4IIII PRECISION 2.0 3D POWER METER,Wahoo Kickr Core,419,429,-10
50351,1597657739,wahoo,Zwift - Off the MAAP Invitational Race // Stage 2 (Men) (A) - 15th,4IIII PRECISION 2.0 3D POWER METER,Wahoo Kickr Core,442,451,-9
51468,1598261638,wahoo,Zwift - Off the MAAP Invitational Race // Stage 4 (men) - 17th,4IIII PRECISION 2.0 3D POWER METER,Wahoo Kickr Core,440,447,-7
55041,1600106280,wahoo,Zwift - Invitational League // Qualifying Race #1,4IIII PRECISION 2.0 3D POWER METER,Wahoo Kickr Core,443,439,4
55853,1600367098,wahoo,Zwift - Invitational League // Qualifying Race #2 (Men) ,4IIII PRECISION 2.0 3D POWER METER,Wahoo Kickr Core,421,410,11
56412,1600606560,wahoo,Zwift - Invitational League // Qualifying Race #3 (Men) (A),4IIII PRECISION 2.0 3D POWER METER,Wahoo Kickr Core,438,432,6
63085,1603130669,wahoo,Zwift - Premier Division // Zwift Racing League (men) - TTT,4IIII PRECISION 2.0 3D POWER METER,Wahoo Kickr Core,435,438,-3
63100,1603130669,wahoo,Zwift - Premier Division // Zwift Racing League (men) - TTT,4IIII PRECISION 2.0 3D POWER METER,Wahoo Kickr Core,435,438,-3
63103,1603130669,wahoo,Zwift - Premier Division // Zwift Racing League (men) - TTT,4IIII PRECISION 2.0 3D POWER METER,Wahoo Kickr Core,435,438,-3
65163,1603742158,wahoo,Zwift - Premier Division // Zwift Racing League (men) (A),4IIII PRECISION 2.0 3D POWER METER,Wahoo Kickr Core,448,453,-5
67310,1604343537,wahoo,Zwift - Premier Division // Zwift Racing League (men) (A) - 3rd,4IIII PRECISION 2.0 3D POWER METER,Wahoo Kickr Core,444,444,0
74739,1606161299,wahoo,Zwift - Premier Division // Zwift Racing League (men) (A) - 16th,4IIII PRECISION 2.0 3D POWER METER,Wahoo Kickr Core,454,458,-4
77714,1606762859,wahoo,Zwift - Premier Division // Zwift Racing League (men) (A),4IIII PRECISION 2.0 3D POWER METER,Wahoo Kickr Core,435,441,-6
95075,1610392438,wahoo,Zwift - Premier Division // Zwift Racing League (men) (A),4IIII PRECISION 2.0 3D POWER METER,Wahoo Kickr Core,455,428,27
99260,1610999834,wahoo,Zwift - Premier Division // Zwift Racing League (men) (A),4IIII PRECISION 2.0 3D POWER METER,Wahoo Kickr Core,431,429,2
102932,1611601348,wahoo,Zwift - Premier Division // Zwift Racing League (men) (A) - 14th,4IIII PRECISION 2.0 3D POWER METER,Wahoo Kickr Core,453,455,-2
106935,1612209930,wahoo,Zwift - Premier Division // Zwift Racing League (men) (A) - 22nd,4IIII PRECISION 2.0 3D POWER METER,Wahoo Kickr Core,440,435,5
112360,1612983508,wahoo,Zwift - Movistar Team Challenge // Round 1 (A),4IIII PRECISION 2.0 3D POWER METER,Wahoo Kickr Core,411,387,24
113592,1613156279,wahoo,Zwift - Movistar Team Challenge // Round 1 (men),4IIII PRECISION 2.0 3D POWER METER,Wahoo Kickr Core,464,459,5
116742,1613588279,wahoo,Zwift - Movistar Team Challenge // Round 2 (men) - Race 3/4,4IIII PRECISION 2.0 3D POWER METER,Wahoo Kickr Core,431,415,16
117902,1613761094,wahoo,Zwift - Movistar Team Challenge // Round 2 (men) - 3rd,4IIII PRECISION 2.0 3D POWER METER,Wahoo Kickr Core,457,461,-4
122609,1614629791,wahoo,Zwift - Premier Division // Zwift Racing League (men) (A),4IIII PRECISION 2.0 3D POWER METER,Wahoo Kickr Core,437,425,12
124146,1614884279,wahoo,Zwift - Ramp Test,4IIII PRECISION 2.0 3D POWER METER,Wahoo Kickr Core,467,486,-19
124149,1614886709,wahoo,Zwift - Movistar Team Challenge // Points Race (men) - Attack of the cramp,4IIII PRECISION 2.0 3D POWER METER,Wahoo Kickr Core,415,401,14
49985,1597394997,wahoo,Zwift - Off the MAAP Invitational Race // Stage 1 (Men) (A),garmin,wahoo,426,416,10
50383,1597657800,wahoo,Zwift - Off the MAAP Invitational Race // Stage 2 (Men) (A),garmin,wahoo,424,435,-11
50870,1597913394,wahoo,Zwift - Off the MAAP Invitational Race // Stage 3 (men) ,garmin,wahoo,431,445,-14
54785,1599911602,wahoo,Zwift - Watopia,garmin,wahoo,409,409,0
54786,1599906699,wahoo,Zwift - Watopia,garmin,wahoo,395,409,-14
54787,1599906699,wahoo,Zwift - Watopia,garmin,wahoo,395,409,-14
55149,1600106384,wahoo,Zwift - Invitational League // Qualifying Race #1,garmin,wahoo,423,422,1
55987,1600367379,wahoo,Zwift - Invitational League // Qualifying Race #2 (Men) ,garmin,wahoo,393,407,-14
61343,1602528595,wahoo,Zwift - Premier Division // Zwift Racing League (men) ,garmin,wahoo,435,453,-18
63173,1603131345,wahoo,Zwift - Premier Division // Zwift Racing League (men) ,garmin,wahoo,441,453,-12
65235,1603742397,wahoo,Zwift - Premier Division // Zwift Racing League (men) (A),garmin,wahoo,432,446,-14
74735,1606161597,wahoo,Zwift - Premier Division // Zwift Racing League (men) (A),garmin,wahoo,452,472,-20
76036,1606416540,wahoo,Zwift - WTRL NOPINZ WORLD TTT CHAMPIONSHIPS - Zone 7 (C),garmin,wahoo,412,435,-23
77720,1606763581,wahoo,Zwift - Premier Division // Zwift Racing League (men) (A),garmin,wahoo,412,433,-21
102413,1611165595,wahoo,Zwift - MIDWEEK Winter Series by SZR (A),garmin,wahoo,379,382,-3
103000,1611601472,wahoo,Zwift - Premier Division // Zwift Racing League (men) (A),garmin,wahoo,430,437,-7
112367,1612983563,wahoo,Zwift - Movistar Team Challenge // Round 1 (A),garmin,wahoo,403,404,-1
112927,1613067246,wahoo,Zwift - BRT TTT,garmin,wahoo,426,420,6
113687,1613156400,wahoo,Zwift - Movistar Team Challenge // Round 1 (men),garmin,wahoo,432,437,-5
115464,1613419286,wahoo,Zwift - Premier Division // Zwift Racing League (men) (A),garmin,wahoo,442,455,-13
116847,1613588364,wahoo,Zwift - Movistar Team Challenge // Round 2 (men) - Race 3/4,garmin,wahoo,398,416,-18
117971,1613761177,wahoo,Zwift - Movistar Team Challenge // Round 2 (men),garmin,wahoo,466,466,0
119201,1614020969,wahoo,Zwift - Premier Division // Zwift Racing League (men) (A),garmin,wahoo,413,434,-21
122582,1614629791,wahoo,Zwift - Premier Division // Zwift Racing League (men) (A),garmin,wahoo,404,415,-11
124242,1614886800,wahoo,Zwift - Movistar Team Challenge // Points Race (men),garmin,wahoo,379,396,-17
124245,1614884356,wahoo,Zwift - Ramp Test,garmin,wahoo,454,481,-27
129291,1615231182,wahoo,Zwift - Team TFC Mad Monday Race Series (high-end categories) (A),garmin,wahoo,374,395,-21
129293,1615835977,wahoo,Zwift - Team TFC Mad Monday Race Series (high-end categories) (A),garmin,wahoo,394,417,-23
64349,1603452002,wahoo,Zwift - 3R LaGuardia Loop Reverse Flat Race - 8 Laps (24.5km/15.2mi 216m) (A),Quarq Dfour91,Wahoo Kickr,375,373,2
81726,1607626800,wahoo,Zwift - BENELIGA 2020-2021 (E),Quarq Dfour91,Wahoo Kickr,376,380,-4
86000,1608631509,wahoo,Bologna TT,Quarq Dfour91,Wahoo Kickr,399,395,4
86916,1608816901,wahoo,Zwift - Crit City Race (A),Quarq Dfour91,Wahoo Kickr,366,363,3
87109,1608883498,wahoo,Zwift - 3R Lagurdia Super Sprint Race - 1 Lap (3.7km/2.6mi 27m) (A),Quarq Dfour91,Wahoo Kickr,471,470,1
87723,1609061393,wahoo,Zwift -  SloZl - Slovenian Zwift League - Weekly Race,Quarq Dfour91,Wahoo Kickr,334,335,-1
88914,1609319125,wahoo,Zwift - 3R Watopia Flat Route Race - 3 Laps (30.3km/18.8mi 162m) (A),Quarq Dfour91,Wahoo Kickr,366,367,-1
90559,1609664714,wahoo,Zwift - Newbury Velo Road Race (A),Quarq Dfour91,Wahoo Kickr,346,356,-10
90573,1609671914,wahoo,3R Innsbruckring Sprint Race - 1 Lap (8.8km/5.5mi 77m),Quarq Dfour91,Wahoo Kickr,392,397,-5
90613,1609674313,wahoo,Zwift - Crit City Race (A),Quarq Dfour91,Wahoo Kickr,367,373,-6
92402,1609959635,wahoo,Zwift - TDZ Stage 1: Longer Ride,Quarq Dfour,Wahoo Kickr,291,286,5
92970,1610046012,wahoo,BENELIGA 2020-2021,Quarq Dfour91,Wahoo Kickr,400,413,-13
93781,1610191823,wahoo,Zwift - EMU Novice Race (A),Quarq Dfour91,Wahoo Kickr,410,409,1
94539,1610184615,wahoo,Zwift - DBR SufferDay League III (A),Quarq Dfour91,Wahoo Kickr,391,389,2
97077,1610650815,wahoo,BENELIGA 2020-2021,Quarq Dfour91,Wahoo Kickr,402,419,-17
101013,1611255616,wahoo,Zwift - BENELIGA 2020-2021 (E),Quarq Dfour91,Wahoo Kickr,377,382,-5
101676,1611390619,wahoo,Zwift - TEAM VEGAN Tofu Tornado XL (A),Quarq Dfour91,Wahoo Kickr,407,413,-6
103200,1611646214,wahoo,Zwift - ZHQ FutureWorks Crit City Race - Anti-sandbagging (A),Quarq Dfour91,Wahoo Kickr,366,368,-2
104757,1611860413,wahoo,Zwift - BENELIGA 2020-2021 (E),Quarq Dfour91,Wahoo Kickr,381,380,1
106057,1612087815,wahoo,Zwift - 3R Sand & Sequoias - 1 Lap (20km/12.5mi 173m) (A),Quarq Dfour (S5),Wahoo Kickr,397,399,-2
106076,1612091108,wahoo,Zwift - 3R Innsbruckring Sprint Race - 1 Lap (8.8km/5.5mi 77m) (A),Quarq Dfour (S5),Wahoo Kickr,387,375,12
108993,1612465218,wahoo,Zwift - BENELIGA 2020-2021 (E),Quarq Dfour91,Wahoo Kickr,401,402,-1
113023,1613070013,wahoo,BENELIGA 2020-2021,Quarq Dfour91,Wahoo Kickr,422,439,-17
113316,1613120715,wahoo,Zwift - 3R Whole Lotta Lava Hilly Race - 2 Laps (28.9km/12.53mi 336m) (A),Quarq Dfour91,Wahoo Kickr,410,407,3
114159,1613229309,wahoo,Zwift - OH MY CRIT!! - Saturday Smash Race (A),Quarq Dfour91,Wahoo Kickr,415,425,-10
117308,1613674813,wahoo,BENELIGA 2020-2021,Quarq Dfour91,Wahoo Kickr,368,370,-2
32169,1588702534,wahoo,Zwift - UNO X CUP powered by DCU & Feltet.dk (A),SRAM RED AXS Power Meter,Wahoo Kickr 2018,361,359,2
34076,1589307319,wahoo,Zwift - UNO X CUP powered by DCU & Feltet.dk (A),SRAM RED AXS Power Meter,Wahoo Kickr 2018,375,353,22
34331,1589372552,wahoo,Zwift - ZHQ Beta Crit City Race (A),SRAM RED AXS Power Meter,Wahoo Kickr 2018,328,296,32
34827,1589472427,wahoo,Zwift - 3R Watopia Rally Steady Ride [~3w/kg avg] (B),SRAM RED AXS Power Meter,Wahoo Kickr 2018,272,224,48
35123,1589571864,wahoo,Zwift -  Crit City  (A),SRAM RED AXS Power Meter,Wahoo Kickr 2018,361,331,30
35709,1589748900,wahoo,Zwift - JETT Monday Morning Ride(2.5~3.0w/kg)50mins (B),SRAM RED AXS Power Meter,Wahoo Kickr 2018,289,269,20
35782,1589802911,wahoo,Zwift - 4x2min Sprint Ramps,SRAM RED AXS Power Meter,Wahoo Kickr 2018,231,214,17
35787,1589805604,wahoo,Zwift - Velocity - Dig the Bike Fantastic (D),SRAM RED AXS Power Meter,Wahoo Kickr 2018,171,159,12
35792,1589808810,wahoo,Zwift - Ascenders Team Recovery Monday (D),SRAM RED AXS Power Meter,Wahoo Kickr 2018,217,217,0
36113,1589912096,wahoo,Zwift - UNO X CUP powered by DCU & Feltet.dk (A),SRAM RED AXS Power Meter,Wahoo Kickr 2018,357,317,40
36992,1590219278,wahoo,Zwift - INC Steady State - Group Training Ride 2.9 - 3.5w (B),SRAM RED AXS Power Meter,Wahoo Kickr 2018,316,312,4
37399,1590326044,wahoo,Zwift - KISS at Race 100 - Americas (A),SRAM RED AXS Power Meter,Wahoo Kickr 2018,330,328,2
37864,1590516847,wahoo,Zwift - UNO X CUP powered by DCU & Feltet.dk (A),SRAM RED AXS Power Meter,Wahoo Kickr 2018,398,397,1
39122,1591121630,wahoo,Zwift - UNO X CUP powered by DCU & Feltet.dk (A),SRAM RED AXS Power Meter,Wahoo Kickr 2018,364,340,24
39478,1591254251,wahoo,Zwift - 3R Innsbruckring Flat Race - 5 Laps (44km/27.3mi 385m) (A),SRAM RED AXS Power Meter,Wahoo Kickr 2018,319,303,16
40238,1591535640,wahoo,Zwift - KISS at Race 100 - Americas (A),SRAM RED AXS Power Meter,Wahoo Kickr 2018,316,291,25
40554,1591726438,wahoo,Zwift - UNO X CUP powered by DCU & Feltet.dk (A),SRAM RED AXS Power Meter,Wahoo Kickr 2018,366,345,21
54862,1600002296,wahoo,Zwift - 3R Watopia Flat Route Race - 4 Laps (40.5km/25.1mi 216m) (A),Favero Assioma,Wahoo Kickr 2018,308,309,-1
92935,1610044192,wahoo,Zwift - FUSION WINTER CUP (A),Favero Assioma,Wahoo Kickr 2018,344,346,-2
93742,1610184614,wahoo,Zwift - DBR SufferDay League III (A),Favero Assioma,Wahoo Kickr 2018,375,372,3
95807,1610476126,wahoo,Zwift - Zwift Racing League | WTRL - Men&#039;s/Mixed EMEA E2 DIVISION 6 (A),Favero Assioma,Wahoo Kickr 2018,319,323,-4
97631,1610742324,wahoo,Zwift - 3R Innsbruckring Flat Race - 4 Laps (35.2km/21.9mi 308m) (A),Favero Assioma,Wahoo Kickr 2018,290,291,-1
99262,1611000593,wahoo,Zwift - GGCC Glasgow Green Cycle Club Race Series (A),Favero Assioma,Wahoo Kickr 2018,374,376,-2
99701,1611081436,wahoo,Zwift - Zwift Racing League | WTRL - Men&#039;s/Mixed EMEA E2 DIVISION 6 (A),Favero Assioma,Wahoo Kickr 2018,325,336,-11
101071,1611253793,wahoo,Zwift - FUSION WINTER CUP (A),Favero Assioma,Wahoo Kickr 2018,336,334,2
101882,1611410396,wahoo,Zwift - MGCC hosts Ontario Cycling Association Virtual Challenge #2 (A),Favero Assioma,Wahoo Kickr 2018,320,314,6
103578,1611685732,wahoo,Zwift - Zwift Racing League | WTRL - Men&#039;s/Mixed EMEA E2 DIVISION 6 (A),Favero Assioma,Wahoo Kickr 2018,366,367,-1
104734,1611858588,wahoo,Zwift - FUSION WINTER CUP (A),Favero Assioma,Wahoo Kickr 2018,320,319,1
105104,1611928194,wahoo,Zwift - KISS Race Series - Pacific AM (A),Favero Assioma,Wahoo Kickr 2018,337,340,-3
107466,1612290530,wahoo,Zwift - Zwift Racing League | WTRL - Men&#039;s/Mixed EMEA E2 DIVISION 6 (A),Favero Assioma,Wahoo Kickr 2018,346,327,19
108055,1612361102,wahoo,Zwift - 02/03/2021,Favero Assioma,Wahoo Kickr 2018,213,210,3
108225,1612377869,wahoo,Zwift - Danmarks Cykle Union & Partners 4/6 (A),Favero Assioma,Wahoo Kickr 2018,357,348,9
108954,1612463395,wahoo,Zwift - FUSION WINTER CUP (A),Favero Assioma,Wahoo Kickr 2018,369,366,3
109799,1612603773,wahoo,Zwift - DBR SufferDay League III (A),Favero Assioma,Wahoo Kickr 2018,351,347,4
111700,1612900791,wahoo,Zwift - Zwift Racing League | WTRL - Men&#039;s/Mixed EMEA W2 DIVISION 1 (A),Favero Assioma,Wahoo Kickr 2018,340,344,-4
112278,1612982696,wahoo,Zwift - Danmarks Cykle Union & Partners 5/6 (A),Favero Assioma,Wahoo Kickr 2018,365,364,1
113018,1613068193,wahoo,Zwift - 02/11/2021,Favero Assioma,Wahoo Kickr 2018,342,341,1
115904,1613500133,wahoo,Zwift - Zwift Racing League | WTRL - Men&#039;s/Mixed EMEA E2 DIVISION 6 (A),Favero Assioma,Wahoo Kickr 2018,367,362,5
116702,1613587500,wahoo,Zwift - Danmarks Cykle Union & Partners 6/6 (A),Favero Assioma,Wahoo Kickr 2018,319,317,2
119679,1614104932,wahoo,Zwift - Zwift Racing League | WTRL - Men&#039;s/Mixed EMEA E2 DIVISION 6 (A),Favero Assioma,Wahoo Kickr 2018,309,300,9
120803,1614277795,wahoo,Zwift - 02/25/2021,Favero Assioma,Wahoo Kickr 2018,411,404,7
123671,1614797095,wahoo,Zwift - Scandinavian Cup 2021 - Round 2 - Men (A),Favero Assioma,Wahoo Kickr 2018,346,356,-10
124129,1614882620,wahoo,Zwift - FUSION SPRING CUP (A),Favero Assioma,Wahoo Kickr 2018,0,0,0
124130,1614882620,wahoo,Zwift - FUSION SPRING CUP (A),Favero Assioma,Wahoo Kickr 2018,328,338,-10
126669,1615401891,wahoo,Zwift - Scandinavian Cup 2021 - Round 3 - Men (A),Favero Assioma,Wahoo Kickr 2018,329,338,-9
127134,1615487395,wahoo,Zwift - 03/11/2021,Favero Assioma,Wahoo Kickr 2018,330,336,-6
129213,1615919390,wahoo,Zwift - CeramicSpeed Race Series: Open Race (A),Favero Assioma,Wahoo Kickr 2018,361,365,-4
123650,1614797051,wahoo,Zwift - Scandinavian Cup 2021 - Round 2 - Men (A),OskarHvid.2021-03-03-19-57-19-632Z.GarminPush.84118749985,Wahoo Kickr V5,415,409,6
124116,1614882120,wahoo,Zwift - FUSION SPRING CUP (A),OskarHvid.2021-03-04-20-24-34-371Z.GarminPush.84234735275,Wahoo Kickr V5,389,384,5
126642,1615401757,wahoo,Zwift - Scandinavian Cup 2021 - Round 3 - Men (A),Quarq dZero,Wahoo Kickr V5,442,430,12
127242,1615487200,wahoo,Zwift - FUSION SPRING CUP (A),Quarq dZero,Wahoo Kickr V5,402,400,2
129228,1615918717,wahoo,Zwift - CeramicSpeed Race Series - devastating... ,Quarq dZero,Wahoo Kickr V5,432,428,4
129246,1615919415,wahoo,Zwift - CeramicSpeed Race Series: Open Race (A),Assioma Favero Duo,Wahoo Kickr,407,420,-13
87546,1608995700,wahoo,Zwift - OH MY CRIT - Saturday Smash Race (A),ASSIOMA DUO ,WAHOO KICKR CORE,374,370,4
92843,1610036097,wahoo,Zwift - OH MY CRIT! - The Double Race 1/2 (A),ASSIOMA DUO ,WAHOO KICKR CORE,386,369,17
92855,1610039102,wahoo,Zwift - OH MY CRIT! - The Double Race 2/2 (A),ASSIOMA DUO ,WAHOO KICKR CORE,362,346,16
95631,1610475726,wahoo,Zwift - Zwift Racing League | WTRL - Men&#039;s/Mixed EMEA E1 DIVISION 6 (A),ASSIOMA DUO ,WAHOO KICKR CORE,346,335,11
97543,1610733727,wahoo,Zwift - KIRCHMAIR Race Series (A),ASSIOMA DUO ,WAHOO KICKR CORE,352,335,17
100087,1611073797,wahoo,Zwift - ZHQ FutureWorks Crit City Race - Anti-sandbagging (A),ASSIOMA DUO ,WAHOO KICKR CORE,389,371,18
101320,1611309898,wahoo,Zwift - 3R Innsbruckring Flat Race - 4 Laps (35.2km/21.9mi 308m) (A),ASSIOMA DUO ,WAHOO KICKR CORE,346,333,13
103544,1611685153,wahoo,Zwift - Zwift Racing League | WTRL - Men&#039;s/Mixed EMEA E1 DIVISION 6 (A),ASSIOMA DUO ,WAHOO KICKR CORE,361,343,18
107390,1612289984,wahoo,Zwift - Zwift Racing League | WTRL - Men&#039;s/Mixed EMEA E1 DIVISION 6 (A),ASSIOMA DUO ,WAHOO KICKR CORE,374,361,13
108821,1612458290,wahoo,Zwift - OH MY CRIT!! - The Double Race 2/2 (A),ASSIOMA DUO ,WAHOO KICKR CORE,390,373,17
109678,1612604521,wahoo,Zwift - Ramp Test,ASSIOMA DUO ,WAHOO KICKR CORE,420,411,9
109690,1608799107,wahoo,Zwift - Ramp Test,ASSIOMA DUO ,WAHOO KICKR CORE,438,433,5
110540,1612713835,wahoo,Zwift - 3R Tick Tock Flat Race - 1 Lap (19km/11.8mi 50m) (A),ASSIOMA DUO ,WAHOO KICKR CORE,378,364,14
112042,1612895222,wahoo,Zwift - Zwift Racing League | WTRL - Men&#039;s/Mixed EMEA E1 DIVISION 6 (A),ASSIOMA DUO ,WAHOO KICKR CORE,393,380,13
112878,1613060104,wahoo,Zwift - OH MY CRIT!! - The Double Race 1/2 (A),ASSIOMA DUO ,WAHOO KICKR CORE,346,335,11
114567,1613229302,wahoo,Zwift - OH MY CRIT!! - Saturday Smash Race (A),ASSIOMA DUO ,WAHOO KICKR CORE,416,397,19
118430,1613837102,wahoo,Zwift - 3R Endurance Series p/b OTE Sports- Stage 1 (E),ASSIOMA DUO ,WAHOO KICKR CORE,358,343,15
118834,1613923506,wahoo,Zwift - 3R Tick Tock Flat Race - 1 Lap (19km/11.8mi 50m) (A),ASSIOMA DUO ,WAHOO KICKR CORE,344,330,14
123976,1614874508,wahoo,Zwift - OH MY CRIT!! - The Double Race 1/2 (A),ASSIOMA DUO ,WAHOO KICKR CORE,391,375,16
124542,1614965409,wahoo,Zwift - EVO CC / Le Col - Sprint Race Series (A),ASSIOMA DUO ,WAHOO KICKR CORE,386,369,17
6757,1576784599,wahoo,Zwift - Lamb Chop Series  (A),SRM Powermeter ,Wahoo Kickr 18,351,348,3
12447,1580845204,wahoo,3R Ultimate Racing League - Round 5,SRM Powermeter ,Wahoo Kickr 18,377,377,0
19510,1585077305,wahoo,Zwift - Tour of Watopia Pro-Am Men&#039;s Race #3 (A),SRM Powermeter ,Wahoo Kickr 18,344,346,-2
58548,1601486998,wahoo,Zwift - NCF Vinter Cup 2020 - Runde 2 - Herrer (A),SRM Powermeter ,Wahoo Kickr V5,343,348,-5
60200,1602091799,wahoo,Zwift - NCF Vinter Cup 2020 - Runde 3 - Herrer (A),SRM Powermeter ,Wahoo Kickr V5,371,377,-6
62026,1602696598,wahoo,Zwift - NCF Vinter Cup 2020 - Runde 4 - Herrer (A),SRM Powermeter ,Wahoo Kickr V5,373,384,-11
63292,1603131164,wahoo,Zwift - Premier Division // Zwift Racing League (men) ,SRM Powermeter ,Wahoo Kickr V5,380,391,-11
63872,1603301406,wahoo,Zwift - NCF Vinter Cup 2020 - Runde 5 - Herrer (A),SRM Powermeter ,Wahoo Kickr V5,368,374,-6
65199,1603742400,wahoo,Zwift - Premier Division // Zwift Racing League (men) (A),SRM Powermeter ,Wahoo Kickr 18,374,388,-14
65863,1603909800,wahoo,Zwift - NCF Vinter Cup 2020 - Runde 6 - Herrer (A),SRM Powermeter ,Wahoo Kickr V5,395,417,-22
67268,1604344320,wahoo,Zwift - Premier Division // Zwift Racing League (men) (A),SRM Powermeter ,Wahoo Kickr V5,383,404,-21
67960,1604514627,wahoo,Zwift - NCF Vinter Cup 2020 - Runde 7 - Herrer (A),SRM Powermeter ,Wahoo Kickr V5,354,371,-17
70489,1605119366,wahoo,Zwift - NCF Vinter Cup 2020 - Runde 8 - Herrer (A),SRM Powermeter ,Wahoo Kickr V5,369,376,-7
70490,1604951999,wahoo,Zwift - Premier Division // Zwift Racing League (men) (A),SRM Powermeter ,Wahoo Kickr V5,397,419,-22
71960,1605553602,wahoo,Zwift - Premier Division // Zwift Racing League (men) (A),SRM Powermeter ,Wahoo Kickr V5,378,396,-18
73578,1605896991,wahoo,Zwift - Team WEZ Friday Race,SRM Powermeter ,Wahoo Kickr V5,374,391,-17
75996,1606414420,wahoo,Zwift - WTRL NOPINZ WORLD TTT CHAMPIONSHIPS - Zone 4 (C),SRM Powermeter ,Wahoo Kickr V5,366,378,-12
76792,1606560297,wahoo,Into the Red by RELENTLESS,SRM Powermeter ,Wahoo Kickr V5,385,396,-11
77675,1606763515,wahoo,Zwift - Premier Division // Zwift Racing League (men) (A),SRM Powermeter ,Wahoo Kickr V5,385,397,-12
80065,1607254220,wahoo,Zwift - Stages of DIRT (A),SRM Powermeter ,Wahoo Kickr V5,372,375,-3
92741,1610036122,wahoo,Zwift,SRM Powermeter ,Wahoo Kickr V5,316,319,-3
96420,1610562604,wahoo,Zwift - NCF Vintercup 2021 - Runde 1 - Herrer (A),SRM Powermeter ,Wahoo Kickr V5,368,373,-5
100363,1611167423,wahoo,Zwift - NCF Vintercup 2021 - Runde 2 - Herrer (A),SRM Powermeter ,Wahoo Kickr 18,318,325,-7
100645,1601208620,wahoo,ZADA test,SRM Powermeter ,Wahoo Kickr 18,397,404,-7
100944,1611256354,wahoo,Zwift - Richmond,SRM Powermeter ,Wahoo Kickr 18,222,226,-4
112341,1612983532,wahoo,Movistar Team Challenge // Round 1,SRM Powermeter ,Wahoo Kickr V5,326,332,-6
116649,1613586058,wahoo,Zwift - NCF Vintercup 2021 - Runde 6 - Herrer (A),SRM Powermeter ,Wahoo Kickr V5,337,346,-9
117280,1613672775,wahoo,Zwift - FUSION WINTER CUP (A),SRM Powermeter ,Wahoo Kickr V5,335,340,-5
119095,1614020991,wahoo,Zwift - Premier Division // Zwift Racing League (men) (A),Wahoo Kickr V5,Wahoo Kickr V5,349,346,3
120352,1614192215,wahoo,Zwift - Scandinavian Cup 2021 - Round 1 - Men (A),SRM Powermeter ,Wahoo Kickr V5,379,383,-4
122581,1614629997,wahoo,Zwift - Premier Division // Zwift Racing League (men) (A),SRM Powermeter ,Wahoo Kickr V5,372,383,-11
123607,1614797101,wahoo,Zwift - Scandinavian Cup 2021 - Round 2 - Men (A),SRM Powermeter ,Wahoo Kickr V5,354,368,-14
124096,1614882522,wahoo,Zwift - FUSION SPRING CUP (A),SRM Powermeter ,Wahoo Kickr V5,354,367,-13
126643,1615401815,wahoo,Zwift - Scandinavian Cup 2021 - Round 3 - Men (A),SRM Powermeter ,Wahoo Kickr V5,377,383,-6
61535,1602609300,wahoo,Zwift - Zwift Racing League | WTRL,Power2max NG,Wahoo Kickr,429,410,19
64085,1603299599,wahoo,Zwift - MIDWEEK Autumn Series by SZR (A),Quarq Dfour,Wahoo Kickr,408,403,5
64225,1603389599,wahoo,Zwift -  Flanders The BZR Ronde  (A),Quarq Dfour,Wahoo Kickr,380,379,1
65657,1603822559,wahoo,Zwift - Zwift Racing League | WTRL - EMEA E (MEN) -  Division 2 (A),Quarq Dfour,Wahoo Kickr,372,373,-1
66598,1604136602,wahoo,Zwift - DBR Saturday Race (A),Quarq Dfour,Wahoo Kickr,396,390,6
67579,1604427870,wahoo,Zwift - Zwift Racing League | WTRL - Men&#039;s EMEA E1 DIVISION 2 (A),Quarq Dfour,Wahoo Kickr,382,376,6
71384,1605358822,wahoo,Zwift - 111 - Strongman racing series (A),4iiii R8000,Wahoo Kickr,402,398,4
73121,1605812397,wahoo,Zwift -  Flanders The BZR Ronde  (A),4iiii R8000,Wahoo Kickr,367,377,-10
73863,1605971709,wahoo,Zwift - OH MY CRIT - Saturday Smash Race (A),4iiii R8000,Wahoo Kickr,379,398,-19
75007,1606241758,wahoo,Zwift - Zwift Racing League | WTRL - Men&#039;s EMEA E1 DIVISION 2,4iiii R8000,Wahoo Kickr,383,403,-20
75870,1606393498,wahoo,Zwift - EMU Japan Race (A),4iiii R8000,Wahoo Kickr,355,363,-8
79284,1607076301,wahoo,Zwift - 3R Innsbruckring Flat Race - 4 Laps (35.2km/21.9mi 308m) (A),Quarq Dfour,Wahoo Kickr,398,385,13
85687,1608546600,wahoo,Zwift - European Lunch Ride (E),Quarq Dfour,Wahoo Kickr,343,331,12
86196,1608663304,wahoo,Zwift - Team Italy & Frenchy Fuzion League (A),Quarq Dfour,Wahoo Kickr,419,415,4
86379,1608712224,wahoo,Flanders Endurance Series,Quarq Dfour,Wahoo Kickr,355,361,-6
86945,1608818698,wahoo,Zwift - 3R Classique Flat Race - 6 Laps (37.7km/23.4mi 114m) (A),Quarq Dfour,Wahoo Kickr,382,388,-6
89727,1609495494,wahoo,Zwift - 3R Innsbruckring Flat Race - 4 Laps (35.2km/21.9mi 308m) (A),Quarq Dfour,Wahoo Kickr,402,400,2
91804,1609872004,wahoo,Zwift - UK Armed Forces Cycling Community Race Night (A),Quarq Dfour,Wahoo Kickr,390,392,-2
92354,1609958706,wahoo,Zwift - GCA Cup (A),Quarq Dfour,Wahoo Kickr,365,369,-4
95619,1610475320,wahoo,Zwift - Zwift Racing League | WTRL - Men&#039;s/Mixed EMEA E1 DIVISION 1 (A),Quarq Dfour,Wahoo Kickr,390,389,1
96404,1610563504,wahoo,Zwift - GCA Cup (A),Quarq Dfour,Wahoo Kickr,402,389,13
97826,1610791197,wahoo,Zwift - Cycling Ireland Zwift League Rd 8 (A),Quarq Dfour,Wahoo Kickr,348,345,3
98387,1610874899,wahoo,Zwift - Fantasy Nutrinovex Rice (A),Quarq Dfour,Wahoo Kickr,409,409,0
99666,1611080283,wahoo,Zwift - Zwift Racing League | WTRL - Men&#039;s/Mixed EMEA E1 DIVISION 1 (A),Quarq Dfour,Wahoo Kickr,402,404,-2
103878,1611684900,wahoo,Zwift - Zwift Racing League | WTRL - Men&#039;s/Mixed EMEA E1 DIVISION 1 (A),Quarq Dfour,Wahoo Kickr,413,409,4
107311,1612289700,wahoo,Zwift - Zwift Racing League | WTRL - Men&#039;s/Mixed EMEA E1 DIVISION 1 (A),Quarq Dfour,Wahoo Kickr,423,407,16
108592,1612378801,wahoo,Zwift - Open - Movistar Team Challenge Community Qualifier Race #1,Quarq Dfour,Wahoo Kickr,408,406,2
109427,1612548003,wahoo,Zwift - KIRCHMAIR Race Series (A),Quarq Dfour,Wahoo Kickr,409,403,6
109429,1612549800,wahoo,Zwift - KIRCHMAIR Race Series (A),Quarq Dfour,Wahoo Kickr,393,396,-3
111514,1612894682,wahoo,Zwift - Zwift Racing League | WTRL - Men&#039;s/Mixed EMEA E1 DIVISION 1 (A),Quarq Dfour,Wahoo Kickr,415,412,3
112304,1612983010,wahoo,Zwift - ATR Clubhouse Bash 4WAY (A),Quarq Dfour,Wahoo Kickr,427,421,6
115926,1613499299,wahoo,Zwift - Zwift Racing League | WTRL - Men&#039;s/Mixed EMEA E1 DIVISION 1 (A),Quarq Dfour,Wahoo Kickr,402,392,10
122954,1614709200,wahoo,Zwift - Zwift Racing League | WTRL - Men&#039;s/Mixed EMEA E1 DIVISION 1 (A),Quarq Dfour,Wahoo Kickr,397,406,-9
124573,1614969000,wahoo,Zwift - KIRCHMAIR Race Series (A),Quarq Dfour,Wahoo Kickr,414,404,10
126216,1615316594,wahoo,Zwift - London,Quarq Dfour,Wahoo Kickr,401,395,6
129283,1615921380,wahoo,Zwift - 3R Omnium Event - Race 2 - iTT (E),Quarq Dfour,Wahoo Kickr,412,401,11
53199,1599129617,wahoo,Zwift - DIRT Doozy Race (A),4ii Power Meter,Wahoo Kickr Core,415,416,-1
55137,1600106394,wahoo,Zwift - Invitational League // Qualifying Race #1,4ii Power Meter,Wahoo Kickr Core,440,432,8
55439,1600200916,wahoo,Zwift - JETT ZWIFT Morning Race (A),4iii Power Meter,Wahoo Kickr Core,311,322,-11
55942,1600367412,wahoo,Zwift - Invitational League // Qualifying Race #2 (Men) ,4iii Power Meter,Wahoo Kickr Core,382,412,-30
58647,1601485859,wahoo,Zwift - Watopia,4iii Power Meter,Wahoo Kickr Core,80,429,-349
59229,1601727473,wahoo,Zwift - London,4iii Power Meter,Wahoo Kickr Core,204,211,-7
59249,1601727473,wahoo,Zwift - Watopia,4iii Power Meter,Wahoo Kickr Core,204,437,-233
59250,1601731131,wahoo,Zwift - Watopia,4iii Power Meter,Wahoo Kickr Core,419,437,-18
61340,1602528541,wahoo,Zwift - Premier Division // Zwift Racing League (men) ,4iii Power Meter,Wahoo Kickr Core,434,458,-24
117348,1613674821,wahoo,Zwift - FLANDERS The BZR Ronde Watopian League (A),4iii Power Meter,Wahoo Kickr Core,409,409,0
117436,1613674795,wahoo,Zwift - London,4iii Power Meter,Wahoo Kickr Core,0,408,-408
119455,1614086997,wahoo,Zwift - ZHQ FutureWorks Circuit Race - Anti-sandbagging (A),4iii Power Meter,Wahoo Kickr Core,287,286,1
119859,1614086997,wahoo,Zwift - Zwift Racing League | WTRL - Men&#039;s/Mixed EMEA E1 DIVISION 1 (A),4iii Power Meter,Wahoo Kickr Core,414,304,110
119880,1614104098,wahoo,Zwift - Zwift Racing League | WTRL - Men&#039;s/Mixed EMEA E1 DIVISION 1 (A),4iii Power Meter,Wahoo Kickr Core,414,413,1
121888,1614460198,wahoo,Zwift - 3R Gotham Grind Flat Race - 3 Laps (27.8km/17.4mi 87m) (A),4iii Power Meter,Wahoo Kickr Core,401,395,6
123198,1614709108,wahoo,Zwift - Zwift Racing League | WTRL - Men&#039;s/Mixed EMEA E1 DIVISION 1 (A),4iii Power Meter,Wahoo Kickr Core,417,403,14
125851,1615231194,wahoo,Zwift - Team TFC Mad Monday Race Series (high-end categories) (A),4iii Power Meter,Wahoo Kickr Core,442,422,20
127095,1615486555,wahoo,Zwift - 03/11/2021,4iii Power Meter,Wahoo Kickr Core,406,406,0
128796,1615835997,wahoo,Zwift - Team TFC Mad Monday Race Series (high-end categories) (A),4iii Power Meter,Wahoo Kickr Core,428,431,-3
85330,1608451375,neo,Zwift - Watopia,Favero Assioma Duo,Tacx Neo Smartbike,208,213,-5
85719,1608552429,neo,Zwift - Three Sisters Zada test ,Favero Assioma Duo,Tacx Neo Smartbike,453,463,-10
102937,1611598920,neo,Zwift - Premier Division // Zwift Racing League (men) (A),Favero Assioma Duo,Tacx Neo Smartbike,425,443,-18
106926,1612206823,neo,Zwift - Premier Division // Zwift Racing League (men) (A),Favero Assioma Duo,Tacx Neo Smartbike,387,411,-24
108762,1612453103,neo,Zwift - 5x8 min ftp,Favero Assioma Duo,Tacx Neo Smartbike,373,383,-10
109332,1612537105,neo,Zwift - 15minST10sek650,Favero Assioma Duo,Tacx Neo Smartbike,311,321,-10
110586,1612717369,neo,Zwift - Watopia,Favero Assioma Duo,Tacx Neo Smartbike,390,397,-7
111073,1612808802,neo,Zwift - Premier Division // Zwift Racing League (men) (A),Favero Assioma Duo,Tacx Neo Smartbike,417,432,-15
115411,1613415186,neo,Zwift - Premier Division // Zwift Racing League (men) (A),Favero Assioma Duo,Tacx Neo Smartbike,440,458,-18
118986,1613927612,neo,Zwift - Watopia,Favero Assioma Duo,Tacx Neo Smartbike,393,402,-9
119159,1614018293,neo,Zwift - Premier Division // Zwift Racing League (men) (A),Favero Assioma Duo,Tacx Neo Smartbike,374,392,-18
120373,1614189178,neo,Zwift - Scandinavian Cup 2021 - Round 1 - Men (A),Favero Assioma Duo,Tacx Neo Smartbike,401,415,-14
122647,1614626679,neo,Zwift - Premier Division // Zwift Racing League (men) (A),Favero Assioma Duo,Tacx Neo Smartbike,402,414,-12
123609,1614794963,neo,Zwift - Scandinavian Cup 2021 - Round 2 - Men (A),Favero Assioma Duo,Tacx Neo Smartbike,403,414,-11
126650,1615398796,neo,Zwift - Scandinavian Cup 2021 - Round 3 - Men (A),Favero Assioma Duo,Tacx Neo Smartbike,426,443,-17
40851,1591814116,wahoo,Zwift - Deeside Thistle and Moray Firth Time Trial Special (A),Favero Assioma Duo - Zwfit,WattBike Atom - Wahoo,414,406,8
55371,1600192495,wahoo,Zwift - Team Italy & Frenchy Fuzion League (A),WattBike Atom - Zwift,Favero Assioma Duo - Wahoo Elemnt,367,401,-34
55552,1600273798,wahoo,Zwift - LEQP Provence Rose Ride (C),WattBike Atom - Zwift,Favero Assioma Duo - Wahoo Elemnt,254,264,-10
55892,1600367355,wahoo,Zwift - Invitational League // Qualifying Race #2 (Men) ,WattBike Atom - Zwift,Favero Assioma Duo - Wahoo Elemnt,402,422,-20
63220,1603133661,wahoo,ZADA - Three Sisters Test (Take 2),WattBike Atom - Zwift,Favero Assioma Duo - Wahoo Elemnt,390,421,-31
81184,1607541895,wahoo,Deeside Thistle and Moray Firth Race,Favero Assioma Duo - Zwfit,WattBike Atom - Wahoo,403,397,6
81628,1607624991,wahoo,FUSION DECEMBER CUP,Favero Assioma Duo - Zwfit,WattBike Atom - Wahoo,432,415,17
82780,1607873094,wahoo,3R Watopia 65km Race - 6 laps (40mi 324m),Favero Assioma Duo - Zwfit,WattBike Atom - Wahoo,412,412,0
83194,1607973595,wahoo,Team TFC Mad Monday Winter Series,Favero Assioma Duo - Zwfit,WattBike Atom - Wahoo,422,416,6
83533,1608056631,wahoo,Zwift Racing League | WTRL - Mens EMEA E1 DIVISION 1,Favero Assioma Duo - Zwfit,WattBike Atom - Wahoo,425,419,6
84056,1608146695,wahoo,Deeside Thistle and Moray Firth Race,Favero Assioma Duo - Zwfit,WattBike Atom - Wahoo,407,408,-1
84289,1608221693,wahoo,OH MY CRIT! - The Double Race 1/2,Favero Assioma Duo - Zwfit,WattBike Atom - Wahoo,446,443,3
84326,1608224684,wahoo,OH MY CRIT! - The Double Race 2/2,Favero Assioma Duo - Zwfit,WattBike Atom - Wahoo,442,423,19
84814,1608317994,wahoo,Tour of New York Stage 1,WattBike Atom - Zwift,Favero Assioma Duo - Wahoo Elemnt,414,409,5
85081,1608382795,wahoo,Tour of New York Stage 2,WattBike Atom - Zwift,Favero Assioma Duo - Wahoo Elemnt,439,429,10
85469,1608473689,wahoo,KISS 100 Race Series - Americas,WattBike Atom - Zwift,Favero Assioma Duo - Wahoo Elemnt,373,394,-21
85878,1608578388,wahoo,Team TFC Mad Monday Winter Series,WattBike Atom - Zwift,Favero Assioma Duo - Wahoo Elemnt,408,410,-2
86951,1608826489,wahoo,OH MY CRIT! - The Double Race 1/2,WattBike Atom - Zwift,Favero Assioma Duo - Wahoo Elemnt,432,427,5
86979,1608829479,wahoo,OH MY CRIT! - The Double Race 2/2,WattBike Atom - Zwift,Favero Assioma Duo - Wahoo Elemnt,408,413,-5
90286,1609603483,wahoo,3R Classique Flat Race - 4 Laps (26.9km/16.7mi 76m),WattBike Atom - Zwift,Favero Assioma Duo - Wahoo Elemnt,406,415,-9
91385,1609787992,wahoo,Team TFC Mad Monday Winter Series,WattBike Atom - Zwift,Favero Assioma Duo - Wahoo Elemnt,419,411,8
92939,1610044184,wahoo,Zwift - FUSION WINTER CUP (A),WattBike Atom - Zwift,Favero Assioma Duo - Wahoo Elemnt,434,438,-4
93901,1610205288,wahoo,OH MY CRIT - Saturday Smash Race,WattBike Atom - Zwift,Favero Assioma Duo - Wahoo Elemnt,411,435,-24
94485,1610288094,wahoo,Zwift - KISS 100 Race Series - Americas (A),WattBike Atom - Zwift,Favero Assioma Duo - Wahoo Elemnt,415,432,-17
112334,1612016989,wahoo,Zwift - 1.5 Hour LSD,WattBike Atom - Zwift,Favero Assioma Duo - Wahoo Elemnt,251,269,-18
112373,1612980247,wahoo,Zwift - 1.5 Hour LSD,WattBike Atom - Zwift,Favero Assioma Duo - Wahoo Elemnt,251,269,-18
114736,1613312085,wahoo,Zwift - Feedback Session,Favero Assioma Duo - Zwfit,WattBike Atom - Wahoo,410,381,29
117261,1613672677,wahoo,Doppio ,Favero Assioma Duo - Zwfit,WattBike Atom - Wahoo,431,406,25
119922,1614127555,wahoo,Zwift - Zwift Racing League | WTRL - Men&#039;s/Mixed AMERICAS E DIVISION 1 (A),WattBike Atom - Zwift,Favero Assioma Duo - Wahoo Elemnt,405,427,-22
2713,1569577525,neo,Zwift - KISS AT Base,SRM,Tacx Neo,281,290,-9
2953,1569919846,neo,Zwift - Eat The Pain Race #KODAnutrition,SRM,Tacx Neo,380,379,1
3042,1570007179,neo,Zwift - DIRT Cup Series - Team Sweep,SRM,Neo,403,408,-5
3121,1570093756,neo,Zwift - KISS Americas AM,SRM,Tacx Neo,366,376,-10
3418,1572338855,neo,Eat The Pain Race,SRM,Tacx Neo,393,398,-5
78853,1606993200,neo,Zwift - KISS Race Series - Americas AM (A),Powermeter Stages Cycling,Tacx Neo,418,413,5
79688,1607162400,neo,Cycling Ireland Zwift League Rd 4,Powermeter Stages Cycling,Tacx Neo,431,429,2
79731,1607173621,neo,Zwift - Frenchy Fuzion Watopia Tour – Etape 6,Powermeter Stages Cycling,Tacx Neo,422,426,-4
80715,1607425200,neo,KISS Race Series - Americas AM,Powermeter Stages Cycling,Tacx Neo,469,468,1
81842,1607598000,neo,KISS Race Series - Americas AM,Powermeter Stages Cycling,Tacx Neo,426,417,9
83013,1607864700,neo,Zwift - 3R Watopia Flat Route Race - 4 Laps (40.5km/25.1mi 216m) (A),Powermeter Stages Cycling,Tacx Neo,409,402,7
83426,1608030002,neo,KISS Race Series - Americas AM,Powermeter Stages Cycling,Tacx Neo,465,468,-3
84230,1608202802,neo,KISS Race Series - Americas AM,Powermeter Stages Cycling,Tacx Neo,464,453,11
84771,1608310801,neo,Zwift - Tour of New York Stage 1 - Open Longer,Powermeter Stages Cycling,Tacx Neo,412,406,6
91081,1609600499,neo,Zwift - OH MY CRIT - Saturday Smash Race (A),Powermeter Stages Cycling,Tacx Neo,427,420,7
91083,1609600499,neo,Zwift - OH MY CRIT - Saturday Smash Race (A),Powermeter Stages Cycling,Tacx Neo,427,420,7
92031,1609844401,neo,Zwift - KISS Race Series - Americas AM (A),Powermeter Stages Cycling,Tacx Neo,468,460,8
92169,1609929901,neo,Zwift - The Morning Grind by STPC (A),Powermeter Stages Cycling,Tacx Neo,487,475,12
92317,1609956000,neo,Zwift - MIDWEEK Winter Series by SZR (A),Powermeter Stages Cycling,Tacx Neo,416,405,11
93340,1610113801,neo,Zwift - KISS Race Series - Pacific AM (A),Powermeter Stages Cycling,Tacx Neo,496,486,10
95465,1610449191,neo,Zwift - KISS Race Series - Americas AM (A),Powermeter Stages Cycling,Tacx Neo,444,428,16
95466,1610453096,neo,Zwift - 3R Gotham Grind Flat Race - 2 Laps (18.5km/11.6mi 58m) (A),Powermeter Stages Cycling,Tacx Neo,444,433,11
96211,1610534700,neo,Zwift - The Morning Grind by STPC (A),Powermeter Stages Cycling,Tacx Neo,398,388,10
96349,1610560800,neo,Zwift - MIDWEEK Winter Series by SZR (A),6102233745_ACTIVITY,Tacx Neo,457,436,21
96868,1610640901,neo,Zwift - OH MY CRIT! - The Double Race 1/2 (A),Powermeter Stages Cycling,Tacx Neo,423,413,10
98248,1610820176,neo,Zwift - Championnat des departements Frenchy Fuzion (E),Powermeter Stages Cycling,Tacx Neo,453,438,15
99576,1611054006,neo,Zwift - KISS Race Series - Americas AM (A),Powermeter Stages Cycling,Tacx Neo,501,495,6
102073,1611424977,neo,Zwift - Championnat des Regions Frenchy Fuzion (E),Powermeter Stages Cycling,Tacx Neo,486,467,19
103278,1611658796,neo,Zwift - KISS Race Series - Americas AM (A),Powermeter Stages Cycling,Tacx Neo,450,437,13
104513,1611827920,neo,Zwift - Japan ZWIFT Hill Climb Race (A),Powermeter Stages Cycling,Tacx Neo,467,444,23
105382,1611989916,neo,Zwift - 3R Weekend Race Club - Race 1 (A),Powermeter Stages Cycling,Tacx Neo,434,422,12
107183,1612260097,neo,Zwift - KISS Race Series - Americas AM (A),Powermeter Stages Cycling,Tacx Neo,480,466,14
108221,1612375192,neo,Zwift - LES ROUTES DE ZWIFT Frenchy Fuzion - Etape 1 (C),Powermeter Stages Cycling,Tacx Neo,434,418,16
108850,1612460847,neo,Zwift - LES ROUTES DE ZWIFT Frenchy Fuzion - Etape 2 (E),Powermeter Stages Cycling,Tacx Neo,493,474,19
109446,1612545848,neo,Zwift - LES ROUTES DE ZWIFT Frenchy Fuzion - Etape 3 (E),Powermeter Stages Cycling,Tacx Neo,438,430,8
109679,1612600700,neo,Zwift - LES ROUTES DE ZWIFT Frenchy Fuzion - Etape 4 (A),Powermeter Stages Cycling,Tacx Neo,486,480,6
110009,1612628864,neo,Zwift - LES ROUTES DE ZWIFT Frenchy Fuzion - Etape 5 (E),Powermeter Stages Cycling,Tacx Neo,447,448,-1
111377,1612865017,neo,Zwift - KISS Race Series - Americas AM (A),Powermeter Stages Cycling,Tacx Neo,430,426,4
111485,1612889505,neo,Zwift - 3R Volcano KOM After Party Race - 2 laps + climb (40.2km/25mi 286m) (A),Powermeter Stages Cycling,Tacx Neo,439,430,9
112586,1612977664,neo,Zwift - MIDWEEK Winter Series by SZR (A),Powermeter Stages Cycling,Tacx Neo,416,410,6
112723,1613038246,neo,Zwift - KISS Race Series - Americas AM (A),Powermeter Stages Cycling,Tacx Neo,420,418,2
127027,1615480615,neo,Zwift - OH MY CRIT!! - The Double Race 2/2 (A),Powermeter Stages Cycling,Tacx Neo,423,413,10
127028,1615449525,neo,Zwift - ZESP ,Powermeter Stages Cycling,Tacx Neo,455,444,11
127889,1615621494,neo,Zwift - TEAM VEGAN Tofu Tornado XL (A),Powermeter Stages Cycling,Tacx Neo,440,442,-2
112,1565767518,neo,Zwift - PM dual comparison,Quarq Riken,Tacx Neo,241,232,9
3603,1570614308,neo,Zwift - DIRT Cup Series (A) + cooldown,Quarq Riken,Tacx Neo,363,350,13
3641,1572688181,neo,Neo / Quarq accuracy comparison,Quarq Riken (SRM PC8),Tacx Neo,291,282,9
3778,1572940747,neo,Zwift - Watopia / Accuracy Test,Quarq Riken (SRM PC8),Tacx Neo,257,251,6
3995,1573294159,neo,Pre Race Ride - Alp Du Zwift (DFour / Neo),Quarq DFour,Tacx Neo,330,318,12
6158,1576224424,neo,Base Endurance ERG Accuracy Test,Quarq Riken (SRM PC8),Tacx Neo FE-C,234,230,4
6159,1576224424,neo,Base Endurance Free Ride Accuracy Test,Quarq Riken (SRM PC8),Tacx Neo FE-C,248,238,10
6235,1576005002,neo,Quarq Riken (SRM PC8) / Tacx Neo (Training Ride),Quarq Riken (SRM PC8),Tacx Neo,370,362,8
6238,1576313986,neo,14/12 Neo vs. Quarq Riken,Quarq Riken (SRM PC8),Tacx Neo,370,362,8
6335,1576403785,neo,15/12 Tacx Neo vs. Quarq DFour - 9 Stages of DIRT,Quarq DFour (SRM PC8),Tacx Neo,345,337,8
7189,1577179821,neo,Tacx Test - 24/12,Quarq Riken (SRM PC8),Tacx Neo,211,205,6
7272,1577299405,neo,Warmup + FIETS Magazine Race Series,Quarq Riken (SRM PC8),Tacx Neo,319,302,17
7392,1577434196,neo,Warmup + 3R Whole Lotta Lava Hilly Race + Cooldown,Quarq Riken (SRM PC8),Tacx Neo,337,325,12
8987,1578822465,neo,dPAC.fit Climbers Day + cooldown,Quarq Riken (SRM PC8),Tacx Neo,346,331,15
9583,1579112772,neo,Warmup + Tour de Zwift // Pro-Am Invitational,Quarq DFour (SRM PC8),Tacx Neo,370,346,24
9763,1579247554,neo,Another Neo accuracy Test,Quarq Riken - Edge 500,Tacx Neo FE-C,247,241,6
9877,1579339112,neo,warmup + DBR Saturday Race + 1h Cooldown,Quarq DFour (SRM PC8),Tacx Neo,336,319,17
10225,1579596051,neo,Warmup + 3R Whole Lotta Lava Hilly Race,Quarq Riken (SRM PC8),Tacx Neo,345,331,14
10757,1579854631,neo,Warmup + Tour de Zwift Stage 4 - DNF,Quarq Riken (SRM PC8),Tacx Neo,374,364,10
11311,1580225696,neo,Warmup + 3R Ultimate Racing League (A),Quarq Riken (SRM PC8),Tacx Neo,363,351,12
11913,1580400788,neo,Quarq DFour (SRM PC8) / Tacx Neo,Quarq DFour (SRM PC8),Tacx Neo,346,327,19
12456,1580840133,neo,Zwift - Tour de Zwift // Pro-Am Invitational (A),Quarq DFour (SRM PC8),Tacx Neo,343,340,3
13116,1581240407,neo,Quarq Riken (SRM PC8) / Tacx Neo,Quarq Riken (SRM PC8),Tacx Neo,352,339,13
15530,1582624379,neo,Warmup + Eat The Pain Race 25/02,Quarq Riken (SRM PC8),Tacx Neo,359,348,11
18153,1584267208,neo,Ramp Test + Indoor Specialist Gravel Grinder,Quarq Riken (SRM PC8),Tacx Neo,381,377,4
19155,1584867607,neo,3R Tour of Ice & Fire + Z2 ERG + Indoor Specialist Gravel Grinder,Quarq Riken (SRM PC8),Tacx Neo,334,324,10
19836,1585247600,neo,Warmup + KALAS Cup,Quarq Riken (SRM PC8),Tacx Neo,343,323,20
21648,1585896022,neo, Haute Route Watopia Stage 1,Quarq Riken (SRM PC8),Tacx Neo,367,358,9
21977,1585989523,neo,Warmup +  Haute Route Watopia Stage 2 (E),Quarq Riken (SRM PC8),Tacx Neo,357,338,19
22245,1586075428,neo,Haute Route Watopia Stage 3 (incl. warmup & cooldown),Quarq Riken (SRM PC8),Tacx Neo,343,335,8
23084,1586367028,neo,USA Cycling Race League by Indoor Specialist (incl. warmup & cooldown),Quarq Riken (SRM PC8),Tacx Neo,351,331,20
23978,1586681067,neo,dPAC.fit Climbers Day (12/04 - w/ warmup),Quarq Riken (SRM PC8),Tacx Neo,354,340,14
34258,1589360965,neo,USA Cycling Race League by Indoor Specialist (incl. warmup & cooldown),Quarq Riken (SRM PC8),Tacx Neo (Garmin Edge),351,338,13
40492,1591692443,neo,SRAM Send it Series - Race 5 - Mens (Warmup + Cooldown in ERG),Quarq Riken (SRM PC8),Tacx Neo (Garmin Edge),354,335,19
43500,1593070521,neo,FutureWorks Boost Mode Test Race (w/ warmup and cooldown),Quarq Riken (SRM PC8),Tacx Neo (Garmin Edge),344,326,18
43732,1593193203,neo,3R Lutscher CCW Climbing Race (w/ warmup & cooldown),Quarq Riken (SRM PC8),Tacx Neo (Garmin Edge),400,390,10
47136,1595320662,neo,3R Turbocharged Team Race Series (w/ warmup & cooldown),Quarq Riken (SRM PC8),Tacx Neo (Garmin Edge),317,319,-2
49875,1597337419,neo,WTRL Team Time Trial PREMIER LEAGUE,Quarq DFour (SRM PC8),Tacx Neo (Garmin Edge),334,317,17
52124,1598518013,neo,Cycling Australias The Chop by AHDR (w/ warmup & cooldown),Quarq Riken (SRM PC8),Tacx Neo (Garmin Edge),348,329,19
52930,1598979640,neo,WTRL Gravel Series (w/ warmup + cooldown9,Quarq Riken (SRM PC8),Tacx Neo (Garmin Edge),355,340,15
54312,1599725882,neo,Zwift - Cycling Australia&#039;s The Chop by AHDR (A),Quarq Riken (SRM PC8),Tacx Neo FE-C (Zwift),343,322,21
55331,1600153425,neo,Zwift - 3R UCI Worlds Race - 1 Lap (23.7km/14.7mi 494m) (A),Quarq Riken (SRM PC8),Tacx Neo FE-C (Zwift),357,340,17
56014,1600364222,neo,Zwift - Invitational League // Qualifying Race #2 (A),Quarq Riken (SRM PC8),Tacx Neo FE-C (Zwift),357,340,17
116697,1613584493,neo,Zwift - Watopia,Stages G3 Dual sided,Tacx Neo,319,339,-20
117172,1613664893,neo,Zwift - OH MY CRIT!! - The Double Race 1/2 (A),Stages G3 dual sided,Tacx Neo,342,366,-24
117200,1613667899,neo,Zwift - OH MY CRIT!! - The Double Race 2/2 (A),Stages G3 dual sided,Tacx Neo,347,360,-13
118339,1613837159,neo,Zwift - 3R Endurance Series p/b OTE Sports- Stage 1 (A),Stages G3 dual sided,Tacx Neo,330,344,-14
120402,1614189592,neo,Zwift - MIDWEEK Winter Series by SZR (A),Stages G3 dual sided,Tacx Neo,337,358,-21
120856,1614269693,neo,Zwift - OH MY CRIT!! - The Double Race 1/2 (A),Stages G3 dual sided,Tacx Neo,323,348,-25
120857,1614272692,neo,Zwift - OH MY CRIT!! - The Double Race 2/2 (A),Stages G3 dual sided,Tacx Neo,303,317,-14
123619,1614796103,neo,Zwift - 3R Race - France Petit Boucle - 45KM (A),Stages G3 dual sided,Tacx Neo,326,347,-21
124059,1614874506,neo,Zwift - OH MY CRIT!! - The Double Race 1/2 (A),Stages G3 dual sided,Tacx Neo,335,351,-16
124061,1614877511,neo,Zwift - OH MY CRIT!! - The Double Race 2/2 (A),Stages G3 dual sided,Tacx Neo,354,362,-8
125059,1615046752,neo,Zwift - 3R Endurance Series p/b OTE Sports (A),Stages G3 dual sided,Tacx Neo,315,317,-2
127086,1615482284,neo,Zwift - OH MY CRIT!! - The Double Race 2/2 (A),Stages G3 dual sided,Tacx Neo,333,356,-23
127556,1615568694,neo,Zwift - 3R Racing (A),Stages G3 dual sided,Tacx Neo,329,337,-8
128042,1615651555,neo,Zwift - 3R Endurance Series p/b OTE Sports (A),Stages G3 dual sided,Tacx Neo,350,354,-4
129313,1615919390,neo,Zwift - CeramicSpeed Race Series: Open Race (A),Stages left,Tacx Neo,332,353,-21
3950,1573203899,wahoo,Zwift - 3R Whole Lotta Lava Hilly Race - 2 Laps (28.9km/12.53mi 336m) (A),Quarq DFour,Wahoo Kickr 2017 with Element Bolt,0,0,0
3990,1573283414,wahoo,Team ZWC Weekend Race,Quarq D-four,Wahoo Kickr 2017 with Element Bolt,0,0,0
4121,1573554002,wahoo,Zwift - Eat The Pain Race (A),Quarq DFour,Wahoo Kickr 2017 with Element Bolt,0,0,0
4319,1573888199,wahoo,Zwift - Team ZWC Weekend Race - The Highline 6Laps (A),Quarq DFour,Wahoo Kickr 2017 with Element Bolt,0,0,0
4456,1574158798,wahoo,Zwift - Eat The Pain Race (A),Quarq DFour,Wahoo Kickr 2017 with Element Bolt,0,0,0
4601,1574332499,wahoo,Zwift - Japan ZWIFT Hillclimb Race (A),Quarq DFour,Wahoo Kickr 2017 with Element Bolt,0,0,0
4712,1574493000,wahoo,Zwift - Team ZWC Weekend Race - Quatch Quest (A),Quarq DFour,Wahoo Kickr 2017 with Element Bolt,0,0,0
5050,1574937299,wahoo,Zwift - Japan ZWIFT Hillclimb Race (A),Quarq DFour,Wahoo Kickr 2017 with Element Bolt,0,0,0
5181,1575097798,wahoo,Zwift - Team ZWC Weekend Race - Zwift Medio Fondo (A),Quarq DFour,Wahoo Kickr 2017 with Element Bolt,0,0,0
5248,1575179998,wahoo,Zwift - KISS at Race 100 - EU (A),Quarq DFour,Wahoo Kickr 2017 with Element Bolt,0,0,0
5353,1575368399,wahoo,Zwift - Eat The Pain Race (A),Quarq DFour,Wahoo Kickr 2017 with Element Bolt,0,0,0
5893,1575973199,wahoo,Zwift - Eat The Pain Race (A),Zwift,Wahoo Kickr 2017 with Element Bolt,302,304,-2
5972,1576061099,wahoo,Zwift - DIRT Cup Series (A),Quarq DFour,Wahoo Kickr 2017,0,0,0
6465,1576578002,wahoo,Zwift - Eat The Pain Race (A),Quarq DFour,Wahoo Kickr 2017 with Element Bolt,0,0,0
7195,1577182797,wahoo,Zwift - Eat The Pain Race (A),Quarq DFour,Wahoo Kickr 2017 with Element Bolt,325,321,4
10235,1579601999,wahoo,Zwift - Eat The Pain Race (A),Quarq DFour - Zwift,Wahoo Kickr 2017 - Element Bolt,351,341,10
94976,1610390611,wahoo,Zwift - Premier Division // Zwift Racing League (men) (A),Favero Assioma DUO to Garmin Edge1000,Wahoo Kickr 2017 to Zwift,310,310,0
99167,1610998179,wahoo,Zwift - Premier Division // Zwift Racing League (men) (A),Favero Assioma DUO to Garmin Edge1000,Wahoo Kickr 2017 to Zwift,328,325,3
6605,1576520099,wahoo,Zwift - Race,"Zwift, Sram Red Quarq DZero","Garmin 520, Wahoo Kickr &#039;19",0,0,0
8622,1578591044,wahoo,DCUCup (B) - 2nd,"Zwift, Sram Red Quarq DZero","Garmin 520, Wahoo Kickr &#039;19",283,278,5
11383,1580234395,wahoo,DCU Cup,"Zwift, Sram Red Quarq DZero","Garmin 520, Wahoo Kickr &#039;19",330,312,18
11393,1580220075,wahoo,Zwift - Zwift Time Trial Tuesday: Tempus Fugit (E),"Zwift, Sram Red Quarq DZero","Garmin 520, Wahoo Kickr &#039;19",307,295,12
18941,1584731698,wahoo,Tour of Watopia Pro-Am Men&#039;s Race,"Zwift, Sram Red Quarq DZero","Garmin 520, Wahoo Kickr &#039;19",365,350,15
19459,1585077298,wahoo,Tour of Watopia Pro-Am Men&#039;s Race,"Zwift, Sram Red Quarq DZero","Garmin 520, Wahoo Kickr &#039;19",334,328,6
31738,1588702499,wahoo,UNO X CUP - ondt i benene fra søndagens vEveresting,"Zwift, Sram Red Quarq DZero","Garmin 520, Wahoo Kickr &#039;19",356,341,15
34099,1589307290,wahoo,UNO X CUP - Begynderfejl: sad for langt tilbage da feltet splitter,"*Garmin 520, Sram Red Quarq DZero","*Zwift, Wahoo Kickr &#039;19",324,312,12
56628,1600606800,wahoo,Zwift - Invitational League // Qualifying Race #3 (Men) (A),"*Garmin 830, Sram Red Quarq DZero","*Zwift, Wahoo Kickr &#039;19",363,344,19
67327,1604343601,wahoo,Zwift - EVR Europe Race (A),"Zwift, Sram Red Quarq DZero","Garmin 830, Wahoo Kickr gen 5",318,303,15
67689,1604428522,wahoo,Zwift - Zwift Racing League | WTRL - Men&#039;s EMEA E1 DIVISION 1 (A),"Zwift, Sram Red Quarq DZero","Garmin 830, Wahoo Kickr gen 5",346,330,16
78642,1606937100,wahoo,Zwift - Deeside Thistle and Moray Firth Race (A),"*Garmin 830, Sram Red Quarq DZero","Zwift, Wahoo Gen 5",315,303,12
79086,1607020198,wahoo,Zwift - FUSION DECEMBER CUP,"Zwift, Sram Red Quarq DZero","Garmin 830, Wahoo Kickr gen 5",317,301,16
80125,1607262297,wahoo,Zwift,"Garmin 830, Sram Red Quarq DZero","Zwift, Wahoo Kickr Gen 5",298,293,5
80856,1607451294,wahoo,Zwift,"Garmin 830, Sram Red Quarq DZero","Zwift, Wahoo Kickr Gen 5",345,338,7
92457,1609961393,wahoo,"Zwift, Wahoo Kickr Gen 5 / Garmin 830, Sram Red Quarq DZero","Garmin 830, Sram Red Quarq DZero","Zwift, Wahoo Kickr Gen 5",335,328,7
92949,1610044190,wahoo,"Zwift, Wahoo Kickr Gen 5 / Garmin 830, Sram Red Quarq DZero","Garmin 830, Sram Red Quarq DZero","Zwift, Wahoo Kickr Gen 5",352,353,-1
93424,1610125182,wahoo,"Zwift, Wahoo Kickr Gen 5 / Garmin 830, Sram Red Quarq DZero","Garmin 830, Sram Red Quarq DZero","Zwift, Wahoo Kickr Gen 5",349,345,4
96827,1610626490,wahoo,Zwift,"Garmin 830, Sram Red Quarq DZero","Zwift, Wahoo Kickr Gen 5",345,340,5
99023,1610990990,wahoo,Zwift,"Garmin 830, Sram Red Quarq DZero","Zwift, Wahoo Kickr Gen 5",303,298,5
101036,1611253789,wahoo,Zwift - FUSION WINTER CUP (A),"Garmin 830, Sram Red Quarq DZero","Zwift, Wahoo Kickr Gen 5",357,356,1
106844,1612200894,wahoo,Zwift - TT,"Garmin 830, Sram Red Quarq DZero","Zwift, Wahoo Kickr Gen 5",350,344,6
108955,1612463393,wahoo,Zwift - FUSION WINTER CUP #2nd,"Garmin 830, Sram Red Quarq DZero","Zwift, Wahoo Kickr Gen 5",363,356,7
111685,1612895006,wahoo,Zwift - Zwift Racing League | WTRL - Men&#039;s/Mixed EMEA E1 DIVISION 1 (A),"Garmin 830, Sram Red Quarq DZero","Zwift, Wahoo Kickr Gen 5",379,371,8
113072,1613068198,wahoo,Zwift - 02/11/2021,"Garmin 830, Sram Red Quarq DZero","Zwift, Wahoo Kickr Gen 5",365,364,1
115228,1613414665,wahoo,Zwift - KATT Race by WKG - #1,"Garmin 830, Sram Red Quarq DZero","Zwift, Wahoo Kickr Gen 5",347,338,9
117344,1613672996,wahoo,Zwift - FUSION WINTER CUP (A),"Garmin 830, Sram Red Quarq DZero","Zwift, Wahoo Kickr Gen 5",363,363,0
119533,1614099610,wahoo,Zwift - BST Mountaingoat iTT (A),"Garmin 830, Sram Red Quarq DZero","Zwift, Wahoo Kickr Gen 5",351,349,2
120842,1614277787,wahoo,Zwift - FUSION WINTER CUP (A),"Garmin 830, Sram Red Quarq DZero","Zwift, Wahoo Kickr Gen 5",407,402,5
124114,1614882575,wahoo,Zwift - 03/04/2021,"Garmin 830, Sram Red Quarq DZero","Zwift, Wahoo Kickr Gen 5",354,347,7
127172,1615487399,wahoo,Zwift - FUSION SPRING CUP (A),"Garmin 830, Sram Red Quarq DZero","Zwift, Wahoo Kickr Gen 5",352,353,-1
128749,1615832094,wahoo,Zwift -  DBR Monday Race (A),"Garmin 830, Sram Red Quarq DZero","Zwift, Wahoo Kickr Gen 5",370,358,12
129332,1615919395,wahoo,Zwift - CeramicSpeed Race Series: Open Race (A),"Garmin 830, Sram Red Quarq DZero","Zwift, Wahoo Kickr Gen 5",351,342,9
61919,1602696590,wahoo,Zwift - NCF Vinter Cup 2020 - Runde 4 - Herrer (A),Quarq axs xx1 Alma,Wahoo Kicker V5,434,422,12
67967,1604514589,wahoo,Zwift - NCF Vinter Cup 2020 - Runde 7 - Herrer (A),Favero Assioma DUO,Wahoo Kickr Bike,419,428,-9
69440,1604951990,wahoo,Zwift - Premier Division // Zwift Racing League (men) (A),Favero Assioma DUO,Wahoo Kickr Bike,484,487,-3
70273,1605119395,wahoo,Zwift - NCF Vinter Cup 2020 - Runde 8 - Herrer (A),Favero Assioma DUO,Wahoo Kickr Bike,430,434,-4
72642,1605724190,wahoo,Zwift - NCF Vinter Cup 2020 - Runde 9 - Herrer (A),Favero Assioma DUO,Wahoo Kickr Bike,401,405,-4
73146,1605814190,wahoo,Zwift - World Championships Experience // Danish Cycling Federation,Favero Assioma DUO,Wahoo Kickr Bike,422,423,-1
74695,1606161570,wahoo,Zwift - Premier Division // Zwift Racing League (men) (A),Favero Assioma DUO,Wahoo Kickr Bike,463,467,-4
76014,1606414429,wahoo,Zwift - WTRL NOPINZ WORLD TTT CHAMPIONSHIPS - Zone 4 (C),Wahoo Kickr V5,Wahoo Kickr Bike,423,424,-1
77685,1606763494,wahoo,Zwift - Premier Division // Zwift Racing League (men) (A),Favero Assioma DUO,Wahoo Kickr Bike,429,428,1
84022,1608145412,wahoo,Zwift - NCF 2020 TTT Challenge (E),Favero Assioma DUO,Wahoo Kickr Bike,424,424,0
95019,1610392483,wahoo,Zwift - Premier Division // Zwift Racing League (men) (A),Favero Assioma DUO,Wahoo Kickr Bike,459,444,15
96505,1610562589,wahoo,Zwift - NCF Vintercup 2021 - Runde 1 - Herrer (A),Favero Assioma DUO,Wahoo Kickr Bike,425,422,3
99189,1610999731,wahoo,Zwift - Premier Division // Zwift Racing League (men) (A),Favero Assioma DUO,Wahoo Kickr Bike,455,454,1
100326,1611167369,wahoo,Zwift - NCF Vintercup 2021 - Runde 2 - Herrer (A),Favero Assioma DUO,Wahoo Kickr Bike,377,384,-7
104148,1611772189,wahoo,Zwift - NCF Vintercup 2021 - Runde 3 - Herrer (A),Favero Assioma DUO,Wahoo Kickr Bike,480,478,2
106916,1612210004,wahoo,Zwift - Premier Division // Zwift Racing League (men) (A),Favero Assioma DUO,Wahoo Kickr Bike,457,466,-9
108250,1612376989,wahoo,Zwift - NCF Vintercup 2021 - Runde 4 - Herrer (A),Favero Assioma DUO,Wahoo Kickr Bike,432,434,-2
111060,1612812164,wahoo,Zwift - Premier Division // Zwift Racing League (men) (A),Favero Assioma DUO,Wahoo Kickr Bike,481,481,0
112336,1612983584,wahoo,Movistar Team Challenge // Round 1,Favero Assioma DUO,Wahoo Kickr Bike,437,420,17
113615,1613156384,wahoo,Zwift - Movistar Team Challenge // Round 1 (men),Favero Assioma DUO,Wahoo Kickr Bike,452,453,-1
115373,1613419299,wahoo,Zwift - Premier Division // Zwift Racing League (men) (A),Favero Assioma DUO,Wahoo Kickr Bike,454,459,-5
116738,1613588380,wahoo,Zwift - Movistar Team Challenge // Round 2 (men) - Race 3/4,Favero Assioma DUO,Wahoo Kickr Bike,428,427,1
117911,1613761180,wahoo,Zwift - Movistar Team Challenge // Round 2 (men),Favero Assioma DUO,Wahoo Kickr Bike,469,468,1
119149,1614020984,wahoo,Zwift - Premier Division // Zwift Racing League (men) (A),Favero Assioma DUO,Wahoo Kickr Bike,454,454,0
122562,1614629972,wahoo,Zwift - Premier Division // Zwift Racing League (men) (A),Favero Assioma DUO,Wahoo Kickr Bike,412,412,0
129305,1615919389,wahoo,Zwift - CeramicSpeed Race Series: Open Race (A),Favero Assioma DUO,Wahoo Kickr Bike,452,453,-1
96506,1610559532,wahoo,Zwift - 30 min 280w,Quarq Dfour,Wahoo Kickr,470,465,5
104266,1611770678,wahoo,Zwift - NCF Vintercup 2021 - Runde 3 - Herrer (A),Quarq Dfour,Wahoo Kickr,476,472,4
108295,1612375894,wahoo,Zwift - NCF Vintercup 2021 - Runde 4 - Herrer (A),Quarq Dfour,Wahoo Kickr,469,464,5
112413,1612980678,wahoo,Zwift - NCF Vintercup 2021 - Runde 5 - Herrer (A),Quarq Dfour,Wahoo Kickr,489,489,0
116764,1613585472,wahoo,Zwift - NCF Vintercup 2021 - Runde 6 - Herrer (A),Quarq Dfour,Wahoo Kickr,428,417,11
40909,1591836312,wahoo,Zwift - USA Cycling Race League by Indoor Specialist (A),SRAM Force AXS Quarq ,2019 Wahoo Kickr Power,450,443,7
50793,1597879811,wahoo,Zwift - Austin Driveway Series Criterium (A),SRAM Force AXS Quarq to Wahoo ,2019 Wahoo Kickr Power to Zwift,413,403,10
51387,1598188512,wahoo,Zwift - KISS at Race 100 - Americas (A),SRAM Force AXS Quarq to Wahoo ,2019 Wahoo Kickr Power to Zwift,334,328,6
52083,1598484626,wahoo,Zwift - Austin Driveway Series Criterium (A),SRAM Force AXS Quarq to Wahoo ,2019 Wahoo Kickr Power to Zwift,387,380,7
53158,1599089413,wahoo,Zwift - Austin Driveway Series Criterium (A),SRAM Force AXS Quarq to Wahoo ,2019 Wahoo Kickr Power to Zwift,402,392,10
53159,1599093616,wahoo,Zwift - 3R Volcano Circuit Flat Race - 4 Laps (18.9km/11.7mi 80m) (A),SRAM Force AXS Quarq to Wahoo ,2019 Wahoo Kickr Power to Zwift,395,384,11
53215,1599146113,wahoo,Zwift - OH MY CRIT! - The Double Race 1/2 (A),SRAM Force AXS Quarq to Wahoo ,2019 Wahoo Kickr Power to Zwift,389,385,4
53324,1599174013,wahoo,Zwift - Koa Sports League Warrior Race (A),SRAM Force AXS Quarq to Wahoo ,2019 Wahoo Kickr Power to Zwift,352,342,10
54255,1599694212,wahoo,Austin Driveway Series Criterium :: Finesse Wahoo DUB + SOME (5 in top 7),SRAM Force AXS Quarq to Wahoo ,2019 Wahoo Kickr Power to Zwift,349,339,10
54256,1599698723,wahoo,Zwift - USA Cycling Race League by Indoor Specialist (A),SRAM Force AXS Quarq to Wahoo ,2019 Wahoo Kickr Power to Zwift,396,384,12
54882,1600002913,wahoo,Zwift - KISS at Race 100 - Americas (A),SRAM Force AXS Quarq to Wahoo ,2019 Wahoo Kickr Power to Zwift,422,411,11
57131,1600903813,wahoo,Zwift - Austin Driveway Series Criterium (A),SRAM Force AXS Quarq to Wahoo ,2019 Wahoo Kickr Power to Zwift,384,370,14
58655,1601508616,wahoo,Zwift - Austin Driveway Series Criterium (A),SRAM Force AXS Quarq to Wahoo ,2019 Wahoo Kickr Power to Zwift,377,364,13
61677,1602632715,wahoo,Zwift - Zwift Racing League | WTRL (A),SRAM Force AXS Quarq to Wahoo ,2019 Wahoo Kickr Power to Zwift,437,421,16
61701,1602640819,wahoo,Zwift - Zwift Racing League | WTRL,SRAM Force AXS Quarq to Wahoo ,2019 Wahoo Kickr Power to Zwift,377,374,3
63993,1603323017,wahoo,Zwift - Austin Driveway Series Criterium (A),SRAM Force AXS Quarq to Wahoo ,2019 Wahoo Kickr Power to Zwift,392,379,13
65616,1603842317,wahoo,Zwift - Zwift Racing League | WTRL - AMERICAS E (MEN) -  Division 1 (A),SRAM Force AXS Quarq to Wahoo ,2019 Wahoo Kickr Power to Zwift,415,403,12
67851,1604451919,wahoo,Zwift - Zwift Racing League | WTRL - Men&#039;s AMERICAS E DIVISION 1 (A),SRAM Force AXS Quarq to Wahoo ,2019 Wahoo Kickr Power to Zwift,395,383,12
70017,1605055511,wahoo,Zwift - Zwift Racing League | WTRL - AMERICAS E (MEN) -  Division 1 (A),SRAM Force AXS Quarq to Wahoo ,2019 Wahoo Kickr Power to Zwift,450,432,18
70919,1605222922,wahoo,Zwift - Koa Sports League Warrior Race (A),SRAM Force AXS Quarq to Wahoo ,2019 Wahoo Kickr Power to Zwift,344,334,10
72787,1605747912,wahoo,Zwift - Cycling Canada Wednesday Night Race Series (A),SRAM Force AXS Quarq to Wahoo ,2019 Wahoo Kickr Power to Zwift,413,403,10
75286,1606265123,wahoo,Zwift - Zwift Racing League | WTRL - Men&#039;s AMERICAS E DIVISION 1,SRAM Force AXS Quarq to Wahoo ,2019 Wahoo Kickr Power to Zwift,419,409,10
75708,1606350613,wahoo,Zwift - Austin Driveway Series Criterium (A),SRAM Force AXS Quarq to Wahoo ,2019 Wahoo Kickr Power to Zwift,354,337,17
76472,1606485013,wahoo,Zwift - KISS Race Series - Pacific AM (A),SRAM Force AXS Quarq to Wahoo ,2019 Wahoo Kickr Power to Zwift,395,385,10
78309,1606870510,wahoo,Zwift - Zwift Racing League | WTRL - Men&#039;s AMERICAS E DIVISION 1 (A),SRAM Force AXS Quarq to Wahoo ,2019 Wahoo Kickr Power to Zwift,395,387,8
78723,1606951813,wahoo,Zwift - ZHQ FutureWorks Circuit Race - Anti-sandbagging (A),SRAM Force AXS Quarq to Wahoo ,2019 Wahoo Kickr Power to Zwift,358,344,14
78752,1606959919,wahoo,Zwift - USA Cycling Race League by Indoor Specialist (A),SRAM Force AXS Quarq to Wahoo ,2019 Wahoo Kickr Power to Zwift,391,378,13
81051,1607474720,wahoo,Zwift - Zwift Racing League | WTRL - Men&#039;s AMERICAS E DIVISION 1 (A),SRAM Force AXS Quarq to Wahoo ,2019 Wahoo Kickr Power to Zwift,423,412,11
85105,1608390924,wahoo,Zwift - OH MY CRIT - Saturday Smash Race (A),SRAM Force AXS Quarq to Wahoo ,2019 Wahoo Kickr Power to Zwift,434,423,11
85405,1608469214,wahoo,Zwift - Tour of New York Stage 3 - Open Longer,SRAM Force AXS Quarq to Wahoo ,2019 Wahoo Kickr Power to Zwift,364,354,10
86318,1608683416,wahoo,Zwift - Midweek Criterium Race (A),SRAM Force AXS Quarq to Wahoo ,2019 Wahoo Kickr Power to Zwift,369,358,11
86732,1608771913,wahoo,Zwift - Cycling Canada Wednesday Night Race Series (A),SRAM Force AXS Quarq to Wahoo ,2019 Wahoo Kickr Power to Zwift,445,434,11
87578,1609007332,wahoo,Kickr V5 Testing ,SRAM Force AXS Quarq to Wahoo ,Wahoo Kickr V5 to Zwift,260,250,10
87958,1609092002,wahoo,ZADA Three Sisters Test,SRAM Force AXS Quarq to Wahoo ,Wahoo Kickr V5 to Zwift,446,434,12
88535,1609243202,wahoo,Z2 V5 Testing ,SRAM Force AXS Quarq to Wahoo ,Wahoo Kickr V5 to Zwift,309,306,3
89238,1609370402,wahoo,The Rocket Ride ,SRAM Force AXS Quarq to Wahoo ,Wahoo Kickr V5 to Zwift,368,363,5
89517,1609431321,wahoo,Zwift - OH MY CRIT! - The Double Race 1/2 (A),SRAM Force AXS Quarq to Wahoo ,Wahoo Kickr V5 to Zwift,397,386,11
89541,1609434317,wahoo,Zwift - OH MY CRIT! - The Double Race 2/2 (A),SRAM Force AXS Quarq to Wahoo ,Wahoo Kickr V5 to Zwift,404,389,15
89576,1609437313,wahoo,Zwift - Team Italy Superveloce Race (A),SRAM Force AXS Quarq to Wahoo ,Wahoo Kickr V5 to Zwift,354,340,14
89848,1609506618,wahoo,Zwift - BMTR New Year&#039;s Day 100 - Riding For Alzheimer&#039;s (A),SRAM Force AXS Quarq to Wahoo ,Wahoo Kickr V5 to Zwift,307,303,4
90298,1609605000,wahoo,Zwift - TEAM VEGAN Tofu Tornado (A),SRAM Force AXS Quarq to Wahoo ,Wahoo Kickr V5 to Zwift,412,404,8
90778,1609682480,wahoo,Zwift - Zwift Fondo Series 2020/21 (B),SRAM Force AXS Quarq to Wahoo ,Wahoo Kickr V5 to Zwift,407,398,9
92639,1609980016,wahoo,Zwift - 3R Volcano Circuit Flat Race - 4 Laps (18.9km/11.7mi 80m) (A),SRAM Quarq AXS to Wahoo,Wahoo Kickr V5 to Zwift ,372,362,10
93093,1610057712,wahoo,Zwift - 3R Alpe Du Zwift KOM Race (20km 1444m) (A),SRAM Quarq AXS to Wahoo,Wahoo Kickr V5 to Zwift ,423,410,13
93987,1610209827,wahoo,Zwift - TEAM VEGAN Tofu Tornado (A),SRAM Quarq AXS to Wahoo,Wahoo Kickr V5 to Zwift ,393,386,7
95032,1610392496,wahoo,Zwift - Premier Division // Zwift Racing League (men) (A),SRAM Quarq AXS to Wahoo,Wahoo Kickr V5 to Zwift ,425,395,30
97250,1610672422,wahoo,Zwift - KISS Race Series - Americas PM (A),SRAM Quarq AXS to Wahoo,Wahoo Kickr V5 to Zwift ,383,368,15
99247,1610999540,wahoo,Zwift - Premier Division // Zwift Racing League (men) (A),SRAM Quarq AXS to Wahoo,Wahoo Kickr V5 to Zwift ,416,403,13
100572,1611191114,wahoo,Zwift - Cycling Canada Wednesday Night Race Series (A),SRAM Quarq AXS to Wahoo,Wahoo Kickr V5 to Zwift ,414,403,11
101165,1611270002,wahoo,Zwift - Alex TenElshof &#039;s Meetup - Ven-Top,SRAM Quarq AXS to Wahoo,Wahoo Kickr V5 to Zwift ,301,285,16
102129,1611455220,wahoo,Neo Testing ,Neo2T to Zwift,Assioma Duo to Wahoo ,352,376,-24
102410,1611495901,wahoo,TC Stage Racing // Stage 7,Neo2T to Zwift,Assioma Duo to Wahoo ,429,450,-21
103769,1611698678,wahoo,Testing out new Q ring ,Neo2T to Zwift,Assioma Duo to Wahoo ,346,358,-12
104370,1611795899,wahoo,Zwift - Cycling Canada Wednesday Night Race Series (A),Neo2T to Zwift,Assioma Duo to Wahoo ,438,454,-16
104475,1611831619,wahoo,Zwift - KISS Race Series - Americas AM (A),Neo2T to Zwift,Assioma Duo to Wahoo ,399,418,-19
106912,1612210018,wahoo,Zwift - Premier Division // Zwift Racing League (men) (A),Neo2T to Zwift,Assioma Duo to Wahoo ,426,446,-20
107746,1612312499,wahoo,“Duel” recording just for the hell of it ,Neo2T to Zwift,Assioma Duo to Wahoo ,330,341,-11
110487,1612705499,wahoo,Mandred Memorial Tour // Stage 1,Neo2T to Zwift,Assioma Duo to Wahoo ,340,355,-15
111025,1612811994,wahoo,Zwift - Premier Division // Zwift Racing League (men) (A),Neo2T to Zwift,Assioma Duo to Wahoo ,422,441,-19
113191,1613084413,wahoo,Zwift - TDZ Stage 8: Group Ride,Neo2T to Zwift,Assioma Duo to Wahoo ,363,351,12
115383,1613419333,wahoo,Zwift - Premier Division // Zwift Racing League (men) (A),Neo2T to Zwift,Assioma Duo to Wahoo ,456,477,-21
119147,1614020999,wahoo,Zwift - Premier Division // Zwift Racing League (men) (A),Neo2T to Zwift,Assioma Duo to Wahoo ,381,399,-18
122615,1614629730,wahoo,Premier Division // Zwift Racing League // Race 8 TTT,Neo2T to Zwift,Assioma Duo to Wahoo ,395,413,-18
124726,1614981249,wahoo,Outdoor Dual Testing ,Assioma Duo to Wahoo ,SRAM Quarq AXS to Wahoo,363,363,0
128461,1615731320,wahoo,Zwift - KISS 100 // 6th,Neo2T to Zwift,Assioma Duo to Wahoo ,407,430,-23
106423,1612124899,wahoo,Zwift - Richmond,Favero to Edge 1030,Wahoo Kickr to Zwift,291,303,-12
106883,1612208820,wahoo,Zwift - Premier Division // Zwift Racing League (men) (A),Favero to Edge 1030,Wahoo Kickr to Zwift,390,382,8
110970,1612811585,wahoo,Zwift - Premier Division // Zwift Racing League (men) (A),Favero to Edge 1030,Wahoo Kickr to Zwift,393,386,7
115346,1613419080,wahoo,Zwift - Premier Division // Zwift Racing League (men) (A),Favero to Edge 1030,Wahoo Kickr to Zwift,406,420,-14
122540,1614628620,wahoo,Zwift - Premier Division // Zwift Racing League (men) (A),Favero to Edge 1030,Wahoo Kickr to Zwift,375,369,6
9524,1579115699,wahoo,Zwift - Tour de Zwift // Pro-Am Invitational (A),Stages 105 Left Power Meter,Wahoo Kickr Core,338,340,-2
10717,1579806899,wahoo,Zwift - Tour de Zwift // Pro-Am Invitational,Stages 105 Left Power Meter,Wahoo Kickr Core,380,364,16
12080,1580496123,wahoo,Zwift - Tour de Zwift // Pro-Am Invitational (A),Stages 105 Left Power Meter,Wahoo Kickr Core,335,350,-15
12524,1580801067,wahoo,Zwift - Tour de Zwift // Pro-Am Invitational (A) Yorkshire,Stages 105 Left Power Meter,Wahoo Kickr Core,358,365,-7
25848,1587054594,wahoo,Zwift - Trofeo Bologna Race (A),Favero Assioma DUO,Wahoo Kickr Core,383,360,23
25850,1587057113,wahoo,Zwift - ZHR Hare & Hounds Race (A),Favero Assioma DUO,Wahoo Kickr Core,312,287,25
51483,1598261699,wahoo,Zwift - Off the MAAP Invitational Race // Stage 4 (men) ,Favero Assioma DUO,Wahoo Kickr Core,373,364,9
56472,1600606800,wahoo,Zwift - Invitational League // Qualifying Race #3 (Men) (A),Favero Assioma DUO,Wahoo Kickr Core,353,352,1
61409,1602528598,wahoo,Zwift - Premier Division // Zwift Racing League (men) ,Favero Assioma DUO,Wahoo Kickr Core,382,377,5
63160,1603131351,wahoo,Zwift - Premier Division // Zwift Racing League (men) ,Favero Assioma DUO,Wahoo Kickr Core,354,345,9
67437,1604344437,wahoo,Zwift - Premier Division // Zwift Racing League (men) (A),Favero Assioma DUO,Wahoo Kickr Core,365,360,5
67438,1603742400,wahoo,Zwift - Premier Division // Zwift Racing League (men) (A),Favero Assioma DUO,Wahoo Kickr Core,370,359,11
69460,1604951999,wahoo,Zwift - Premier Division // Zwift Racing League (men) (A),Favero Assioma DUO,Wahoo Kickr Core,411,397,14
73621,1605896999,wahoo,Zwift - Team WEZ Friday Race,Favero Assioma DUO,Wahoo Kickr Core,391,387,4
76596,1606501274,wahoo,Zwift - Team WEZ Friday Race (E),Favero Assioma DUO,Wahoo Kickr Core,360,356,4
79520,1607106600,wahoo,Zwift - Team WEZ Friday Race (E),Favero Assioma DUO,Wahoo Kickr Core,336,332,4
82072,1607711400,wahoo,Zwift - Team WEZ Friday Race (E),Favero Assioma DUO,Wahoo Kickr Core,395,394,1
84838,1608316198,wahoo,Zwift - Team WEZ Friday Race (E),Favero Assioma DUO,Wahoo Kickr Core,343,344,-1
95073,1610392499,wahoo,Zwift - Premier Division // Zwift Racing League (men) (A),Favero Assioma DUO,Wahoo Kickr Core,355,336,19
102961,1611601500,wahoo,Zwift - Premier Division // Zwift Racing League (men) (A),Favero Assioma DUO,Wahoo Kickr Core,373,367,6
106924,1612210015,wahoo,Zwift - Premier Division // Zwift Racing League (men) (A),Favero Assioma DUO,Wahoo Kickr Core,334,338,-4
112422,1612983596,wahoo,Zwift - Movistar Team Challenge // Round 1 (A),Favero Assioma DUO,Wahoo Kickr Core,331,331,0
113286,1613067296,wahoo,Zwift - BRT TTT,Favero Assioma DUO,Wahoo Kickr Core,372,376,-4
113706,1613156398,wahoo,Zwift - Movistar Team Challenge // Round 1 (men),Favero Assioma DUO,Wahoo Kickr Core,384,382,2
115457,1613419319,wahoo,Zwift - Premier Division // Zwift Racing League (men) (A),Favero Assioma DUO,Wahoo Kickr Core,378,376,2
117926,1613761199,wahoo,Zwift - Movistar Team Challenge // Round 2 (men),Favero Assioma DUO,Wahoo Kickr Core,387,389,-2
119173,1614020999,wahoo,Zwift - Premier Division // Zwift Racing League (men) (A),Favero Assioma DUO,Wahoo Kickr Core,322,326,-4
122592,1614629815,wahoo,Zwift - Premier Division // Zwift Racing League (men) (A),Favero Assioma DUO,Wahoo Kickr Core,368,369,-1
79316,1607021895,wahoo,Zwift - BENELIGA 2020-2021 (E),Favero Assioma (to Zwift),Wahoo Kickr C (to Garmin),338,343,-5
81837,1607626658,wahoo,Zwift - BENELIGA 2020-2021 (E),Favero Assioma (to Zwift),Wahoo Kickr C (to Garmin),358,345,13
84593,1608231470,wahoo,Zwift - BENELIGA 2020-2021 (E),Favero Assioma (to Zwift),Wahoo Kickr C (to Garmin),365,360,5
87941,1609078391,wahoo,Zwift - KISS 100 Race Series - Americas (A),Favero Assioma (to Zwift),Wahoo Kickr C (to Garmin),340,342,-2
89126,1609351132,wahoo,Zwift - MIDWEEK Winter Series by SZR (A),Favero Assioma (to Zwift),Wahoo Kickr C (to Garmin),356,358,-2
89740,1609489708,wahoo,Zwift - Flanders Endurance Series (E),Favero Assioma (to Zwift),Wahoo Kickr C (to Garmin),367,365,2
90873,1609689841,wahoo,Zwift - 3R Tick Tock Flat Race - 1 Lap (19km/11.8mi 50m) (A),Favero Assioma (to Zwift),Wahoo Kickr C (to Garmin),327,333,-6
93017,1610045888,wahoo,BENELIGA 2020-2021,Favero Assioma (to Zwift),Wahoo Kickr C (to Garmin),356,348,8
94267,1610269168,wahoo,Zwift - Paceheads Race (A),Favero Assioma (to Garmin),Wahoo Kickr C (to Zwift),340,331,9
95084,1610392709,wahoo,Zwift - Team TFC Mad Monday Winter Series (A),Favero Assioma (to Garmin),Wahoo Kickr C (to Zwift),367,369,-2
101267,1611255459,wahoo,Zwift - BENELIGA 2020-2021 (E),Favero Assioma (to Zwift),Wahoo Kickr C (to Garmin),348,342,6
104737,1611858335,wahoo,Zwift - BENELIGA 2020-2021 (E),Favero Assioma (to Garmin),Wahoo Kickr C (to Zwift),348,342,6
109793,1612600055,wahoo,Zwift - Zwift Fondo Series: Gran Fondo,Favero Assioma (to Garmin),Wahoo Kickr C (to Zwift),354,352,2
111613,1612894896,wahoo,Zwift - Zwift Racing League | WTRL - Men&#039;s/Mixed EMEA E1 DIVISION 1 (A),Favero Assioma (to Garmin),Wahoo Kickr C (to Zwift),375,370,5
113130,1613069948,wahoo,Zwift - BENELIGA 2020-2021 (E),Favero Assioma (to Garmin),Wahoo Kickr C (to Zwift),387,389,-2
115889,1613499288,wahoo,Zwift - Zwift Racing League | WTRL - Men&#039;s/Mixed EMEA E1 DIVISION 1 (A),Favero Assioma DUO (to Garmin),Wahoo Kickr C (to Zwift),379,381,-2
117377,1613674745,wahoo,Zwift - BENELIGA 2020-2021 (E),Favero Assioma DUO (to Garmin),Wahoo Kickr C (to Zwift),344,340,4
123036,1614709155,wahoo,Zwift - Zwift Racing League | WTRL - Men&#039;s/Mixed EMEA E1 DIVISION 1 (A),Favero Assioma (to Garmin),Wahoo Kickr C (to Zwift),351,347,4
124208,1614884370,wahoo,Zwift - Flanders The BZR Ronde Spring Classics League (A),Favero Assioma DUO (to Garmin),Wahoo Kickr C (to Zwift),328,324,4
126655,1615402738,wahoo,Zwift - Zwift NL Race Day (A),Favero Assioma DUO (to Garmin),Wahoo Kickr C (to Zwift),362,360,2
127845,1615630053,wahoo,ZADA - Three Sisters Test,Favero Assioma DUO (to Garmin),Wahoo Kickr C (to Zwift),387,382,5
129230,1615919342,wahoo,Zwift - CeramicSpeed Race Series: Open Race (A),Favero Assioma DUO (to Garmin),Wahoo Kickr C (to Zwift),354,355,-1
73409,1605815606,wahoo,Zwift - KISS Race Series - EU PM (A),Favero Assioma Duo,Wahoo KICKR Smart V4,313,304,9
75303,1606248887,wahoo,Zwift - JETT ZWIFT Morning Race (A),Favero Assioma Duo,Wahoo KICKR Smart V4,309,305,4
76299,1606419574,wahoo,Zwift - KISS Race Series - EU PM (A),Favero Assioma Duo,Wahoo KICKR Smart V4,315,305,10
78296,1606848716,wahoo,Zwift - BEAT Series: 2K Keirin Sprint Night (A),Favero Assioma Duo,Wahoo KICKR Smart V4,0,0,0
78301,1606852843,wahoo,Zwift - JETT ZWIFT Morning Race (A),Favero Assioma Duo,Wahoo KICKR Smart V4,311,304,7
79170,1607023777,wahoo,Zwift - Crit City Race (A),Favero Assioma Duo,Wahoo KICKR Smart V4,324,314,10
79175,1607026784,wahoo,Zwift - 3R LaGuardia Loop Flat Race - 6 Laps (17.5km/10.9 162m) (A),Favero Assioma Duo,Wahoo KICKR Smart V4,302,297,5
81793,1607291161,wahoo,Zwift - 3R Watopia Flat Route Reverse Race - 2 Laps (20.5km/12.7mi 108m) (A),Favero Assioma Duo,Wahoo KICKR Smart V4,413,405,8
81797,1607639858,wahoo,Zwift - Koa Sports League Warrior Race (A),Favero Assioma Duo,Wahoo KICKR Smart V4,346,340,6
84582,1608246055,wahoo,Zwift - Koa Sports League Warrior Race (A),Favero Assioma Duo,Wahoo KICKR Smart V4,292,287,5
84585,1608159901,wahoo,Zwift - 3R Volcano Flat Reverse 50k Race - 4 Laps (48.8km/30.7mi 184m) (A),Favero Assioma Duo,Wahoo KICKR Smart V4,294,288,6
88813,1609238591,wahoo,Zwift - KISS Race Series - Americas AM (A),Favero Assioma Duo,Wahoo KICKR Smart V4,330,322,8
88815,1609244024,wahoo,Zwift - EMU Japan Race (A),Favero Assioma Duo,Wahoo KICKR Smart V4,318,308,10
88818,1609138575,wahoo,Zwift - 3R Watopia Flat Route Race - 3 Laps (30.3km/18.8mi 162m) (A),CooSpo,Wahoo Tickr,325,331,-6
88819,1609138575,wahoo,Zwift - 3R Watopia Flat Route Race - 3 Laps (30.3km/18.8mi 162m) (A),CooSpo,Wahoo Tickr,324,331,-7
89246,1609361363,wahoo,Zwift - I Tsan 555&#039;s Meetup - Quatch Quest,Favero Assioma Duo,Wahoo KICKR Smart V4,330,326,4
94377,1610269197,wahoo,Zwift - Paceheads Race (A),Favero Assioma Duo,Wahoo KICKR Smart V4,346,339,7
95452,1610438488,wahoo,Zwift - Zwift Racing League | WTRL - Men&#039;s/Mixed APAC DIVISION 2 (A),Favero Assioma Duo,Wahoo KICKR Smart V4,319,312,7
96848,1610620473,wahoo,Zwift - KISS Race Series - Americas AM (A),Favero Assioma Duo,Wahoo KICKR Smart V4,295,296,-1
96853,1610627096,wahoo,EMU - Carson,Favero Assioma Duo,Wahoo KICKR Smart V4,319,310,9
97938,1610745967,wahoo,Zwift - JETT TT Race (E),Favero Assioma Duo,Wahoo KICKR Smart V4,390,387,3
98344,1610841546,wahoo,Zwift - 3R & ZID Merdeka Classique Flat Race Series - Round 4 of 4 (A),Favero Assioma Duo,Wahoo KICKR Smart V4,334,322,12
99572,1611044810,wahoo,Zwift - Zwift Racing League | WTRL - Men&#039;s/Mixed APAC DIVISION 2 (A),Favero Assioma Duo,Wahoo KICKR Smart V4,312,307,5
99575,1611052467,wahoo,Zwift - KISS Race Series - Americas AM (A),Favero Assioma Duo,Wahoo KICKR Smart V4,365,363,2
99578,1611058950,wahoo,Zwift - EMU Japan Race (A),Favero Assioma Duo,Wahoo KICKR Smart V4,331,327,4
100775,1611225200,wahoo,Zwift - KISS Race Series - Americas AM (A),Favero Assioma Duo,Wahoo KICKR Smart V4,335,330,5
100776,1611231180,wahoo,Zwift - EMU Japan Race (A),Favero Assioma Duo,Wahoo KICKR Smart V4,334,330,4
103335,1611649301,wahoo,Zwift - Zwift Racing League | WTRL - Men&#039;s/Mixed APAC DIVISION 2 (A),Favero Assioma Duo,Wahoo KICKR Smart V4,324,321,3
103339,1611658568,wahoo,Zwift - Japan Zwift Tuesday Race (A),Favero Assioma Duo,Wahoo KICKR Smart V4,341,331,10
104541,1611830020,wahoo,Zwift - KISS Race Series - Americas AM (A),Favero Assioma Duo,Wahoo KICKR Smart V4,336,341,-5
104542,1611835468,wahoo,Zwift - EMU Japan Race (A),Favero Assioma Duo,Wahoo KICKR Smart V4,328,325,3
116120,1613462585,wahoo,Zwift - Zwift Racing League | WTRL - Men&#039;s/Mixed APAC DIVISION 2 (A),Favero Assioma Duo,Wahoo KICKR Smart V4,371,368,3
116139,1613473502,wahoo,Zwift - Japan Zwift Tuesday Race (A),Favero Assioma Duo,Wahoo KICKR Smart V4,292,284,8
120208,1614161514,wahoo,Zwift - The Morning Grind by STPC (A),Favero Assioma Duo,Wahoo KICKR Smart V4,343,342,1
120210,1614068352,wahoo,Zwift - Zwift Racing League | WTRL - Men&#039;s/Mixed APAC DIVISION 2 (A),Favero Assioma Duo,Wahoo KICKR Smart V4,286,286,0
120664,1614248479,wahoo,Zwift - KISS Race Series - Americas AM (New Pack Dynamics) (A),Favero Assioma Duo,Wahoo KICKR Smart V4,322,321,1
121938,1614462581,wahoo,Zwift - Haute Route Watopia 2021 Stage 2 (A),Favero Assioma Duo (Venge),Wahoo KICKR Smart V4,363,358,5
122794,1614672417,wahoo,Zwift - Zwift Racing League | WTRL - Men&#039;s/Mixed APAC DIVISION 2 (A),Favero Assioma Duo (Venge),Wahoo KICKR Smart V4,318,309,9
123411,1614767207,wahoo,Zwift - The Morning Grind by STPC (A),Favero Assioma Duo (Venge),Wahoo KICKR Smart V4,314,311,3
123883,1614854564,wahoo,Zwift - KISS Race Series - Americas AM (New Pack Dynamics) (A),Favero Assioma Duo (Venge),Wahoo KICKR Smart V4,320,314,6
88765,1609272025,neo,Zwift - KISS Race Series - EU PM (A),4iiii Dura Ace dual power meter,Tacx Neo 2,427,415,12
91919,1609872774,neo,Zwift - Team Italy & Frenchy Fuzion League (A),4iiii Dura Ace dual power meter,Tacx Neo 2,426,407,19
92357,1609955687,neo,Zwift - MIDWEEK Winter Series by SZR (A),4iiii Dura Ace dual power meter,Tacx Neo 2,379,362,17
97629,1610746469,neo,Zwift - Ramp Test,4iiii Dura Ace dual power meter,Tacx Neo 2,421,400,21
102486,1611505594,neo,Zwift - Watopia - three sisters Zada test,Verve InfoCrank,Tacx Neo 2,398,379,19
102490,1611004661,neo,Zwift - Ramp Test,Verve InfoCrank,Tacx Neo 2,431,384,47
106421,1612120974,neo,Zwift - 3R LaGuardia Super Sprint Race - 1 Lap (3.7km/2.6mi 27m) (A),Verve InfoCrank,Tacx Neo 2,421,389,32
106923,1612208380,neo,Zwift - Premier Division // Zwift Racing League (men) (A),Verve InfoCrank,Tacx Neo 2,415,395,20
108285,1612376732,neo,Zwift - Open - Movistar Team Challenge Community Qualifier Race #1,Verve InfoCrank,Tacx Neo 2,423,387,36
108367,1612376732,neo,Zwift - Open - Movistar Team Challenge Community Qualifier Race #1,Verve InfoCrank,Tacx Neo 2,423,387,36
112411,1612983166,neo,Zwift - Movistar Team Challenge // Round 1 (A),Verve InfoCrank,Tacx Neo 2,403,369,34
113606,1613153807,neo,Zwift - Movistar Team Challenge // Round 1 (men),Verve InfoCrank,Tacx Neo 2,420,404,16
116769,1613587055,neo,Zwift - Movistar Team Challenge // Round 2 (men) - Race 3/4,Verve InfoCrank,Tacx Neo 2,393,374,19
120023,1614028872,neo,Zwift - Ramp Test,Verve InfoCrank,Tacx Neo 2,425,408,17
118392,1613838802,wahoo,Zwift - 3R Innsbruckring Flat Race - 3 Laps (26.4km/16.4mi 231m) (A),Quarq D-Four,Wahoo Kickr,314,304,10
120056,1614108924,wahoo,Zwift - Zwift Racing League | WTRL - Men&#039;s/Mixed EMEA W2 DIVISION 1 (A),Quarq D-Four,Wahoo Kickr v5,352,345,7
123369,1614713516,wahoo,Zwift - Zwift Racing League | WTRL - Men&#039;s/Mixed EMEA W2 DIVISION 1 (A),Quarq D-Four,Wahoo Kickr v5,360,356,4
32756,1588946384,wahoo,Wahoo Kickr / Favero Assioma Pedals,Favero Assioma Pedals,Wahoo Kickr,478,477,1
114279,1613229311,wahoo,Zwift - OH MY CRIT!! - Saturday Smash Race (A),Favero Assioma Duos,Wahoo Kickr v5 (2020),465,444,21
114866,1613328293,wahoo,Zwift - TDZ Stage 4: Longer Ride,Favero Assioma Duos,Wahoo Kickr v5 (2020),439,418,21
116106,1613505996,wahoo,Zwift - JETT ZWIFT Morning Race (A),Favero Assioma Duos,Wahoo Kickr v5 (2020),504,483,21
128875,1615847907,wahoo,Watopia - Quick Solo Training to Test New Crankset,Favero Assioma Duos,Wahoo Kickr v5 (2020),430,419,11
129354,1615925159,wahoo,Zwift - JETT ZWIFT Morning Race (A),Favero Assioma Duos,Wahoo Kickr v5 (2020),419,415,4
6314,1576389996,wahoo,Zwift - Absa Cape Epic Workout 1,Quarq DZero Crank,Wahoo Kickr18,0,0,0
11998,1580564688,wahoo,Zwift - WTRL Winter Racing League (A),Quarq DZero Crank,Wahoo Kickr18,374,377,-3
52827,1598941503,wahoo,Zwift - 3R Watopia Flat Route Race - 3 Laps (30.3km/18.8mi 162m) (A),Quarq DZero Crank,Wahoo Kickr18,343,343,0
53005,1599027317,wahoo,Zwift - Tri NZ Night Race (A),Quarq DZero Crank,Wahoo Kickr18,399,400,-1
96904,1610563418,wahoo,Zwift - Danmarks Cykle Union & Partners 1/6 (A) Den rigtige,Rotor 2inPower DM MTB Boost ,Wahoo Kickr ,388,372,16
97903,1610653695,wahoo,Zwift - DBR SufferDay League III (A),Rotor 2inPower DM MTB Boost ,Wahoo Kickr ,375,353,22
100492,1611167690,wahoo,Zwift - Danmarks Cykle Union & Partners 2/6 (A),Rotor 2inPower DM MTB Boost ,Wahoo Kickr ,413,399,14
104293,1611772911,wahoo,Zwift - Danmarks Cykle Union & Partners 3/6 (A),Rotor 2inPower DM MTB Boost ,Wahoo Kickr ,424,405,19
108440,1612377849,wahoo,Zwift - Danmarks Cykle Union & Partners 4/6 (A),Rotor 2inPower DM MTB Boost ,Wahoo Kickr ,374,358,16
112503,1612982692,wahoo,Zwift - Danmarks Cykle Union & Partners 5/6 (A),Rotor 2inPower DM MTB Boost ,Wahoo Kickr ,398,379,19
116904,1613587469,wahoo,Zwift - Danmarks Cykle Union & Partners 6/6 (A),Rotor 2inPower DM MTB Boost ,Wahoo Kickr ,357,341,16
129396,1615919422,wahoo,Zwift - CeramicSpeed Race Series: Open Race (A),Rotor 2inPower DM MTB Boost ,Wahoo Kickr v4 ,416,398,18
19487,1585129801,wahoo,Zwift - KISS 80 km group ride,Quarq SRAM Red,Wahoo Kickr,342,329,13
19505,1585137661,wahoo,Zwift - Stage 5 - Shorter Ride - Tour of Watopia 2020,Quarq SRAM Red,Wahoo Kickr,375,355,20
19526,1585141202,wahoo,Zwift - Stage 5 - Longer Ride - Tour of Watopia 2020,Quarq SRAM Red,Wahoo Kickr,288,278,10
21483,1585850399,wahoo,Zwift - KALAS Cup - Round 10 (A),Quarq SRAM Red,Wahoo Kickr,379,374,5
21941,1585988998,wahoo,Zwift - DBR Sufferday League (A),Quarq SRAM Red,Wahoo Kickr,409,402,7
26993,1587574801,wahoo,Zwift - Swedish Zwift Racing Cup by SZR - Dead! ,Quarq SRAM Red,Wahoo Kickr,385,363,22
28986,1588009057,wahoo,Zwift - USA Cycling Race League by Indoor Specialist  (A) - Just kill me 😳☠,Quarq SRAM Red,Wahoo Kickr,378,367,11
29941,1588267687,wahoo,Zwift - WTRL Team Time Trial Premier League - Zwift race is pain. Team Time Trial is torture,Quarq SRAM Red,Wahoo Kickr,404,385,19
37010,1590222602,wahoo,Zwift - DBR Sufferday League (A),Quarq SRAM Red,Wahoo Kickr,376,359,17
57187,1600941599,wahoo,KISS at Race - Americas AM - 3rd ,Quarq SRAM Red,Wahoo Kickr gen5,441,430,11
60116,1602092701,wahoo,DCU race,Quarq SRAM Red,Wahoo Kickr gen5,424,412,12
60838,1602341172,wahoo,ZADA 3 Sisters Test,Quarq SRAM Red,Wahoo Kickr gen5,416,404,12
62190,1602785403,wahoo,TTT,Quarq SRAM Red,Wahoo Kickr gen5,413,403,10
64062,1603360799,wahoo,Zwift - KISS at Race - Americas AM (A),Quarq SRAM Red,Wahoo Kickr gen5,418,403,15
64177,1603387684,wahoo,WTRL - Team Time Trial,Quarq SRAM Red,Wahoo Kickr gen5,408,389,19
66137,1603995904,wahoo,WTRL - TTT,Quarq SRAM Red,Wahoo Kickr gen5,429,416,13
67953,1604516402,wahoo,DCU - Feltet.dk November Series - Made it hard on the climb and 7th in the sprint. Team mate won,Quarq SRAM Red,Wahoo Kickr gen5,455,446,9
70331,1605121199,wahoo,Zwift - DCU – Feltet.dk November series (A) 1st - Whaat:),Quarq SRAM Red,Wahoo Kickr gen5,430,415,15
71002,1605207426,wahoo,Zwift - Espresso,Quarq SRAM Red,Wahoo Kickr gen5,410,392,18
72653,1605725999,wahoo,DCU - Feltet.dk November Series. 4th on results,Quarq SRAM Red,Wahoo Kickr gen5,396,384,12
73225,1605814201,wahoo,Zwift - World Championships Experience // Danish Cycling Federation - 8th,Quarq SRAM Red,Wahoo Kickr gen5,392,388,4
75570,1606330803,wahoo,Zwift - DCU – Feltet.dk November series (A),Quarq SRAM Red,Wahoo Kickr gen5,390,378,12
76988,1606576502,wahoo,Zwift - OH MY CRIT - Saturday Smash Race (A),Quarq SRAM Red,Wahoo Kickr gen5,378,371,7
77313,1606659319,wahoo,Zwift - KISS 100 Race Series - Americas (A),Quarq SRAM Red,Wahoo Kickr gen5,339,336,3
78423,1606905899,wahoo,Zwift - New Workout,Quarq SRAM Red,Wahoo Kickr gen5,398,388,10
79264,1607072703,wahoo,Zwift - 3R Whole Lotta Lava Hilly Race - 2 Laps (28.9km/12.53mi 336m) (A),Quarq SRAM Red,Wahoo Kickr gen5,394,383,11
81102,1607536798,wahoo,Zwift - MIDWEEK Winter Series by SZR (A),Quarq SRAM Red,Wahoo Kickr gen5,393,384,9
81631,1607624999,wahoo,FUSION DECEMBER CUP - 1st,Quarq SRAM Red,Wahoo Kickr gen5,427,417,10
82718,1607861521,wahoo,ZADA 3 sister test - Michael Knudsen (PO auto - CeramicSpeed),Quarq SRAM Red,Wahoo Kickr gen5,437,431,6
89109,1609351202,wahoo,Zwift - MIDWEEK Winter Series by SZR (A),Quarq SRAM Red,Wahoo Kickr gen5,466,450,16
89789,1609404781,wahoo,Zwift - Peel Cycling - Morning Chase (A),Quarq SRAM Red,Wahoo Kickr gen5,437,447,-10
90268,1609600501,wahoo,Zwift - New Workout,Quarq SRAM Red,Wahoo Kickr gen5,389,399,-10
91269,1609779602,wahoo,Zwift - TDZ Stage 1: Standard Ride,Quarq SRAM Red,Wahoo Kickr gen5,198,201,-3
93317,1610111256,wahoo,Zwift - TDZ Stage 1: Shorter Ride,Quarq SRAM Red,Wahoo Kickr gen5,232,240,-8
93825,1610197321,wahoo,Zwift - New Workout,Quarq SRAM Red,Wahoo Kickr gen5,379,390,-11
94414,1610287382,wahoo,Zwift - TDZ Stage 2: Shorter Ride,Quarq SRAM Red,Wahoo Kickr gen5,376,385,-9
94959,1610392501,wahoo,Zwift - Premier Division // Zwift Racing League (men) (A),Quarq SRAM Red,Wahoo Kickr gen5,403,412,-9
97421,1610719323,wahoo,Zwift - TDZ Stage 3: Standard Ride,Quarq SRAM Red,Wahoo Kickr gen5,383,399,-16
98356,1610866582,wahoo,active recovery,Quarq SRAM Red,Wahoo Kickr gen5,175,181,-6
99174,1610999256,wahoo,Zwift - Premier Division // Zwift Racing League (men) (A),Quarq SRAM Red,Wahoo Kickr gen5,394,399,-5
100126,1611129602,wahoo,Zwift - TDZ Stage 4: Longer Ride,Quarq SRAM Red,Wahoo Kickr gen5,287,288,-1
100341,1611168301,wahoo,Zwift - Danmarks Cykle Union & Partners 2/6 (A),Quarq SRAM Red,Wahoo Kickr gen5,435,435,0
102691,1611385202,wahoo,Zwift - EVO CC 160km Base Ride [3.0-3.2w/kg avg] (B),Quarq SRAM Red,Wahoo Kickr gen5,372,375,-3
102717,1611569595,wahoo,Zwift - Innsbruck,Quarq SRAM Red,Wahoo Kickr gen5,270,270,0
102883,1611601494,wahoo,Zwift - Premier Division // Zwift Racing League (men) (A) - 4th,Quarq SRAM Red,Wahoo Kickr gen5,439,447,-8
106593,1612180359,wahoo,Premier Division stage 4 recon ride,Quarq SRAM Red,Wahoo Kickr gen5,249,251,-2
106875,1612210011,wahoo,Zwift - Premier Division // Zwift Racing League (men) (A),Quarq SRAM Red,Wahoo Kickr gen5,404,402,2
111483,1612890004,wahoo,Zwift - TDZ Stage 8: Group Ride,Quarq SRAM Red,Wahoo Kickr gen5,218,216,2
115368,1613419319,wahoo,Zwift - Premier Division // Zwift Racing League (men) (A) - F*cking drop out on second climb,Quarq SRAM Red,Wahoo Kickr gen5,430,435,-5
119118,1614021001,wahoo,Zwift - Premier Division // Zwift Racing League (men) (A) - 15th,Quarq SRAM Red,Wahoo Kickr gen5,372,384,-12
122616,1614630094,wahoo,Zwift - Premier Division // Zwift Racing League (men) (A),Quarq SRAM Red,Wahoo Kickr gen5,425,428,-3
94980,1610389836,wahoo,Zwift - Premier Division // Zwift Racing League (men) (A),Kickr Core,Wahoo_1_11_2021,407,426,-19
27830,1587801893,neo,Zwift - 3R Crit City - Downtown Dolphin - 16laps (A),Power2max NG,Tacx Neo 2,413,403,10
27954,1587825840,neo,Zwift - GCA Liga #2 (D) Men Only,Power2max NG(to Zwift),Tacx Neo 2(to GarminEdge1000),438,427,11
29557,1588239868,neo,Zwift - Koa Sports League Race (A),Power2max NG(to Zwift),Tacx Neo 2(to GarminEdge1000),445,432,13
30424,1588406392,neo,Zwift - e-liga FINALE - eCycling Austria,Power2max NG(to Zwift),Tacx Neo 2(to GarminEdge1000),409,411,-2
30686,1588430640,neo,Zwift - GCA Liga #3 (D) Men Only,Power2max NG(to Zwift),Tacx Neo 2(to GarminEdge1000),428,422,6
32375,1588844635,neo,Zwift - Koa Sports League Race (A),Power2max NG(to Zwift),Tacx Neo 2(to GarminEdge1000),432,429,3
33030,1589035183,neo,Zwift - GCA Liga #4 ,Power2max NG(to Zwift),Tacx Neo 2(to GarminEdge1000),436,427,9
34591,1589449473,neo,Zwift - Koa Sports League Race (A),Power2max NG(to Zwift),Tacx Neo 2(to GarminEdge1000),408,400,8
34770,1589469171,neo,Zwift - OH CRIT!! - The Double Race - Lockdown Series Round 2 Race 1 (A),Power2max NG(to Zwift),Tacx Neo 2(to GarminEdge1000),455,445,10
36568,1590054260,neo,Zwift - Koa Sports League Race (A),Power2max NG(to Zwift),Tacx Neo 2(to GarminEdge1000),422,405,17
40028,1591459012,neo,Zwift - GCA Klassiker #1,Power2max NG(to Zwift),Tacx Neo 2(to GarminEdge1000),431,421,10
40972,1591869547,neo,Zwift - Koa Sports League Race (A),Power2max NG(to Zwift),Tacx Neo 2(to GarminEdge1000),427,418,9
41457,1592063824,neo,Zwift - GCA Klassiker #2,Power2max NG(to Zwift),Tacx Neo 2(to GarminEdge1000),438,428,10
42163,1592332744,neo,Zwift - 3R & Wahoo Ride Real Race Series - Round 5 of 7 (A),Power2max NG(to Zwift),Tacx Neo 2(to GarminEdge1000),410,394,16
42818,1592474314,neo,Zwift - Koa Sports League Race (A),Power2max NG(to Zwift),Tacx Neo 2(to GarminEdge1000),423,412,11
42859,1592668703,neo,Zwift - GCA Klassiker #3,Power2max NG(to Zwift),Tacx Neo 2(to GarminEdge1000),460,445,15
76809,1606554104,neo,Zwift - e-liga | eCycling league Austria Race 2 (A),Power2max NG(to Zwift),Tacx Neo 2,372,361,11
84991,1608368135,neo,Zwift - e-liga | eCycling league Austria Race ,Power2max NG(to Zwift),Tacx Neo 2(to GarminEdge1000),405,388,17
95412,1610441000,neo,Zwift - Zwift Racing League | WTRL - Men&#039;s/Mixed APAC DIVISION 1 (A),Power2max NG(to Zwift),Tacx Neo 2(to GarminEdge1030),407,367,40
96507,1610563522,neo,Zwift - GCA Cup,Power2max NG(to Zwift),Tacx Neo 2(to GarminEdge1030),395,388,7
99511,1611046052,neo,Zwift - Zwift Racing League | WTRL - Men&#039;s/Mixed APAC DIVISION 1 (A),Power2max NG(to Zwift),Tacx Neo 2(to GarminEdge1030),418,412,6
100440,1611168300,neo,Zwift - GCA Cup,Power2max NG(to Zwift),Tacx Neo 2(to GarminEdge1030),392,384,8
101525,1611340196,neo,Zwift - KIRCHMAIR Race Series,Power2max NG(to Zwift),Tacx Neo 2(to GarminEdge1030),424,415,9
103247,1611650641,neo,Zwift - Zwift Racing League | WTRL - Men&#039;s/Mixed APAC,Power2max NG(to Zwift),Tacx Neo 2(to GarminEdge1030),432,421,11
105416,1611943141,neo,Zwift - KIRCHMAIR Race Series (A),Power2max NG(to Zwift),Tacx Neo 2(to GarminEdge1030),418,401,17
105420,1611945022,neo,Zwift - Race,Power2max NG(to Zwift),Tacx Neo 2(to GarminEdge1030),428,416,12
105782,1612025855,neo,Zwift - GCA Liga 2021 #1,Power2max NG(to Zwift),Tacx Neo 2(to GarminEdge1030),463,463,0
107105,1612255475,neo,Zwift - Zwift Racing League | WTRL - Men&#039;s/Mixed APAC DIVISION 1,Power2max NG(to Zwift),Tacx Neo 2(to GarminEdge1030),438,429,9
110094,1612630728,neo,Zwift - GCA Liga 2021 #2,Power2max NG(to Zwift),Tacx Neo 2(to GarminEdge1030),399,390,9
111797,1612860704,neo,Zwift - Zwift Racing League,Power2max NG to Zwift,Tacx Neo 2 to Garmin 1030,441,434,7
114280,1613235571,neo,Zwift - GCA Liga 2021 #3,Power2max NG,Tacx Neo 2,430,425,5
115602,1613465034,neo,Zwift - Zwift Racing League,Power2max NG,Tacx Neo 2,444,436,8
118484,1613840358,neo,Zwift - GCA Liga 2021 #4,Power2max NG,Tacx Neo 2,441,431,10
119394,1614069857,neo,Zwift - Zwift Racing League,Power2max NG,Tacx Neo 2,388,380,8
121790,1614445121,neo,Zwift - GCA Liga 2021 #5,Power2max NG,Tacx Neo 2,439,431,8
124618,1614970940,neo,Zwift - Zwift Racing League | WTRL Battle Royale Playoff - Men&#039;s Points Race (A),Power2max NG,Tacx Neo 2,433,425,8
127999,1615648449,neo,Zwift - OH MY CRIT!! - Saturday Smash Race ,Power2max NG,Tacx Neo 2,495,490,5
29201,1588179612,neo,Zwift - Swedish Zwift Racing Cup by SZR (A),4iii Crank Arm,Tacx Neo,369,369,0
39854,1591379972,neo,Zwift - TeamPTz Friday&#039;s Race League (A),4iii Crank Arm,Tacx Neo,372,378,-6
43568,1593104718,neo,Zwift - Espresso,4iii Crank Arm,Tacx Neo,346,350,-4
44169,1593507226,neo,Zwift - SRAM Send it Series - Race 8 - Men&#039;s (E),4iii Crank Arm,Tacx Neo,394,403,-9
51956,1598435170,neo,Zwift - USA Cycling Race League by Indoor Specialist (A),4iii Crank Arm,Tacx Neo,376,380,-4
53233,1599137462,neo,Zwift - 3R Knickerbocker Climbing Race - 1 Lap (22.4km/13.9mi 365m) (A),4iii Crank Arm,Tacx Neo,367,377,-10
53879,1599547598,neo,Zwift -  Kiwi Crew Riot Race (A),4iii Crank Arm,Tacx Neo,313,333,-20
54591,1599827776,neo,Zwift - KISS at Race - Pacific AM (A),4iii Crank Arm,Tacx Neo,345,356,-11
57022,1600879042,neo,Zwift - MIDWEEK Autumn Series by SZR (A),4iii Crank Arm,Tacx Neo,365,370,-5
62257,1602784545,neo,Zwift - Pre Event Ride // Swedish Cycling Federation,4iii Crank Arm,Tacx Neo,354,358,-4
63667,1603214138,neo,Zwift - Zwift Racing League | WTRL - EMEA E (MEN) - TTT Grp 1,4iii Crank Arm,Tacx Neo,356,361,-5
73193,1605814160,neo,Zwift - World Championships Experience // Danish Cycling Federation,4iii Crank Arm,Tacx Neo,352,360,-8
76572,1606501794,neo,Zwift - Team WEZ Friday Race (E),4iii Crank Arm,Tacx Neo,373,384,-11
77328,1606659301,neo,Zwift - KISS 100 Race Series - Americas (A),4iii Crank Arm,Tacx Neo,338,343,-5
79508,1607106594,neo,Zwift - Team WEZ Friday Race (E),4iii Crank Arm,Tacx Neo,335,345,-10
82041,1607711400,neo,Zwift - Team WEZ Friday Race (E),4iii Crank Arm,Tacx Neo,384,395,-11
93943,1610202855,wahoo,Zwift - Watopia,4iii Crank Arm,Wahoo Kickr,397,398,-1
94942,1610387099,wahoo,Zwift - SCF SWE Cup (A),4iii Crank Arm,Wahoo Kickr,371,355,16
95662,1610475300,wahoo,Zwift - Zwift Racing League | WTRL - Men&#039;s/Mixed EMEA E1 DIVISION 1 (A),4iii Crank Arm,Wahoo Kickr,383,369,14
99661,1611080307,wahoo,Zwift - Zwift Racing League | WTRL - Men&#039;s/Mixed EMEA E1 DIVISION 1 (A),4iii Crank Arm,Wahoo Kickr,360,365,-5
103480,1611684887,wahoo,Zwift - Zwift Racing League | WTRL - Men&#039;s/Mixed EMEA E1 DIVISION 1 (A),4iii Crank Arm,Wahoo Kickr,391,401,-10
107367,1612289627,wahoo,Zwift - Zwift Racing League | WTRL - Men&#039;s/Mixed EMEA E1 DIVISION 1 (A),4iii Crank Arm,Wahoo Kickr,384,389,-5
108313,1612378799,wahoo,Zwift - Open - Movistar Team Challenge Community Qualifier Race #1,4iii Crank Arm,Wahoo Kickr,405,412,-7
111548,1612894709,wahoo,Zwift - Zwift Racing League | WTRL - Men&#039;s/Mixed EMEA E1 DIVISION 1 (A),4iii Crank Arm,Wahoo Kickr,386,388,-2
113971,1613206803,wahoo,Zwift - Team WEz Race (E),4iii Crank Arm,Wahoo Kickr,386,383,3
119052,1614014999,wahoo,Zwift -  SCF SWE Cup Men (A),Favero Assioma UNO,Wahoo Kickr,446,443,3
119622,1614104100,wahoo,Zwift - Zwift Racing League | WTRL - Men&#039;s/Mixed EMEA E1 DIVISION 1 (A),Favero Assioma UNO,Wahoo Kickr,368,366,2
122966,1614709326,wahoo,Zwift - Zwift Racing League | WTRL - Men&#039;s/Mixed EMEA E1 DIVISION 1 (A),Favero Assioma UNO,Wahoo Kickr,378,374,4
125792,1615224599,wahoo,Zwift -  SCF SWE Cup Men (A),Favero Assioma UNO,Wahoo Kickr,385,381,4
128347,1615712401,wahoo,Zwift - 03/14/2021,Favero Assioma UNO,Wahoo Kickr,390,387,3
128793,1615832692,wahoo,Zwift -  SCF SWE Cup Men (A),Favero Assioma UNO,Wahoo Kickr,361,371,-10
48,1565719800,wahoo,Zwift - FUSION ECT Racing League (A) #21,Kickr Core - Zwift,Wahoo Bolt - Quarq Dfour,393,390,3
4385,1573981203,wahoo,Zwift - Danmarks Cykle Union Racing League (A),P2M NGeco - Zwift,Kickr 18 - Wahoo Bolt,0,0,0
4481,1574187302,wahoo,Zwift - Danmarks Cykle Union Racing League (A),P2M NGeco - Zwift,Kickr 18 - Wahoo Bolt,0,0,0
4691,1574435704,wahoo,Zwift - 3R Sand and Sequoias Race (A) #2 ,P2M NGeco - Zwift,Kickr 18 - Wahoo Bolt,0,0,0
4910,1574792101,wahoo,Zwift - Danmarks Cykle Union Racing League (A) #1,P2M NGeco - Zwift,Kickr 18 - Wahoo Bolt,0,0,0
5131,1574962807,wahoo,Zwift - Team Italy Specialissima Race  (A),P2M NGeco - Zwift,Kickr 18 - Wahoo Bolt,0,0,0
5184,1575106201,wahoo,Zwift - DBR Saturday Race (A) #3,P2M NGeco - Zwift,Kickr 18 - Wahoo Bolt,0,0,0
5251,1575190802,wahoo,Zwift - Danmarks Cykle Union Racing League (A) #6,P2M NGeco - Zwift,Kickr 18 - Wahoo Bolt,0,0,0
5378,1575396903,wahoo,Zwift - Danmarks Cykle Union Racing League (A),P2M NGeco - Zwift,Kickr 18 - Wahoo Bolt,406,405,1
5739,1575795602,wahoo,Zwift - Danmarks Cykle Union Racing League (A) #5,P2M NGeco - Zwift,Kickr 18 - Wahoo Bolt,0,0,0
5910,1576001702,wahoo,Zwift - Danmarks Cykle Union Racing League (A) #6,P2M NGeco - Zwift,Kickr 18 - Wahoo Bolt,0,0,0
6052,1576096202,wahoo,Zwift - Beta Race #3 FUSION ECT Bronze,P2M NGeco - Zwift,Kickr 18 - Wahoo Bolt,0,0,0
6117,1576176902,wahoo,Zwift - Team Italy Superveloce Race (A) #3 no PU,P2M NGeco - Zwift,Kickr 18 - Wahoo Bolt,373,370,3
6324,1576400404,wahoo,Zwift - Danmarks Cykle Union Racing League (A),P2M NGeco - Zwift,Kickr 18 - Wahoo Bolt,0,0,0
6504,1576606501,wahoo,Zwift - Danmarks Cykle Union Racing League (A) #10 skide ITT,P2M NGeco - Zwift,Kickr 18 - Wahoo Bolt,391,385,6
6614,1576693201,wahoo,Zwift - Crit City Race (A) #2,P2M NGeco - Zwift,Kickr 18 - Wahoo Bolt,362,352,10
6897,1576918801,wahoo,Zwift - Danmarks Cykle Union Sprinters Special (A) #2 HRM messUp,P2M NGeco - Zwift,Kickr 18 - Wahoo Bolt,339,335,4
7002,1577005203,wahoo,Zwift - Danmarks Cykle Union Racing League (A) #3,P2M NGeco - Zwift,Kickr 18 - Wahoo Bolt,343,342,1
7115,1577110512,wahoo,Zwift - 3R Classique Reverse Flat Race - 5 Laps (32km/20.1mi 76m) (A) #1,P2M NGeco - Zwift,Kickr 18 - Wahoo Bolt,345,344,1
7177,1577182802,wahoo,Zwift - 3R Innsbruckring Sprint Race - 1 Lap (8.8km/5.5mi 77m) (A) #3,P2M NGeco - Zwift,P2M NGeco - Wahoo Bolt,360,361,-1
7229,1577268591,wahoo,Zwift - Watopia,P2M NGeco - Zwift,Kickr 18 - Wahoo Bolt,329,335,-6
7411,1577459703,wahoo,Zwift - 3R Sand and Sequoias Race (A) #2,P2M NGeco - Zwift,Kickr 18 - Wahoo Bolt,373,370,3
7534,1577610002,wahoo,Zwift - Danmarks Cykle Union Racing League (A) #3,P2M NGeco - Zwift,Kickr 18 - Wahoo Bolt,358,361,-3
7620,1577701202,wahoo,Zwift - 3R Volcano Flat Reverse Race - 3 Laps (36.6km/22.7mi 138m) (A),P2M NGeco - Zwift,Kickr 18 - Wahoo Bolt,365,364,1
8030,1578139203,wahoo,Zwift - HBR17 by Herd Racing League (Europe) (E) #2,P2M NGeco - Zwift,Kickr 18 - Wahoo Bolt,335,339,-4
8311,1578423303,wahoo,Zwift - Team Italy Gladiators Race (A) ,P2M NGeco - Zwift,Kickr 18 - Wahoo Bolt,401,402,-1
8612,1578591003,wahoo,Zwift - Danmarks Cykle Union 2020 Cup (A)#5 TeamWork FTW,P2M NGeco - Zwift,Kickr 18 - Wahoo Bolt,397,398,-1
8822,1578738603,wahoo,Zwift - 3R Volcano Climb Race - 1 Lap (22.4km/14mi 204m) (A) #1,P2M NGeco - Zwift,Kickr 18 - Wahoo Bolt,392,394,-2
8929,1578819603,wahoo,Zwift - Danmarks Cykle Union 2020 Cup (A) #3,P2M NGec-1o - Zwift,Kickr 18 - Wahoo Bolt,360,364,-4
9510,1579115708,wahoo,Zwift - Tour de Zwift // Pro-Am Invitational (A),P2M NGeco - Zwift,Kickr 18 - Wahoo Bolt,436,439,-3
9695,1579200901,wahoo,Zwift - Team Italy Superveloce Race (A) #1,P2M NGeco - Zwift,Kickr 18 - Wahoo Bolt,370,371,-1
10672,1579806900,wahoo,Tour de Zwift // Pro-Am Invitational #killerRoute,P2M NGeco - Zwift,Kickr 18 - Wahoo Bolt,399,401,-2
10968,1580029201,wahoo,Danmarks Cykle Union 2020 Cup (A) #4,P2M NGeco - Zwift,Kickr 18 - Wahoo Bolt,404,405,-1
11181,1580148917,wahoo,Zwift - 01/27/2020,P2M NGeco - Zwift,Kickr 18 - Wahoo Bolt,394,393,1
11338,1580234401,wahoo,Kickr 18 - Wahoo Bolt / P2M NGeco - Zwift,P2M NGeco - Zwift,Kickr 18 - Wahoo Bolt,390,392,-2
11526,1580324703,wahoo,DBR Wednesday Race,P2M NGeco - Zwift,Kickr 18 - Wahoo Bolt,414,414,0
11871,1580498099,wahoo,Tour de Zwift // Pro-Am Invitational (A),P2M NGeco - Zwift,Kickr 18 - Wahoo Bolt,440,441,-1
12618,1580929501,wahoo,DBR Race,P2M NGeco - Zwift,Kickr 18 - Wahoo Bolt,362,366,-4
12745,1581010201,wahoo,Zwift - Danmarks Cykle Union 2020 Cup (A) #1,P2M NGeco - Zwift,Kickr 18 - Wahoo Bolt,366,365,1
12970,1581157801,wahoo,Zwift - 3R Volcano Climb Race - 1 Lap (22.4km/14mi 204m) (A) #1,P2M NGeco - Zwift,Kickr 18 - Wahoo Bolt,398,398,0
13106,1581238861,wahoo,Zwift - Danmarks Cykle Union 2020 Cup (A) #2,P2M NGeco - Zwift,Kickr 18 - Wahoo Bolt,332,335,-3
13393,1581444061,wahoo,Zwift - Danmarks Cykle Union 2020 Cup (A) #3,P2M NGeco - Zwift,Kickr 18 - Wahoo Bolt,396,399,-3
13708,1581618602,wahoo,Zwift - FUSION ECT BEUNSTOPPABLE Racing Series (A) #2,P2M NGeco - Zwift,Kickr 18 - Wahoo Bolt,364,367,-3
14372,1581962402,wahoo,Zwift - 3R Gotham Grind Flat Race - 3 Laps (27.8km/17.4mi 87m) (A) #1,P2M NGeco - Zwift,Kickr 18 - Wahoo Bolt,327,331,-4
14514,1582045802,wahoo,Zwift - 3R Volcano KOM After Party Race - 2 laps + climb (40.2km/25mi 286m) (A) #7 skide bakke :),P2M NGeco - Zwift,Kickr 18 - Wahoo Bolt,410,412,-2
15138,1582361102,wahoo,Zwift - Crit City Race (A) #1,P2M NGeco - Zwift,Kickr 18 - Wahoo Bolt,361,360,1
15596,1582658101,wahoo,Zwift - Feltet.dk Race Series (A) #27 fail-event!,P2M NGeco - Zwift,Kickr 18 - Wahoo Bolt,371,379,-8
15865,1582821900,wahoo,Zwift - Mikkeller and Friends Race (A) #10,P2M NGeco - Zwift,Kickr 18 - Wahoo Bolt,388,390,-2
16464,1583170262,wahoo,Zwift - Danmarks Cykle Union 2020 Cup (A) #1 TAK til Jeppe for sublimt teamwork!,P2M NGeco - Zwift,Kickr 18 - Wahoo Bolt,347,350,-3
16626,1583262902,wahoo,Zwift - Feltet.dk Race Series (A) #7,P2M NGeco - Zwift,Kickr 18 - Wahoo Bolt,408,408,0
16918,1583429460,wahoo,Zwift - Danmarks Cykle Union 2020 Cup (A) #2,P2M NGeco - Zwift,Kickr 18 - Wahoo Bolt,369,377,-8
17131,1583576999,wahoo,3R Volcano Climb Race - 1 Lap (22.4km/14mi 204m),P2M NGeco - Zwift,Kickr 18 - Wahoo Bolt,395,398,-3
17487,1583863263,wahoo,Zwift - Danmarks Cykle Union 2020 Cup (A),P2M NGeco - Zwift,Kickr 18 - Wahoo Bolt,415,416,-1
17821,1584040501,wahoo,Zwift - Tour of Watopia Pro-Am Men&#039;s Race #1 (A),P2M NGeco - Zwift,Kickr 18 - Wahoo Bolt,371,395,-24
18290,1584379861,wahoo,Zwift - Danmarks Cykle Union 2020 Cup (A) #1,P2M NGeco - Zwift,Kickr 18 - Wahoo Bolt,333,333,0
19407,1585072858,wahoo,Zwift - Danmarks Cykle Union 2020 Cup (A),P2M NGeco - Zwift,Kickr 18 - Wahoo Bolt,358,359,-1
19610,1585163099,wahoo,Zwift - DBR Wednesday Race (A) #9 failer :),P2M NGeco - Zwift,Kickr 18 - Wahoo Bolt,387,388,-1
20897,1585678500,wahoo,Zwift - Feltet.dk Race Series (A) #39,P2M NGeco - Zwift,Kickr 18 - Wahoo Bolt,385,386,-1
25598,1587147061,wahoo,Zwift - Richmond Challenge // Zwift Classic (A) :/,Quarq Dfour - Zwift,Kickr 18 - Wahoo Bolt,431,417,14
33204,1589105400,wahoo,Zwift - 3R Sand & Sequoias - 1 Lap (20km/12.5mi 173m) (A) #2,Quarq Dfour - Zwift,Kickr 18 - Wahoo Bolt,379,373,6
35827,1589822101,wahoo,Zwift - DBR Wahoo League (A) #6 #DQ-NoHRM che�ck DualRecording,Quarq Dfour - Zwift,Kickr 18 - Wahoo Bolt,400,388,12
37289,1590304200,wahoo,Zwift - 3R Figure 8 Hilly Race - 1 Lap (29.2km/18.1m 234m) (A) #1,Quarq Dfour - Zwift,Kickr 18 - Wahoo Bolt,342,340,2
40838,1591812301,wahoo,Zwift - DBR Boerkop Cykler Cup (A) #2,Quarq Dfour - Zwift,Kickr 18 - Wahoo Bolt,379,372,7
41359,1592037002,wahoo,Zwift - DBR Saturday Race  (A) #1,Quarq Dfour - Zwift,Kickr 18 - Wahoo Bolt,375,369,6
41995,1592331300,wahoo,Zwift - UNO X CUP powered by DCU & Feltet.dk (A) #13 hot hot hot..!!!,Quarq Dfour - Zwift,Kickr 18 - Wahoo Bolt,400,393,7
42589,1592571000,wahoo,Zwift - KISS at Race - Pacific AM (A) #2,Quarq Dfour - Zwift,Kickr 18 - Wahoo Bolt,338,331,7
44947,1593934505,wahoo,Zwift - ZHR Masters Weekender (A) #2,Quarq Dfour - Zwift,Kickr 18 - Wahoo Bo-3lt,362,353,9
47747,1595763900,wahoo,Zwift - Crit City Race (A) #1,Quarq Dfour - Zwift,Kickr 18 - Wahoo Bolt,376,366,10
50746,1597860000,wahoo,Zwift - Off The MAAP Stage 2 Race (A) #2,Quarq Dfour - Zwift,Kickr 18 - Wahoo Bolt,403,395,8
50935,1597934402,wahoo,Zwift - Team Italy Specialissima Race (A) #1,Quarq Dfour - Zwift,Kickr 18 - Wahoo Bolt,393,387,6
51214,1598092201,wahoo,Zwift - 3R Volcano Climb Race - 1 Lap (22.4km/14mi 204m) (A) #2,Quarq Dfour - Zwift,Kickr 18 - Wahoo Bolt,413,411,2
51517,1598278501,wahoo,Zwift - 3R Classique Reverse Flat Race - 5 Laps (32km/20.1mi 76m) (A) #2,Kickr 18 - Wahoo Bolt,Quarq Dfour - Wahoo Bolt,331,333,-2
52161,1598537101,wahoo,Zwift - 3R Classique Flat Race - 6 Laps (37.7km/23.4mi 114m) (A) #2,Quarq Dfour - Zwift,Kickr 18 - Wahoo Bolt,357,352,5
52448,1598689801,wahoo,Zwift - DBR Saturday Race  (A) #14,Quarq Dfour - Zwift,Kickr 18 - Wahoo Bolt,401,398,3
52767,1598898001,wahoo,Zwift - TFC Mad Monday Summer Series (9 of 10) (A) #9 ,Quarq Dfour - Zwift,Kickr 18 - Wahoo Bolt,394,385,9
53768,1599502800,wahoo,Zwift - TFC Mad Monday Summer Series (10 of 10) (A) #30 ouch a hill finish!!!,Kickr 18 - Wahoo Bolt,Quarq Dfour - Wahoo Bolt,375,384,-9
55595,1600280700,wahoo,Zwift - 09/16/2020,Quarq Dfour - Wahoo Bolt,Kickr 18 - Wahoo Bolt,328,322,6
55875,1600367400,wahoo,"Zwift - Invitational League // Qualifying Race #2 (Men) #100 Everyone disappaered 2,5 k from finish line!!!",Quarq Dfour - Wahoo Bolt,Kickr 18 - Wahoo Bolt,396,388,8
57617,1601107501,wahoo,Zwift - 3R Flat Race (A) #2,Quarq Dfour - Zwift,Kickr 18 - Wahoo Bolt,366,363,3
58541,1601487901,wahoo,Zwift - DCU powered by Feltet.dk (A) #3,Quarq Dfour - Zwift,Kickr 18 - Wahoo Bolt,373,373,0
59356,1601798401,wahoo,Zwift - Paceheads Race (30.2km / 255hm) (A) #2,Quarq Dfour - Zwift,Kickr 18 - Wahoo Bolt,363,366,-3
59837,1602003598,wahoo,Zwift - ZRG Race (A) #1,Quarq Dfour - Zwift,Kickr 18 - Wahoo Bolt,348,321,27
60401,1602181798,wahoo,Zwift - Cycling Ireland Zwift Sprint Race (A) #1,Quarq Dfour - Zwift,Kickr 18 - Wahoo Bolt,340,316,24
60694,1602313199,wahoo,Zwift - ZHQ Beta Crit City Race (A) #1,Quarq Dfour - Zwift,Kickr 18 - Wahoo Bolt,381,376,5
60945,1602411000,wahoo,Zwift - 3R Sand & Sequoias - 1 Lap (20km/12.5mi 173m) (A),Quarq Dfour - Zwift,Kickr 18 - Wahoo Bolt,364,351,13
60946,1602414299,wahoo,Zwift - 3R Innsbruckring Sprint Race - 1 Lap (8.8km/5.5mi 77m) (A) #2,Quarq Dfour - Zwift,Kickr 18 - Wahoo Bolt,384,366,18
61553,1602609304,wahoo,Zwift - Zwift Racing League | WTRL #35,Quarq Dfour - Zwift,Kickr 18 - Wahoo Bolt,398,391,7
61831,1602686102,wahoo,Zwift - 3R Sand & Sequoias - 1 Lap (20km/12.5mi 173m) (A) #2,Quarq Dfour - Zwift,Kickr 18 - Wahoo Bolt,365,339,26
62427,1602849900,wahoo,Zwift - 3R Greater London 8 Hilly Race - 1 Lap (23.8km/14.8mi 238m) (A) #3 Freaking Box Hill,P2M NGeco - Zwift,Kickr 18 - Wahoo Bolt,429,429,0
62573,1602925499,wahoo,Zwift - 3R Hilly Race (A) #1,P2M NGeco - Zwift,Kickr 18 - Wahoo Bolt,337,337,0
63516,1603214578,wahoo,Zwift - Zwift Racing League | WTRL - EMEA E (MEN) - TTT Grp 1 OUCH...!!!,P2M NGeco - Zwift,Kickr 18 - Wahoo Bolt,383,360,23
65092,1603736101,wahoo,Zwift - DBR Ride´N´Roll League (A)#2,P2M NGeco - Zwift,Kickr 18 - Wahoo Bolt,375,363,12
65401,1603811100,wahoo,Zwift - 3R Volcano Circuit Flat Race - 8 Laps (35.2km/21.9mi 160m) (A) #1,P2M NGeco - Zwift,Kickr 18 - Wahoo Bolt,360,335,25
65758,1603897501,wahoo,Zwift - 3R LaGurardia Super Sprint Race - 1 Lap (3.7km/2.6mi 27m) (A) #2 #niceOneTom :),P2M NGeco - Zwift,Kickr 18 - Wahoo Bolt,420,392,28
66114,1603992599,wahoo,Zwift - EVO CC Sprint Race Series  (A) #1,P2M NGeco - Zwift,Kickr 18 - Wahoo Bolt,342,334,8
66587,1604140201,wahoo,Zwift - 3R Volcano Climb Race - 1 Lap (22.4km/14mi 204m) (A) #2 DBR K. Farup taking the win on the wheel of a flier..!!!,P2M NGeco - Zwift,Kickr 18 - Wahoo Bolt,397,387,10
67551,1604421601,wahoo,Zwift - Team Italy Specialissima Race (A) #1,Quarq Dfour - Zwift,Kickr V5 - Wahoo Bolt,371,353,18
68219,1604601901,wahoo,Zwift - XRS - ZTR Thursday Night Race (A) #2,Quarq Dfour - Zwift,Kickr V5 - Wahoo Bolt,350,338,12
68786,1604757598,wahoo,ZA Road Group Ride,Quarq Dfour - Zwift,Kickr V5 - Wahoo Bolt,263,258,5
69381,1604946901,wahoo,Zwift - XRS Races: Monday&#039;s blues (A) #1,P2M NGeco - Zwift,Kickr V5 - Wahoo Bolt,393,380,13
69682,1605020511,wahoo,Zwift - 2x5 og 15 min SST,P2M NGeco - Zwift,Kickr V5 - Wahoo Bolt,315,310,5
70175,1605107099,wahoo,Zwift - 3R LaGurardia Super Sprint Race - 1 Lap (3.7km/2.6mi 27m) (A),P2M NGeco - Zwift,Kickr V5 - Wahoo Bolt,370,361,9
70841,1605205799,wahoo,Zwift - FUSION ECT BEUNSTOPPABLE Racing Series (A) #4 Lock FTW!,P2M NGeco - Zwift,Kickr V5 - Wahoo Bolt,341,332,9
71560,1605429299,wahoo,Zwift - ZHR Masters Weekender (A) #1,P2M NGeco - Zwift,Kickr V5 - Wahoo Bolt,328,318,10
72224,1605637410,wahoo,Zwift - Zwift Racing League | WTRL - Men&#039;s EMEA E1 DIVISION 1 (A) #toasted,P2M NGeco - Zwift,Kickr V5 - Wahoo Bolt,390,380,10
72568,1605710101,wahoo,Zwift - 3R Sand & Sequoias - 1 Lap (20km/12.5mi 173m) (A) #1,Quarq Dfour - Zwift,Kickr V5 - Wahoo Bolt,355,351,4
74075,1606032298,wahoo,Zwift - 3R Volcano Circuit - 6 Laps (A),Quarq Dfour - Zwift,Kickr V5 - Wahoo Bolt,356,348,8
75008,1606241699,wahoo,Zwift - Zwift Racing League | WTRL - Men&#039;s EMEA E1 DIVISION 1 #skideBakke og alt for ho�j puls...,Quarq Dfour - Zwift,Kickr V5 - Wahoo Bolt,394,387,7
75903,1606399498,wahoo,3R Classique Flat Race - 6 Laps (37.7km/23.4mi 114m) #2 + 10 x 40/20,P2M NGeco - Zwift,Kickr V5 - Wahoo Bolt,362,356,6
76778,1606557600,wahoo,Zwift - Cycling Ireland Zwift League Rd 3 (A) #1 Hell Yeah,P2M NGeco - Zwift,Kickr V5 - Wahoo Bolt,392,391,1
77210,1606638899,wahoo,Zwift - ZHR Masters Weekender (A) #3 GCC team win!,P2M NGeco - Zwift,Kickr V5 - Wahoo Bolt,368,356,12
77652,1606760999,wahoo,Zwift - Team KST ,P2M NGeco - Zwift,Kickr V5 - Wahoo Bolt,371,365,6
80026,1607249375,wahoo,Zwift - 3R Sand & Sequoias - 1 Lap (20km/12.5mi 173m) (A) #3 ,P2M NGeco - Zwift,Kickr V5 - Wahoo Bolt,354,346,8
82613,1607848103,wahoo,Zwift - ZHQ FutureWorks Circuit Race - Anti-sandbagging (A),Quarq Dfour - Zwift,Kickr V5 - Wahoo Bolt,323,316,7
87688,1609057690,wahoo,Zwift - ZHQ FutureWorks Circuit Race - Anti-sandbagging (A),Quarq Dfour - Zwift,Kickr V5 - Wahoo App,334,333,1
88284,1609179196,wahoo,Zwift -  DBR Monday Race (A) #10 prygl af Vulkanen!,Quarq Dfour - Zwift,Kickr V5 - Wahoo App,417,411,6
88707,1609267989,wahoo,Zwift - Team Italy & Frenchy Fuzion League (A) #32 flere prygl pa vulkanen!,Quarq Dfour - Zwift,Kickr V5 - Wahoo App,415,409,6
88969,1609331281,wahoo,Zwift - 3R LaGuardia Loop Flat Race - 10 Laps (28.3km/17.6mi 270m) (A) #4,Quarq Dfour - Zwift,Kickr V5 - Wahoo App,389,346,43
89862,1609522082,wahoo,Zwift - EVO CC / Le Col - Sprint Race Series (A) #1,Quarq Dfour - Zwift,Kickr V5 - Wahoo App,347,346,1
90558,1609664614,wahoo,Zwift - Newbury Velo Road Race (A) #9 shittyLegs,Quarq Dfour - Zwift,Kickr V5 - Wahoo App,390,378,12
91729,1609862524,wahoo,Zwift - 3R Volcano Circuit Flat Race - 8 Laps (35.2km/21.9mi 160m) (A) #9,Quarq Dfour - Zwift,Kickr V5 - Wahoo App,366,354,12
92928,1610044108,wahoo,Zwift - FUSION WINTER CUP (A) #8,Quarq Dfour - Zwift,Kickr V5 - Wahoo App,379,369,10
93718,1610188059,wahoo,Zwift - 3R Volcano Climb Race - 1 Lap (22.4km/14mi 204m) (A) #1,Quarq Dfour - Zwift,Kickr V5 - Wahoo App,398,389,9
95632,1610475138,wahoo,Zwift - Zwift Racing League | WTRL - Men&#039;s/Mixed EMEA E1 DIVISION 1 (A),Quarq Dfour - Zwift,Kickr V5 - Wahoo App,387,378,9
97788,1610791072,wahoo,Zwift - Cycling Ireland Zwift League Rd 8 (A) #2,Quarq Dfour - Zwift,Kickr V5 - Wahoo App,348,342,6
99702,1611080100,wahoo,Zwift - Zwift Racing League | WTRL - Men&#039;s/Mixed EMEA E1 DIVISION 1 (A),Quarq Dfour - Zwift,Kickr V5 - Wahoo App,371,365,6
101694,1611397671,wahoo,Zwift - 3R Volcano Climb Race - 1 Lap (22.4km/14mi 204m) (A) #2,Quarq Dfour - Zwift,Kickr V5 - Wahoo App,417,409,8
102949,1611602280,wahoo,Zwift - Team TFC Mad Monday Winter Series (A) #2,Quarq Dfour - Zwift,Kickr V5 - Wahoo App,370,365,5
105466,1612003341,wahoo,Zwift - Into the Red by RELENTLESS (A) #1,Zwift,Kickr V5 - Wahoo App,366,359,7
115221,1613415478,wahoo,Zwift -  SCF SWE Cup Men (A),Quarq Dfour - Zwift,Kickr V5 - Wahoo App,414,428,-14
116674,1613587098,wahoo,Zwift - Danmarks Cykle Union & Partners 6/6 (A) #45 all for Lock!,Kickr V5 - Zwift,Quarq Dfour - Wahoo Bolt,358,347,11
117269,1613674623,wahoo,Zwift - Team KST ,Kickr V5 - Zwift,Quarq Dfour - Wahoo Bolt,367,362,5
117710,1613742492,wahoo,Zwift - KISS Race Series - Pacific AM (A) #5,Kickr V5 - Zwift,Quarq Dfour - Wahoo Bolt,403,402,1
118141,1613816889,wahoo,"Zwift - Cycling Weekly Winter Lockdown RR Series (A) #DNF WTF Zwift & Wahoo, huge dropouts!!!!",Kickr V5 - Zwift,Quarq Dfour - Wahoo Bolt,354,354,0
118585,1613901435,wahoo,Zwift - DBR Sunday Race (A),Quarq Dfour - Zwift,Kickr V5 - Wahoo App,348,348,0
121975,1614503656,wahoo,Zwift - Fantasy Nutrinovex Rice by PETA-Z (E),Kickr V5 - Zwift,Quarq Dfour - Wahoo Bolt,361,370,-9
122391,1614614867,wahoo,Zwift - 3R Classique Reverse Flat Race - 4 Laps (26.9km/16.7mi 57m) (A) #2,Quarq Dfour - Zwift,Kickr V5 - Wahoo App,335,320,15
123988,1614877358,wahoo,Zwift - OH MY CRIT!! - The Double Race 2/2 (A) #15,Quarq Dfour - Zwift,Kickr V5 - Wahoo App,400,395,5
125318,1615107791,wahoo,Zwift - Newbury Velo Road Race (A) #6 gummiben,Quarq Dfour - Zwift,Kickr V5 - Wahoo App,376,371,5
127435,1615555951,wahoo,Zwift - Crit City Race (A) #2,Kickr V5 - Zwift,Quarq Dfour - Wahoo Bolt,368,367,1
34402,1589307290,neo,Zwift - UNO X CUP powered by DCU & Feltet.dk (A),FSA Powerbox,Tacx Neo,373,360,13
35259,1589617799,neo,Zwift - DBR Sufferday League (A),FSA Powerbox,Tacx Neo,346,348,-2
35808,1589811297,neo,Zwift - 3R Classique Reverse Flat Race - 5 Laps (32km/20.1mi 76m) (A),FSA Powerbox,Tacx Neo,363,370,-7
36078,1589912091,neo,Zwift - UNO X CUP powered by DCU & Feltet.dk (A),FSA Powerbox,Tacx Neo,363,379,-16
36869,1590160498,neo,Zwift - 3R Sand and Sequoias Race (A),FSA Powerbox,Tacx Neo,386,359,27
36991,1590219299,neo,Zwift - INC Steady State - Group Training Ride 2.9 - 3.5w (B),FSA Powerbox,Tacx Neo,358,337,21
38301,1590680787,neo,Zwift - Richmond,FSA Powerbox,Tacx Neo,308,293,15
82267,1607769879,neo,Into the Red by RELENTLESS,Quarq Dzero ,Old Overheating Neo,447,432,15
82952,1607885973,neo,Zwift Fondo Series 2020/21,Quarq Dzero ,Old Overheating Neo,440,425,15
83673,1608061898,neo,Zwift Racing League | WTRL - Mens EMEA W1 DIVISION 1,Quarq Dzero ,Old Overheating Neo,430,418,12
87817,1609071545,neo,Ottawa TopSpeed Race,Quarq Dzero ,Old Overheating Neo,421,413,8
88324,1609183134,neo,Team TFC Mad Monday Winter Series,Quarq Dzero ,Old Overheating Neo,400,389,11
88325,1609186138,neo,GGCC Glasgow Green Cycle Club Race Series,Quarq Dzero ,Old Overheating Neo,352,344,8
90259,1609595345,neo,XRS Races: Saturday Climbing Series,Quarq Dzero ,Old Overheating Neo,411,405,6
90876,1609683135,neo,KISS 100 Race Series - Americas,Quarq Dzero ,Old Overheating Neo,392,384,8
91402,1609787394,neo,Team TFC Mad Monday Winter Series,Quarq Dzero ,Old Overheating Neo,386,381,5
91407,1609790940,neo,GGCC Glasgow Green CC Race Series,Quarq Dzero ,Old Overheating Neo,351,347,4
92445,1609963003,neo,TDZ Stage 1: Group Ride,Quarq Dzero ,Old Overheating Neo,399,393,6
94647,1610307262,neo,Zwift - KISS Race Series - EU PM (A),Quarq Dzero ,Neo OG,425,417,8
96268,1610532804,neo,Calibration check,Quarq Dzero ,Neo OG,258,258,0
96547,1610567287,neo,Zwift - TDZ Stage 2: Standard Ride,Quarq Dzero ,Neo OG,383,376,7
97459,1610717946,neo,Z2/Z3 Session,Quarq Dzero ,Neo OG,328,327,1
98743,1610909348,neo,Zwift - BRT Iron Goat Racing League (A),Quarq Dzero ,Neo OG,437,429,8
99914,1611084715,neo,Zwift - Zwift Racing League | WTRL - Men&#039;s/Mixed EMEA W2 DIVISION 1 (A),Quarq Dzero ,Neo OG,402,402,0
99926,1611084715,neo,Zwift - 3R Volcano Flat Reverse Race - 3 Laps (36.6km/22.7mi 138m) (A),Quarq Dzero ,Neo OG,422,415,7
82587,1607829301,neo,Zwift - 3R Watopia Flat Route Race - 3 Laps (30.3km/18.8mi 162m) (A),Power 2 Max,Neo 2T,336,321,15
82907,1607883121,neo,Zwift - ZHR Hare & Hounds Race (A),Power 2 Max,Neo 2T,349,336,13
101388,1611324240,neo,Zwift - 3R Innsbruckring Flat Race - 2 Laps (17.6km/10.9m 154m) (A),Assioma P Duo,Tacx NEo,393,389,4
102506,1611509399,neo,Zwift - 210 Watt,Assioma P Duo,Tacx NEo,239,243,-4
103272,1611650565,neo,Zwift - Zwift Racing League | WTRL - Men&#039;s/Mixed APAC DIVISION 1 (A),Assioma P Duo,Tacx NEo,384,390,-6
103567,1611684956,neo,Zwift - Zwift Racing League | WTRL - Men&#039;s/Mixed EMEA E1 DIVISION 3 (A),Assioma P Duo,Tacx NEo,398,399,-1
82395,1607786098,wahoo,Zwift - OH MY CRIT - Saturday Smash Race (A),Quarq DZERO,Wahoo Kickr,449,452,-3
83530,1608056469,wahoo,Zwift - Zwift Racing League | WTRL - Men&#039;s EMEA E1 DIVISION 1 (A),Quarq DZERO,Wahoo Kickr,377,384,-7
108491,1612396761,wahoo,Zwift - Open - Movistar Team Challenge Community Qualifier Race #2,Quarq DZERO,Wahoo Kickr,398,401,-3
12863,1581015602,wahoo,Zwift - KALAS Cup - Round 2 (A),Garmin Vector 3s,Wahoo Kickr 2017,458,459,-1
13349,1581141900,wahoo,Zwift - 3R Road To Ruins Hilly Race - 1 Lap (29..2km/18.1mi 275m) (A),Garmin Vector 3s,Wahoo Kickr 2017,416,419,-3
13511,1581450022,wahoo,Zwift - 3R Ultimate Racing League - Round 6 (A),Garmin Vector 3s,Wahoo Kickr 2017,414,410,4
13853,1581620400,wahoo,Zwift - KALAS Cup - Round 3 (A),Garmin Vector 3s,Wahoo Kickr 2017,396,406,-10
14639,1582053313,wahoo,Zwift - Feltet.dk Race Series,Garmin Vector 3s,Wahoo Kickr 2017,400,400,0
15016,1582225189,wahoo,Zwift - KALAS Cup - Round 4 (A),Garmin Vector 3s,Wahoo Kickr 2017,426,431,-5
15395,1582484393,wahoo,Zwift - BRT Iron Goat Racing League (A),Garmin Vector 3s,Wahoo Kickr 2017,421,423,-2
15397,1582358692,wahoo,Zwift - 3R Richmond UCI Reverse Race - 2 Laps (A),Garmin Vector 3s,Wahoo Kickr 2017,391,399,-8
15974,1582830013,wahoo,Zwift - KALAS Cup - Round 5 (A),Garmin Vector 3s,Wahoo Kickr 2017,401,407,-6
16411,1582999515,wahoo,Zwift - 3R Three Sisters Hilly Race (47km/29.2mi 879m) (A),Garmin Vector 3s,Wahoo Kickr 2017,437,437,0
16414,1583043297,wahoo,Zwift - 3R Gotham Grind Flat Race - 2 Laps (18.5km/11.6mi 58m) (A),Garmin Vector 3s,Wahoo Kickr 2017,357,357,0
16874,1583262890,wahoo,Zwift - Feltet.dk Race Series (A),Garmin Vector 3s,Wahoo Kickr 2017,414,417,-3
17046,1583434782,wahoo,Zwift - KALAS Cup - Round 6 (A),Garmin Vector 3s,Wahoo Kickr 2017,396,397,-1
17327,1583648113,wahoo,Zwift - 3R Gotham Grind Flat Race - 2 Laps (18.5km/11.6mi 58m) (A),Garmin Vector 3s,Wahoo Kickr 2017,397,399,-2
17328,1583561102,wahoo,Zwift - 3R Road To Ruins Hilly Race - 1 Lap (29..2km/18.1mi 275m) (A),Garmin Vector 3s,Wahoo Kickr 2017,381,381,0
17622,1583867692,wahoo,Zwift - Feltet.dk Race Series (A),Garmin Vector 3s,Wahoo Kickr 2017,397,399,-2
17902,1584040471,wahoo,Zwift - Tour of Watopia Pro-Am Men&#039;s Race #1 (A),Garmin Vector 3s,Wahoo Kickr 2017,449,448,1
18513,1584472494,wahoo,Zwift - Feltet.dk Race Series (A),Garmin Vector 3s,Wahoo Kickr 2017,412,412,0
18798,1584644390,wahoo,Zwift - KALAS Cup - Round 8 (A),Garmin Vector 3s,Wahoo Kickr 2017,393,395,-2
18924,1584731678,wahoo,Zwift - Tour of Watopia Pro-Am Men&#039;s Race #2 (A),Garmin Vector 3s,Wahoo Kickr 2017,452,452,0
19104,1584857687,wahoo,Zwift - 3R Gotham Grind Flat Race - 2 Laps (18.5km/11.6mi 58m) (A),Garmin Vector 3s,Wahoo Kickr 2017,405,407,-2
19521,1585077229,wahoo,Zwift - Tour of Watopia Pro-Am Men&#039;s Race #3 (A),Garmin Vector 3s,Wahoo Kickr 2017,411,416,-5
19888,1585249178,wahoo,Zwift - KALAS Cup - Round 9 (A),Garmin Vector 3s,Wahoo Kickr 2017,431,430,1
20276,1585462492,wahoo,Zwift - 3R Gotham Grind Flat Race - 2 Laps (18.5km/11.6mi 58m) (A),Garmin Vector 3s,Wahoo Kickr 2017,403,402,1
20574,1585508410,wahoo,Zwift - Stage 1 - Longer Ride - Tour of Watopia 2020,Garmin Vector 3s,Wahoo Kickr 2017,391,389,2
20893,1585677608,wahoo,Zwift - NCF Spring Cup (A),Garmin Vector 3s,Wahoo Kickr 2017,419,419,0
21507,1585850383,wahoo,Zwift - KALAS Cup - Round 10 (A),Garmin Vector 3s,Wahoo Kickr 2017,415,404,11
21889,1585889973,wahoo,Zwift - Stage 1 - Longer Ride - Tour of Watopia 2020,Garmin Vector 3s,Wahoo Kickr 2017,372,372,0
21890,1585978177,wahoo,Zwift - XRS Races - The Saturday Classic (A),Garmin Vector 3s,Wahoo Kickr 2017,391,388,3
22124,1586063063,wahoo,Zwift - 3R Volcano Flat Race - 3 Laps (36.6km/22.7mi 138m) (A),Garmin Vector 3s,Wahoo Kickr 2017,387,385,2
22822,1586282361,wahoo,Zwift - NCF Spring Cup (A),Garmin Vector 3s,Wahoo Kickr 2017,467,469,-2
23439,1586495687,wahoo,Zwift - London International Race (A),Garmin Vector 3s,Wahoo Kickr 2017,433,421,12
23441,1586495687,wahoo,Zwift - 3R Innsbruckring Sprint Race - 1 Lap (8.8km/5.5mi 77m) (A),Garmin Vector 3s,Wahoo Kickr 2017,433,430,3
23642,1586582990,wahoo,Zwift - XRS Races - The Saturday Classic (A),Garmin Vector 3s,Wahoo Kickr 2017,408,408,0
23922,1586667864,wahoo,Zwift - 3R Volcano Flat Race - 3 Laps (36.6km/22.7mi 138m) (A),Garmin Vector 3s,Wahoo Kickr 2017,383,385,-2
24667,1586887168,wahoo,Zwift - NCF Spring Cup (A),Garmin Vector 3s,Wahoo Kickr 2017,405,403,2
25745,1587186295,wahoo,Zwift - 3R Watopia Hilly Reverse Race - 3 Laps (27.5km/17.1mi 300m) (A),Garmin Vector 3s,Wahoo Kickr 2017,397,396,1
25746,1587147008,wahoo,Zwift - Richmond Challenge // Zwift Classic (A),Garmin Vector 3s,Wahoo Kickr 2017,439,448,-9
26097,1587274196,wahoo,Zwift - XRS Races: a Longer and Hard race (A),Garmin Vector 3s,Wahoo Kickr 2017,413,412,1
26740,1587491981,wahoo,Zwift - NCF Spring Cup (A),Garmin Vector 3s,Wahoo Kickr 2017,426,434,-8
27568,1587659383,wahoo,Zwift - Watopia Cup Race // Zwift Classic (A),Garmin Vector 3s,Wahoo Kickr 2017,403,406,-3
28037,1587838185,wahoo,Zwift - Crit City Slam // Zwift Classic,Garmin Vector 3s,Wahoo Kickr 2017,422,424,-2
28126,1587877495,wahoo,Zwift - 3R Volcano Flat Race - 3 Laps (36.6km/22.7mi 138m) (A),Garmin Vector 3s,Wahoo Kickr 2017,395,400,-5
28292,1587918592,wahoo,Zwift - Crit City Slam Race // Zwift Classic (A),Garmin Vector 3s,Wahoo Kickr 2017,388,390,-2
28912,1588096778,wahoo,Zwift - NCF Spring Cup (A),Garmin Vector 3s,Wahoo Kickr 2017,448,447,1
29144,1588177815,wahoo,Zwift - Crit City Slam Race // Zwift Classic (A),Garmin Vector 3s,Wahoo Kickr 2017,386,387,-1
29946,1588310103,wahoo,Zwift - 3R Innsbruckring Sprint Race - 1 Lap (8.8km/5.5mi 77m) (A),Garmin Vector 3s,Wahoo Kickr 2017,436,435,1
29947,1588313376,wahoo,Zwift - 3R Volcano Circuit Flat Race - 4 Laps (18.9km/11.7mi 80m) (A),Garmin Vector 3s,Wahoo Kickr 2017,356,360,-4
30364,1588397391,wahoo,Zwift - XRS Races - The Saturday Classic (A),Garmin Vector 3s,Wahoo Kickr 2017,432,432,0
30782,1588482265,wahoo,Zwift - 3R Volcano Flat Race - 3 Laps (36.6km/22.7mi 138m) (A),Garmin Vector 3s,Wahoo Kickr 2017,398,398,0
31760,1588702477,wahoo,Zwift - UNO X CUP powered by DCU & Feltet.dk (A),Garmin Vector 3s,Wahoo Kickr 2017,454,456,-2
32101,1588787687,wahoo,Zwift - USA Cycling Race League p/b Saris+ThePro&#039;sCloset  (A),Garmin Vector 3s,Wahoo Kickr 2017,393,395,-2
32870,1589002192,wahoo,Zwift - XRS Races - The Saturday Classic (A),Garmin Vector 3s,Wahoo Kickr 2017,385,387,-2
33153,1589087066,wahoo,Zwift - 3R Volcano Flat Race - 3 Laps (36.6km/22.7mi 138m) (A),Garmin Vector 3s,Wahoo Kickr 2017,377,376,1
34187,1589307251,wahoo,Zwift - UNO X CUP powered by DCU & Feltet.dk (A),Garmin Vector 3s,Wahoo Kickr 2017,460,465,-5
35741,1589691872,wahoo,Zwift - 3R Volcano Flat Race - 3 Laps (36.6km/22.7mi 138m) (A),Garmin Vector 3s,Wahoo Kickr 2017,419,402,17
36532,1590037198,wahoo,Zwift - Tour for All 2020: Stage 5 3R&#039;s Choice with NAOYA YOSHIOKA,Garmin Vector 3s,Wahoo Kickr 2017,387,394,-7
36794,1590123589,wahoo,Zwift - Tour for All 2020: Stage 5 3R&#039;s Choice,Garmin Vector 3s,Wahoo Kickr 2017,426,429,-3
36982,1590210017,wahoo,Zwift - Tour for All 2020: Stage 5 3R&#039;s Choice with KOHEI UCHIMA,Garmin Vector 3s,Wahoo Kickr 2017,420,421,-1
37283,1590296691,wahoo,Zwift - 3R Volcano Flat Race - 3 Laps (36.6km/22.7mi 138m) (A),Garmin Vector 3s,Wahoo Kickr 2017,419,424,-5
37969,1590516893,wahoo,Zwift - UNO X CUP powered by DCU & Feltet.dk (A),Garmin Vector 3s,Wahoo Kickr 2017,481,484,-3
38198,1590602070,wahoo,Zwift - USA Cycling Race League by Indoor Specialist (A),Garmin Vector 3s,Wahoo Kickr 2017,465,463,2
38615,1590815066,wahoo,Zwift - 3R Watopia Hilly Reverse Race - 3 Laps (27.5km/17.1mi 300m) (A),Garmin Vector 3s,Wahoo Kickr 2017,423,428,-5
39221,1591121666,wahoo,Zwift - UNO X CUP powered by DCU & Feltet.dk (A),Assioma Duo,Wahoo Kickr 2017,461,477,-16
39782,1591349372,wahoo,Zwift - ZHR Morning Tea Race (A),Assioma Duo,Wahoo Kickr 2017,408,409,-1
39783,1591346675,wahoo,Zwift - Crit City Race (A),Assioma Duo,Wahoo Kickr 2017,420,425,-5
39908,1591421390,wahoo,Zwift - XRS Races - The Saturday Classic (A),Assioma Duo,Wahoo Kickr 2017,420,409,11
40095,1591506288,wahoo,Zwift - 3R Volcano Flat Race - 3 Laps (36.6km/22.7mi 138m) (A),Assioma Duo,Wahoo Kickr 2017,372,378,-6
41377,1592026207,wahoo,Zwift - XRS Races - The Saturday Classic (A),Assioma Duo,Wahoo Kickr 2017,409,400,9
41812,1592211585,wahoo,Zwift - MET-5 Race (A),Assioma Duo,Wahoo Kickr 2017,370,380,-10
41955,1592299771,wahoo,Zwift - ZHR Masters Asia (B),Assioma Duo,Wahoo Kickr 2017,389,391,-2
43061,1592630990,wahoo,Zwift - XRS Races - The Saturday Classic (A),Assioma Duo,Wahoo Kickr 2017,429,434,-5
43062,1592715891,wahoo,Zwift - 3R Volcano Flat Race - 3 Laps (36.6km/22.7mi 138m) (A),Assioma Duo,Wahoo Kickr 2017,403,410,-7
43565,1592936090,wahoo,Zwift - UNO X CUP powered by DCU & Feltet.dk (A),Assioma Duo,Wahoo Kickr 2017,465,469,-4
44129,1593454795,wahoo,Zwift - TFC Mad Monday Series (6 of 6) (A),Assioma Duo,Wahoo Kickr 2017,365,379,-14
44130,1593450892,wahoo,Zwift - DBR Monday Race  (A),Assioma Duo,Wahoo Kickr 2017,357,366,-9
44134,1593422093,wahoo,Zwift - 3R Watopia Flat Route Race - 4 Laps (41km/25.5mi 216m) (A),Assioma Duo,Wahoo Kickr 2017,398,412,-14
44135,1593420298,wahoo,Zwift - Crit City Race (A),Assioma Duo,Wahoo Kickr 2017,396,407,-11
44964,1593840616,wahoo,Zwift - XRS Races - The Saturday Classic (A),Assioma Duo,Wahoo Kickr 2017,395,402,-7
44965,1593925489,wahoo,Zwift - 3R Volcano Flat Race - 3 Laps (36.6km/22.7mi 138m) (A),Assioma Duo,Wahoo Kickr 2017,405,422,-17
45080,1594011765,wahoo,Zwift - Virtual Tour de France - Open - Stage 2 Discovery Ride,Assioma Duo,Wahoo Kickr 2017,401,413,-12
45768,1594357821,wahoo,Zwift - Virtual Tour de France - Open - Stage 1 Discovery Ride,Assioma Duo,Wahoo Kickr 2017,418,429,-11
46358,1594706440,wahoo,Zwift - Virtual Tour de France - Open - Stage 3 Discovery Ride,Assioma Duo,Wahoo Kickr 2017,391,402,-11
47158,1595269189,wahoo,Zwift - TFC Mad Monday Summer Series (3 of 10) (A),Assioma Duo,Wahoo Kickr 2017,440,466,-26
47261,1595357991,wahoo,Zwift - KISS at Race - EU PM (A),Assioma Duo,Wahoo Kickr 2017,335,348,-13
47637,1595654996,wahoo,Zwift - XRS Races - The Saturday Classic (A),Assioma Duo,Wahoo Kickr 2017,389,379,10
47828,1595789994,wahoo,Zwift - 2020 BRT Intra-Team Championship Road Race (A),Assioma Duo,Wahoo Kickr 2017,425,442,-17
47829,1595831396,wahoo,Zwift - ZHQ Beta Crit City Race (A),Assioma Duo,Wahoo Kickr 2017,389,381,8
48231,1596050093,wahoo,Zwift - 3R Tick Tock Flat Race - 2 Lap (36km/22.4mi 100m) (A),Assioma Duo,Wahoo Kickr 2017,310,321,-11
48232,1596045291,wahoo,Zwift - USA Cycling Race League by Indoor Specialist (A),Assioma Duo,Wahoo Kickr 2017,376,377,-1
48233,1595967296,wahoo,Zwift - JETT ZWIFT Morning Race (A),Assioma Duo,Wahoo Kickr 2017,419,410,9
48234,1595961586,wahoo,Zwift - 3R Turbocharged Team Race Series - Round 3 (A),Assioma Duo,Wahoo Kickr 2017,445,430,15
48543,1596344679,wahoo,Zwift - 3R Volcano Flat Race - 3 Laps (36.6km/22.7mi 138m) (A),Assioma Duo,Wahoo Kickr 2017,379,386,-7
49426,1596949487,wahoo,Zwift - 3R Volcano Flat Race - 3 Laps (36.6km/22.7mi 138m) (A),Assioma Duo,Wahoo Kickr 2017,371,376,-5
49427,1596905422,wahoo,Zwift - 3R Innsbruckring Flat Race - 3 Laps (26.4km/16.4mi 231m) (A),Assioma Duo,Wahoo Kickr 2017,390,394,-4
49429,1596864587,wahoo,Zwift - XRS Races - The Saturday Classic (A),Assioma Duo,Wahoo Kickr 2017,454,457,-3
49912,1597381190,wahoo,Zwift - Longer Ride - 7 Days of Tarmac SL7: Stage 2 with Mike Whitesides,Assioma Duo,Wahoo Kickr 2017,417,414,3
49914,1597341598,wahoo,Zwift - Longer Ride - 7 Days of Tarmac SL7: Stage 2,Assioma Duo,Wahoo Kickr 2017,404,412,-8
49915,1597083595,wahoo,Zwift - TFC Mad Monday Summer Series (6 of 10) (A),Assioma Duo,Wahoo Kickr 2017,469,466,3
50212,1597554284,wahoo,Zwift - 3R Volcano Flat Race - 3 Laps (36.6km/22.7mi 138m) (A),Assioma Duo,Wahoo Kickr 2017,410,416,-6
50213,1597471495,wahoo,Zwift - 3R Road To Ruins Hilly Race - 1 Lap (29..2km/18.1mi 275m) (A),Assioma Duo,Wahoo Kickr 2017,415,424,-9
50665,1597688375,wahoo,Zwift - TFC Mad Monday Summer Series (7 of 10) (A),Assioma Duo,Wahoo Kickr 2017,407,402,5
52909,1598678988,wahoo,Zwift - XRS Races - The Saturday Classic (A),Assioma Duo,Wahoo Kickr 2017,454,475,-21
52911,1598763878,wahoo,Zwift - 3R Volcano Flat Race - 3 Laps (36.6km/22.7mi 138m) (A),Assioma Duo,Wahoo Kickr 2017,395,410,-15
53611,1599153123,wahoo,Zwift - ZHR Hare & Hounds Race (A),Assioma Duo,Wahoo Kickr 2017,357,376,-19
53612,1599368676,wahoo,Zwift - 3R Volcano Flat Race - 3 Laps (36.6km/22.7mi 138m) (A),Assioma Duo,Wahoo Kickr 2017,406,407,-1
54094,1599502790,wahoo,Zwift - TFC Mad Monday Summer Series (10 of 10) (A),Assioma Duo,Wahoo Kickr 2017,386,387,-1
54216,1599674693,wahoo,Zwift - DBR Wednesday Race (A),Assioma Duo,Wahoo Kickr 2017,432,441,-9
54686,1599815116,wahoo,Zwift - 3R Whole Lotta Lava Hilly Race - 2 Laps (28.9km/12.53mi 336m) (A),Assioma Duo,Wahoo Kickr 2017,426,419,7
54688,1599888593,wahoo,Zwift - XRS Races - The Saturday Classic (A),Assioma Duo,Wahoo Kickr 2017,436,411,25
54819,1599973484,wahoo,Zwift - 3R Volcano Flat Race - 3 Laps (36.6km/22.7mi 138m) (A),Assioma Duo,Wahoo Kickr 2017,356,357,-1
55130,1600106121,wahoo,Zwift - Invitational League // Qualifying Race #1,Assioma Duo,Wahoo Kickr 2017,442,442,0
55982,1600367289,wahoo,Zwift - Invitational League // Qualifying Race #2 (Men) ,Assioma Duo,Wahoo Kickr 2017,407,401,6
57172,1600931096,wahoo,Zwift - 3R Innsbruckring Flat Race - 5 Laps (44km/27.3mi 385m) (A),Assioma Duo,Wahoo Kickr 2017,371,359,12
57173,1600883073,wahoo,Zwift - NCF Vinter Cup 2020 - Runde 1 - Herrer (A),Assioma Duo,Wahoo Kickr 2017,434,411,23
58162,1601317168,wahoo,Zwift - TFC Mad Monday Autumn Series (A),Assioma Duo,Wahoo Kickr 2017,383,392,-9
58705,1601486989,wahoo,Zwift - NCF Vinter Cup 2020 - Runde 2 - Herrer (A),Assioma Duo,Wahoo Kickr 2017,381,394,-13
59345,1601787885,wahoo,Zwift - 3R Volcano Flat Race - 3 Laps (36.6km/22.7mi 138m) (A),Assioma Duo,Wahoo Kickr 2017,368,362,6
59346,1601702987,wahoo,Zwift - XRS Races - The Saturday Classic (A),Assioma Duo,Wahoo Kickr 2017,456,429,27
59349,1601573390,wahoo,Zwift - FUSION ECT BEUNSTOPPABLE Racing Series (A),Assioma Duo,Wahoo Kickr 2017,364,353,11
59817,1601921989,wahoo,Zwift - TFC Mad Monday Autumn Series (A),Assioma Duo,Wahoo Kickr 2017,415,412,3
60509,1602091797,wahoo,Zwift - NCF Vinter Cup 2020 - Runde 3 - Herrer (A),Assioma Duo,Wahoo Kickr 2017,424,406,18
61077,1602392722,wahoo,Zwift - 3R Volcano Flat Race - 3 Laps (36.6km/22.7mi 138m) (A),Assioma Duo,Wahoo Kickr 2017,409,406,3
61569,1602609278,wahoo,Zwift - Zwift Racing League | WTRL,Assioma Duo,Wahoo Kickr 2017,461,448,13
62029,1602696584,wahoo,Zwift - NCF Vinter Cup 2020 - Runde 4 - Herrer (A),Assioma Duo,Wahoo Kickr 2017,388,392,-4
63936,1603301389,wahoo,Zwift - NCF Vinter Cup 2020 - Runde 5 - Herrer (A),Assioma Duo,Wahoo Kickr 2017,423,423,0
65642,1603822488,wahoo,Zwift - Zwift Racing League | WTRL - EMEA E (MEN) -  Division 1 (A),Assioma Duo,Wahoo Kickr 2017,424,427,-3
65643,1603517385,wahoo,Zwift - XRS Races - The Saturday Classic (A),Assioma Duo,Wahoo Kickr 2017,442,433,9
65644,1603360796,wahoo,Zwift - KISS at Race - Americas AM (A),Assioma Duo,Wahoo Kickr 2017,425,415,10
65887,1603909772,wahoo,Zwift - NCF Vinter Cup 2020 - Runde 6 - Herrer (A),Assioma Duo,Wahoo Kickr 2017,483,473,10
66758,1604167474,wahoo,Zwift - 3R Three Sisters Hilly Race (47km/29.2mi 879m) (A),Assioma Duo,Wahoo Kickr 2017,432,428,4
66818,1604078984,wahoo,Zwift - ZHQ FutureWorks Circuit Race - Anti-sandbagging (A),Assioma Duo,Wahoo Kickr 2017,366,365,1
66819,1604082643,wahoo,Zwift - BRT Ages Racing League (B),Assioma Duo,Wahoo Kickr 2017,414,410,4
66820,1604086019,wahoo,Zwift - ZHR Hare & Hounds Race (A),Assioma Duo,Wahoo Kickr 2017,328,334,-6
67105,1604253630,wahoo,Zwift - Frenchy Fuzion Social Ride Recup - 2.5W/Kg (E),Assioma Duo,Wahoo Kickr 2017,229,233,-4
67106,1604251795,wahoo,Zwift - ZHQ FutureWorks Circuit Race - Anti-sandbagging (A),Assioma Duo,Wahoo Kickr 2017,376,371,5
67790,1604428248,wahoo,Zwift - Zwift Racing League | WTRL - Men&#039;s EMEA E1 DIVISION 1 (A),Assioma Duo,Wahoo Kickr 2017,411,412,-1
67974,1604514596,wahoo,Zwift - NCF Vinter Cup 2020 - Runde 7 - Herrer (A),Assioma Duo,Wahoo Kickr 2017,389,390,-1
69845,1604815795,wahoo,Zwift - ZA Road Race #1: 4 - 5 w/kg,Assioma Duo,Wahoo Kickr 2017,403,403,0
69851,1605032052,wahoo,Zwift - Zwift Racing League | WTRL - EMEA E1 (MEN) -  Division 1 (A),Assioma Duo,Wahoo Kickr 2017,479,483,-4
70338,1605119388,wahoo,Zwift - NCF Vinter Cup 2020 - Runde 8 - Herrer (A),Assioma Duo,Wahoo Kickr 2017,409,411,-2
72104,1605420298,wahoo,Zwift - Open: 2020 El Giro de Rigo - Official Route,Assioma Duo,Wahoo Kickr 2017,409,387,22
72106,1605333901,wahoo,Zwift - 3R Road To Ruins Hilly Race - 1 Lap (29..2km/18.1mi 275m) (A),Assioma Duo,Wahoo Kickr 2017,408,417,-9
72107,1605261901,wahoo,Zwift - 3R Innsbruckring Flat Race - 4 Laps (35.2km/21.9mi 308m) (A),Assioma Duo,Wahoo Kickr 2017,360,364,-4
72108,1605176998,wahoo,Zwift - ZHR Up & Down Race (A),Assioma Duo,Wahoo Kickr 2017,405,409,-4
72837,1605723305,wahoo,Zwift - NCF Vinter Cup 2020 - Runde 9 - Herrer (A),Assioma Duo,Wahoo Kickr 2017,397,392,5
78205,1606846965,wahoo,Zwift - Zwift Racing League | WTRL - Men&#039;s EMEA E1 DIVISION 1 (A),Assioma Duo,Wahoo Kickr 2017,421,420,1
91082,1609487509,wahoo,Zwift - ZHQ FutureWorks Crit City Race - Boost mode (A),Assioma Duo,Wahoo Kickr 2017,387,381,6
89609,1609442343,wahoo,BRT Criterium Racing League,Tacx Neo 2T to Zwift,Vector 3 to Wahoo iOS App,350,337,13
89609,1609442343,neo,BRT Criterium Racing League,Vector 3 to Wahoo iOS App,Tacx Neo 2T to Zwift,337,350,-13
90287,1609604969,wahoo,TEAM VEGAN Tofu Tornado - Veganuary STAGE 1,Tacx Neo 2T to Zwift,Vector 3 to Wahoo iOS App,340,329,11
90287,1609604969,neo,TEAM VEGAN Tofu Tornado - Veganuary STAGE 1,Vector 3 to Wahoo iOS App,Tacx Neo 2T to Zwift,329,340,-11
91825,1609872590,wahoo,Zwift - AHDR Bacon Rolls with Caffeine  (B),Tacx Neo 2T to Zwift,Vector 3 to Wahoo iOS App,219,214,5
91825,1609872590,neo,Zwift - AHDR Bacon Rolls with Caffeine  (B),Vector 3 to Wahoo iOS App,Tacx Neo 2T to Zwift,214,219,-5
92498,1609975201,wahoo,Zwift - Finesse Rockets Base Ride (C),Tacx Neo 2T to Zwift,Vector 3 to Wahoo iOS App,302,302,0
92498,1609975201,neo,Zwift - Finesse Rockets Base Ride (C),Vector 3 to Wahoo iOS App,Tacx Neo 2T to Zwift,302,302,0
93438,1610129071,wahoo,World Elite Zwifters Friday Group Ride,Tacx Neo 2T to Zwift,Vector 3 to Wahoo iOS App,296,291,5
93438,1610129071,neo,World Elite Zwifters Friday Group Ride,Vector 3 to Wahoo iOS App,Tacx Neo 2T to Zwift,291,296,-5
93994,1610209733,wahoo,TEAM VEGAN Tofu Tornado - Veganuary STAGE 2,Tacx Neo 2T to Zwift,Vector 3 to Wahoo iOS App,341,339,2
93994,1610209733,neo,TEAM VEGAN Tofu Tornado - Veganuary STAGE 2,Vector 3 to Wahoo iOS App,Tacx Neo 2T to Zwift,339,341,-2
95723,1610475690,neo,Three Sisters Test - Neo 2T,Vector 3 to Edge 130,Tacx Neo 2T to Zwift,334,341,-7
96371,1610560790,neo,MIDWEEK Winter Series by SZR,Vector 3 dual sided to Edge 130 (secondary),Tacx Neo 2T to Zwift (primary),327,334,-7
97249,1610672423,neo,Zwift - KISS Race Series - Americas PM (A),Vector 3 dual sided to Edge 130 (secondary),Tacx Neo 2T to Zwift (primary),296,302,-6
98154,1610814589,neo,TEAM VEGAN Tofu Tornado - Veganuary STAGE 3,Vector 3 dual sided to Edge 130 (secondary),Tacx Neo 2T to Zwift (primary),319,326,-7
100504,1611172803,neo,Zwift - Joseph Chudyk&#039;s Meetup - 2018 UCI Worlds Short Lap,Vector 3 dual sided to Edge 130 (secondary),Tacx Neo 2T to Zwift (primary),324,332,-8
101085,1611259647,neo,Zwift - Joseph Chudyk&#039;s Meetup,Vector 3 dual sided to Edge 130 (secondary),Tacx Neo 2T to Zwift (primary),303,308,-5
102945,1611601441,neo,Zwift - Premier Division // Zwift Racing League (men) (A),Vector 3 dual sided to Edge 130 (secondary),Tacx Neo 2T to Zwift (primary),309,316,-7
104375,1611699864,neo,Zwift - Alex TenElshof &#039;s Meetup,Vector 3 dual sided to Edge 130 (secondary),Tacx Neo 2T to Zwift (primary),286,283,3
104689,1611859495,neo,XRS - ZTR Thursday Night Race,Vector 3 dual sided to Edge 130 (secondary),Tacx Neo 2T to Zwift (primary),345,332,13
106356,1612118396,neo,XRS Races Crit,Vector 3 dual sided to Edge 130 (secondary),Tacx Neo 2T to Zwift (primary),310,310,0
106740,1612205097,neo,Zwift - KATT Race by WKG (A),Vector 3 dual sided to Edge 130 (secondary),Tacx Neo 2T to Zwift (primary),332,327,5
107575,1612295991,neo,Zwift - KISS Race Series - EU PM (A),Vector 3 dual sided to Edge 130 (secondary),Tacx Neo 2T to Zwift (primary),316,313,3
108297,1612378704,neo,Zwift - MINI CRIT by WKG (A),Vector 3 dual sided to Edge 130 (secondary),Tacx Neo 2T to Zwift (primary),306,300,6
108301,1612379694,neo,Zwift - Bullseye Points Race by Herd Racing League (A),Vector 3 dual sided to Edge 130 (secondary),Tacx Neo 2T to Zwift (primary),295,288,7
110979,1612811973,neo,Zwift - Premier Division // Zwift Racing League (men) (A),Vector 3 dual sided to Edge 130 (secondary),Tacx Neo 2T to Zwift (primary),346,340,6
112321,1612983595,neo,Movistar Team Challenge // Round 1,Vector 3 dual sided to Edge 130 (secondary),Tacx Neo 2T to Zwift (primary),328,318,10
115423,1613419293,neo,Zwift - Premier Division // Zwift Racing League (men) (A),Vector 3 dual sided to Edge 130 (secondary),Tacx Neo 2T to Zwift (primary),358,356,2
116785,1613588389,neo,Zwift - Movistar Team Challenge // Round 2 (men) - Race 3/4,Vector 3 dual sided to Edge 130 (secondary),Tacx Neo 2T to Zwift (primary),317,313,4
117558,1613678404,neo,Zwift - KISS Race Series - EU PM (A),Vector 3 dual sided to Edge 130 (secondary),Tacx Neo 2T to Zwift (primary),345,339,6
118475,1613754290,neo,Zwift - 3R Racing (A),Vector 3 dual sided to Edge 130 (secondary),Tacx Neo 2T to Zwift (primary),313,306,7
122649,1614629694,neo,Zwift - Premier Division // Zwift Racing League (men) (A),Vector 3 dual sided to Edge 130 (secondary),Tacx Neo 2T to Zwift (primary),320,313,7
50907,1597913414,wahoo,Zwift - Off the MAAP Invitational Race // Stage 3 (men) ,Quarq - Garmin Edge 520,Wahoo Kickr Core,367,375,-8
55132,1600106412,wahoo,Zwift - Invitational League // Qualifying Race #1,Quarq - Garmin Edge 520,Wahoo Kickr Core,357,370,-13
55999,1600367411,wahoo,Zwift - Invitational League // Qualifying Race #2 (Men) ,Quarq DZero - Garmin Edge 520,Wahoo Kickr Core,340,351,-11
56491,1600606800,wahoo,Zwift - Invitational League // Qualifying Race #3 (Men) (A),Garmin Vector 2 - Edge 520,Wahoo Kickr Core,354,361,-7
58643,1601491501,wahoo,Zwift - Johan Norén&#039;s Meetup - Three Sisters,Garmin Vector 2 - Edge 520,Wahoo KICKR V5,389,393,-4
58923,1601585751,wahoo,Zwift - 1 x 20 min,Garmin Vector 2 - Edge 520,Wahoo KICKR V5,349,346,3
59080,1601650799,wahoo,Zwift - ZHQ Beta Crit City Race (A),Garmin Vector 2 - Edge 520,Wahoo KICKR V5,368,361,7
59499,1601839057,wahoo,Zwift - 2 x 30 min + 2 x 8 min,Garmin Vector 2 - Edge 520,Wahoo KICKR V5,347,349,-2
59663,1601928525,wahoo,Zwift - Richmond,Garmin Vector 2 - Edge 520,Wahoo KICKR V5,294,296,-2
59911,1602009955,wahoo,Zwift - 10 x 1 min attacks,Garmin Vector 2 - Edge 520,Wahoo KICKR V5,291,290,1
60105,1602089996,wahoo,Zwift - MIDWEEK Autumn Series by SZR (A),Garmin Vector 2 - Edge 520,Wahoo KICKR V5,362,364,-2
60413,1602179998,wahoo,Zwift -  Flanders The BZR Ronde  (A),Garmin Vector 2 - Edge 520,Wahoo KICKR V5,364,374,-10
60599,1602253269,wahoo,Zwift - Watopia,Garmin Vector 2 - Edge 520,Wahoo KICKR V5,333,333,0
60862,1602350419,wahoo,Zwift - NYC,Garmin Vector 2 - Edge 520,Wahoo KICKR V5,259,257,2
61054,1602435864,wahoo,Zwift - NYC,Garmin Vector 2 - Edge 520,Wahoo KICKR V5,349,347,2
61325,1602528595,wahoo,Zwift - Premier Division // Zwift Racing League (men) ,Garmin Vector 2 - Edge 520,Wahoo KICKR V5,391,401,-10
61621,1602616029,wahoo,Zwift - 7 x 8 min,Garmin Vector 2 - Edge 520,Wahoo KICKR V5,326,325,1
61975,1602696130,wahoo,Zwift - Watopia,Garmin Vector 2 - Edge 520,Wahoo KICKR V5,258,251,7
62295,1602785697,wahoo,Zwift - Pre Event Ride // Swedish Cycling Federation,Garmin Vector 2 - Edge 520,Wahoo KICKR V5,363,378,-15
62646,1602944099,wahoo,Zwift - OH MY CRIT - Saturday Smash Race (A),Garmin Vector 2 - Edge 520,Wahoo KICKR V5,382,375,7
62935,1603047310,wahoo,Zwift - 3 x 30 min,Quarq DZero - Garmin Edge 520,Wahoo KICKR V5,318,320,-2
63550,1603218916,wahoo,Zwift - 1 x 20 min + 7 x 1 min,Quarq DZero - Garmin Edge 520,Wahoo KICKR V5,360,363,-3
63853,1603299617,wahoo,Zwift - MIDWEEK Autumn Series by SZR (A),Quarq DZero - Garmin Edge 520,Wahoo KICKR V5,363,372,-9
64214,1603386561,wahoo,Zwift - 7 x 15s,Quarq DZero - Garmin Edge 520,Wahoo KICKR V5,239,238,1
64664,1603548915,wahoo,Zwift - OH MY CRIT - Saturday Smash Race (A),Quarq DZero - Garmin Edge 520,Wahoo KICKR V5,365,376,-11
65198,1603742395,wahoo,Zwift - Premier Division // Zwift Racing League (men) (A),Garmin Vector 2 - Edge 520,Wahoo KICKR V5,382,386,-4
65840,1603907994,wahoo,Zwift - MIDWEEK Autumn Series by SZR (A),Garmin Vector 2 - Edge 520,Wahoo KICKR V5,356,354,2
66280,1604002897,wahoo,Zwift - Watopia,Garmin Vector 2 - Edge 520,Wahoo KICKR V5,341,335,6
66516,1604079005,wahoo,Zwift - EVO CC Sprint Race Series  (A),Garmin Vector 2 - Edge 520,Wahoo KICKR V5,373,367,6
67083,1604245180,wahoo,Zwift - 10 x 2 min (2x) @ ftp,Garmin Vector 2 - Edge 520,Wahoo KICKR V5,308,303,5
67983,1604512818,wahoo,Zwift - MIDWEEK Autumn Series by SZR (A),Garmin Vector 2 - Edge 520,Wahoo KICKR V5,350,350,0
68361,1604605819,wahoo,Zwift - WTRL Team Time Trial - Zone 8 (C),Garmin Vector 2 - Edge 520,Wahoo KICKR V5,357,353,4
68504,1604665401,wahoo,Zwift - Watopia,Garmin Vector 2 - Edge 520,Wahoo KICKR V5,376,366,10
69498,1604952011,wahoo,Zwift - Premier Division // Zwift Racing League (men) (A),Garmin Vector 2 - Edge 520,Wahoo KICKR V5,420,416,4
70435,1605117609,wahoo,Zwift - MIDWEEK Autumn Series by SZR (A),Garmin Vector 2 - Edge 520,Wahoo KICKR V5,355,343,12
70886,1605204044,neo,Zwift - Watopia,2020-11-12-19-30-43,Tacx Neo 2T,333,332,1
71207,1605304568,neo,Aiming for Enrike,Quarq DZero - Garmin Edge 520,Tacx Neo 2T,343,342,1
71468,1605366896,neo,Zwift - OH MY CRIT - Saturday Smash Race (A),Quarq DZero - Garmin Edge 520,Tacx Neo 2T,330,329,1
72776,1605731545,neo,Blind Youth Industrial Park,Quarq DZero - Garmin Edge 520,Tacx Neo 2T,271,270,1
73249,1605814201,neo,Zwift - World Championships Experience // Danish Cycling Federation,Quarq DZero - Garmin Edge 520,Tacx Neo 2T,352,349,3
73962,1605901562,neo,Zwift - 2 x 20 min,Quarq DZero - Garmin Edge 520,Tacx Neo 2T,335,334,1
73970,1605968298,neo,Zwift - Karl Tiselius&#039;s Meetup - Three Sisters,Quarq DZero - Garmin Edge 520,Tacx Neo 2T,388,385,3
74747,1606161601,neo,Zwift - Premier Division // Zwift Racing League (men) (A),Quarq DZero - Garmin Edge 520,Tacx Neo 2T,395,392,3
75223,1606239305,neo,Zwift - 4 x 10 min,Quarq DZero - Garmin Edge 520,Tacx Neo 2T,342,338,4
75636,1606327207,neo,Zwift - MIDWEEK Autumn Series by SZR (A),Quarq DZero - Garmin Edge 520,Tacx Neo 2T,370,368,2
76439,1606422907,neo,Zwift - 1 x 30 min + 3 x 8 min,Quarq DZero - Garmin Edge 520,Tacx Neo 2T,353,354,-1
77087,1606576514,neo,Zwift - OH MY CRIT - Saturday Smash Race (A),Quarq DZero - Garmin Edge 520,Tacx Neo 2T,350,350,0
77223,1606638009,neo,Zwift - Team Italy & Frenchy Fuzion Endurance Race (A),Quarq DZero - Garmin Edge 520,Tacx Neo 2T,378,375,3
78620,1606932011,neo,Zwift - MIDWEEK Winter Series by SZR (A),Quarq DZero - Garmin Edge 520,Tacx Neo 2T,355,355,0
81258,1607525106,neo,Zwift - Men&#039;s Elite // 2020 UCI Cycling Esports World Championships,Quarq DZero - Garmin Edge 520,Tacx Neo 2T,356,357,-1
84110,1608144312,neo,Zwift - GCA Cup (A),Quarq DZero - Garmin Edge 520,Tacx Neo 2T,364,364,0
84530,1608235209,neo,Zwift - KISS Race Series - EU PM (A),Quarq DZero - Garmin Edge 520,Tacx Neo 2T,411,412,-1
85123,1608390906,neo,Zwift - OH MY CRIT - Saturday Smash Race (A),Quarq DZero - Garmin Edge 520,Tacx Neo 2T,413,412,1
85592,1608494411,neo,Zwift - KISS Race Series - EU PM (A),Quarq DZero - Garmin Edge 520,Tacx Neo 2T,413,414,-1
86294,1608655385,neo,Zwift - 4 x 8 min,Quarq DZero - Garmin Edge 520,Tacx Neo 2T,346,348,-2
87212,1608904205,neo,Zwift - KISS Race Series - Pacific AM (A),Quarq DZero - Garmin Edge 520,Tacx Neo 2T,374,377,-3
89409,1609351201,neo,Zwift - MIDWEEK Winter Series by SZR (A),Quarq DZero - Garmin Edge 520,Tacx Neo 2T,358,359,-1
90389,1609597297,neo,Will You Smile Again For Me,Quarq DZero - Garmin Edge 520,Tacx Neo 2T,329,330,-1
92467,1609955993,neo,Zwift - MIDWEEK Winter Series by SZR (A),Quarq DZero - Garmin Edge 520,Tacx Neo 2T,372,372,0
94106,1610130478,neo,Zwift - 2 x 20 min,Quarq DZero - Garmin Edge 520,Tacx Neo 2T,330,330,0
94108,1610216681,neo,Zwift - 4 x 7 min + 1  x 20 min,Quarq DZero - Garmin Edge 520,Tacx Neo 2T,330,331,-1
95064,1610392478,neo,Zwift - Premier Division // Zwift Racing League (men) (A),Quarq DZero - Garmin Edge 520,Tacx Neo 2T,353,353,0
96603,1610571346,neo,Zwift - 6 x 7 min,Quarq DZero - Garmin Edge 520,Tacx Neo 2T,330,332,-2
99148,1610996408,neo,Zwift -  SCF SWE Cup Men (A),Quarq DZero - Garmin Edge 520,Tacx Neo 2T,361,361,0
102983,1611601495,neo,Zwift - Premier Division // Zwift Racing League (men) (A),Quarq DZero - Garmin Edge 520,Tacx Neo 2T,351,352,-1
106768,1612205990,neo,Zwift -  SCF SWE Cup Men (A),Quarq DZero - Garmin Edge 520,Tacx Neo 2T,355,358,-3
111159,1612805406,neo,Zwift -  SCF SWE Cup Men (A),Quarq DZero - Garmin Edge 520,Tacx Neo 2T,375,377,-2
113852,1613203503,neo,Zwift - 3R Weekend Race Club - Race 1 (A),Quarq DZero - Garmin Edge 520,Tacx Neo 2T,342,344,-2
115446,1613419315,neo,Zwift - Premier Division // Zwift Racing League (men) (A),Quarq DZero - Garmin Edge 520,Tacx Neo 2T,399,399,0
119063,1614015004,neo,Zwift -  SCF SWE Cup Men (A),Quarq DZero - Garmin Edge 520,Tacx Neo 2T,413,416,-3
128573,1615756414,neo,3 x 8 min + 4 x 1 min,Quarq DZero - Garmin Edge 520,Tacx Neo 2T,358,348,10
128839,1615834816,neo,Zwift -  SCF SWE Cup Men (A),Quarq DZero - Garmin Edge 520,Tacx Neo 2T,365,357,8
85017,1608368660,wahoo,Zwift - e-liga | eCycling league Austria Race 3 (A),Rotor inSpider to Zwift,Wahoo KickR Core to Garmin,384,388,-4
87884,1609078494,wahoo,Zwift - KISS 100 Race Series - Americas (A),InSpider to Garmin,Wahoo KickR Core to Zwift,415,419,-4
88558,1609239596,wahoo,Zwift - KISS Race Series - Americas AM (A),Rotor InSpider ,Wahoo KickR Core,437,440,-3
97983,1610787896,wahoo,Zwift - e-liga | eCycling league Austria Race 4 (A),Rotor inSpider,Wahoo KickR Core,476,453,23
101791,1611392691,wahoo,Zwift - e-liga | eCycling league Austria Race 5 (A),Rotor InSpider to Garmin Edge 1030 Plus,Wahoo KickR Core to Zwift,447,431,16
109704,1612602293,wahoo,Zwift - e-liga | eCycling league Austria Race 6 (A),Rotor InSpider to Garmin Edge 1030+,Wahoo KickR Core to Zwift,400,384,16
118107,1613811890,wahoo,Zwift - e-liga | eCycling league Austria Race 7 (A),Rotor inSpider to Garmin,Wahoo KickR Core to Zwift,402,374,28
121210,1614347394,wahoo,Zwift - KISS Race Series - Pacific AM (A),Rotor INspider,Wahoo KickR Core,418,409,9
79658,1607159909,neo,Zwift - DBR Saturday Race (A),Stages gen3,Tacx Neo 2,349,357,-8
55044,1600105276,wahoo,Zwift - Invitational League // Qualifying Race #1,Garmin Vector 3S,Wahoo KICKR Bike,358,362,-4
56613,1600606118,wahoo,Zwift - Invitational League // Qualifying Race #3 (Men) (A),Garmin Vector 3S,Wahoo KICKR Bike,373,381,-8
61283,1602528269,wahoo,Zwift - Premier Division // Zwift Racing League (men) ,Garmin Vector 3S,Wahoo KICKR Bike,419,416,3
63151,1603129894,wahoo,Zwift - Premier Division // Zwift Racing League (men) ,Garmin Vector 3S,Wahoo KICKR Bike,394,398,-4
65203,1603741399,wahoo,Zwift - Premier Division // Zwift Racing League (men) (A),Garmin Vector 3S,Wahoo KICKR Bike,399,396,3
69517,1604951201,wahoo,Zwift - Premier Division // Zwift Racing League (men) (A),Garmin Vector 3S,Wahoo KICKR Bike,403,408,-5
74710,1606161019,wahoo,Zwift - Premier Division // Zwift Racing League (men) (A),Garmin Vector 3S,Wahoo KICKR Bike,373,372,1
99169,1610998475,wahoo,Zwift - Premier Division // Zwift Racing League (men) (A),Garmin Vector 3S,Wahoo KICKR Bike,374,379,-5
119207,1614014734,wahoo,Zwift -  SCF SWE Cup Men (A),Garmin Vector 3S,Wahoo KICKR Bike,441,448,-7
90054,1609571526,wahoo,Zada test - three sisters,Favero assimao,Wahoo Kickr,363,369,-6
90060,1609571526,wahoo,Zada test - three sisters,Favero assimao,Wahoo Kickr,363,369,-6
93480,1610131555,wahoo,Zwift - Team CLS Racing - Hills &#039;n&#039; Thrills S5 (E),Favero assimao,Wahoo Kickr,403,380,23
95008,1610390943,wahoo,Zwift - Premier Division // Zwift Racing League (men) (A),Favero assimao,Wahoo Kickr,407,419,-12
96266,1610548496,wahoo,Zwift - 3R Sand & Sequoias - 1 Lap (20km/12.5mi 173m) (A),Favero assimao,Wahoo Kickr,355,362,-7
96938,1610648227,wahoo,Zwift - Vienna,Favero assimao,Wahoo Kickr,385,395,-10
98364,1610865021,wahoo,Zwift - XRS Races: a Longer and Hard race (A),Favero assimao,Wahoo Kickr,352,359,-7
100250,1611144015,wahoo,Zwift - TDZ Stage 4: Longer Ride,Favero assimao,Wahoo Kickr,361,379,-18
102929,1611601463,wahoo,Zwift - Premier Division // Zwift Racing League (men) (A),Favero assimao,Wahoo Kickr,404,416,-12
104008,1611752393,wahoo,Zwift - TDZ Stage 5: Longer Ride,Favero assimao,Wahoo Kickr,406,426,-20
105414,1611995395,wahoo,Zwift - London Lockdown eRace Series: Race 1 (A) 38th ATL,Favero assimao,Wahoo Kickr,397,409,-12
106239,1612105160,wahoo,Zwift - TDZ Stage 6: Longer Ride,Favero assimao,Wahoo Kickr,418,418,0
108071,1612364339,wahoo,Zwift - Cat A - 4.0 w/kg and above,Favero assimao,Wahoo Kickr,393,408,-15
112396,1612983315,wahoo,Zwift - Movistar Team Challenge // Round 1 (A),Favero assimao,Wahoo Kickr,374,380,-6
112449,1612983315,wahoo,Zwift - Movistar Team Challenge // Round 1 (A),Favero assimao,Wahoo Kickr,374,380,-6
113601,1613156354,wahoo,Zwift - Movistar Team Challenge // Round 1 (men),Favero assimao,Wahoo Kickr,428,432,-4
116732,1613588343,wahoo,Zwift - Movistar Team Challenge // Round 2 (men) - Race 3/4,Favero assimao,Wahoo Kickr,371,373,-2
117907,1613761080,wahoo,Zwift - Movistar Team Challenge // Round 2 (men),Favero assimao,Wahoo Kickr,436,439,-3
118051,1613808176,wahoo,Zwift - 3R Weekend Race Club - Race 1 (A),Favero assimao,Wahoo Kickr,346,348,-2
119116,1614020908,wahoo,Zwift - Premier Division // Zwift Racing League (men) (A),Favero assimao,Wahoo Kickr,375,385,-10
120361,1614191372,wahoo,Zwift - UKAFC Race Night (A),Favero assimao,Wahoo Kickr,376,383,-7
123575,1614783549,wahoo,Zwift - UKAFC Race Night (A),Favero assimao,Wahoo Kickr,416,424,-8
129270,1615919303,wahoo,Zwift - CeramicSpeed Race Series: Open Race (A),Favero assimao,Wahoo Kickr,416,409,7
103223,1611650722,neo,Zwift - Zwift Racing League | WTRL - Men&#039;s/Mixed APAC DIVISION 1 (A),Quarq,Tacx Neo,439,430,9
104925,1611880878,neo,Zwift - WTRL Team Time Trial - Zone 10 (C),Quarq,Tacx Neo,340,338,2
58261,1601396996,wahoo,Zwift - EVO CC Sprint Race Series  (A),2020-09-29-18-29-56,Wahoo Kicrk 5.0,389,381,8
58530,1601487893,wahoo,Zwift - DCU powered by Feltet.dk (A),Quarq power meter Dfour,Wahoo Kickr 5.0,396,396,0
58743,1601552134,wahoo,Zwift - Watopia,Quarq power meter Dfour,Wahoo Kickr 5.0,424,424,0
61269,1602528580,wahoo,Zwift - Premier Division // Zwift Racing League (men) ,Quarq power meter Dfour,Wahoo Kickr 5.0,437,437,0
61272,1602528580,wahoo,Zwift - Premier Division // Zwift Racing League (men) ,Quarq power meter Dfour,Wahoo Kickr 5.0,437,437,0
65220,1603742383,wahoo,Zwift - Premier Division // Zwift Racing League (men) (A),Quarq power meter Dfour,Wahoo Kickr 5.0,400,403,-3
66347,1603995888,wahoo,Zwift - WTRL Team Time Trial Platinum League (C),Quarq power meter Dfour,Wahoo Kickr 5.0,384,382,2
67263,1604344374,wahoo,Zwift - Premier Division // Zwift Racing League (men) (A),Quarq power meter Dfour,Wahoo Kickr 5.0,409,404,5
67944,1604516395,wahoo,Zwift - DCU – Feltet.dk November series,Quarq power meter Dfour,Wahoo Kickr 5.0,442,451,-9
68281,1604602373,wahoo,Zwift - Espresso,Quarq power meter Dfour,Wahoo Kickr 5.0,382,384,-2
69495,1604951968,wahoo,Zwift - Premier Division // Zwift Racing League (men) (A),Quarq power meter Dfour,Wahoo Kickr 5.0,443,450,-7
71980,1605553729,wahoo,Zwift - Premier Division // Zwift Racing League (men) (A),Quarq power meter Dfour,Wahoo Kickr 5.0,392,397,-5
76035,1606416228,wahoo,Zwift - WTRL NOPINZ WORLD TTT CHAMPIONSHIPS - Zone 6 (C),Quarq power meter Dfour,Wahoo Kickr 2018,402,406,-4
77725,1606763632,wahoo,Zwift - Premier Division // Zwift Racing League (men) (A),Quarq power meter Dfour,Wahoo Kickr 5.0,405,412,-7
78827,1606991694,wahoo,Zwift - Japan ZWIFT Hill Climb Race (A) gensyn med isbjerget,Quarq power meter Dfour,Wahoo Kickr 5.0,415,422,-7
81156,1607540696,wahoo,Zwift - DBR Wednesday Race (A),Quarq power meter Dfour,Wahoo Kickr 5.0,384,390,-6
81629,1607624992,wahoo,Zwift - FUSION DECEMBER CUP (A),2020-12-10-19-29-52,Wahoo Kickr 5.0,435,444,-9
83638,1608050394,wahoo,Zwift - Team Italy Specialissima Race (A),Quarq power meter Dfour,Wahoo Kickr 5.0,367,370,-3
84472,1608229794,wahoo,Zwift - FUSION DECEMBER CUP (A),Quarq power meter Dfour,Wahoo Kickr 5.0,406,410,-4
96419,1610563441,wahoo,Zwift - Danmarks Cykle Union & Partners 1/6 (A),Quarq power meter Dfour,Wahoo Kickr 5.0,431,445,-14
99183,1610999938,wahoo,Zwift - Premier Division // Zwift Racing League (men) (A),Quarq power meter Dfour,Wahoo Kickr 5.0,395,403,-8
100319,1611168219,wahoo,Zwift - Danmarks Cykle Union & Partners 2/6 (A),Quarq power meter Dfour,Wahoo Kickr 5.0,428,437,-9
101083,1611232053,wahoo,Zwift - Watopia,Quarq power meter Dfour,Wahoo Kickr 5.0,358,369,-11
108314,1612377879,wahoo,Zwift - Danmarks Cykle Union & Partners 4/6 (A),Quarq power meter Dfour,Wahoo Kickr 5.0,371,382,-11
111014,1612812175,wahoo,Zwift - Premier Division // Zwift Racing League (men) (A),Quarq power meter Dfour,Wahoo Kickr 5.0,414,423,-9
112319,1612982669,wahoo,Zwift - Danmarks Cykle Union & Partners 5/6 (A),Quarq power meter Dfour,Wahoo Kickr 5.0,409,418,-9
115347,1613419298,wahoo,Zwift - Premier Division // Zwift Racing League (men) (A),Quarq power meter Dfour,Wahoo Kickr 5.0,430,444,-14
116348,1613491520,wahoo,Zwift - 3R Volcano Circuit Flat Race - 8 Laps (35.2km/21.9mi 160m) (A),Quarq power meter Dfour,Wahoo Kickr 5.0,350,363,-13
116999,1613587494,wahoo,Zwift - 02/17/2021,Wahoo Kickr 5.0,Wahoo Kickr 5.0,370,377,-7
117001,1613587494,wahoo,Zwift - 02/17/2021,Quarq power meter Dfour,Wahoo Kickr 5.0,370,377,-7
119107,1614020985,wahoo,Zwift - Premier Division // Zwift Racing League (men) (A) internet bj�lken,Quarq power meter Dfour,Wahoo Kickr 5.0,390,396,-6
120400,1614192306,wahoo,Zwift - Scandinavian Cup 2021 - Round 1 - Men (A),Quarq power meter Dfour,Wahoo Kickr 5.0,389,390,-1
122624,1614630077,wahoo,Zwift - Premier Division // Zwift Racing League (men) (A),Quarq power meter Dfour,Wahoo Kickr 5.0,396,408,-12
123674,1614797097,wahoo,Zwift - Scandinavian Cup 2021 - Round 2 - Men (A),Quarq power meter Dfour,Wahoo Kickr 5.0,401,408,-7
35138,1589567492,wahoo,Zwift - Newbury Velo Crit (A),Quarq DZero,Wahoo Kickr,356,376,-20
45147,1592479193,wahoo,Zwift - British Cycling Time Trial Series (A),Quarq DZero,Wahoo Kickr,357,382,-25
124346,1614882543,wahoo,Zwift - FUSION SPRING CUP (A),Quarq DZero,Wahoo Kickr,348,368,-20
127692,1615487007,wahoo,Zwift - FUSION SPRING CUP (A),Quarq DZero,Wahoo Kickr,351,369,-18
3242,1570206591,neo,Zwift - ZHR Afternoon Tea Race (A),quarq dzero,TACX NEO 2,359,343,16
3273,1572073773,neo,Zwift - Team ZWC Weekend Race - Lutscher CCW (A),quarq dzero,TACX NEO 2,366,353,13
3274,1572078572,neo,Zwift - DBR Saturday Race (A),quarq dzero,TACX NEO 2,373,364,9
4323,1573891454,neo,Zwift - 3R Greater London Flat Race - 2 Laps (A),quarq dzero,TACX NEO 2,354,342,12
5997,1576073379,neo,Zwift - KISS at Race - Pacific AM (A),quarq dzero,TACX NEO 2,362,341,21
6190,1576258180,neo,Zwift - ZHR Afternoon Tea Race (A),Zwift,TACX NEO 2,336,321,15
6456,1576565999,neo,Zwift - Crit City Race (A),quarq dzero,TACX NEO 2,339,319,20
6491,1576602599,neo,Zwift - 3R Volcano KOM After Party Race - 2 laps + climb (40.2km/25mi 286m) (A),quarq dzero,TACX NEO 2,397,379,18
6599,1576676699,neo,Zwift - Crit City Race (A),quarq dzero,TACX NEO 2,374,360,14
6600,1576678198,neo,Zwift - New Workout,quarq dzero,TACX NEO 2,384,369,15
6867,1576857897,neo,Zwift - 3R Volcano Flat Race - 3 Laps (36.6km/22.7mi 138m) (A),quarq dzero,TACX NEO 2,361,348,13
6869,1576865396,neo,Zwift - 3R Lutscher CCW Climbing Race - 1 Lap (22.1km/13.9mi 827m) (A),quarq dzero,TACX NEO 2,368,356,12
7038,1577021394,neo,Zwift - New Workout,quarq dzero,TACX NEO 2,352,337,15
7178,1577171393,neo,Zwift - 3R UCI Worlds Race - 1 Lap (23.7km/14.7mi 494m) (A),quarq dzero,TACX NEO 2,337,325,12
7180,1577174392,neo,Zwift - KISS at Race - Down Under (A),quarq dzero,TACX NEO 2,356,346,10
7182,1577178921,neo,Zwift - Watopia,quarq dzero,TACX NEO 2,322,312,10
7234,1577268292,neo,Zwift - 3R Road To Ruins Hilly Race - 1 Lap (29..2km/18.1mi 275m) (A),quarq dzero,TACX NEO 2,0,0,0
7457,1577523589,neo,Danmarks Cykle Union Punchers Special,quarq dzero,TACX NEO 2,379,361,18
7471,1577530809,neo,Zwift - MGCC Bagel (B),quarq dzero,TACX NEO 2,304,290,14
7572,1577628888,neo,Zwift - KISS at Race 100 - Americas (A),quarq dzero,TACX NEO 2,382,366,16
7736,1577786688,neo,Zwift - Ultimate - Goodbye 2019 By 3R (A),quarq dzero,TACX NEO 2,372,362,10
7738,1577789987,neo,Zwift - DIRT Rolling Thunder Ride (C),quarq dzero,TACX NEO 2,373,345,28
7812,1577888986,neo,Zwift - Imperial Century ,quarq dzero,TACX NEO 2,365,352,13
7962,1578042285,neo,Zwift - 3R Whole Lotta Lava Hilly Race - 2 Laps (28.9km/12.53mi 336m) (A),quarq dzero,TACX NEO 2,357,348,9
7964,1578045885,neo,Zwift - 3R Innsbruckring Flat Race - 4 Laps (35.2km/21.9mi 308m) (A),quarq dzero,TACX NEO 2,357,341,16
8123,1578214785,neo,Zwift - Zwift Gran Fondo,quarq dzero,TACX NEO 2,370,358,12
8260,1578380985,neo,Zwift - 3R UCI Worlds Race - 1 Lap (23.7km/14.7mi 494m) (A),quarq dzero,TACX NEO 2,326,316,10
8261,1578383984,neo,Zwift - KISS at Race - Down Under (A),quarq dzero,TACX NEO 2,334,321,13
8448,1578495908,neo,Zwift - 3R LaGurardia Super Sprint Race - 1 Lap (3.7km/2.6mi 27m) (A),quarq dzero,TACX NEO 2,351,341,10
8451,1578496378,neo,Zwift - Watopia,quarq dzero,TACX NEO 2,374,353,21
8762,1578672282,neo,Zwift - 3R Volcano Flat Race - 3 Laps (36.6km/22.7mi 138m) (A),quarq dzero,TACX NEO 2,381,361,20
9014,1578838480,neo,Zwift - KISS at Race 100 - Americas (A),quarq dzero,TACX NEO 2,351,338,13
9166,1578931814,neo,Zwift - 3R Classique Reverse Flat Race - 4 Laps (26.9km/16.7mi 57m) (A),quarq dzero,TACX NEO 2,325,315,10
9817,1579284577,neo,Zwift - Tour de Zwift: Stage 2 Race (A),quarq dzero,TACX NEO 2,345,337,8
9820,1579287576,neo,Zwift - The Friday Criterium Winter Race Series  (32 mi / 51 km) (A),quarq dzero,TACX NEO 2,381,362,19
10234,1579604974,neo,Zwift - ZWIFT JAPAN CUP SERIES (A),quarq dzero,TACX NEO 2,384,373,11
10245,1579612473,neo,Zwift - 3R Figure 8 Hilly Reverse Race - 1 Lap (29.2km/18.1mi 234m ) (A),quarq dzero,TACX NEO 2,370,361,9
10788,1579885800,neo,Zwift - Tour de Zwift: Stage 4 Race (A),quarq dzero,TACX NEO 2,400,389,11
10789,1579881898,neo,Zwift - 3R Volcano Flat Race - 3 Laps (36.6km/22.7mi 138m) (A),quarq dzero,TACX NEO 2,366,349,17
11055,1580048068,neo,Zwift - KISS at Race 100 - Americas (A),quarq dzero,TACX NEO 2,401,384,17
11681,1580403865,neo,Zwift - OH CRIT!! - The Double Race - Race 2/2 (A),quarq dzero,TACX NEO 2,385,375,10
11690,1580405964,neo,Zwift - Tour de Zwift: Stage 5 Race (A),quarq dzero,TACX NEO 2,359,347,12
11958,1580549368,neo,Zwift - DBR Saturday Race (A),quarq dzero,TACX NEO 2,356,346,10
12576,1580922559,neo,Zwift - Tour de Zwift: Stage 7 Race (A),quarq dzero,TACX NEO 2,360,338,22
12920,1581091459,neo,Zwift - 3R Volcano Flat Race - 3 Laps (36.6km/22.7mi 138m) (A),quarq dzero,TACX NEO 2,373,359,14
12924,1581095358,neo,Zwift - Tour de Zwift: Stage 7 Race (A),quarq dzero,TACX NEO 2,367,357,10
13133,1581253456,neo,Zwift - 3R Watopia Flat Route Race - 4 Laps (40.5km/25.1mi 216m) (A),quarq dzero,TACX NEO 2,362,351,11
13138,1581257357,neo,Zwift - Tour de Zwift: Stage 3 Race (A),quarq dzero,TACX NEO 2,317,304,13
13387,1581433456,neo,Zwift - 3R Volcano Circuit Flat Race - 8 Laps (35.2km/21.9mi 160m) (A),quarq dzero,TACX NEO 2,348,339,9
13388,1581438555,neo,Zwift - VZT Tofu Tornado (A),quarq dzero,TACX NEO 2,352,344,8
13677,1581598753,neo,Zwift - Tour de Zwift: Stage 1 Long Distance,quarq dzero,TACX NEO 2,294,281,13
41256,1591970719,neo,Zwift - 3R Innsbruckring Flat Race - 2 Laps (17.6km/10.9m 154m) (A),quarq dzero,TACX NEO 2,365,359,6
41258,1591974891,neo,Zwift - 3R Sand and Sequoias Race (A),quarq dzero,TACX NEO 2,353,346,7
41677,1592148300,neo,Zwift - 3R Watopia 65km Race - 6 laps (40mi 324m) (A),quarq dzero,TACX NEO 2,349,336,13
41949,1592316324,neo,Zwift - 3R LaGuardia Super Sprint Race - 1 Lap (3.7km/2.6mi 27m) (A),quarq dzero,TACX NEO 2,381,374,7
41961,1592319920,neo,Zwift - 3R & Wahoo Ride Real Race Series - Round 5 of 7 (A),quarq dzero,TACX NEO 2,350,341,9
42415,1592489097,neo,Zwift - 3R Classique Flat Race - 6 Laps (37.7km/23.4mi 114m) (A),quarq dzero,TACX NEO 2,347,340,7
42416,1592493297,neo,Zwift - OH CRIT!! - Lockdown Series - Round 3 Race 1 (A),quarq dzero,TACX NEO 2,348,336,12
42839,1592661594,neo,Zwift - XRS Races: Saturday Climbing Series (A),quarq dzero,TACX NEO 2,365,357,8
43099,1592745295,neo,Zwift - KISS at Race 100 - Americas (A),quarq dzero,TACX NEO 2,373,360,13
43227,1592924692,neo,Zwift - 3R & Wahoo Ride Real Race Series - Round 6 of 7 (A),quarq dzero,TACX NEO 2,399,386,13
43379,1593009650,neo,Zwift - Watopia,quarq dzero,TACX NEO 2,322,324,-2
43548,1593093891,neo,Zwift - 3R Classique Flat Race - 6 Laps (37.7km/23.4mi 114m) (A),quarq dzero,TACX NEO 2,353,347,6
45010,1593954901,neo,Zwift - KISS at Race 100 - Americas (A),quarq dzero,TACX NEO 2,378,366,12
45317,1594132199,neo,Zwift - Sydkysten Cycling - Carl Ras Race (A),quarq dzero,TACX NEO 2,362,351,11
45322,1594134299,neo,Zwift - 3R Volcano Circuit Flat Race - 8 Laps (35.2km/21.9mi 160m) (A),quarq dzero,TACX NEO 2,321,310,11
45326,1594137392,neo,Zwift - France,quarq dzero,TACX NEO 2,296,295,1
47067,1595269200,neo,Zwift - TFC Mad Monday Summer Series (3 of 10) (A),quarq dzero,TACX NEO 2,393,384,9
47160,1595343900,neo,Zwift - 3R Turbocharged Team Race Series - Round 2 (A),quarq dzero,TACX NEO 2,367,355,12
47163,1595341802,neo,Zwift - Sydkysten Cycling - Carl Ras Race (A),quarq dzero,TACX NEO 2,300,285,15
47443,1595513596,neo,Zwift - New Workout ERG From 10:44 to 24:36,quarq dzero,TACX NEO 2,270,270,0
47445,1595517298,neo,Zwift - New Workout,quarq dzero,TACX NEO 2,320,309,11
53770,1599498887,neo,Zwift - DBR Ride´N´Roll League (A),quarq dzero,TACX NEO 2,361,350,11
54139,1599667156,neo,Zwift - Support SA Talent Virtual Racing Series,quarq dzero,TACX NEO 2,400,390,10
54537,1599803375,neo,Zwift - Zwift Racing - Boogie,quarq dzero,TACX NEO 2,320,323,-3
54833,1599980833,neo,Zwift - Random attacks,quarq dzero,TACX NEO 2,363,365,-2
54835,1599983312,neo,Zwift Academy 2019 Workout #7: VO2max Development,quarq dzero,TACX NEO 2,316,315,1
55339,1600181952,neo,Zwift - ZHQ Beta Crit City Race (A) uden strøm,quarq dzero,TACX NEO 2,349,344,5
55349,1600187356,neo,Zwift - ZHR Masters Europe (A) med strøm,quarq dzero,TACX NEO 2,355,343,12
55549,1600272552,neo,Zwift - 3R Tick Tock Flat Race - 2 Lap (36km/22.4mi 100m) (A),quarq dzero,TACX NEO 2,308,306,2
56077,1600409350,neo,Zwift - 3R Volcano Circuit Flat Race - 4 Laps (18.9km/11.7mi 80m) (A),quarq dzero,TACX NEO 2,323,314,9
56078,1600411416,neo,Zwift - SST (Short),quarq dzero,TACX NEO 2,315,308,7
56694,1600705746,neo,Zwift - EVO CC Sprint Race Series  (A),quarq dzero,TACX NEO 2,326,298,28
57406,1601014149,neo,Zwift - 3R Volcano Circuit Flat Race - 4 Laps (18.9km/11.7mi 80m) (A),quarq dzero,TACX NEO 2,310,298,12
57409,1601017504,neo,Zwift - 3R Innsbruckring Race - 33.2km (A),quarq dzero,TACX NEO 2,357,337,20
58287,1601391840,neo,Zwift - 3R Volcano Circuit Flat Race - 8 Laps (35.2km/21.9mi 160m) (A),quarq dzero,TACX NEO 2,331,324,7
58291,1601396942,neo,Zwift - EVO CC Sprint Race Series  (A),quarq dzero,TACX NEO 2,359,343,16
58804,1601561044,neo,Zwift - 3R Classique Flat Race - 6 Laps (37.7km/23.4mi 114m) (A),quarq dzero,TACX NEO 2,351,341,10
58808,1601565237,neo,Zwift - OH MY CRIT! - The Double Race 1/2 (A),quarq dzero,TACX NEO 2,338,325,13
58995,1601617904,neo,Zwift - Watopia,quarq dzero,TACX NEO 2,311,314,-3
64457,1603472778,neo,Zwift - Watopia,quarq dzero,TACX NEO 2,329,323,6
64829,1603621314,neo,Zwift - VO2 & AC,quarq dzero,TACX NEO 2,322,317,5
65386,1603799348,neo,Zwift - 3x15 FTP Intervals,quarq dzero,TACX NEO 2,329,321,8
66334,1604040662,neo,Zwift - Watopia,quarq dzero,TACX NEO 2,325,326,-1
66981,1604236409,neo,Zwift - KISS at Race 100 - Americas (A),quarq dzero,TACX NEO 2,336,330,6
67644,1604423371,neo,Zwift - VO2 & AC,quarq dzero,TACX NEO 2,322,322,0
67938,1604507913,neo,Zwift - Watopia,quarq dzero,TACX NEO 2,334,340,-6
74256,1606054391,neo,Zwift - KISS 100 Race Series - Americas (A),quarq dzero,TACX NEO 2,385,376,9
77319,1606659184,neo,Zwift - KISS 100 Race Series - Americas (A),quarq dzero,TACX NEO 2,320,311,9
80117,1607254642,neo,Zwift - Mat Hayman Paris Roubaix 1,quarq dzero,TACX NEO 2,323,316,7
81484,1607608297,neo,Zwift - New Workout,quarq dzero,TACX NEO 2,347,342,5
84615,1608274899,neo,Zwift - New Workout,quarq dzero,TACX NEO 2,338,335,3
85485,1608473564,neo,Zwift - KISS 100 Race Series - Americas (A),quarq dzero,TACX NEO 2,350,336,14
87208,1608905485,neo,Zwift - New Workout,quarq dzero,TACX NEO 2,346,345,1
87795,1609071566,neo,Zwift - New Workout,quarq dzero,TACX NEO 2,251,240,11
87806,1609063661,neo,Zwift - 3R Sand & Sequoias - 1 Lap (20km/12.5mi 173m) (A),quarq dzero,TACX NEO 2,352,327,25
108174,1612375174,neo,Zwift - MIDWEEK Winter Series by SZR (A),quarq dzero,TACX NEO 2,331,324,7
112833,1613060079,neo,Zwift - OH MY CRIT!! - The Double Race 1/2 (A),quarq dzero,TACX NEO 2,316,311,5
114613,1613293477,neo,Zwift - Newbury Velo Road Race (A),quarq dzero,TACX NEO 2,380,371,9
115750,1613485789,neo,Zwift - DBR Tuesday Race (A),quarq dzero,TACX NEO 2,391,382,9
115960,1613489380,neo,Zwift - Team Draft Innsbruckring Race (A),quarq dzero,Neo 2,355,343,12
117744,1613742600,neo,Zwift - KISS Race Series - Pacific AM (A),quarq dzero,TACX NEO 2,367,358,9
121447,1614416669,neo,Zwift - 3R Endurance Series p/b OTE Sports (E),quarq dzero,TACX NEO 2,323,319,4
121976,1614499469,neo,Zwift - 3R Volcano Circuit - 6 Laps (A),quarq dzero,TACX NEO 2,309,299,10
121979,1614502329,neo,Zwift - Watopia,quarq dzero,TACX NEO 2,284,275,9
122913,1614698957,neo,Zwift - Team Draft Innsbruckring Race (A),quarq dzero,TACX NEO 2,335,323,12
122922,1614702552,neo,Zwift - TEAM VEGAN Tofu Tornado (A),quarq dzero,TACX NEO 2,377,367,10
123550,1614787796,neo,Zwift - 3R Tick Tock Flat Race - 2 Lap (36km/22.4mi 100m) (A),quarq dzero,TACX NEO 2,329,318,11
123557,1614791666,neo,Zwift - Masters SA (A),quarq dzero,TACX NEO 2,324,317,7
126147,1615303760,neo,Zwift - Team Draft Innsbruckring Race (A),quarq dzero,TACX NEO 2,353,341,12
126152,1615307961,neo,Zwift - Team Italy Specialissima Race (A),quarq dzero,TACX NEO 2,364,347,17
126505,1615391956,neo,Zwift - Sydkysten Race (A),quarq dzero,TACX NEO 2,348,344,4
129351,1615909454,neo,Zwift - EVO CC Sprint Race Series  (A),quarq dzero,TACX NEO 2,359,350,9
129359,1615912150,neo,Zwift - TEAM VEGAN Tofu Tornado (A),quarq dzero,TACX NEO 2,347,338,9
37875,1590518173,wahoo,Zwift - 3R & Wahoo Ride Real Race Series - Round 3 of 7 (A),4iiii Ultegra 8000 left side crank 170mm,Wahoo KICKR 2018,446,443,3
40098,1591457384,wahoo,Zwift - TEAM VEGAN Tofu Tornado (A),4iiii Ultegra 8000 left side crank 170mm,Wahoo KICKR 2018,403,392,11
40720,1591727997,wahoo,Zwift - 3R & Wahoo Ride Real Race Series - Round 4 of 7 (A),4iiii Ultegra 8000 left side crank 170mm,Wahoo KICKR 2018,451,449,2
41112,1591896099,wahoo,Zwift - Espresso,4iiii Ultegra 8000 left side crank 170mm,Wahoo KICKR 2018,449,449,0
43792,1593248401,wahoo,Zwift - Cycling Ireland Watopia Classic (A),4iiii Ultegra 8000 left side crank 170mm,Wahoo KICKR 2018,430,429,1
43794,1593253803,wahoo,Zwift - 3R Volcano Climb Race - 1 Lap (22.4km/14mi 204m) (A),4iiii Ultegra 8000 left side crank 170mm,Wahoo KICKR 2018,422,422,0
44502,1593542392,wahoo,Zwift - 3R & Wahoo Ride Real Race Series - Round 7 of 7 (A),4iiii Ultegra 8000 left side crank 170mm,Wahoo KICKR 2018,463,468,-5
44503,1593597898,wahoo,Zwift - 3R Road To Ruins Hilly Race - 1 Lap (29..2km/18.1mi 275m) (A),4iiii Ultegra 8000 left side crank 170mm,Wahoo KICKR 2018,431,433,-2
45487,1594224119,wahoo,Zwift - BC Bike Race 2020 - Stage 5  - 7 Day Virtual Challenge (A),4iiii Ultegra 8000 left side crank 170mm,Wahoo KICKR 2018,427,426,1
55049,1600106388,wahoo,Zwift - Invitational League // Qualifying Race #1,4iiii Ultegra 8000 left side crank 170mm,Wahoo KICKR 2018,429,401,28
55838,1600367395,wahoo,Zwift - Invitational League // Qualifying Race #2 (Men) ,4iiii Ultegra 8000 left side crank 170mm,Wahoo KICKR 2018,388,390,-2
93258,1610039088,wahoo,Zwift - OH MY CRIT! - The Double Race 2/2 (A),4iiii Ultegra 8000 left side crank 170mm,Wahoo KICKR 2018,406,414,-8
93985,1610209803,wahoo,Zwift - TEAM VEGAN Tofu Tornado (A),4iiii Ultegra 8000 left side crank 170mm,Wahoo KICKR 2018,383,381,2
67612,1604428168,wahoo,Zwift - Zwift Racing League | WTRL - Men&#039;s EMEA E1 DIVISION 1 (A),Stages left crank,Wahoo Kickr (main source),338,372,-34
68484,1604667587,wahoo,Zwift - ZA Road Group Ride: 2.2 - 2.7 w/kg,Sortie_v_lo_l_apr_s_midi (1),Wahoo Kickr (source principale),260,278,-18
68965,1604827789,wahoo,Zwift -  SloZl - Slovenian Zwift League - Weekly Race  (A),racesloZI.test powertap pedals.calibate wahoo,Wahoo Kickr (source principale),387,411,-24
69076,1604850170,wahoo,Zwift - ZA Tri: TT Race. - 20k,ZA Tri test Stages Left Crank,Wahoo Kickr (main source),260,290,-30
69343,1604940922,wahoo,Zwift - Ventouro Social Group Ride (C),Rotor Inpower Left Crank,Wahoo Kickr (main source),304,321,-17
69887,1605031926,wahoo,Zwift - Zwift Racing League | WTRL - EMEA E1 (MEN) -  Division 1 (A),Rotor Inpower Left Crank,Wahoo Kickr (main source),426,428,-2
72287,1604658798,wahoo,Zwift - Zwift Racing League | WTRL - Men&#039;s EMEA E1 DIVISION 1 (A),Rotor Inpower Left Crank,Wahoo Kickr (main source),378,369,9
75084,1606241519,wahoo,Zwift - Zwift Racing League | WTRL - Men&#039;s EMEA E1 DIVISION 1,Rotor Inpower Left Crank Garmin 810,Wahoo Kickr (main source),424,422,2
78080,1606846904,wahoo,Zwift - Zwift Racing League | WTRL - Men&#039;s EMEA E1 DIVISION 1 (A),Rotor Inpower Left Crank Garmin 810,Wahoo Kickr (main source),406,398,8
79674,1607162270,wahoo,Zwift - Nations Challenge // France (E),Rotor Inpower Left Crank Garmin 810,Wahoo Kickr (main source),338,337,1
81038,1607451124,wahoo,Zwift - Zwift Racing League | WTRL - Men&#039;s EMEA E1 DIVISION 1 (A),Rotor Inpower Left Crank Garmin 810,Wahoo Kickr (main source),396,388,8
83553,1608056645,wahoo,Zwift - Zwift Racing League | WTRL - Men&#039;s EMEA E1 DIVISION 1 (A),Rotor Inpower Left Crank Garmin 810,Wahoo Kickr (main source),384,378,6
95621,1610474925,wahoo,Zwift - Zwift Racing League | WTRL - Men&#039;s/Mixed EMEA E1 DIVISION 1 (A),Rotor Inpower Left Crank,Wahoo Kickr (main source),404,400,4
99699,1611080376,wahoo,Zwift - Zwift Racing League | WTRL - Men&#039;s/Mixed EMEA E1 DIVISION 1 (A),Rotor Inpower Left Crank,Wahoo Kickr (main source),369,362,7
103488,1611684644,wahoo,Zwift - Zwift Racing League | WTRL - Men&#039;s/Mixed EMEA E1 DIVISION 1 (A),Rotor Inpower Left Crank Garmin 810,Wahoo Kickr (main source),447,439,8
107322,1612289372,wahoo,Zwift - Zwift Racing League | WTRL - Men&#039;s/Mixed EMEA E1 DIVISION 1 (A),Rotor Inpower Left Crank Garmin 810,Wahoo Kickr (main source),416,398,18
111630,1612894426,wahoo,Zwift - Zwift Racing League | WTRL - Men&#039;s/Mixed EMEA E1 DIVISION 1 (A),Rotor Inpower Left Crank Garmin 810,Wahoo Kickr (main source),376,363,13
112215,1612976199,wahoo,Zwift - TDZ Stage 8: Group Ride,Rotor Inpower Left Crank Garmin 810,Wahoo Kickr (main source),384,360,24
119648,1614103245,wahoo,Zwift - Zwift Racing League | WTRL - Men&#039;s/Mixed EMEA E1 DIVISION 1 (A),Rotor Inpower Left Crank Garmin 810,Wahoo Kickr (main source),428,422,6
122945,1614708940,wahoo,Zwift - Zwift Racing League | WTRL - Men&#039;s/Mixed EMEA E1 DIVISION 1 (A),Rotor Inpower Left Crank Garmin 810,Wahoo Kickr (main source),400,383,17
103992,1611684901,wahoo,Zwift Racing League | WTRL - Men&#039;s/Mixed EMEA E1 DIVISION 1 (A),POWER PRO POWER METER ULTEGRA R8000,Wahoo KICKR Power Trainer v5.0,389,396,-7
104868,1611860413,wahoo,BENELIGA 2020-2021 (E),POWER PRO POWER METER ULTEGRA R8000,Wahoo KICKR Power Trainer v5.0,371,389,-18
88165,1609057217,neo,Zwift - Team Italy & Frenchy Fuzion Endurance Race (A),Quarq Dzero,Tacx Neo 2,327,331,-4
92651,1610016986,neo,Zwift - KISS Race Series - Americas AM (A),Quarq Dzero,Tacx Neo 2,343,325,18
96103,1610475246,neo, Zwift Racing League | WTRL - Men&#039;s/Mixed EMEA E2 DIVISION 1,Quarq Dzero,Tacx Neo 2,330,311,19
103473,1611684934,neo,Zwift - Zwift Racing League | WTRL - Men&#039;s/Mixed EMEA E1 DIVISION 1 (A),Quarq Dzero,Tacx Neo 2,346,341,5
107361,1612289664,neo,Zwift - Zwift Racing League | WTRL - Men&#039;s/Mixed EMEA E1 DIVISION 1 (A),Quarq Dzero,Tacx Neo 2,331,327,4
111610,1612894859,neo,Zwift - Zwift Racing League | WTRL - Men&#039;s/Mixed EMEA E1 DIVISION 1 (A),Quarq Dzero,Tacx Neo 2,340,332,8
112764,1613032731,neo,Zwift - TDZ Stage 8: Group Ride,Quarq Dzero,Tacx Neo 2,275,268,7
119712,1614104129,neo,Zwift - Zwift Racing League | WTRL - Men&#039;s/Mixed EMEA E1 DIVISION 1 (A),Quarq Dzero,Tacx Neo 2,333,319,14
121460,1614416351,neo,Zwift - Haute Route Watopia 2021 Stage 2 (A),Quarq Dzero,Tacx Neo 2,351,344,7
122016,1614502755,neo,Zwift - Haute Route Watopia 2021 Stage 3 (A),Quarq Dzero,Tacx Neo 2,348,344,4
122965,1614709196,neo,Zwift - Zwift Racing League | WTRL - Men&#039;s/Mixed EMEA E1 DIVISION 1 (A),Quarq Dzero,Tacx Neo 2,303,299,4
123866,1614849926,neo,Zada Three Sisters Test,Quarq Dzero,Tacx Neo 2,362,353,9
126487,1615393841,neo,Zwift - Absa Cape Epic Stage 2 Time Trial pb Dimension Data - Open (A),Quarq Dzero,Tacx Neo 2,343,350,-7
127511,1615566577,neo,Zwift - Absa Cape Epic Stage 3 pb ABUS - Open	 (A),Quarq Dzero,Tacx Neo 2,336,325,11
128340,1615712350,neo,Zwift - Braganca Granfondo by BikeService / WEz,Quarq Dzero,Tacx Neo 2,328,325,3
129211,1615919357,neo,Zwift - CeramicSpeed Race Series: Open Race (A),Quarq Dzero,Tacx Neo 2,349,336,13
6060,1576091100,neo,Zwift - DBR HEINO CUP (A),Favero Assioma Duo,Tacx Neo,379,357,22
6652,1576695900,neo,Zwift - DBR HEINO CUP (A),Favero Assioma Duo,Tacx Neo,382,372,10
8117,1578214800,neo,Zwift - Zwift Gran Fondo,Favero Assioma Duo,Tacx Neo,373,360,13
8340,1578425999,neo,Zwift - 3R Ultimate Racing League - Round 1 (A),Favero Assioma Duo,Tacx Neo,367,360,7
9379,1579030799,neo,Zwift - 3R Ultimate Racing League - Round 2 (A),Favero Assioma Duo,Tacx Neo,364,351,13
10328,1579635242,neo,Zwift - 3R Ultimate Racing League - Round 3 (A),Favero Assioma Duo,Tacx Neo,382,371,11
10495,1579719900,neo,Zwift - DBR HEINO CUP (A),Favero Assioma Duo,Tacx Neo,394,377,17
11386,1580240400,neo,Zwift - 3R Ultimate Racing League - Round 4 (A),Favero Assioma Duo,Tacx Neo,385,378,7
12810,1581015600,neo,Zwift - KALAS Cup - Round 2 (A),Favero Assioma Duo,Tacx Neo,415,411,4
13443,1581449999,neo,Zwift - 3R Ultimate Racing League - Round 6 (A),Favero Assioma Duo,Tacx Neo,356,346,10
13755,1581620400,neo,Zwift - KALAS Cup - Round 3 (A),Favero Assioma Duo,Tacx Neo,366,358,8
14984,1582225199,neo,Zwift - KALAS Cup - Round 4 (A),Favero Assioma Duo,Tacx Neo,376,366,10
15939,1582830000,neo,Zwift - KALAS Cup - Round 5 (A),Favero Assioma Duo,Tacx Neo,361,345,16
16971,1583434798,neo,Zwift - KALAS Cup - Round 6 (A),Favero Assioma Duo,Tacx Neo,370,368,2
17524,1583867699,neo,Zwift - Feltet.dk Race Series (A),Favero Assioma Duo,Tacx Neo,364,354,10
20073,1585386000,neo,Zwift -  KALAS Indoor EFCT race series #Crit (A),Favero Assioma Duo,Tacx Neo,357,347,10
20311,1585468797,neo,Zwift -  KALAS Indoor EFCT race series #Road race (A),Favero Assioma Duo,Tacx Neo,368,360,8
20905,1585677600,neo,Zwift - NCF Spring Cup (A),Favero Assioma Duo,Tacx Neo,376,366,10
21526,1585850400,neo,Zwift - KALAS Cup - Round 10 (A),Favero Assioma Duo,Tacx Neo,377,376,1
22845,1586282400,neo,Zwift - NCF Spring Cup (A),Favero Assioma Duo,Tacx Neo,411,391,20
23323,1586455800,neo,Zwift - London International // Zwift Classic (A),Favero Assioma Duo,Tacx Neo,389,380,9
24685,1586887200,neo,Zwift - NCF Spring Cup (A),Favero Assioma Duo,Tacx Neo,371,361,10
28066,1587838200,neo,Zwift - Crit City Slam // Zwift Classic,Favero Assioma Duo,Tacx Neo,402,394,8
28865,1588096800,neo,Zwift - NCF Spring Cup (A),Favero Assioma Duo,Tacx Neo,380,364,16
31733,1588697999,neo,Zwift - NCF Grand Prix 2020 - Runde 1 - Elite (A),Favero Assioma Duo,Tacx Neo,395,381,14
34001,1589302801,neo,Zwift - NCF Grand Prix 2020 - Runde 2 - Elite Herrer/Kvinner (A),Favero Assioma Duo,Tacx Neo,375,367,8
34004,1589306400,neo,Zwift - NCF Grand Prix 2020 - Runde 2 - Aldersbestemt (C),Favero Assioma Duo,Tacx Neo,373,355,18
36189,1589911500,neo,Zwift - NCF Grand Prix 2020 - Runde 3 - Aldersbestemt (C),Favero Assioma Duo,Tacx Neo,411,405,6
37917,1590512401,neo,Zwift - NCF Grand Prix 2020 - Runde 4 - Elite Herrer/Kvinner (A),Favero Assioma Duo,Tacx Neo,348,339,9
39179,1591121100,neo,Zwift - NCF Grand Prix 2020 - Runde 5 - Aldersbestemt (C),Favero Assioma Duo,Tacx Neo,369,358,11
47896,1595874000,neo,Zwift - TFC Mad Monday Summer Series (4 of 10) (A),New Favero Assioma Duo,Tacx Neo,353,339,14
51871,1598380800,neo,Zwift - 3R Turbocharged Team Race Series - Bonus Round (A),New Favero Assioma Duo,Tacx Neo,348,334,14
52100,1598461200,neo,Zwift - MIDWEEK Summer Series by SZR (A),New Favero Assioma Duo,Tacx Neo,358,345,13
52456,1598689801,neo,Zwift - DBR Saturday Race  (A),New Favero Assioma Duo,Tacx Neo,364,360,4
52774,1598898000,neo,Zwift - TFC Mad Monday Summer Series (9 of 10) (A),New Favero Assioma Duo,Tacx Neo,369,356,13
53374,1598982901,neo,Zwift - Team Italy & Frenchy Fuzion League (A),New Favero Assioma Duo,Tacx Neo,414,405,9
53375,1598986800,neo,Zwift - KISS at Race - EU PM (A),New Favero Assioma Duo,Tacx Neo,355,345,10
53376,1599154201,neo,Zwift - FUSION ECT BEUNSTOPPABLE Racing Series (A),New Favero Assioma Duo,Tacx Neo,372,365,7
53762,1599498902,neo,Zwift - DBR Ride´N´Roll League (A),New Favero Assioma Duo,Tacx Neo,402,393,9
54201,1599674700,neo,DBR Wednesday Race,New Favero Assioma Duo,Tacx Neo,374,358,16
54699,1599899400,neo,Zwift - DBR SufferDay League II (A),New Favero Assioma Duo,Tacx Neo,400,405,-5
55205,1600106402,neo,Zwift - Invitational League // Qualifying Race #1,New Favero Assioma Duo,Tacx Neo,385,372,13
56136,1600365343,neo,Zwift - Test up Alpe,New Favero Assioma Duo,Tacx Neo,382,375,7
56482,1600606802,neo,Zwift - Invitational League // Qualifying Race #3 (Men) (A),New Favero Assioma Duo,Tacx Neo,394,392,2
57682,1601109001,neo,Zwift - DBR SufferDay League II (A),New Favero Assioma Duo,Tacx Neo,387,383,4
58552,1601487002,neo,Zwift - NCF Vinter Cup 2020 - Runde 2 - Herrer (A),New Favero Assioma Duo,Tacx Neo,384,376,8
59651,1601922002,neo,Zwift - TFC Mad Monday Autumn Series (A),New Favero Assioma Duo,Tacx Neo,364,360,4
60424,1602091801,neo,Zwift - NCF Vinter Cup 2020 - Runde 3 - Herrer (A),New Favero Assioma Duo,Tacx Neo,362,363,-1
60431,1602178214,neo,Zwift - FUSION ECT BEUNSTOPPABLE Racing Series (A),New Favero Assioma Duo,Tacx Neo,386,372,14
61591,1602609302,neo,Zwift - Zwift Racing League | WTRL,New Favero Assioma Duo,Tacx Neo,398,387,11
61935,1602696603,neo,Zwift - NCF Vinter Cup 2020 - Runde 4 - Herrer (A),New Favero Assioma Duo,Tacx Neo,401,385,16
125364,1615118530,wahoo,Zwift - ZHQ FutureWorks Crit City Race - Anti-sandbagging (A),Favero Assioma Duo,Wahoo Kickr,366,345,21
76799,1606557348,neo,Zwift - 11/28/2020,Quarq,Neo,360,356,4
76806,1606557348,neo,Zwift - 11/28/2020,Quarq,neo,360,356,4
78792,1606931742,neo,quarq / neo,quarq,neo,363,359,4
88701,1609267875,neo,Zwift - 12/29/2020,quarq,neo,433,424,9
100366,1611169753,neo,TUZ Winter chase race league,quarq,neo,375,369,6
31296,1588612272,wahoo,Zwift - DBR Wahoo League (A),Garmin Vector 2 Dual Side,Wahoo Kicker 3,428,412,16
31907,1588745488,wahoo,Zwift - 3R Innsbruckring Flat Race - 3 Laps (26.4km/16.4mi 231m) (A),Garmin Vector 2 Dual Side,Wahoo Kicker 3,437,415,22
32963,1589022489,wahoo,Zwift - DIRT Dadurday Chase Race  (A),Garmin Vector 2 Dual Side,Wahoo Kicker 3,426,402,24
32985,1589029405,wahoo,Zwift - Tour for All 2020: Stage 2 Shorter Race A/B,Garmin Vector 2 Dual Side,Wahoo Kicker 3,414,389,25
33189,1589103803,wahoo,Zwift - Points Race League by Team DIRT (A),Garmin Vector 2 Dual Side,Wahoo Kicker 3,380,363,17
33325,1588490515,wahoo,Zwift - ZHR Masters Weekender (B),Garmin Vector 2 Dual Side,Wahoo Kicker 3,412,388,24
34557,1589443914,wahoo,Zwift - Tour for All 2020: Stage 3 Shorter Race A/B,Garmin Vector 2 Dual Side,Wahoo Kicker 3,382,382,0
41401,1592034237,wahoo,Zwift - EVR Asia Weekend (A),Garmin Vector 2 Dual Side,Wahoo Kicker 3,373,358,15
41613,1592123811,wahoo,Zwift - Newbury Velo Road Race (A),Garmin Vector 2 Dual Side,Wahoo Kicker 3,434,402,32
42619,1592584566,wahoo,Zwift - Crit City Race (A),Garmin Vector 2 Dual Side,Wahoo Kicker 3,388,400,-12
42812,1592656488,wahoo,Zwift - WTRL Saturday Crit (A).... Race no 500 on Zwift,Garmin Vector 2 Dual Side,Wahoo Kicker 3,399,395,4
44066,1593449001,wahoo,Zwift - DBR Monday Race  (A),Garmin Vector 3 Single Side,Wahoo Kicker 3,399,375,24
46927,1595148542,wahoo,Zwift - Newbury Velo Road Race (A),Garmin Vector 3 Single Side,Wahoo Kicker 3,390,384,6
47452,1595520117,wahoo,Zwift - OH MY CRIT! - The Double Race 2/2 (A),Garmin Vector 3 Single Side,Wahoo Kicker 3,406,407,-1
47453,1595526501,wahoo,Zwift - Team Italy Superveloce Race (A),Garmin Vector 3 Single Side,Wahoo Kicker 3,363,357,6
47557,1595606428,wahoo,Zwift - 3R Volcano Flat Race - 3 Laps (36.6km/22.7mi 138m) (A),Garmin Vector 3 Single Side,Wahoo Kicker 3,394,383,11
48003,1595951556,wahoo,Wahoo Kicker 3 / Garmin Vector 3 Single Side,Garmin Vector 3 Single Side,Wahoo Kicker 3,431,402,29
48573,1596357531,wahoo,Zwift - Newbury Velo Road Race (A).... Trying to hold The Saris boys&#039; wheels,Garmin Vector 3 Single Side,Wahoo Kicker 3,418,397,21
49197,1596815722,wahoo,Zwift - 3R Volcano Flat Race - 3 Laps (36.6km/22.7mi 138m) (A).... New bike day!! Spezialized SL 7,Garmin Vector 3 Single Side,Wahoo Kicker 3,389,389,0
54886,1600013123,wahoo,Zwift - Stages of DIRT (A),Garmin Vector 3 Single Side,Wahoo Kicker 3,383,366,17
61543,1602607871,wahoo,Zwift - Zwift Racing League | WTRL,Garmin Vector 3 Single Side,Wahoo Kicker 3,401,400,1
69332,1604939555,wahoo,Zwift - Garmin Never Stop Cycling // Stage 1 Road - Open Category,Garmin Vector 3 Single Side,Wahoo Kicker 3,407,392,15
78032,1606843764,wahoo,Zwift - Zwift Racing League | WTRL - Men&#039;s EMEA E1 DIVISION 1 (A),Garmin Vector 3 Single Side,Wahoo Kicker 3,390,383,7
95606,1610472032,wahoo,Zwift - Zwift Racing League | WTRL - Men&#039;s/Mixed EMEA E1 DIVISION 2 (A),Garmin Vector 3 Single Side,Wahoo Kicker 3,378,371,7
122893,1614705925,wahoo,Zwift - ZHQ FutureWorks Circuit Race - Anti-sandbagging (A),Garmin Vector 3 Single Side,Wahoo Kicker 3,368,345,23
61713,1602609313,wahoo,Zwift - Zwift Racing League | WTRL,Quarq DFour,Wahoo Kickr Core,383,395,-12
62763,1602867610,wahoo,Zwift - ZRG-CC Falling Leaves Tour (A),Quarq DFour,Wahoo Kickr Core,363,380,-17
62764,1602932996,wahoo,Zwift - ZA Road Race #1: 4 - 5 w/kg,Quarq DFour,Wahoo Kickr Core,361,375,-14
64542,1603472402,wahoo,Zwift - ZRG-CC Falling Leaves Tour (A),Quarq DFour,Wahoo Kickr Core,355,369,-14
65783,1603822503,wahoo,Zwift Racing League | WTRL - EMEA E (MEN) - Division 1,Quarq DFour,Wahoo Kickr Core,370,377,-7
65867,1603911910,wahoo,Zwift - DBR HEINO CUP III (A),Quarq DFour,Wahoo Kickr Core,363,373,-10
66561,1604080824,wahoo,Zwift - ZRG-CC Falling Leaves Tour (A),Quarq DFour,Wahoo Kickr Core,347,354,-7
68560,1604685602,wahoo,Zwift - ZRG-CC Falling Leaves Tour (A),Quarq DFour,Wahoo Kickr Core,373,377,-4
68562,1604515501,wahoo,Zwift - GCA Cup (A),Quarq DFour,Wahoo Kickr Core,367,370,-3
69674,1604854801,wahoo,Zwift - Zwift Fondo Series 2020/21: Gran Fondo ,Quarq DFour,Wahoo Kickr Core,391,382,9
69781,1605032100,wahoo,Zwift - Zwift Racing League | WTRL - EMEA E1 (MEN) -  Division 1 (A),Quarq DFour,Wahoo Kickr Core,418,417,1
70277,1605120299,wahoo,GCA Cup (A),Quarq DFour,Wahoo Kickr Core,356,350,6
71232,1605290405,wahoo,Zwift - ZRG-CC Falling Leaves Tour (A),Quarq DFour,Wahoo Kickr Core,323,325,-2
71259,1605344702,wahoo,e-liga | eCycling league Austria Race 1 (A),Quarq DFour,Wahoo Kickr Core,414,412,2
72263,1605637527,wahoo,Zwift - Zwift Racing League | WTRL - Men&#039;s EMEA E1 DIVISION 1 (A),Quarq DFour,Wahoo Kickr Core,393,388,5
73209,1605816024,wahoo,Zwift - KISS Race Series - EU PM (A),Quarq DFour,Wahoo Kickr Core,381,367,14
73755,1605895204,wahoo,ZRG-CC Falling Leaves Tour (A) ,Quarq DFour,Wahoo Kickr Core,388,381,7
75073,1606154381,wahoo,3R Bologna Race - 2 Laps (A),Quarq DFour,Wahoo Kickr Core,415,401,14
75743,1606329897,wahoo,Zwift - GCA Cup (A),Quarq DFour,Wahoo Kickr Core,419,0,419
76002,1606415152,wahoo, WTRL NOPINZ WORLD TTT CHAMPIONSHIPS - Zone 5 (C),Quarq DFour,Wahoo Kickr Core,381,373,8
76594,1606499999,wahoo,ZRG-CC Falling Leaves Tour,Quarq DFour,Wahoo Kickr Core,360,345,15
76744,1606554320,wahoo,e-liga | eCycling league Austria Race 2,Quarq DFour,Wahoo Kickr Core,382,395,-13
78060,1606847124,wahoo,Zwift Racing League | WTRL - Men&#039;s EMEA E1 DIVISION 1 (A),Quarq DFour,Wahoo Kickr Core,370,380,-10
79022,1607020200,wahoo, FUSION DECEMBER CUP (A),Quarq DFour,Wahoo Kickr Core,343,350,-7
79486,1607104799,wahoo,ZRG-CC Falling Leaves Tour (A),Quarq DFour,Wahoo Kickr Core,384,392,-8
79917,1607191501,wahoo,Zwift - 3R Three Sisters Hilly Race (47km/29.2mi 879m) (A),Quarq DFour,Wahoo Kickr Core,366,380,-14
80542,1607367586,wahoo,Zwift - WKG Winter League 2020 / 2021  (A),2020-12-07-19-59-46,Wahoo Kickr Core,377,388,-11
80548,1607368802,wahoo,Zwift - Team TFC Mad Monday Races (A),Quarq DFour,Wahoo Kickr Core,343,349,-6
80795,1607451307,wahoo,Zwift - Zwift Racing League | WTRL - Men&#039;s EMEA E1 DIVISION 1 (A),Quarq DFour,Wahoo Kickr Core,382,392,-10
81519,1607619905,wahoo,OH MY CRIT! - The Double Race 2/2 (A),5938735167_ACTIVITY,Wahoo Kickr Core,359,363,-4
81561,1607616912,wahoo,OH MY CRIT! - The Double Race 1/2 (A),Quarq DFour,Wahoo Kickr Core,380,387,-7
82017,1607709599,wahoo,ZRG-CC Falling Leaves Tour (A),Quarq DFour,Wahoo Kickr Core,376,382,-6
82852,1607868901,wahoo,Zwift - KISS 100 Race Series - Americas (A),Quarq DFour,Wahoo Kickr Core,393,399,-6
83545,1608056735,wahoo,Zwift - Zwift Racing League | WTRL - Men&#039;s EMEA E1 DIVISION 1 (A),Quarq DFour,Wahoo Kickr Core,360,365,-5
84163,1608144300,wahoo,GCA Cup (A),Quarq DFour,Wahoo Kickr Core,376,387,-11
84789,1608314397,wahoo,Zwift - ZRG-CC Falling Leaves Tour (A),Quarq DFour,Wahoo Kickr Core,314,323,-9
84997,1608368701,wahoo,e-liga | eCycling league Austria Race 3 (A),Quarq DFour,Wahoo Kickr Core,378,383,-5
86164,1608660001,wahoo,KIRCHMAIR TT Race (A),Wahoo Kickr Core --&gt; Garmin,Wahoo Kickr Core,386,387,-1
86168,1608658183,wahoo,EVO CC Sprint Race Series (A),Quarq DFour,Wahoo Kickr Core,366,376,-10
86623,1607367586,wahoo,GCA Cup (A),Quarq DFour,Wahoo Kickr Core,377,429,-52
86630,1608749092,wahoo,GCA Cup (A),Quarq DFour,Wahoo Kickr Core,416,429,-13
86821,1608793500,wahoo,Zwift - 3R Innsbruckring Flat Race - 5 Laps (44km/27.3mi 385m) (A),Quarq DFour,Wahoo Kickr Core,327,333,-6
86843,1608790215,wahoo,Zwift - 3R Racing (A),Quarq DFour,Wahoo Kickr Core,352,361,-9
87253,1608919222,wahoo,KIRCHMAIR Race Series (A),Quarq DFour,Wahoo Kickr Core,349,357,-8
87255,1608920997,wahoo,KIRCHMAIR Race Series (A) ,Quarq DFour,Wahoo Kickr Core,309,318,-9
87533,1608995696,wahoo,OH MY CRIT - Saturday Smash Race (A),Quarq DFour,Wahoo Kickr Core,406,409,-3
87894,1609078501,wahoo,KISS 100 Race Series (A),Quarq DFour,Wahoo Kickr Core,392,397,-5
88901,1609239604,wahoo,KISS Race Series - Americas AM (A),Quarq DFour,Wahoo Kickr Core,336,341,-5
89351,1609412401,wahoo,KISS Race Series - Americas AM (A),Quarq DFour,Wahoo Kickr Core,382,393,-11
89903,1609523994,wahoo,KIRCHMAIR Race Series (A),Quarq DFour,Wahoo Kickr Core,368,371,-3
89905,1609523994,wahoo,Zwift - KIRCHMAIR Race Series (A),Quarq DFour,Wahoo Kickr Core,368,362,6
90145,1609579801,wahoo,DBR SufferDay League III (A),Quarq DFour,Wahoo Kickr Core,401,411,-10
91915,1609872897,wahoo,Team Italy & Frenchy Fuzion League,Quarq,Wahoo Kickr Core,407,414,-7
92549,1609956006,wahoo,MIDWEEK Winter Series by SZR,Quarq DFour,Wahoo Kickr Core,383,389,-6
93442,1610125215,wahoo,ZRG-CC 2021 Series (A),Quarq DFour,Wahoo Kickr Core,354,365,-11
94366,1610269499,wahoo,Zwift - Newbury Velo Road Race (A),Quarq DFour,Wahoo Kickr Core,386,392,-6
95062,1610392799,wahoo,Team TFC Monday Winter Series (A) - Platz 12,Quarq DFour,Wahoo Kickr Core,385,394,-9
97321,1610560793,wahoo,MIDWEEK Winter Series by SZR (A),Quarq DFour,Wahoo Kickr Core,376,380,-4
97325,1610646306,wahoo,Zwift - WTRL Team Time Trial - Zone 3 (C),Quarq DFour,Wahoo Kickr Core,371,380,-9
97825,1610787890,wahoo,e-liga | eCycling league Austria Race 4 (A),Quarq DFour,Wahoo Kickr Core,429,435,-6
97828,1610729996,wahoo,Zwift -  ZRG-CC 2021 Series (A),Quarq DFour,Wahoo Kickr Core,347,352,-5
98452,1610882999,wahoo,Stages of DIRT (E),Quarq DFour,Wahoo Kickr Core,334,339,-5
99218,1610999623,wahoo,Zwift - Premier Division // Zwift Racing League (men) (A),Quarq DFour,Wahoo Kickr Core,382,387,-5
100491,1611169201,wahoo,Zwift NL Race Day,Quarq DFour,Wahoo Kickr Core,395,406,-11
101700,1611392690,wahoo,e-liga | eCycling league Austria Race 4 (A),Quarq DFour,Wahoo Kickr Core,397,405,-8
102982,1611601421,wahoo,Premier Division // Zwift Racing League (men) (A),Quarq DFour,Wahoo Kickr Core,388,397,-9
104202,1611687292,wahoo,Team Italy and Frenchy Fuzion League (A) ,Quarq DFour,Wahoo Kickr Core,371,388,-17
104210,1611766808,wahoo,Zwift - TDZ Stage 5: Longer Ride,Quarq DFour,Wahoo Kickr Core,418,425,-7
105771,1612025997,wahoo,GCA Liga 2021 #1,Quarq DFour,Wahoo Kickr Core,423,427,-4
106364,1612112997,wahoo,Zwift - Haute Route Nation // Weekend Ride (B),Quarq DFour,Wahoo Kickr Core,292,296,-4
106944,1612210001,wahoo,Premier Division // Zwift Racing League (men) (A),Quarq DFour,Wahoo Kickr Core,395,383,12
110045,1612630791,wahoo,GCA Liga 2021 #2,Quarq DFour,Wahoo Kickr Core,374,375,-1
111077,1612812095,wahoo,Zwift - Premier Division // Zwift Racing League (men) (A),Quarq DFour,Wahoo Kickr Core,389,390,-1
114338,1613235597,wahoo,GCA Liga 2021 #3,Quarq DFour,Wahoo Kickr Core,409,397,12
115472,1613419260,wahoo,Zwift - Premier Division // Zwift Racing League (men) (A),Quarq DFour,Wahoo Kickr Core,420,428,-8
118890,1613840393,wahoo,GCA Liga 2021 #4,Quarq DFour,Wahoo Kickr Core,393,392,1
122620,1614629853,wahoo,Premier Division // Zwift Racing League (men) (A),Quarq DFour,Wahoo Kickr Core,380,383,-3
122636,1614445193,wahoo,GCA Liga 2021 #5 (A),Quarq DFour,Wahoo Kickr Core,383,381,2
124840,1615021486,wahoo,e-liga | eCycling league Austria Race 8 (A),Quarq DFour,Wahoo Kickr Core,406,410,-4
126356,1615312797,wahoo,KIRCHMAIR Club Championship 2021 – Race #1 (A),Quarq DFour,Wahoo Kickr Core,410,415,-5
127796,1615626302,wahoo,e-liga | eCycling league Austria Race 9 (A),Quarq DFour,Wahoo Kickr Core,384,382,2
129132,1615832096,wahoo,Zwift -  DBR Monday Race (A),Quarq DFour,Wahoo Kickr Core,402,404,-2
129133,1615917621,wahoo,KIRCHMAIR Club Championship 2021 – Race #2 (A),Quarq DFour,Wahoo Kickr Core,380,381,-1
57253,1600967062,neo,Zwift - Espresso,Zwift,Tacx Neo,338,340,-2
57478,1601038158,neo,Zwift - KISS at Race - Pacific AM (A),Zwift,Tacx Neo,392,383,9
58787,1601567090,neo,Zwift - Mikkeller and Friends Race (A),Zwift,Tacx Neo,392,371,21
59057,1601642993,neo,Stages / Tacx Neo,Stages,Tacx Neo,346,331,15
59451,1601828400,neo,Stages of DIRT,Power Tap P1,Tacx Neo,381,349,32
59854,1602006887,neo,Stages / Tacx Neo,Stages,Tacx Neo,339,334,5
59857,1602009227,neo,P1 - Neo test,Power Tap P1,Tacx Neo,250,235,15
60799,1602338873,neo,Stages / Tacx Neo,Stages,Tacx Neo,239,222,17
66269,1604007839,neo,Power comparison test,Stages,Tacx Neo,362,346,16
67066,1604257125,neo,Power Tap P1 / Tacx Neo,Power Tap P1,Tacx Neo,332,338,-6
67405,1604359943,neo,3R 50km LONDON-Greater London Flat Race (52km/32.4mi),Power Tap P1,Tacx Neo,357,351,6
68394,1604614462,neo,Power Tap P1 / Tacx Neo,Power Tap P1,Tacx Neo,326,331,-5
68396,1604538047,neo,Power Tap P1 / Tacx Neo,Power Tap P1,Tacx Neo,339,338,1
69988,1605037187,neo,Zwift Racing League | WTRL - EMEA W1 (MEN) -  Division 1,Power Tap P1,Tacx Neo,405,406,-1
72432,1605569716,neo,Power Tap P1 / Tacx Neo,Power Tap P1,Tacx Neo,359,355,4
74790,1606174514,neo,Power Tap P1 / Tacx Neo,Power Tap P1,Tacx Neo,360,349,11
77826,1606778969,neo,Power Tap P1 / Tacx Neo,Power Tap P1,Tacx Neo,389,375,14
84146,1608167093,neo,Zwift - Cycling Canada Wednesday Night Race Series (A),Power Tap P1,Tacx Neo,379,376,3
85629,1608513911,neo,Power Tap P1 / Tacx Neo,Power Tap P1,Tacx Neo,252,253,-1
87044,1608834458,neo,Three Sisters Test,Power Tap P1,Tacx Neo,356,358,-2
91675,1609787783,neo,Zwift - Team TFC Mad Monday Winter Series (A),Power Tap P1,Tacx Neo,361,353,8
92482,1609968413,neo,Tacx Neo / Power Tap P1,Power Tap P1,Tacx Neo,304,310,-6
92742,1610035651,neo,Power Tap P1 / Tacx Neo,Power Tap P1,Tacx Neo,383,388,-5
95979,1610497855,neo,Zwift - Zwift Racing League | WTRL - Men&#039;s/Mixed AMERICAS E DIVISION 4 (A),Power Tap P1,Tacx Neo,341,345,-4
98563,1610892425,neo,Power Tap P1 / Tacx Neo,Power Tap P1,Tacx Neo,337,338,-1
99991,1611104181,neo,Power Tap P1 / Tacx Neo,Power Tap P1,Tacx Neo,345,344,1
103804,1611708273,neo,Tacx Neo,Power Tap P1,Tacx Neo,359,356,3
107702,1612313289,neo,Power Tap P1 / Tacx Neo,Power Tap P1,Tacx Neo,364,361,3
111888,1612918432,neo,Power Tap P1 / Tacx Neo,Power Tap P1,Tacx Neo,376,376,0
114436,1613085215,neo,Power Tap P1 / Tacx Neo,Power Tap P1,Tacx Neo,328,328,0
119938,1614127690,neo,Power Tap P1 / Tacx Neo,Power Tap P1,Tacx Neo,369,366,3
120954,1614294725,neo,Koa Sports League Warrior Race,Power Tap P1,Tacx Neo,383,380,3
122422,1614622368,neo,Tacx Neo / Power Tap P1,Power Tap P1,Tacx Neo,333,333,0
122713,1614641590,neo,Power Tap P1 / Tacx Neo,Power Tap P1,Tacx Neo,377,370,7
123254,1614732799,neo,Power Tap P1 / Tacx Neo,Power Tap P1,Tacx Neo,352,351,1
125007,1615043643,neo,Power Tap P1 / Tacx Neo,Power Tap P1,Tacx Neo,361,360,1
127672,1615583240,neo,TOAD - Day 2,Power Tap P1,Tacx Neo,286,321,-35
128434,1615739219,neo,Power Tap P1 / Tacx Neo,Power Tap P1,Tacx Neo,368,367,1
17,1565624585,wahoo,Zwift - 3R Classique Reverse Flat Race - 4 Laps (26.9km/16.7mi 57m) (A),Favero Assioma DUO,Wahoo Kickr Core 2018,442,434,8
124,1565774263,wahoo,"#1 - Four man breakaway. Hard as hell, got it on the line!  - Zwift - The Morning Grind (A)",Favero Assioma DUO,Wahoo Kickr Core 2018,438,430,8
566,1566324597,wahoo,FUSION ECT Racing League,Favero Assioma DUO,Wahoo Kickr Core 2018,423,425,-2
720,1566568621,wahoo,3R Innsbruckring Flat Race - 2 Laps (17.6km/10.9m 154m),Favero Assioma DUO,Wahoo Kickr Core 2018,427,422,5
722,1566568621,wahoo,Zwift - 3R Sand and Sequoias Race (A),Favero Assioma DUO,Wahoo Kickr Core 2018,438,430,8
768,1566756060,wahoo,#4 - when the sprinter drops you on a climb - Zwift - 3R Watopia Hilly Reverse Race - 4 Laps (36.7km/22.8mi 400m) (A),Favero Assioma DUO,Wahoo Kickr Core 2018,0,0,0
800,1566838981,wahoo,#3 - Legs stopped working on the last climb - Zwift - DBR Monday Race League (A),Favero Assioma DUO,Wahoo Kickr Core 2018,471,478,-7
951,1567068175,wahoo,Nothing in the legs after hards nights of work - Zwift - The Lamb Chop Race (A),Favero Assioma DUO,Wahoo Kickr Core 2018,0,0,0
1096,1567331873,wahoo,"#6 - Dropout when in a strong attack, lost the group, burned all my matches to get back, nothing in the sprint - Zwift - 3R Sand & Sequoias - 1 Lap (20km/12.5mi 173m) (A)",Favero Assioma DUO,Wahoo Kickr Core 2018,0,0,0
1172,1567443704,wahoo,#4 - Gotta learn to save energy :) - 2 hours outside before this race - Zwift - DBR Monday Race League (A),Favero Assioma DUO,Wahoo Kickr Core 2018,416,403,13
1287,1567617727,wahoo,"#1st - Great teamtactics, and my best sprint ind 90 days :) - Zwift - DBR Wednesday Race (A)",Favero Assioma DUO,Wahoo Kickr Core 2018,0,0,0
1330,1567704808,wahoo,#39 - Just too fat - Zwift - Watopia Cup // Zwift Classic ,Favero Assioma DUO,Wahoo Kickr Core 2018,494,508,-14
1377,1567766925,wahoo,#2 - Sore legs and guys on ZP = bad combo :) Zwift - EVR Asia Race (E),Favero Assioma DUO,Wahoo Kickr Core 2018,0,0,0
1478,1567963511,wahoo,#2 - Zwift - 3R Watopia Hilly Reverse Race - 4 Laps (36.7km/22.8mi 400m) (A),Favero Assioma DUO,Wahoo Kickr Core 2018,0,0,0
1609,1568194038,wahoo,Plan was to help Attermann win the Series. He did... without my help #tired - Zwift - The Morning Grind (A),Favero Assioma DUO,Wahoo Kickr Core 2018,0,0,0
1812,1568443230,wahoo,"#4th - Attack fiesta, and then I blew up with 1,5 lap to go. Glad I&#039;m not racing the Zwift Classics ;) - Zwift - FUSION ECT WHENITMATTERS Racing Series (A)",Favero Assioma DUO,Wahoo Kickr Core 2018,0,0,0
1874,1568552030,wahoo,#4 - When your teammate attacks and the only one he drops is you! 40k solo to clame 4th - Zwift - KISS 100 Race - Americas (A),Favero Assioma DUO,Wahoo Kickr Core 2018,431,426,5
1929,1568650686,wahoo,#4 - Teamattack split the peloton. Fun race - Zwift - DBR Monday Race League (A),Favero Assioma DUO,Wahoo Kickr Core 2018,456,454,2
2006,1568741662,wahoo,Zwift - FUSION ECT Racing League (A),Favero Assioma DUO,Wahoo Kickr Core 2018,441,443,-2
2391,1569257132,wahoo,"#6th - Too tired, 2 restdays coming up :) - Zwift - DBR Monday Race League (A)",Favero Assioma DUO,Wahoo Kickr Core 2018,454,444,10
2664,1569517320,wahoo,#1 - Zwift - 3R Whole Lotta Lava Hilly Race - 1 Lap (16.9km/10.5mi 183m) (A),Favero Assioma DUO,Wahoo Kickr Core 2018,0,0,0
2665,1569517320,wahoo,3rd - notmy proudest finale - Zwift - FUSION ECT BEUNSTOPPABLE Racing Series (A),Favero Assioma DUO,Wahoo Kickr Core 2018,0,0,0
3162,1570124855,wahoo,"#13 - still not at 100 percent. No top power, but a high heart rate, though :P - Zwift - FUSION ECT BEUNSTOPPABLE Racing Series (A)",Favero Assioma DUO,Wahoo Kickr Core 2018,419,416,3
3247,1570214819,wahoo,#1 - body start to feel better &lt;3 - Zwift - EVR Europe Race (E),Favero Assioma DUO,Wahoo Kickr Core 2018,439,456,-17
4488,1574186735,wahoo,Zwift - WORLDOFFUSION Racing Series (A),Favero Assioma DUO,Wahoo Kickr Core 2018,463,446,17
4536,1574249295,wahoo,Random uphill intervals,Favero Assioma DUO,Wahoo Kickr Core 2018,422,409,13
5062,1574941387,wahoo,4th . Crushed by the ODZ train :) - Zwift - TeamODZ Thursday Morning Throwdown (E),Favero Assioma DUO,Wahoo Kickr 18,424,421,3
5216,1575125022,wahoo,#15th - dropped on the last climb :( - Zwift - OH CRIT!! - Saturday Smash Series (A),Favero Assioma DUO,Wahoo Kickr 18,0,0,0
5414,1575396788,wahoo,"#8th. Z3 indtil the hill, and then 5 minute test. Survival to the top after that! - Zwift - Danmarks Cykle Union Racing League (A)",Favero Assioma DUO,Wahoo Kickr 18,0,0,0
5415,1575396788,wahoo,"#23th, I think. Not a fan of Box Hil l :) - Zwift - WORLDOFFUSION Racing Series (A)",Favero Assioma DUO,Wahoo Kickr 18,499,498,1
5576,1575568075,wahoo,Zwift - FTP Test,Favero Assioma DUO,Wahoo Kickr 18,452,454,-2
5680,1575710442,wahoo,#14th - Don�t know what happend. Dropped on downhill from Titans Grove - Zwift - DBR Saturday Race (A),Favero Assioma DUO,Wahoo Kickr 18,443,442,1
5745,1575794949,wahoo,#1st  - solo 1 lap :o - Zwift - Danmarks Cykle Union Racing League (A),Favero Assioma DUO,Wahoo Kickr 18,454,454,0
5748,1575794949,wahoo,7 or 8th. Went long to set up Simon for sprint. And then Lind took it! ;) - Zwift - 3R Sand & Sequoias - 1 Lap (20km/12.5mi 173m) (A),Favero Assioma DUO,Wahoo Kickr 18,422,425,-3
5750,1575794949,wahoo,#4th. 3rd race of the day #dead - 3R Innsbruckring Sprint Race - 1 Lap (8.8km/5.5mi 77m),Favero Assioma DUO,Wahoo Kickr 18,434,423,11
5949,1576001388,wahoo,Zwift - Danmarks Cykle Union Racing League (A),Favero Assioma DUO,Wahoo Kickr 18,474,492,-18
5950,1576001388,wahoo,12th - no sprint after 2 races today - Zwift - WORLDOFFUSION Racing Series (A),Favero Assioma DUO,Wahoo Kickr 18,440,447,-7
6173,1576243821,wahoo,"#4th - had to sprint seated because the Kickr made the room jump, and my Macbook was about to fall on the floor. Waste of Aero PU :/ - Zwift - KISS at Race - Pacific AM (A)",Favero Assioma DUO,Wahoo Kickr 18,430,402,28
6510,1576605757,wahoo,6th - Det var ledt - Zwift - Danmarks Cykle Union Racing League (A),Favero Assioma DUO,Wahoo Kickr 18,446,458,-12
6827,1576848532,wahoo,#2 - used all my matches to chase down a guy who is not even on Zwiftpower #stupid - Zwift - KISS at Race - Pacific AM (A),Favero Assioma DUO,Wahoo Kickr 18,458,455,3
7365,1577375659,wahoo,Zwift - OH CRITMAS!! - The Double Race - Race 1/2 (A),Favero Assioma DUO,Wahoo Kickr 18,404,425,-21
7367,1577375659,wahoo,Zwift - OH CRITMAS!! - The Double Race - Race 2/2 (A),Favero Assioma DUO,Wahoo Kickr 18,443,441,2
7666,1577725906,wahoo,#1st - Happy new year! - Zwift - Danmarks Cykle Union New Year&#039;s Special  (A),Favero Assioma DUO,Wahoo Kickr 18,418,433,-15
7813,1577903125,wahoo,"#2nd - team attack on the last climb, easy sprint victory for Simon - Zwift - DBR Wednesday Race (A)",Favero Assioma DUO,Wahoo Kickr 18,437,436,1
7981,1578063954,wahoo,"7th- Brain wanted to attack, legs wanted to quit. We settled on the sprint. Bad timing once again :) - Zwift - 3R Sand and Sequoias Race (A)",Favero Assioma DUO,Wahoo Kickr 18,414,429,-15
8064,1578145183,wahoo,Zwift - WTRL Winter Racing League,Favero Assioma DUO,Wahoo Kickr 18,396,396,0
8066,1578145183,wahoo,10th - 2nd race in a row - tried to go with 1000m again. Died with cramps in both legs.Zwift - The P Race (A),Favero Assioma DUO,Wahoo Kickr 18,416,420,-4
8233,1578331904,wahoo,"#8th - Remember that you can not kick twice in Zwift sprints, goddammit! :) - Zwift - DBR Caresport Crit Cup  (A)",Favero Assioma DUO,Wahoo Kickr 18,421,424,-3
8401,1578473661,wahoo,Zwift - 3R Watopia Flat Route Race - 3 Laps (30.3km/18.8mi 162m) (A),Favero Assioma DUO,Wahoo Kickr 18,422,420,2
8402,1578473661,wahoo,Zwift - 01/08/2020,Favero Assioma DUO,Wahoo Kickr 18,446,451,-5
9015,1578834940,wahoo,11th - one of the hardest Zwift-races ever! - Zwift - KISS at Race 100 - Americas (A),Power2max,Wahoo Kickr 18,429,418,11
9562,1579112368,wahoo,"Top 100, wuhu! 11th in the first point-spring, and pure surival til Legsnapper where the legs snapped! :) - Zwift - Tour de Zwift // Pro-Am Invitational (A)",Power2max,Wahoo Kickr 18,491,477,14
10261,1579617310,wahoo,Zwift - 3R Ultimate Racing League - Round 3 (A),Power2max,Wahoo Kickr 18,467,459,8
10361,1579617310,wahoo,Zwift - 3R Volcano Circuit Flat Race - 8 Laps (35.2km/21.9mi 160m) (A),Power2max,Wahoo Kickr 18,443,431,12
10899,1579966835,wahoo,4th - Hate that hill. Zwift - Tour de Zwift: Stage 4 Race (A),Power2max,Wahoo Kickr 18,523,522,1
11339,1580231811,wahoo,#1st - That was a tough one! - Zwift - Danmarks Cykle Union 2020 Cup (A),Power2max,Wahoo Kickr 18,463,456,7
11555,1580323267,wahoo,Zwift - DBR Wednesday Race (A),Power2max,Wahoo Kickr 18,456,446,10
11799,1580409656,wahoo,"#14th -Ppl got fooled by the distance bug. Had to follow wheels, which messed up my sprint - Zwift - KALAS Cup - Round 1 (A)",Power2max,Wahoo Kickr 18,462,459,3
12254,1580738886,wahoo,#1st - best sprint in a while! :) - Zwift - 3R Classique Reverse Flat Race - 5 Laps (32km/20.1mi 76m) (A),Power2max,Wahoo Kickr 18,386,373,13
12840,1581011507,wahoo,Zwift - Danmarks Cykle Union 2020 Cup (A),Power2max,Wahoo Kickr 18,325,317,8
12841,1581011507,wahoo,"Made the split on Box Hill, but gravity killed me before the top - Zwift - KALAS Cup - Round 2 (A)",Power2max,Wahoo Kickr 18,509,504,5
13110,1581174348,wahoo,#1st - solo from that stupid long hill that I can&#039;t remember the name on! :D - Zwift - Tour de Zwift: Stage 7 Race (A),Power2max,Wahoo Kickr 18,498,491,7
13257,1581339009,wahoo,"#2nd - aggressive racing paid of, and I&#039;m more than satisfied with 2. place - Zwift - Magnum mOnDayZ RACE presented by Team ODZ (A)",Power2max,Wahoo Kickr 18,524,521,3
13472,1581440631,wahoo,Zwift - Danmarks Cykle Union 2020 Cup (A),Power2max,Wahoo Kickr 18,449,437,12
13474,1581440631,wahoo,21st - 2 man breakaway with Noehr - had to wheelsuck to survive Watopia Hill. #2ndracetoday #3hrs_on_Zwift - Zwift - ,Power2max,Wahoo Kickr 18,424,415,9
13783,1581600540,wahoo,#1st - That finale! Pheww - Zwift - Crit City Race (A),Power2max,Wahoo Kickr 18,451,449,2
14243,1581861286,wahoo,Zwift - KISS at Race 100 - Americas (A),Power2max,Wahoo Kickr 18,470,467,3
14360,1581952191,wahoo,Recovery ride with cadance drills - Zwift - Watopia,Favero Assioma DUO,Wahoo Kickr 18,258,255,3
14611,1582049470,wahoo,"7th - opened a bit early, but satisfited  - Zwift - Feltet.dk Race Series",Power2max,Wahoo Kickr 18,422,420,2
15307,1582467263,wahoo,"#6th - +400w up the Alp did not succed. HRM died, se link in description - Zwift - 3R Alpe Du Zwift KOM Race (20km 1444m) (A)",Favero Assioma DUO,Wahoo Kickr 18,427,429,-2
15498,1582549511,wahoo,#1st - Zwift - Magnum mOnDayZ RACE presented by Team ODZ (A),Favero Assioma DUO,Wahoo Kickr 18,409,406,3
16496,1583169744,wahoo,Zwift - Danmarks Cykle Union 2020 Cup (A),Favero Assioma DUO,Wahoo Kickr 18,467,461,6
16499,1583169744,wahoo,Zwift - DBR Winter Cup (A),Favero Assioma DUO,Wahoo Kickr 18,434,429,5
18335,1584380467,wahoo,7th - dropped chain in the sprint.... #ffs - Zwift - DBR Monday Race (A),Favero Assioma DUO,Wahoo Kickr 18,425,422,3
18866,1584707240,wahoo,"#1st - wheel suckers victory, almost died both times on Titans Grove! - Zwift - KISS at Race - Pacific AM (A)",Favero Assioma DUO,Wahoo Kickr 18,416,411,5
18989,1584782083,wahoo,7th - That. Was. Hard - Zwift - DBR Saturday Race (A),Favero Assioma DUO,Wahoo Kickr 18,491,494,-3
21226,1585761162,wahoo,Zwift - Danmarks Cykle Union – mid-week racing  (A),Favero Assioma DUO,Wahoo Kickr 18,420,412,8
21227,1585761162,wahoo,"#5th - Had Lisons wheel, but yeahhhh :) - Zwift - DBR Wednesday Race (A)",Favero Assioma DUO,Wahoo Kickr 18,399,387,12
29777,1588272669,wahoo,3rd - fun little race :) - Zwift - Zwift Beta Race,Power2max,Wahoo Kickr 18,420,414,6
30484,1588405545,wahoo,35-ish... pure pain - Zwift - DBR Sufferday League (A),Power2max,Wahoo Kickr 18,507,501,6
31795,1588701633,wahoo,Zwift - 05/05/2020,Power2max,Wahoo Kickr 18,500,489,11
34267,1589304881,wahoo,#Sat af - Zwift - UNO X CUP powered by DCU & Feltet.dk (A),Power2max,Wahoo Kickr 18,435,425,10
35132,1589550937,wahoo,Zwift - 3R Innsbruckring Flat Race - 2 Laps (17.6km/10.9m 154m) (A),Power2max,Wahoo Kickr 18,460,425,35
35133,1589550937,wahoo,Zwift - 3R Sand and Sequoias Race (A),Power2max,Wahoo Kickr 18,460,454,6
35644,1589690870,wahoo,"Too many attacks, paid the price #dropped - Zwift - KISS at Race 100 - EU (A)",Power2max,Wahoo Kickr 18,436,432,4
36328,1589967351,wahoo,#19. Little race before Lokke Fonden-training later. Unplaned lead out for Simon :) - Zwift - USA Cycling Race League by Indoor Specialist (A),Power2max,Wahoo Kickr 18,426,418,8
36827,1590141222,wahoo,"#2nd - So Conor Swift did a TT breakaway, the rest of us had to battle for 2nd - Zwift - 3R Innsbruckring Flat Race - 4 Laps (35.2km/21.9mi 308m) (A)",Power2max,Wahoo Kickr 18,440,440,0
39744,1591290365,wahoo,11th - messed up the finale  - Zwift - FUSION ECT BEUNSTOPPABLE Racing Series (A),Power2max,Wahoo Kickr 18,407,398,9
40307,1591542740,wahoo,"#3rd - Bad sportsmanship for higher ranked racers to quit the event on the last km, as the find out they can&#039;t gain points - Zwift - 3R Watopia 65km Race - 6 laps (40mi 324m) (A)",Power2max,Wahoo Kickr 18,411,399,12
41382,1592036493,wahoo,"#13th - lag fiesta, every pedalstroke was 2-3 seconds late :/ But win for Maaloe! - Zwift - DBR Saturday Race  (A)",Power2max,Wahoo Kickr 18,440,430,10
44285,1593527458,wahoo,Zwift - 3R & Wahoo Ride Real Race Series - Round 7 of 7 (A),Power2max,Wahoo Kickr 18,412,405,7
45135,1593853105,wahoo,Zwift - 3R Hilly Race - Watopia Hilly Route - 2 Laps (A),Power2max,Wahoo Kickr 18,483,476,7
45290,1594131180,wahoo,Zwift - Sydkysten Cycling - Carl Ras Race (A),Power2max,Wahoo Kickr 18,445,438,7
45291,1594131180,wahoo,Zwift - 3R Volcano Circuit Flat Race - 8 Laps (35.2km/21.9mi 160m) (A),Power2max,Wahoo Kickr 18,417,411,6
46176,1594657679,wahoo,Zwift - Virtual Tour de France - Open - Stage 4 Discovery Ride,Power2max,Wahoo Kickr 18,477,471,6
48686,1596473158,wahoo,#2 - first ever stream. Find it at ,Power2max,Wahoo Kickr 18,426,423,3
50540,1597759730,wahoo,#11th - The finish line came faster than expected xD Wishful thinking &#039;cause the counter was right! - Zwift - 3R Turbocharged Team Race Series - Round 6 (A),Power2max,Wahoo Kickr 18,397,388,9
50986,1597928096,wahoo,Zwift - Off The MAAP Stage 2 Race (A),Power2max,Wahoo Kickr 18,387,388,-1
50987,1597928096,wahoo,"#4th - Chaos race, with no riders list, and all riders from the open world visible - Zwift - 3R Classique Flat Race - 6 Laps (37.7km/23.4mi 114m) (A)",Power2max,Wahoo Kickr 18,433,428,5
53045,1599041704,wahoo,"#3rd - Hs Zwift changed their algoritm, so honor more raw power? &lt;3 - Zwift - Peak-PTY Midweek TT Climb Challenge (A)",Power2max,Wahoo Kickr 18,468,457,11
53293,1599130528,wahoo,#1st - super hard finish :O - Zwift - Team ODZ Thursday Morning Throwdown (E),Power2max,Wahoo Kickr 18,413,402,11
53438,1599231466,wahoo,#7th - Totallu got that sprint wrong! :O - Zwift - 3R Sand and Sequoias Race (A),Power2max,Wahoo Kickr 18,447,443,4
53581,1599327860,wahoo,#4th - big boy got his butt kicked in the mountains xD - Zwift - 3R Three Sisters Hilly Race (47km/29.2mi 879m) (A),Power2max,Wahoo Kickr 18,475,474,1
54351,1599733757,wahoo,#4th - dropped my chain in sprint for 2nd. ZP hero destroyed the race :/ - Zwift - Team ODZ Thursday Morning Throwdown (E),Power2max,Wahoo Kickr 18,416,411,5
57068,1600880600,wahoo,"#34 - Vi vandt ikke, men havde en fucking fest med det &lt;3 - Zwift - DCU powered by Feltet.dk (A)",Power2max,Wahoo Kickr 18,484,477,7
58463,1601401794,wahoo,#3rd - Zwift - Team Italy & Frenchy Fuzion League (A),Favero Assioma DUO,Wahoo Kickr 18,438,434,4
58554,1601486904,wahoo,"#10th - opened too early in the sprint, with dead legs :) - Zwift - DCU powered by Feltet.dk (A)",Favero Assioma DUO,Wahoo Kickr 18,455,459,-4
60567,1602244442,wahoo,#1st - Zwift - TEAM G7 and Mysenlan Friday Indoor Race (A),Favero Assioma DUO,Wahoo Kickr 18,414,409,5
60927,1602400091,wahoo,Zwift - 10/11/2020,Favero Assioma DUO,Wahoo Kickr 18,436,428,8
61614,1602607153,wahoo,"#42 - won the first sprint, but godt dropped on Volcano - Zwift - Zwift Racing League | WTRL",Favero Assioma DUO,Wahoo Kickr 18,487,481,6
62301,1602781710,wahoo,#12th - Zwift - FUSION ECT BEUNSTOPPABLE Racing Series (A),Favero Assioma DUO,Wahoo Kickr 18,500,493,7
63520,1603212402,wahoo,TTT - Zwift Racing League - WTRL ,Favero Assioma DUO,Wahoo Kickr 18,437,447,-10
64467,1603470969,wahoo,Zwift - Crit City Race (A),Favero Assioma DUO,Wahoo Kickr 18,427,434,-7
65109,1603735030,wahoo,"#16th in scratch, dunno in points - Zwift - DBR Ride´N´Roll League (A)",Favero Assioma DUO,Wahoo Kickr 18,459,460,-1
67165,1604317744,wahoo,Testing new Kickr V5 - Zwift - Base training,Favero Assioma DUO,Wahoo Kickr V5,354,359,-5
68574,1604675931,wahoo,#2nd... 0.020 from the victory - Zwift - 3R Volcano Flat Race - 3 Laps (36.6km/22.7mi 138m) (A),Favero Assioma DUO,Wahoo Kickr V5,423,414,9
69393,1604947920,wahoo,#2nd again - Zwift - EVR Europe Race (A),Favero Assioma DUO,Wahoo Kickr V5,418,418,0
71418,1605365837,wahoo,#18th - hard as fuck - Zwift - OH MY CRIT - Saturday Smash Race (A),Favero Assioma DUO,Wahoo Kickr V5,419,417,2
72249,1605635386,wahoo,"A little part of me died, there - Zwift - Zwift Racing League | WTRL - Men&#039;s EMEA E1 DIVISION 1 (A)",Favero Assioma DUO,Wahoo Kickr V5,443,437,6
73794,1605954840,wahoo,#27th - glad I&#039;m not riding the WTRL-race :D - Zwift - Into the Red by RELENTLESS (A),Favero Assioma DUO,Wahoo Kickr V5,452,454,-2
75434,1606306872,wahoo,"1st - pretty eassy rice, but a win is a win :D - Zwift - 3R LaGuardia Loop Flat Race - 10 Laps (28.3km/17.6mi 270m) (A)",Favero Assioma DUO,Wahoo Kickr V5,436,438,-2
76166,1606414701,wahoo,3rd - just got beatern by a faster man - Zwift - FUSION ECT BEUNSTOPPABLE Racing Series (A),Favero Assioma DUO,Wahoo Kickr V5,422,428,-6
76958,1606571794,wahoo,#1st - Zwift - CCBoucherville-V2000 FUN Races (A),Favero Assioma DUO,Wahoo Kickr V5,439,441,-2
77287,1606648471,wahoo,Zwift - Stages of DIRT (A),Favero Assioma DUO,Wahoo Kickr V5,486,494,-8
77288,1606648471,wahoo,"#2nd - second race, emp�ty legs - Zwift - Ottawa TopSpeed Race (A)",Favero Assioma DUO,Wahoo Kickr V5,389,395,-6
78212,1606845369,wahoo,Another ride in the hurt box - Zwift - TT(T) Warm Up,Favero Assioma DUO,Wahoo Kickr V5,442,444,-2
79101,1607016651,wahoo,Zwift - FUSION DECEMBER CUP (A),Favero Assioma DUO,Wahoo Kickr V5,407,410,-3
80196,1607263605,wahoo,"#20th-something... Racing 116 km Zwift race, just to drop the chain with 300m to go. Hur-fucking-ray! - Zwift - KISS 100 Race Series - Americas (A)",Favero Assioma DUO,Wahoo Kickr V5,442,452,-10
81071,1607528530,wahoo,#3rd - did I just learn to sprint in the dessert? - Zwift - 3R Tick Tock Flat Race - 2 Lap (36km/22.4mi 100m) (A),Favero Assioma DUO,Wahoo Kickr V5,447,446,1
82197,1607622465,wahoo,#32 - Volcano needed to be 1 minute shorter xD - Zwift - FUSION DECEMBER CUP (A),Favero Assioma DUO,Wahoo Kickr V5,469,473,-4
82662,1607838474,wahoo,#12th - Never again - Zwift - KISS 100 Race Series - EU (A),Favero Assioma DUO,Wahoo Kickr V5,463,465,-2
83975,1608132795,wahoo,Zwift - Sydkysten Race (A),Favero Assioma DUO,Wahoo Kickr V5,397,389,8
84490,1608226612,wahoo,#15th - Victory for El Falco - How did I NOT get dropped today :O So much pain. - Zwift - FUSION DECEMBER CUP (A),Favero Assioma DUO,Wahoo Kickr V5,449,451,-2
89060,1609336122,wahoo,Zwift - KISS Race Series - Pacific AM (A),Favero Assioma DUO,Wahoo Kickr V5,421,412,9
93074,1610043552,wahoo,Zwift - FUSION WINTER CUP (A),Favero Assioma DUO,Wahoo Kickr V5,466,458,8
94536,1610287494,wahoo,Zwift - KISS 100 Race Series - Americas (A),Favero Assioma DUO,Wahoo Kickr V5,469,472,-3
96333,1610553069,wahoo,"#30-something. Lead out attack for Falk, who won :) - Zwift - Sydkysten Race (A)",Favero Assioma DUO,Wahoo Kickr V5,430,426,4
98174,1610811719,wahoo,Zwift - 3R Classique Flat Race - 4 Laps (26.9km/16.7mi 76m) (A),Favero Assioma DUO,Wahoo Kickr V5,429,427,2
98179,1610811719,wahoo,#4th - Zwift - TDZ Stage 3: Shorter Ride,Favero Assioma DUO,Wahoo Kickr V5,438,440,-2
99864,1611078740,wahoo,Zwift - TTT,Favero Assioma DUO,Wahoo Kickr V5,449,441,8
100210,1611139735,wahoo,#3rd - Zwift - TDZ Stage 4: Longer Ride,Favero Assioma DUO,Wahoo Kickr V5,434,436,-2
101046,1611252747,wahoo,"#10th - hard on gravel, but fun! - Zwift - FUSION WINTER CUP (A)",Favero Assioma DUO,Wahoo Kickr V5,459,462,-3
102941,1611596609,wahoo,3rd. Win for youngstar Oscar! Zwift -  DBR Monday Race (A),Favero Assioma DUO,Wahoo Kickr V5,429,425,4
103999,1611743707,wahoo,Zwift - The Morning Grind by STPC (A),Favero Assioma DUO,Wahoo Kickr V5,475,475,0
104001,1611743707,wahoo,Zwift - TDZ Stage 5: Shorter Ride,Favero Assioma DUO,Wahoo Kickr V5,398,397,1
104787,1611856421,wahoo,#31. Nothing in the legs. Restday tomorrow :) - Zwift - FUSION WINTER CUP (A),Favero Assioma DUO,Wahoo Kickr V5,465,471,-6
106297,1612101934,wahoo,6th - how on earth did I manage that!? - Zwift - KISS 100 Race Series - Americas (A),Favero Assioma DUO,Wahoo Kickr V5,519,520,-1
108330,1612377203,wahoo,"#last maybe - no pwerups the first 2 laps, then 2xdraft and 2xfeather. Nevermind sprinting then ;) - Zwift - Danmarks Cykle Union & Partners 4/6 (A)",Favero Assioma DUO,Wahoo Kickr V5,459,454,5
109361,1612538611,wahoo,6th - can&#039;t sprint anymore - Zwift - DBR Friday Race (A),Favero Assioma DUO,Wahoo Kickr V5,458,452,6
111393,1612868146,wahoo,Zwift - TDZ Stage 8: Group Ride,Favero Assioma DUO,Wahoo Kickr V5,438,439,-1
111394,1612868146,wahoo,Zwift - 3R Gotham Grind Flat Race - 2 Laps (18.5km/11.6mi 58m) (A),Favero Assioma DUO,Wahoo Kickr V5,422,417,5
113074,1613067698,wahoo,"#27th - team attack again, and again, and again.... Zwift - FUSION WINTER CUP (A)",Favero Assioma DUO,Wahoo Kickr V5,488,481,7
114748,1613310743,wahoo,"#2nd! - More downhill sprints please! - Damn you, Teugels! :D - Zwift - KISS 100 Race Series - Americas (A)",Favero Assioma DUO,Wahoo Kickr V5,449,454,-5
115719,1613482460,wahoo,#1st - longest sprint ever! - Zwift - Endurance,Favero Assioma DUO,Wahoo Kickr V5,507,509,-2
117747,1613739705,wahoo,#1st - KISS - Zwift,Favero Assioma DUO,Wahoo Kickr V5,484,487,-3
120921,1614274812,wahoo,#15th - FUSION WINTER CUP - Zwift,Favero Assioma DUO,Wahoo Kickr V5,521,530,-9
123020,1614707144,wahoo,PLAY OFF BABY!!,Favero Assioma DUO,Wahoo Kickr V5,477,476,1
126087,1615208354,wahoo,2nd - Zwift - Magnum mOnDayZ RACE presented by Team ODZ,Favero Assioma DUO,Wahoo Kickr V5,415,423,-8
6587,1576605868,neo,Zwift - ZwiftTeamPL League – Climbers Series (A),Stages,NEO,366,367,-1
11949,1580498034,neo,Tour de Zwift // Pro-Am Invitational,Stages,NEO,382,423,-41
11967,1580383645,neo,NEO / Stages,Stages,NEO,263,265,-2
11972,1580537456,neo,NEO / Stages,Stages,NEO,260,264,-4
12800,1580843634,neo,Zwift - Tour de Zwift // Pro-Am Invitational (A),Stages,NEO,398,407,-9
17629,1583866797,neo,Zwift - ZwiftTeamPL League – Classic Series (A),Stages,NEO,399,406,-7
23340,1586455791,neo,Zwift - London International // Zwift Classic (A),Stages,NEO,429,444,-15
28020,1587838199,neo,Zwift - Crit City Slam // Zwift Classic (A),Stages,NEO,405,427,-22
55095,1600106404,neo,Zwift - Invitational League // Qualifying Race #1,Stages,NEO,391,396,-5
55876,1600367399,neo,Zwift - Invitational League // Qualifying Race #2 (Men) ,Stages,NEO,385,391,-6
58266,1601392200,neo,ZADA Three Sister Michal Kaminski,Stages,NEO,408,426,-18
61780,1602614698,neo,Zwift - Zwift Racing League | WTRL,Stages,NEO,404,413,-9
63513,1603219793,neo,Zwift - Zwift Racing League | WTRL - EMEA (MEN) - TTT Grp 2 (A),Stages,NEO,390,398,-8
64375,1603447793,neo,Zwift - ZA Road - Race #2 (A),Stages,NEO,403,418,-15
66722,1604160016,neo,ZA Road 2020 - Segment Ride #2,Stages,NEO,429,446,-17
67679,1604433898,neo,Zwift - Zwift Racing League | WTRL - Men&#039;s EMEA W1 DIVISION 1 (A),Stages,NEO,403,405,-2
68430,1604643219,neo,Stages / NEO 2T,Stages,NEO 2T,323,325,-2
69879,1605037500,neo,Zwift Racing League | WTRL - EMEA W1 (MEN) -  Division 1,Stages,NEO 2T,443,441,2
71433,1605369600,neo,Zwift - ZA Road 2020 - Segment Ride #1: Innsbruck Course,Stages,NEO 2T,429,408,21
72290,1605642777,neo,Zwift Racing League | WTRL - Mens EMEA W1 DIVISION 1,Assioma,NEO 2T,417,411,6
78165,1606852433,neo,Zwift - Zwift Racing League | WTRL - Men&#039;s EMEA W1 DIVISION 1 (A),Assioma,NEO 2T,414,396,18
78558,1606921312,neo,Zwift - Michal Kaminski [CANYON DEV]&#039;s Meetup - Four Horsemen,Assioma DUO,NEO 2T (Primary),273,271,2
79522,1607068322,neo,Zwift - Watopia,Assioma DUO,NEO 2T (Primary),335,331,4
80156,1607257823,neo,Zwift - Watopia,Assioma DUO,NEO 2T (Primary),335,331,4
81098,1607525097,neo,Zwift - Men&#039;s Elite // 2020 UCI Cycling Esports World Championships,Assioma DUO,NEO 2T (Primary),403,396,7
82447,1607774918,neo,Zwift - Watopia,Assioma DUO,NEO 2T (Primary),434,434,0
89036,1609241996,neo,Zwift - Michal Kaminski (CANYON)&#039;s Meetup - Big Foot Hills,Assioma DUO,NEO 2T (Primary),304,296,8
90384,1609607386,neo,NEO 2T (Primary) / Assioma DUO,Assioma DUO,NEO 2T (Primary),396,346,50
95664,1610475279,neo,Zwift - Zwift Racing League | WTRL - Men&#039;s/Mixed EMEA E1 DIVISION 1 (A),Assioma DUO,NEO 2T (Primary),395,382,13
99746,1611080532,neo,Zwift - Zwift Racing League | WTRL - Men&#039;s/Mixed EMEA E1 DIVISION 1 (A),Assioma DUO,NEO 2T (Primary),405,391,14
103536,1611684869,neo,Zwift - Zwift Racing League | WTRL - Men&#039;s/Mixed EMEA E1 DIVISION 1 (A),Assioma DUO,NEO 2T (Primary),413,402,11
107399,1612289665,neo,Zwift - Zwift Racing League | WTRL - Men&#039;s/Mixed EMEA E1 DIVISION 1 (A),Assioma DUO,NEO 2T (Primary),432,419,13
115863,1613499253,neo,Zwift - Zwift Racing League | WTRL - Men&#039;s/Mixed EMEA E1 DIVISION 1 (A),Assioma DUO,NEO 2T (Primary),464,445,19
119578,1614104050,neo,Zwift - Zwift Racing League | WTRL - Men&#039;s/Mixed EMEA E1 DIVISION 1 (A),Assioma DUO,NEO 2T (Primary),423,405,18
127805,1615626295,neo,Zwift - 3R Endurance Series p/b OTE Sports (E),Assioma DUO (Primary),NEO 2T ,454,439,15
87603,1608986674,wahoo,Zwift - WTRL Racing (A) 1st,4III,Wahoo Kickr v5,414,413,1
87610,1604854699,wahoo,Granfondo Series A Cat.,4III,Wahoo Kickr v5,325,323,2
87638,1607272811,wahoo,Nations Challenge - Belgium p20/159,4IIII,Wahoo Kickr v5,350,354,-4
88306,1609183022,wahoo,Team TFC Mad Monday Series (A),4IIII,Wahoo Kickr v5,423,423,0
88645,1609262986,wahoo,Zwift - WTRL Racing (A) P3,4IIII,Wahoo Kickr v5,377,381,-4
90292,1609603928,wahoo,PPD. 20 Sec + 3 min,4IIII,Wahoo Kickr v5,366,352,14
90597,1609671703,wahoo,PPD 6min Seated,4IIII,Wahoo Kickr v5,444,440,4
90782,1609689828,wahoo,PPD 10min seated,4IIII,Wahoo Kickr v5,414,415,-1
94168,1610213392,wahoo,EVR Winter Series (A),4IIII,Wahoo Kickr v5,386,389,-3
97048,1610650793,wahoo,The BZR Ronde Watopian League (A) 6th,4IIII,Wahoo Kickr v5,424,426,-2
98511,1610893789,wahoo,Herd Beginner Racing Series / all out 15min /rest/ max standing 5sec sprint,4IIII,Wahoo Kickr v5,428,428,0
108296,1612378199,wahoo,ATR Clubhouse Bash 4WAY,4IIII,Wahoo Kickr v5,412,415,-3
111687,1612891991,wahoo,Zwift - Zwift Racing League WRTL,4IIII,Wahoo Kickr v5,417,416,1
115895,1613499173,wahoo,Zwift - Zwift Racing League | WTRL - Men&#039;s/Mixed EMEA E1 DIVISION 1 (A),Favero Assioma DUO to Edge 1030,Wahoo Kickr v5 to Zwift,432,432,0
116909,1613587799,wahoo,Zwift - ATR Clubhouse Bash 4WAY (A) 6th,Favero Assioma DUO to Edge 1030,Wahoo Kickr v5 to Zwift,401,393,8
119582,1614104092,wahoo,Zwift - Zwift Racing League | WTRL - Men&#039;s/Mixed EMEA E1 DIVISION 1 (A),Favero Assioma DUO to Edge 1030,Wahoo Kickr v5 to Zwift,399,409,-10
122976,1614709404,wahoo,Zwift Racing League | WTRL - Men&#039;s/Mixed EMEA E1 DIVISION 1,Favero Assioma DUO to Edge 1030,Wahoo Kickr v5 to Zwift,381,381,0
123965,1614874479,wahoo,OH MY CRIT!! - The Double Race 1/2,Favero Assioma DUO to Edge 1030,Wahoo Kickr v5 to Zwift,391,388,3
123989,1614877460,wahoo,Zwift - OH MY CRIT!! - The Double Race 2/2 (A),Favero Assioma DUO to Edge 1030,Wahoo Kickr v5 to Zwift,392,383,9
127068,1615477396,wahoo,PEDALES VECTOR3 / WAHOO CORE,PEDALES VECTOR3,WAHOO CORE,320,343,-23
101074,1611254595,wahoo,Zwift - BENELIGA 2020-2021 (E),2021-01-21-184314-ELEMNT ROAM 31BC-19-0,`Wahoo Kickr,387,394,-7
104747,1611859663,wahoo,Zwift - BENELIGA 2020-2021 (E),2021-01-28-184742-ELEMNT ROAM 31BC-24-0,`Wahoo Kickr,385,398,-13
108984,1612464083,wahoo,Zwift - BENELIGA 2020-2021 (E),4iiii,`Wahoo Kickr,394,383,11
113173,1613069096,wahoo,Zwift - BENELIGA 2020-2021 (E),4iiii,`Wahoo Kickr,437,430,7
117358,1613673858,wahoo,Zwift - BENELIGA 2020-2021 (E),4iiii,`Wahoo Kickr,360,366,-6
121685,1614269035,wahoo,Zwift - DBR Friday Race (A),4iiii,`Wahoo Kickr,345,369,-24
122068,1614519718,wahoo,Zwift - La Bicicletta Toronto & Toronto Hustle Donut Race (A),4iiii,`Wahoo Kickr,400,392,8
126049,1615287485,wahoo,Zwift - KISS Race Series - Americas AM (A),4iiii,`Wahoo Kickr,335,343,-8
103904,1611731266,neo,Tacx Neo 2T / Vector 3 Dual Sided,Vector 3 Dual Sided,Tacx Neo 2T,278,278,0
106158,1612086293,neo,zone 2,Vector 3 Dual Sided,Tacx Neo 2T,278,274,4
106161,1612002589,neo,Cycling Weekly Winter Lockdown RR Series,Vector 3 Dual Sided,Tacx Neo 2T,412,414,-2
106164,1611770394,neo,MIDWEEK Winter Series by SZR,Vector 3 Dual Sided,Tacx Neo 2T,380,384,-4
106165,1611678589,neo,TEAM VEGAN Tofu Tornado,Vector 3 Dual Sided,Tacx Neo 2T,390,408,-18
108427,1612378785,neo,Zwift - Open - Movistar Team Challenge Community Qualifier Race #1,Vector 3 Dual Sided,Tacx Neo 2T,412,420,-8
116096,1613505100,neo,Zwift - Zwift Racing League | WTRL - Men&#039;s/Mixed EMEA W2 DIVISION 1 (A),Vector 3 Dual Sided,Tacx Neo 2T,428,437,-9
116100,1613212183,neo,Zwift - Cycling Weekly Winter Lockdown RR Series (A),Vector 3 Dual Sided,Tacx Neo 2T,389,394,-5
78589,1606931997,wahoo,Zwift - MIDWEEK Winter Series by SZR (A),assioma duo,wahoo kickr,382,385,-3
78898,1607006394,wahoo,Zwift - Team Italy Specialissima Race (A),assioma duo,wahoo kickr,324,334,-10
79813,1607181291,wahoo,Zwift - OH MY CRIT - Saturday Smash Race (A),Sortie_CRIT v_lo_l_apr_s_midi,wahoo kickr,371,385,-14
80241,1607260199,wahoo,Zwift - The BMTR Fundo (A),assioma duo,wahoo kickr,312,326,-14
83657,1608056700,neo,Zwift - Zwift Racing League | WTRL - Men&#039;s EMEA E1 DIVISION 1 (A),duo assioma,TACX NEO 2T,376,357,19
88596,1609233615,wahoo,Zwift - The After Party Race (A),duo assioma,wahoo kickr,372,372,0
88597,1609237827,wahoo,Zwift - ZHR Masters Asia (B),duo assioma,wahoo kickr,372,380,-8
92727,1610024713,wahoo,Zwift - 3R Knickerbocker Climbing Race - 1 Lap (22.4km/13.9mi 365m) (A),duo assioma,wahoo kickr,346,357,-11
92728,1610030421,wahoo,Zwift - Team Italy Specialissima Race (A),duo assioma,wahoo kickr,329,328,1
93384,1610121629,wahoo,Zwift - TDZ Stage 1: Longer Ride,duo assioma,wahoo kickr,289,287,2
93957,1610203513,wahoo,Zwift - Crit City Race (A),duo assioma,wahoo kickr,334,329,5
93960,1610205326,wahoo,Zwift - OH MY CRIT - Saturday Smash Race (A),duo assioma,wahoo kickr,385,388,-3
93967,1610209815,wahoo,Zwift - ZHQ FutureWorks Crit City Race - Anti-sandbagging (A),duo assioma,wahoo kickr,357,360,-3
95611,1610475318,wahoo,Zwift - Zwift Racing League | WTRL - Men&#039;s/Mixed EMEA E1 DIVISION 1 (A),duo assioma,wahoo kickr,367,383,-16
96125,1610524945,wahoo,Zwift - TDZ Stage 2: Standard Ride,duo assioma,wahoo kickr,355,338,17
96704,1610607805,wahoo,Zwift - TDZ Stage 2: Shorter Ride,duo assioma,wahoo kickr,303,295,8
97793,1610784920,wahoo,Zwift - Matando o Corpo® by PETA-Z (A),duo assioma,wahoo kickr,397,389,8
98510,1610892211,wahoo,Zwift - TDZ Stage 3: Shorter Ride,duo assioma,wahoo kickr,360,358,2
98979,1610985812,wahoo,Zwift - TDZ Stage 3: Shorter Ride,duo assioma,wahoo kickr,312,301,11
101290,1611304523,wahoo,Zwift - TBR Burrito Race (A),duo assioma,wahoo kickr,309,306,3
101657,1611392539,wahoo,Zwift - Watopia,duo assioma,wahoo kickr,413,136,277
101663,1611392539,wahoo,Zwift - TDZ Stage 4: Standard Ride,duo assioma,wahoo kickr,413,414,-1
102777,1611586826,wahoo,Zwift - TDZ Stage 5: Longer Ride,duo assioma,wahoo kickr,298,300,-2
103440,1611684922,wahoo,Zwift - Zwift Racing League | WTRL - Men&#039;s/Mixed EMEA E1 DIVISION 1 (A),duo assioma,wahoo kickr,385,376,9
104048,1611759733,wahoo,Zwift - TDZ Stage 5: Standard Ride,duo assioma,wahoo kickr,355,351,4
104562,1611842701,wahoo,Zwift - Ascenders Team Social Thursday (C),duo assioma,wahoo kickr,225,218,7
105150,1611936144,wahoo,Zwift - TDZ Stage 6: Standard Ride,duo assioma,wahoo kickr,263,260,3
109362,1612540816,wahoo,Zwift - TDZ Stage 7: Longer Ride,duo assioma,wahoo kickr,347,346,1
110897,1612792942,wahoo,Zwift - TDZ Stage 8: Group Ride,duo assioma,wahoo kickr,313,310,3
117637,1613725413,wahoo,Zwift - TDZ Stage 5: Shorter Ride,duo assioma,wahoo kickr,270,269,1
117639,1613729006,wahoo,Zwift - TDZ Stage 1: Shorter Ride,duo assioma,wahoo kickr,304,292,12
57713,1601119090,wahoo,three sisters test warm up,Giant power pro 2020,Wahoo Kickr core ,262,258,4
57714,1601119090,wahoo,Three sisters test 26/09/2020,Giant power pro 2020,Wahoo Kickr core ,426,428,-2
65201,1603741207,wahoo,Zwift - Premier Division // Zwift Racing League (men) (A),Giant power pro 2020,Wahoo Kickr core ,385,372,13
65994,1603965526,wahoo,Zwift - KISS at Race - Americas AM (A),Giant power pro 2020,Wahoo Kickr core ,387,383,4
88120,1609146434,wahoo,Zwift - 3R Watopia Flat Route Race - 4 Laps (41km/25.5mi 216m) (A),quarq Rikken (2016),Wahoo Kickr core 2 (replacement),340,354,-14
91399,1609784476,wahoo,Zwift - XRS Races: Monday&#039;s blues (A),quarq Rikken (2016),Wahoo Kickr core ,382,398,-16
95099,1610390549,wahoo,Zwift - KATT Race by WKG (A),quarq Rikken (2016),Wahoo Kickr core 2 (replacement),375,394,-19
99277,1610998679,wahoo,Zwift - Premier Division // Zwift Racing League (men) (A),quarq Rikken (2016),Wahoo Kickr core ,388,401,-13
102964,1611601490,wahoo,Zwift - Premier Division // Zwift Racing League (men) (A),quarq Rikken (2016),Wahoo Kickr core 2 (replacement),387,399,-12
106960,1612208240,wahoo,Zwift - Premier Division // Zwift Racing League (men) (A),quarq Rikken (2016),Wahoo Kickr core 2 (replacement),408,408,0
111048,1612811698,wahoo,Zwift - Premier Division // Zwift Racing League (men) (A),quarq Rikken (2016),Wahoo Kickr core 2 (replacement),391,407,-16
112365,1612981880,wahoo,Zwift - Movistar Team Challenge // Round 1 (A),quarq Rikken (2016),Wahoo Kickr core 2 (replacement),389,406,-17
113651,1613155066,wahoo,Zwift - Movistar Team Challenge // Round 1 (men),quarq Rikken (2016),Wahoo Kickr core 2 (replacement),398,411,-13
115419,1613419222,wahoo,Zwift - Premier Division // Zwift Racing League (men) (A),quarq Rikken (2016),Wahoo Kickr core 2 (replacement),420,437,-17
116757,1613587653,wahoo,Zwift - Movistar Team Challenge // Round 2 (men) - Race 3/4,quarq Rikken (2016),Wahoo Kickr core 2 (replacement),373,380,-7
117915,1613759475,wahoo,Zwift - Movistar Team Challenge // Round 2 (men),quarq Rikken (2016),Wahoo Kickr core 2 (replacement),398,410,-12
119129,1614020981,wahoo,Zwift - Premier Division // Zwift Racing League (men) (A),Evening_Ride (2),Wahoo Kickr core 2 (replacement),365,379,-14
122677,1614629518,wahoo,Zwift - Premier Division // Zwift Racing League (men) (A),quarq Rikken (2016),Wahoo Kickr core 2 (replacement),391,401,-10
81993,1607709600,wahoo,Zwift - KIRCHMAIR Race Series (A),Quarq Sram Red DZero,Wahoo Kickr Core,439,418,21
83523,1608056741,wahoo,Zwift - Zwift Racing League | WTRL - Men&#039;s EMEA E1 DIVISION 1 (A),Quarq Sram Red DZero,Wahoo Kickr Core,439,421,18
92348,1609956005,wahoo,Zwift - MIDWEEK Winter Series by SZR (A),Quarq Sram Red DZero,Wahoo Kickr Core,371,382,-11
92443,1609958702,wahoo,Zwift - GCA Cup (A),Quarq Sram Red DZero,Wahoo Kickr Core,367,367,0
92755,1610035203,wahoo,Zwift - TDZ Stage 1: Longer Ride,Quarq Sram Red DZero,Wahoo Kickr Core,378,380,-2
94993,1610392499,wahoo,Zwift - Premier Division // Zwift Racing League (men) (A),Quarq Sram Red DZero,Wahoo Kickr Core,414,405,9
97765,1610787903,wahoo,Zwift - e-liga | eCycling league Austria Race 4 (A),Quarq Sram Red DZero,Wahoo Kickr Core,420,427,-7
99173,1610999610,wahoo,Zwift - Premier Division // Zwift Racing League (men) (A),Quarq Sram Red DZero,Wahoo Kickr Core,410,416,-6
101691,1611392703,wahoo,Zwift - e-liga | eCycling league Austria Race 5 (A),Quarq Sram Red DZero,Wahoo Kickr Core,412,419,-7
102882,1611601494,wahoo,Zwift - Premier Division // Zwift Racing League (men) (A),Quarq Sram Red DZero,Wahoo Kickr Core,422,414,8
105743,1612025999,wahoo,Zwift - GCA Liga 2021 #1,Quarq Sram Red DZero,Wahoo Kickr Core,436,436,0
106874,1612210015,wahoo,Zwift - Premier Division // Zwift Racing League (men) (A),Quarq Sram Red DZero,Wahoo Kickr Core,427,414,13
110015,1612630803,wahoo,Zwift - GCA Liga 2021 #2 (A),Quarq Sram Red DZero,Wahoo Kickr Core,396,383,13
110974,1612812082,wahoo,Zwift - Premier Division // Zwift Racing League (men) (A),Quarq Sram Red DZero,Wahoo Kickr Core,406,408,-2
112825,1613060102,wahoo,Zwift - OH MY CRIT!! - The Double Race 1/2 (A),Quarq Sram Red DZero,Wahoo Kickr Core,370,371,-1
114255,1613235603,wahoo,Zwift - GCA Liga 2021 #3 (A),Quarq Sram Red DZero,Wahoo Kickr Core,402,398,4
115351,1613419323,wahoo,Zwift - Premier Division // Zwift Racing League (men) (A),Quarq Sram Red DZero,Wahoo Kickr Core,441,444,-3
117168,1613664901,wahoo,Zwift - OH MY CRIT!! - The Double Race 1/2 (A),Quarq Sram Red DZero,Wahoo Kickr Core,399,405,-6
118353,1613840402,wahoo,Zwift - GCA Liga 2021 #4 (A),2021-02-20-170002-ELEMNT BOLT 7192-216-0,Wahoo Kickr Core,432,440,-8
119087,1614021000,wahoo,Zwift - Premier Division // Zwift Racing League (men) (A),Quarq Sram Red DZero,Wahoo Kickr Core,397,391,6
121703,1614445203,wahoo,Zwift - GCA Liga 2021 #5 (A),Quarq Sram Red DZero,Wahoo Kickr Core,429,432,-3
122545,1614629854,wahoo,Zwift - Premier Division // Zwift Racing League (men) (A),Quarq Sram Red DZero,Wahoo Kickr Core,425,426,-1
90913,1608368665,wahoo,Zwift - e-liga | eCycling league Austria Race 3 (A),Rotor 2inpower,wahoo Kickr v5,314,296,18
101726,1611392656,wahoo,Zwift - e-liga | eCycling league Austria Race 5 (A),Rotor 2inpower,wahoo Kickr v5,302,284,18
112261,1612980006,wahoo,Zwift - MIDWEEK Winter Series by SZR (B),Rotor 2inpower,wahoo Kickr v5,324,299,25
112964,1613070149,wahoo,Zwift - Richmond,Rotor 2inpower,wahoo Kickr v5,176,176,0
115240,1613413743,wahoo,Zwift - KIRCHMAIR ZRL Preparation Ride (C),Rotor 2inpower,wahoo Kickr v5,231,231,0
116135,1613499833,wahoo,Zwift - Zwift Racing League | WTRL - Men&#039;s/Mixed EMEA E2 DIVISION 1 (B),Rotor 2inpower,wahoo Kickr v5,334,331,3
118163,1613811837,wahoo,Zwift - e-liga | eCycling league Austria Race 7 (A),Rotor 2inpower,wahoo Kickr v5,315,319,-4
124586,1614971021,wahoo,Zwift - Zwift Racing League | WTRL Division Championships - Men&#039;s Points Race (A),Rotor 2inpower,wahoo Kickr v5,316,314,2
124892,1615021423,wahoo,Zwift - e-liga | eCycling league Austria Race 8 (A),Rotor 2inpower,wahoo Kickr v5,362,361,1
124625,1614970706,wahoo,Zwift Racing League | WTRL Battle Royale Playoff - Men&#039;s Points Race,SRM Origin,Wahoo Kickr,347,343,4
125233,1615059742,wahoo,Zwift Racing League | WTRL Battle Royale Playoff - Men&#039;s TTT,SRM Origin,Wahoo Kickr,329,327,2
122629,1614625176,wahoo,Zwift -  SCF SWE Cup Men (A),Garmin-vektor 3,Wahoo Kickr Bike,417,406,11
123156,1614719195,wahoo,Zwift - Innsbruck,Garmin-vektor 3,Wahoo Kickr Bike,144,145,-1
124084,1614880732,wahoo,Zwift - New Workout,Garmin-vektor 3,Wahoo Kickr Bike,358,355,3
126226,1615316572,wahoo,Zwift - 3R Omnium Event - Race 1 - Scatch Race,Garmin-vektor 3,Wahoo Kickr Bike,434,434,0
126612,1615401872,wahoo,Zwift - 03/10/2021,Garmin-vektor 3,Wahoo Kickr Bike,430,425,5
128786,1615834774,wahoo,Zwift -  SCF SWE Cup Men (A),Garmin-vektor 3,Wahoo Kickr Bike,417,402,15
22322,1586102641,wahoo,Zwift - 3R Tick Tock Flat Race - 1 Lap (A) ,Garmin Vector 3 pedals,Wahoo Kickr,341,349,-8
25107,1587029390,wahoo,Trofeo Bologna Race (A) top 4....,Garmin Vector 3 pedals,Wahoo Kickr,372,377,-5
25761,1587198549,wahoo,Richmond Challenge Race // Zwift Classic (A) DNF,Garmin Vector 3 pedals,Wahoo Kickr,324,303,21
26343,1587285100,wahoo,Richmond Challenge Race // Zwift Classic (1 Lap) Winner,Garmin Vector 3 pedals,Wahoo Kickr,344,344,0
29967,1588147425,wahoo,Aussie Crit Crushers Race 1 of 2,Garmin Vector 3 pedals,Wahoo Kickr,359,359,0
30441,1588415378,wahoo,3R Volcano Climb Race - 1 Lap (A) ,Garmin Vector 3 pedals,Wahoo Kickr,361,360,1
31668,1588699677,wahoo,WTRL Sprint Race (A) :(,Garmin Vector 3 pedals,Wahoo Kickr,352,353,-1
32668,1588925340,wahoo,Tour for All 2020: Stage 2 - top 15,Garmin Vector 3 pedals,Wahoo Kickr,346,346,0
33824,1589270941,wahoo,Tour for All 2020: Stage 3 - NY Reverse KOM Attempt (then died),Garmin Vector 3 - Wahoo Bolt,Wahoo Kickr,367,366,1
35271,1589616482,wahoo,Tour for All 2020: Stage 4 Hangover sufferfest,Vector 3 / Wahoo Bolt,Wahoo Kickr / Zwift,335,334,1
37830,1590514148,wahoo,WTRL Empowerment Series,Garmin Vector 3 / Wahoo Bolt,Wahoo Kickr / Zwift,364,364,0
42009,1592333942,wahoo,KISS at Race,Garmin Vector 3 / Wahoo Bolt,Wahoo Kickr / Zwift,339,339,0
43237,1592933353,wahoo,WTRL Empowerment Series- 2nd,Garmin Vector 3 / Wahoo Bolt,Wahoo Kickr / Zwift,363,363,0
45110,1594048493,wahoo,3R Volcano Circuit Sprint Flat Race - 2nd,Garmin Vector 3 / Wahoo Bolt,Wahoo Kickr / Zwift,321,321,0
45237,1593709127,wahoo,Zwift - Donny Chain Gang ,Garmin Vector 3 / Wahoo Bolt,Wahoo Kickr / Zwift,326,326,0
50421,1597686309,wahoo,KATT Race by WKG - Winner,Garmin Vector 3 / Wahoo Bolt,Wahoo Kickr / Zwift,305,305,0
51676,1598367762,wahoo,3R Turbocharged Team Race Series - Bonus Round,Garmin Vector 3 / Wahoo Bolt,Wahoo Kickr / Zwift,374,374,0
55133,1600106150,wahoo,Zwift - Invitational League // Qualifying Race #1,Garmin Vector 3 / Wahoo Bolt,Wahoo Kickr v5/ Zwift,360,333,27
56113,1600426644,wahoo,Zwift -  Stage 1 // Virtual Haute Route Ventoux - 4th,Garmin Vector 3 / Wahoo Bolt,Wahoo Kickr v5/ Zwift,359,358,1
56439,1600606744,wahoo,Zwift - Invitational League // Qualifying Race #3 (Men) (A),Garmin Vector 3 / Wahoo Bolt,Wahoo Kickr v5/ Zwift,344,341,3
57016,1600880340,wahoo,Zwift - MIDWEEK Autumn Series by SZR - 22nd,Garmin Vector 3 / Wahoo Bolt,Wahoo Kickr v5/ Zwift,362,371,-9
15322,1582467287,neo,Zwift - KISS at Race 100 - Americas (A),Quarq AXS,Tacx Neo 2T,346,336,10
15615,1582656290,neo,Zwift - ZESP Hamsters (A),Quarq AXS,Tacx Neo 2T,346,334,12
15915,1582829983,neo,Zwift - KALAS Cup - Round 5 (A),Quarq AXS,Tacx Neo 2T,359,346,13
16741,1583261685,neo,Zwift - Team Italy & Frenchy Fuzion League (A),Quarq AXS,Tacx Neo 2T with Garmin Edge 520,390,375,15
16951,1583434794,neo,Zwift - KALAS Cup - Round 6 (A),Quarq AXS,Tacx Neo 2T with Garmin Edge 520,364,360,4
17134,1583569794,neo,Zwift - VZT Tofu Tornado XL (A),Quarq AXS,Tacx Neo 2T with Garmin Edge 520,366,354,12
17274,1583673352,neo,Zwift - KISS at Race 100 - Americas (A),Quarq AXS,Tacx Neo 2T with Garmin Edge 520,356,345,11
17523,1583866490,neo,Zwift - Team Italy & Frenchy Fuzion League (A),Quarq AXS,Tacx Neo 2T with Garmin Edge 520,363,351,12
17657,1583932192,neo,Zwift - Stage 1 Race (A) - Tour of Watopia 2020,Quarq AXS,Tacx Neo 2T with Garmin Edge 520,362,347,15
17944,1584104993,neo,Zwift - Stage 2 Race (A) - Tour of Watopia 2020,Quarq AXS,Tacx Neo 2T with Garmin Edge 520,369,355,14
18133,1584267000,neo,Zwift - Stage 2 Race (A) - Tour of Watopia 2020,Quarq AXS,Tacx Neo 2T with Garmin Edge 520,369,355,14
18445,1584471296,neo,Zwift - Team Italy & Frenchy Fuzion League (A),Quarq AXS,Tacx Neo 2T with Garmin Edge 520,373,363,10
19002,1584781794,neo,Zwift - Stage 4 Race (A) - Tour of Watopia 2020,Quarq AXS - Zwift,Tacx Neo 2T with Garmin Edge 520,385,368,17
19128,1584865192,neo,Zwift - Team Italy & Frenchy Fuzion Fondo (A),Quarq AXS - Zwift,Tacx Neo 2T with Garmin Edge 520,379,365,14
19530,1585138196,neo,Zwift - Stage 5 Race (A) - Tour of Watopia 2020,Quarq AXS - Zwift,Tacx Neo 2T with Garmin Edge 520,349,337,12
19805,1585249187,neo,Zwift - KALAS Cup - Round 9 (A),Quarq AXS - Zwift,Tacx Neo 2T with Garmin Edge 520,368,356,12
20285,1585466389,neo,Zwift - Team Italy & Frenchy Fuzion Fondo (A),Quarq AXS - Zwift,Tacx Neo 2T with Garmin Edge 520,381,362,19
20871,1582114382,neo,Zwift - Team Italy & Frenchy Fuzion League (A),Quarq AXS - Zwift,Tacx Neo 2T with Garmin Edge 520,372,311,61
21007,1585677294,neo,Zwift - Team Italy & Frenchy Fuzion League (A),Quarq AXS - Zwift,Tacx Neo 2T with Garmin Edge 520,372,360,12
21459,1585848894,neo,Zwift - ZTPL.CC Tour Stage 6 (E),Quarq AXS - Zwift,Tacx Neo 2T with Garmin Edge 520,403,397,6
21947,1585988992,neo,Zwift - DBR Sufferday League (A),Quarq AXS - Zwift,Tacx Neo 2T with Garmin Edge 520,370,358,12
23684,1586593787,neo,Zwift - DBR Sufferday League (A),Quarq AXS - Zwift,Tacx Neo 2T with Garmin Edge 520,369,360,9
23966,1586682292,neo,Zwift - Newbury Velo Road Race (A),Quarq AXS - Zwift,Tacx Neo 2T with Garmin Edge 520,364,354,10
24293,1586798087,neo,Zwift - DBR Wahoo League (A),Quarq AXS - Zwift,Tacx Neo 2T with Garmin Edge 520,365,355,10
24643,1586885686,neo,Zwift - ZTPLCCTour2020 Stage 2 (E),Quarq AXS - Zwift,Tacx Neo 2T with Garmin Edge 520,348,335,13
25238,1587058487,neo,Zwift - ZTPL.CC Tour2020 Stage 3 (E),Quarq AXS - Zwift,Tacx Neo 2T with Garmin Edge 520,373,362,11
25775,1587198587,neo,Zwift - DBR Sufferday League (A),Quarq AXS - Zwift,Tacx Neo 2T with Garmin Edge 520,374,361,13
26142,1587287087,neo,Zwift - Newbury Velo Road Race (A),Quarq AXS - Zwift,Tacx Neo 2T with Garmin Edge 520,372,355,17
26468,1587402886,neo,Zwift - DBR Wahoo League (A),Quarq AXS - Zwift,Tacx Neo 2T with Garmin Edge 520,405,392,13
27831,1587803383,neo,Zwift - DBR Sufferday League (A),Quarq AXS - Zwift,Tacx Neo 2T with Garmin Edge 520,382,367,15
28235,1587906881,neo,Zwift - KISS at Race 100 - Americas (A),Quarq AXS - Zwift,Tacx Neo 2T with Garmin Edge 520,349,338,11
28459,1588007682,neo,Zwift - DBR Wahoo League (A),Quarq AXS - Zwift,Tacx Neo 2T with Garmin Edge 520,360,345,15
30430,1588408175,neo,Zwift - DBR Sufferday League (A),Quarq AXS - Zwift,Tacx Neo 2T with Garmin Edge 520,402,390,12
32928,1589012992,neo,Zwift - DBR Sufferday League (A),Quarq AXS - Zwift,Tacx Neo 2T with Garmin Edge 520,391,372,19
33329,1589116488,neo,Zwift - KISS at Race 100 - Americas (A),Quarq AXS - Zwift,Tacx Neo 2T with Garmin Edge 520,346,336,10
35645,1589721289,neo,Zwift - KISS at Race 100 - Americas (A),Quarq AXS - Zwift,Tacx Neo 2T with Garmin Edge 520,337,324,13
39962,1591429132,wahoo,Zwift - DBR Sufferday League (A),Quarq AXS with Garmin Edge 530,Wahoo Kickr Core,393,391,2
40205,1591533287,wahoo,Zwift - KISS at Race 100 - Americas (A),Quarq AXS with Garmin Edge 530,Wahoo Kickr Core - Zwift,339,338,1
42246,1592414017,neo,Zwift - Zwift NL League - The Watopia Series  (A),Quarq AXS with Garmin Edge 530,Tacx Neo 2T - Zwift (BLE),359,349,10
42929,1592635638,neo,Zwift - ZWC Weekend Race  (A),Quarq AXS with Garmin Edge 530,Tacx Neo 2T - Zwift,403,395,8
43968,1593347126,neo,Zwift - KISS at Race 100 - Americas (A),Quarq AXS with Garmin Edge 530,Tacx Neo 2T - Zwift,376,369,7
44844,1593848478,neo,Zwift - DBR Saturday Race  (A),Quarq AXS with Garmin Edge 530,Tacx Neo 2T - Zwift,364,357,7
45011,1593952314,neo,Zwift - KISS at Race 100 - Americas (A),Quarq AXS with Garmin Edge 530,Tacx Neo 2T - Zwift,355,347,8
45619,1594299198,neo,Zwift - Virtual Tour de France - Open - Stage 1 Discovery Ride,Quarq AXS with Garmin Edge 530,Tacx Neo 2T - Zwift,353,345,8
46031,1594540854,neo,Zwift - L&#039;Etape du Tour Stage 2 - Open,Quarq AXS with Garmin Edge 530,Tacx Neo 2T - Zwift,408,398,10
46052,1594557419,neo,Zwift - KISS at Race 100 - Americas (A),Quarq AXS with Garmin Edge 530,Tacx Neo 2T - Zwift,319,313,6
46484,1594832345,neo,Zwift - MIDWEEK Summer Series by SZR (A),Quarq AXS - Zwift,Tacx Neo 2T with Garmin Edge 520,357,350,7
47170,1595343842,neo,Zwift - 3R Turbocharged Team Race Series - Round 2 (A),Quarq AXS - Zwift,Tacx Neo 2T with Garmin Edge 520,330,318,12
47758,1595769293,neo,Zwift - KISS at Race 100 - Americas (A),Quarq AXS - Zwift,Tacx Neo 2T with Garmin Edge 520,364,358,6
52872,1598894093,wahoo,Zwift - DBR Monday Race  (A),Quarq AXS with Garmin Edge 530,Wahoo Kickr 2018 - Zwift,354,358,-4
54876,1600002655,wahoo,Zwift - KISS at Race 100 - Americas (A),Quarq AXS with Garmin Edge 530,Wahoo Kickr 2018 - Zwift,416,407,9
55097,1600102787,wahoo,DBR Ride´N´Roll League,Quarq AXS with Garmin Edge 530,Wahoo Kickr 2018 - Zwift,366,365,1
56252,1600504181,neo,Zwift - DBR SufferDay League II (A),Quarq AXS - Zwift,Tacx Neo 2T with Garmin Edge 520,404,394,10
56502,1600607680,neo,Zwift - KISS at Race 100 - Americas (A),Quarq AXS - Zwift,Tacx Neo 2T with Garmin Edge 520,380,371,9
56663,1600708479,neo,Zwift - DBR Ride´N´Roll League (A),Quarq AXS - Zwift,Tacx Neo 2T with Garmin Edge 520,349,341,8
57639,1601106525,wahoo,Zwift - DBR SufferDay League II (A),Quarq AXS with Garmin Edge 530,Wahoo Kickr 2018 - Zwift,387,382,5
58065,1601311257,wahoo,Zwift - DBR Ride´N´Roll League (A),Quarq AXS with Garmin Edge 530,Wahoo Kickr 2018 - Zwift,330,340,-10
59207,1601713770,wahoo,Zwift - DBR SufferDay League II (A),Quarq AXS - Zwift,Wahoo Kickr 2018 with Garmin Edge 520,393,385,8
59437,1601817269,wahoo,Zwift - KISS at Race 100 - Americas (A),Quarq AXS - Zwift,Wahoo Kickr 2018 with Garmin Edge 520,346,348,-2
59610,1601916279,wahoo,Zwift - DBR Ride´N´Roll League (A),Quarq AXS with Garmin Edge 530,Wahoo Kickr 2018 - Zwift,346,352,-6
60117,1602089552,wahoo,Zwift - DCU powered by Feltet.dk (A),Quarq AXS with Garmin Edge 530,Wahoo Kickr 2018 - Zwift,358,362,-4
60763,1602316751,wahoo,Zwift - DBR SufferDay League II (A),Quarq AXS with Garmin Edge 530,Wahoo Kickr 2018 - Zwift,374,368,6
61195,1602521065,wahoo,Zwift - DBR Ride´N´Roll League (A),Quarq AXS with Garmin Edge 530,Wahoo Kickr 2018 - Zwift,382,382,0
61638,1602614394,wahoo,Zwift - Zwift Racing League | WTRL,Quarq AXS with Garmin Edge 530,Wahoo Kickr 2018 - Zwift,375,380,-5
62607,1602923346,wahoo,Zwift - DBR SufferDay League II (A),Quarq AXS with Garmin Edge 530,Wahoo Kickr 2018 - Zwift,386,387,-1
63159,1603125632,wahoo,Zwift - DBR Ride´N´Roll League (A),Quarq AXS with Garmin Edge 530,Wahoo Kickr 2018 - Zwift,391,392,-1
63563,1603213967,wahoo,Zwift - Zwift Racing League | WTRL - EMEA (MEN) - TTT Grp 2 (E),Quarq AXS with Garmin Edge 530,Wahoo Kickr 2018 - Zwift,341,349,-8
64565,1603527650,wahoo,Zwift - DBR SufferDay League II (A),Quarq AXS with Garmin Edge 530,Wahoo Kickr 2018 - Zwift,383,382,1
65453,1603820250,wahoo,Zwift - Zwift Racing League | WTRL - EMEA E (MEN) -  Division 6 (A),Quarq AXS with Garmin Edge 530,Wahoo Kickr 2018 - Zwift,370,371,-1
66644,1604134313,wahoo,Zwift - DBR Saturday Race (A),Quarq AXS with Garmin Edge 530,Wahoo Kickr 2018 - Zwift,384,388,-4
68088,1604513232,wahoo,Zwift - DCU – Feltet.dk November series,Quarq AXS with Garmin Edge 530,Wahoo Kickr 2018 - Zwift,423,421,2
71355,1605341686,wahoo,Zwift - Matando o Corpo® PETA-Z (A),Quarq AXS with Garmin Edge 530,Wahoo Kickr 2018 - Zwift,375,380,-5
72631,1605721031,wahoo,Zwift - MIDWEEK Autumn Series by SZR (A),Quarq AXS with Garmin Edge 530,Wahoo Kickr 2018 - Zwift,358,364,-6
73819,1605947373,wahoo,Zwift - TEAM VEGAN Tofu Tornado XL (A),Quarq AXS with Garmin Edge 530,Wahoo Kickr 2018 - Zwift,419,423,-4
73821,1605947373,wahoo,Zwift - Into the Red by RELENTLESS (A),Quarq AXS with Garmin Edge 530,Wahoo Kickr 2018 - Zwift,399,401,-2
76818,1606552148,wahoo,Zwift - Cycling Ireland Zwift League Rd 3 (A),Quarq AXS with Garmin Edge 530,Wahoo Kickr 2018 - Zwift,349,359,-10
76820,1606552148,wahoo,Zwift - Into the Red by RELENTLESS (A),Quarq AXS with Garmin Edge 530,Wahoo Kickr 2018 - Zwift,366,372,-6
77325,1606656379,wahoo,Zwift - KISS 100 Race Series - Americas (A),Quarq AXS with Garmin Edge 530,Wahoo Kickr 2018 - Zwift,325,329,-4
78612,1606931269,wahoo,Zwift - Frenchy Fuzion Watopia Tour - Etape 3 (A),Quarq AXS with Garmin Edge 530,Wahoo Kickr 2018 - Zwift,386,388,-2
80174,1607263770,wahoo,Zwift - KISS 100 Race Series - Americas (A),Quarq AXS with Garmin Edge 530,Wahoo Kickr 2018 - Zwift,349,354,-5
82280,1607765642,wahoo,Zwift - Cycling Ireland Zwift League Rd 5 (A),Quarq AXS with Garmin Edge 530,Wahoo Kickr 2018 - Zwift,417,418,-1
82847,1607868798,wahoo,Zwift - KISS 100 Race Series - Americas (A),Quarq AXS with Garmin Edge 530,Wahoo Kickr 2018 - Zwift,401,400,1
85048,1608370904,wahoo,Zwift - Tour of New York Stage 2 - Open Longer,Quarq AXS with Garmin Edge 530,Wahoo Kickr 2018 - Zwift,383,382,1
85493,1608473686,wahoo,Zwift - KISS 100 Race Series - Americas (A),Quarq AXS with Garmin Edge 530,Wahoo Kickr 2018 - Zwift,332,339,-7
87876,1609077335,wahoo,Zwift - KISS 100 Race Series - Americas (A),Quarq AXS with Garmin Edge 530,Wahoo Kickr 2018 - Zwift,381,382,-1
88700,1609264705,wahoo,Zwift - Team Italy & Frenchy Fuzion League (A),Quarq AXS with Garmin Edge 530,Wahoo Kickr 2018 - Zwift,408,408,0
94484,1610287841,wahoo,Zwift - KISS 100 Race Series - Americas (A),Quarq AXS with Garmin Edge 530,Wahoo Kickr 2018 - Zwift,393,387,6
97909,1610789331,wahoo,Zwift - DBR SufferDay League III (A),Quarq AXS with Garmin Edge 530,Wahoo Kickr 2018 - Zwift,421,419,2
101798,1611394155,wahoo,Zwift - DBR SufferDay League III (A),Quarq AXS with Garmin Edge 530,Wahoo Kickr 2018 - Zwift,379,378,1
102465,1611497645,wahoo,Zwift - KISS 100 Race Series - Americas (A),Quarq AXS with Garmin Edge 530,Wahoo Kickr 2018 - Zwift,365,366,-1
105484,1611996956,wahoo,Zwift - DBR SufferDay League III (A),Quarq AXS with Garmin Edge 530,Wahoo Kickr v5 - Zwift,367,371,-4
106306,1612081779,wahoo,Zwift - Flanders Endurance Race League (A),Quarq AXS with Garmin Edge 530,Wahoo Kickr 2018 - Zwift,376,378,-2
109816,1612603795,wahoo,Zwift - DBR SufferDay League III (A),Quarq AXS with Garmin Edge 530,Wahoo Kickr 2018 - Zwift,381,381,0
112618,1612978870,wahoo,Zwift - MIDWEEK Winter Series by SZR (A),Quarq AXS with Garmin Edge 530,Wahoo Kickr 2018 - Zwift,352,361,-9
114023,1613208540,wahoo,Zwift - DBR SufferDay League III (A),Quarq AXS with Garmin Edge 530,Wahoo Kickr 2018 - Zwift,379,382,-3
118205,1613810874,wahoo,Zwift - DBR SufferDay League III (A),Quarq AXS with Garmin Edge 530,Wahoo Kickr 2018 - Zwift,383,386,-3
121557,1614415494,wahoo,3R Endurance Series p/b OTE Sports,Quarq AXS with Garmin Edge 530,Wahoo Kickr 2018 - Zwift,340,341,-1
122032,1614501932,wahoo,Fantasy Nutrinovex Rice by PETA-Z,Quarq AXS with Garmin Edge 530,Wahoo Kickr 2018 - Zwift,381,386,-5
123567,1614792320,wahoo,Zwift - Guayaba Race by PETA-Z (A),Quarq AXS with Garmin Edge 530,Wahoo Kickr 2018 - Zwift,363,367,-4
124879,1615016734,wahoo,Zwift - Matando o Corpo® by PETA-Z (E),Quarq AXS with Garmin Edge 530,Wahoo Kickr 2018 - Zwift,375,380,-5
129179,1615917688,wahoo,Zwift - CeramicSpeed Race Series: Open Race (A),Quarq AXS with Garmin Edge 530,Wahoo Kickr 2018 - Zwift,400,401,-1
60524,1602177591,wahoo,Zwift - VCRT TTT-  WTRL Team Time Trial - Zone 5 (C),PowerTap ,Wahoo Kickr Core,306,322,-16
63368,1603128599,wahoo,Zwift - Spencer Tapia 🔰 [VCRT]&#039;s Meetup - R.G.V.,PowerTap ,Wahoo Kickr Core,253,273,-20
75098,1606237199,wahoo,Zwift - BST Happy Mountaingoats&#039; Hill Climb TT (A),PowerTap ,Wahoo Kickr Core,395,387,8
58139,1601340294,wahoo,Zwift - TFC Mad Monday Autumn Series (A),Favero Assioma DUO,Wahoo kickr v5,324,308,16
58146,1601348776,wahoo,Zwift - Watopia,Favero Assioma DUO,Wahoo kickr v5,304,302,2
58370,1601423996,wahoo,Zwift - KISS at Race - Americas PM (A),Favero Assioma DUO,Wahoo kickr v5,341,331,10
58937,1601595422,wahoo,Zwift - Espresso,Favero Assioma DUO,Wahoo kickr v5,327,315,12
60483,1602200477,wahoo,Zwift - WTRL Team Time Trial - Zone 7 (C),Favero Assioma DUO,Wahoo kickr v5,324,318,6
61700,1602640796,wahoo,Zwift - Zwift Racing League | WTRL,Favero Assioma DUO,Wahoo kickr v5,350,345,5
63636,1603246200,wahoo,Zwift - 3R Tempus Fugit Flat Race - 2 Laps (37.1km/23.1mi 40m) (A),Favero Assioma DUO,Wahoo kickr v5,303,293,10
65626,1603850392,wahoo,Zwift - Zwift Racing League | WTRL - AMERICAS W (MEN) -  Division 1 (A),Favero Assioma DUO,Wahoo kickr v5,335,329,6
67774,1604459568,wahoo,Zwift - Zwift Racing League | WTRL - Men&#039;s AMERICAS W DIVISION 1 (A),Favero Assioma DUO,Wahoo kickr v5,333,320,13
69175,1604861992,wahoo,Zwift - Zwift Fondo Series 2020/21: Gran Fondo ,Favero Assioma DUO,Wahoo kickr v5,325,319,6
70022,1605063591,wahoo,Zwift - Zwift Racing League | WTRL - AMERICAS W (MEN) -  Division 1 (A),Favero Assioma DUO,Wahoo kickr v5,380,367,13
71522,1605410893,wahoo,Zwift - Watopia,Favero Assioma DUO,Wahoo kickr v5,284,284,0
73329,1605842090,wahoo,Zwift - Garmin Never Stop Cycling // Stage 4 MTB - Open Category 20 min max power test,Favero Assioma DUO,Wahoo kickr v5,336,340,-4
73711,1605927105,wahoo,Zwift - New Workout,Favero Assioma DUO,Wahoo kickr v5,350,336,14
74016,1605985205,wahoo,Zwift - New Workout,5854950966_ACTIVITY,Wahoo kickr v5,383,368,15
79189,1607039083,wahoo,Zwift - Crit City Race (A),Favero Assioma DUO,Wahoo kickr v5,347,348,-1
82123,1607731498,wahoo,Zwift - 3R & ZID Merdeka La Reine Hilly Race - Round 3 of 4 (A),Favero Assioma DUO,Wahoo kickr v5,376,374,2
83770,1608080026,wahoo,Zwift - Zwift Racing League | WTRL - Men&#039;s AMERICAS E DIVISION 1 (A),Favero Assioma DUO,Wahoo kickr v5,326,329,-3
84896,1608339598,wahoo,Zwift - Tour of New York Stage 1 - Open Longer,Favero Assioma DUO,Wahoo kickr v5,342,340,2
88378,1609190993,wahoo,Zwift - Crit City Race (A),Favero Assioma DUO,Wahoo kickr v5,326,328,-2
88379,1609194598,wahoo,Zwift - 3R LaGuardia Loop Reverse Flat Race - 6 Laps (19.1km/11.9 162m) (A),Favero Assioma DUO,Wahoo kickr v5,300,303,-3
91023,1609715100,wahoo,Zwift - 3R Achterbahn Climbing Race (47.4km/29.5mi 988m) (A),Favero Assioma DUO,Wahoo kickr v5,342,344,-2
95974,1610498757,wahoo,Zwift - Zwift Racing League | WTRL - Men&#039;s/Mixed AMERICAS E DIVISION 1 (A),Favero Assioma DUO,Wahoo kickr v5,340,333,7
100010,1611103559,wahoo,Zwift - Zwift Racing League | WTRL - Men&#039;s/Mixed AMERICAS E DIVISION 1 (A),Favero Assioma DUO,Wahoo kickr v5,334,337,-3
103821,1611708362,wahoo,Zwift - Zwift Racing League | WTRL - Men&#039;s/Mixed AMERICAS E DIVISION 1 (A),Favero Assioma DUO,Wahoo kickr v5,351,350,1
107765,1612313158,wahoo,Zwift - Zwift Racing League | WTRL - Men&#039;s/Mixed AMERICAS E DIVISION 1 (A),Favero Assioma DUO,Wahoo kickr v5,353,356,-3
108493,1612396798,wahoo,Zwift - Open - Movistar Team Challenge Community Qualifier Race #2,Favero Assioma DUO,Wahoo kickr v5,358,358,0
111898,1612917959,wahoo,Zwift - Zwift Racing League | WTRL - Men&#039;s/Mixed AMERICAS E DIVISION 1 (A),Favero Assioma DUO,Wahoo kickr v5,344,347,-3
114872,1613331722,wahoo,Zwift - Chasing Cancellara Time Trial (A),Favero Assioma DUO,Wahoo kickr v5,347,354,-7
116194,1613522760,wahoo,Zwift - Zwift Racing League | WTRL - Men&#039;s/Mixed AMERICAS E DIVISION 1 (A),Favero Assioma DUO,Wahoo kickr v5,363,369,-6
119925,1614127560,wahoo,Zwift - Zwift Racing League | WTRL - Men&#039;s/Mixed AMERICAS E DIVISION 1 (A),Favero Assioma DUO,Wahoo kickr v5,320,320,0
121709,1614445198,wahoo,Zwift -  ZTPL.CC Winter League 2021 Stage 12 (A),Favero Assioma DUO,Wahoo kickr v5,340,341,-1
123280,1614732358,wahoo,Zwift - Zwift Racing League | WTRL - Men&#039;s/Mixed AMERICAS E DIVISION 1 (A),Favero Assioma DUO,Wahoo kickr v5,325,329,-4
124274,1614901499,wahoo,Zwift - Crit City Race (A),Favero Assioma DUO,Wahoo kickr v5,317,323,-6
125476,1615136395,wahoo,Zwift - MISTRZOSTWA ZTPL.CC (E)- ,Favero Assioma DUO,Wahoo kickr v5,350,347,3
113340,1613118604,wahoo,Zwift - Flanders Endurance Series (E),Rotor Impower,Wahoo Kickr Core,313,312,1
124163,1614794415,wahoo,Zwift - Guayaba Race by PETA-Z (B),Potenciar rotor,Wahoo Kickr Core,314,313,1
125067,1615046763,wahoo,Impower / Wahoo Kickr Core,Impower,Wahoo Kickr Core,319,318,1
25979,1585310999,wahoo,Zwift - Stage 5 Race (A) - Tour of Watopia 2020,Garmin Vector 3,Wahoo Kickr 2017,353,361,-8
26327,1585396818,wahoo,Zwift - Stage 5 - Longer Ride - Tour of Watopia 2020,Garmin Vector 3,Wahoo Kickr 2017,356,370,-14
26328,1585190517,wahoo,Zwift - ZHR Hare & Hounds Race (A),Garmin Vector 3,Wahoo Kickr 2017,351,360,-9
48293,1596110696,wahoo,Zwift - 3R Volcano Circuit Flat Race - 8 Laps (35.2km/21.9mi 160m) (A),Garmin Vector 3,Wahoo Kickr 2017,342,356,-14
51254,1598105686,wahoo,Zwift - OH MY CRIT - Saturday Smash Race* (A),Garmin Vector 3,Wahoo Kickr 2017,350,367,-17
55061,1600106202,wahoo,Zwift - Invitational League // Qualifying Race #1,Garmin Vector 3,Wahoo Kickr 2017,377,381,-4
61063,1602425410,wahoo,Zwift - ZA Road Race #1: 4 - 5 w/kg,Garmin Vector 3,Wahoo Kickr 2017,369,384,-15
61256,1602528596,wahoo,Zwift - Premier Division // Zwift Racing League (men) ,Garmin Vector 3,Wahoo Kickr 2017,0,0,0
61257,1602528596,wahoo,Zwift - Premier Division // Zwift Racing League (men) ,Garmin Vector 3,Wahoo Kickr 2017,391,401,-10
67090,1604262721,wahoo,Zwift,Garmin Vector 3,Wahoo Kickr 2017,372,374,-2
67538,1604409196,wahoo,3R Figure 8 Hilly Race,Garmin Vector 3,Wahoo Kickr 2017,380,384,-4
72944,1605791148,neo,Garmin Never Stop Cycling // Stage 4 - MTB,4iiii Precision Dual,Tacx Neo 2T,386,380,6
73466,1605877010,neo,Zwift - Race 1 // Men // Z Pro Tri // Community,4iiii Precision Dual,Tacx Neo 2T,360,354,6
74062,1605977974,neo,Zwift - Cycling Canada Pre-Worlds Showdown Series,4iiii Precision Dual,Tacx Neo 2T,384,380,4
75706,1606347901,neo,Zwift - Crit City Race (A),4iiii Precision Dual,Tacx Neo 2T,386,391,-5
78905,1607012005,neo,Zwift - OH MY CRIT! - The Double Race 1/2 (A),4iiii Precision Dual,Tacx Neo 2T,377,378,-1
78922,1607015021,neo,Zwift - OH MY CRIT! - The Double Race 2/2 (A),4iiii Precision Dual,Tacx Neo 2T,380,374,6
79805,1607181150,neo,Zwift - OH MY CRIT - Saturday Smash Race (A),4iiii Precision Dual,Tacx Neo 2T,386,382,4
85255,1608411409,neo,Zwift - Tour of New York Stage 2 - Open Longer,4iiii Precision Dual,Tacx Neo 2T,391,388,3
85596,1608497990,neo,Zwift - Tour of New York Stage 3 - Open Longer,4iiii Precision Dual,Tacx Neo 2T,347,343,4
87256,1608919010,neo,Zwift - KIRCHMAIR Race Series (A),4iiii Precision Dual,Tacx Neo 2T,366,358,8
87257,1608919010,neo,Zwift - KIRCHMAIR Race Series (A),4iiii Precision Dual,Tacx Neo 2T,345,336,9
87471,1608995612,neo,Zwift - OH MY CRIT - Saturday Smash Race (A),4iiii Precision Dual,Tacx Neo 2T,399,394,5
88385,1609201478,neo,Zwift - Toronto Hustle Holiday Classic Stage Race: Stage Two,4iiii Precision Dual,Tacx Neo 2T,361,352,9
89900,1609523870,neo,Zwift - KIRCHMAIR Race Series (A),4iiii Precision Dual,Tacx Neo 2T,366,361,5
89901,1609525808,neo,Zwift - KIRCHMAIR Race Series (A),4iiii Precision Dual,Tacx Neo 2T,364,357,7
90463,1609620672,neo,Zwift - Zwift Fondo Series 2020/21 (A),4iiii Precision Dual,Tacx Neo 2T,373,366,7
92683,1610024390,neo,Zwift - TDZ Stage 1: Longer Ride,4iiii Precision Dual,Tacx Neo 2T,363,358,5
93623,1610164471,neo,TDZ Stage 1: Group Ride,4iiii Precision Dual,Tacx Neo 2T,343,337,6
96239,1610542700,neo,Zwift - TDZ Stage 2: Longer Ride,4iiii Precision Dual,Tacx Neo 2T,373,371,2
98039,1610809911,neo,Zwift - OH MY CRIT - Saturday Smash Race (A),4iiii Precision Dual,Tacx Neo 2T,357,344,13
101951,1611419378,neo,Zwift - TEAM VEGAN Tofu Tornado (A),4iiii Precision Dual,Tacx Neo 2T,424,420,4
103993,1611752397,neo,Zwift - TDZ Stage 5: Longer Ride,4iiii Precision Dual,Tacx Neo 2T,385,383,2
103994,1611752397,neo,Zwift - TDZ Stage 5: Longer Ride,4iiii Precision Dual,Tacx Neo 2T,0,0,0
105662,1612019585,neo,Zwift - OH MY CRIT!! - Saturday Smash Race (A),4iiii Precision Dual,Tacx Neo 2T,387,377,10
108321,1612378388,neo,Zwift - Open - Movistar Team Challenge Community Qualifier Race #1,4iiii Precision Dual,Tacx Neo 2T,368,361,7
109531,1612558072,wahoo,Zwift - TDZ Stage 7: Longer Ride,4iiii Precision Dual,Wahoo Kickr V5,351,369,-18
109955,1612624170,wahoo,Zwift - OH MY CRIT!! - Saturday Smash Race (A),4iiii Precision Dual,Wahoo Kickr V5,413,424,-11
112500,1612988610,wahoo,Zwift - Tri Aus TT (E),Garmin Vector 3,Wahoo Kickr V5,383,377,6
112852,1613060055,wahoo,Zwift - OH MY CRIT!! - The Double Race 1/2 (A),Garmin Vector 3,Wahoo Kickr V5,368,363,5
112855,1613060055,wahoo,Zwift - OH MY CRIT!! - The Double Race 2/2 (A),Garmin Vector 3,Wahoo Kickr V5,370,369,1
113543,1613152308,wahoo,Zwift - KIRCHMAIR Race Series (A),Garmin Vector 3,Wahoo Kickr V5,391,383,8
113544,1613152308,wahoo,Zwift - KIRCHMAIR Race Series (A),Garmin Vector 3,Wahoo Kickr V5,400,392,8
121286,1614344259,wahoo,Zwift - Haute Route Watopia 2021 Stage 1 (A),4iiii Precision Dual,Wahoo Kickr V5,359,369,-10
123985,1614873657,wahoo,Zwift - OH MY CRIT!! - The Double Race 2/2 (A),4iiii Precision Dual,Wahoo Kickr V5,394,403,-9
128000,1615648320,wahoo,Zwift - OH MY CRIT!! - Saturday Smash Race (A),4iiii Precision Dual,Wahoo Kickr V5,377,388,-11
109397,1612376349,wahoo,Zwift - Danmarks Cykle Union & Partners 4/6 (A),Power2Max,Wahoo Kickr v5,418,419,-1
110464,1612601766,wahoo,Zwift - DBR SufferDay League III (A),Power2Max,Wahoo Kickr v5,417,421,-4
112443,1612979750,wahoo,Zwift - Danmarks Cykle Union & Partners 5/6 (A),Power2Max,Wahoo Kickr v5,440,445,-5
114056,1613207952,wahoo,Zwift - DBR SufferDay League III (A),Power2Max,Wahoo Kickr v5,432,430,2
117014,1613553292,wahoo,Zwift - Danmarks Cykle Union & Partners 6/6 (A),Power2Max,Wahoo Kickr v5,408,395,13
120698,1614191526,wahoo,Zwift - Scandinavian Cup 2021 - Round 1 - Men (A),Power2Max,Wahoo Kickr v5,425,414,11
123703,1614795506,wahoo,Zwift - Scandinavian Cup 2021 - Round 2 - Men (A),Gaint Wattmåler,Wahoo Kickr v5,449,434,15
126829,1615400872,wahoo,Zwift - Scandinavian Cup 2021 - Round 3 - Men (A),Gaint Wattmåler,Wahoo Kickr v5,448,423,25
68964,1604825918,neo,Zwift - Zwift Fondo Series 2020/21: Medio Fondo,Rotor inpower,Tacx neo 2T,253,227,26
69242,1604909698,neo,Zwift - Garmin Never Stop Cycling // Stage 1 Road - Open Category,Rotor inpower,Tacx neo 2T,358,348,10
69780,1605032155,neo,Zwift - Zwift Racing League | WTRL - EMEA E1 (MEN) -  Division 2 (A),Rotor inpower,Tacx neo 2T,409,400,9
70725,1605207603,neo, Flanders The BZR Ronde ,Rotor inpower,Tacx neo 2T,414,404,10
71595,1605439798,neo,Zwift - Stages of DIRT (A),Rotor inpower,Tacx neo 2T (zwift),403,395,8
71598,1605438299,neo,Zwift - 3R Innsbruckring Sprint Race - 1 Lap (8.8km/5.5mi 77m) (A),Rotor inpower,Tacx neo 2T (zwift),363,348,15
72226,1605637504,neo,Zwift - Zwift Racing League | WTRL - Men&#039;s EMEA E1 DIVISION 2 (A),Rotor inpower,Tacx neo 2T (zwift),376,363,13
73344,1605813601,neo,Zwift - BRT Criterium Racing League (A),Rotor inpower,Tacx neo 2T (zwift),400,383,17
73571,1605897002,neo,Zwift - Team WEZ Friday Race,Rotor inpower,Tacx neo 2T,431,421,10
75064,1606241697,neo,Zwift - Zwift Racing League | WTRL - Men&#039;s EMEA E1 DIVISION 1,Rotor inpower,Tacx neo 2T (zwift),412,397,15
76107,1606417198,neo,Zwift -  Flanders The BZR Ronde  (A),Rotor inpower,Tacx neo 2T (zwift),383,376,7
76573,1606501797,neo,Zwift - Team WEZ Friday Race (E),Rotor inpower,Tacx neo 2T (zwift),388,381,7
79085,1607021998,neo,Zwift -  Flanders The BZR Ronde  (A),Rotor inpower,Tacx neo 2T (zwift),402,379,23
79488,1607108399,neo,Zwift - Team IRL Without Borders Race (A),Rotor inpower,Tacx neo 2T (zwift),405,388,17
80210,1607273999,neo,Zwift - Nations Challenge // Belgium (E),Rotor inpower,Tacx neo 2T (zwift),370,354,16
80681,1607425196,neo,Zwift - KISS Race Series - Americas AM (A),Rotor inpower,Tacx neo 2T (zwift),417,406,11
81406,1607596495,neo,Zwift - Japan ZWIFT Hill Climb Race (A),Rotor inpower,Tacx neo 2T (zwift),376,369,7
82792,1607850085,neo,Zwift - Zwift Fondo Series 2020/21 (B),Rotor inpower,Tacx neo 2T (zwift),402,388,14
83527,1608056702,neo,Zwift - Zwift Racing League | WTRL - Men&#039;s EMEA E1 DIVISION 2 (A),Rotor inpower,Tacx neo 2T (zwift),370,372,-2
84434,1608231595,neo,Zwift - BENELIGA 2020-2021 (E),Rotor inpower,Tacx neo 2T (zwift),407,406,1
86558,1608746396,neo,Zwift - MIDWEEK Winter Series by SZR (A),Rotor inpower,Tacx neo 2T (zwift),391,367,24
87118,1608883497,neo,Zwift - 3R Lagurdia Super Sprint Race - 1 Lap (3.7km/2.6mi 27m) (A),Rotor inpower,Tacx neo 2T (zwift),415,406,9
87737,1609057826,neo,Zwift - Flanders Endurance Series (E),Rotor inpower,Tacx neo 2T (zwift),368,364,4
88446,1609231500,neo,Zwift - WTRL Racing (A),Rotor inpower,Tacx neo 2T (zwift),359,351,8
88463,1609235578,neo,Zwift - Peel Cycling - Morning Chase (A),Rotor inpower,Tacx neo 2T (zwift),363,356,7
89891,1609523996,neo,Zwift - KIRCHMAIR Race Series (A),Rotor inpower,Tacx neo 2T (zwift),357,353,4
89893,1609525796,neo,Zwift - KIRCHMAIR Race Series (A),Rotor inpower,Tacx neo 2T (zwift),347,343,4
90110,1609579797,neo,Zwift - DBR SufferDay League III (A),Rotor inpower,Tacx neo 2T (zwift),419,407,12
91122,1609749000,neo,Zwift - Flanders Endurance Series (E),Rotor inpower,Tacx neo 2T (zwift),315,306,9
92598,1610008196,neo,Zwift - KISS Race Series - Down Under (A),Rotor inpower,Tacx neo 2T (zwift),399,394,5
93703,1610186395,neo,Zwift - Cycling Ireland Zwift League Rd 7 (A),Rotor inpower,Tacx neo 2T (zwift),358,353,5
95597,1610475295,neo,Zwift - Zwift Racing League | WTRL - Men&#039;s/Mixed EMEA E1 DIVISION 1 (A),Rotor inpower,Tacx neo 2T (zwift),392,381,11
97045,1610650796,neo,BENELIGA 2020-2021,Rotor inpower,Tacx neo 2T (zwift),387,392,-5
98424,1610872197,neo,Zwift - Flanders Endurance Race League,Rotor inpower,Tacx neo 2T (zwift),398,389,9
100661,1611223456,neo,Zwift - 3R Whole Lotta Lava Hilly Race - 1 Lap (16.9km/10.5mi 183m) (A),Rotor inpower,Tacx neo 2T (zwift),388,383,5
100687,1611226916,neo,Zwift - TDZ Stage 4: Standard Ride,Rotor inpower,Tacx neo 2T (zwift),399,392,7
103447,1611684896,neo,Zwift - Zwift Racing League | WTRL - Men&#039;s/Mixed EMEA E1 DIVISION 1 (A),Rotor inpower,Tacx neo 2T (zwift),394,386,8
104941,1611860394,neo,Zwift - BENELIGA 2020-2021 (E),Rotor inpower,Tacx neo 2T (zwift),379,378,1
106582,1612167924,neo,Zwift - Flanders Endurance Series (E),Rotor inpower,Tacx neo 2T (zwift),394,383,11
110287,1612686595,neo,Zwift - Flanders Endurance Race League (A),Rotor inpower,Tacx neo 2T (zwift),414,406,8
112238,1612979995,neo,Zwift - MIDWEEK Winter Series by SZR (A),6251564665_ACTIVITY,Tacx neo 2T (zwift),389,376,13
113051,1613069995,neo,Zwift - BENELIGA 2020-2021 (E),Rotor inpower,Tacx neo 2T (zwift),410,404,6
117572,1613674793,neo,Zwift - BENELIGA 2020-2021 (E),Rotor inpower,Tacx neo 2T (zwift),387,377,10
118290,1613837086,neo,Zwift - Deeside Snowman Sprint Series (A),Rotor inpower,Tacx neo 2T (zwift),368,374,-6
123390,1614755095,neo,Zwift - Aussie Crit Crushers Race 1 of 2 (A),Rotor inpower,Tacx neo 2T (zwift),360,353,7
123391,1614756597,neo,Zwift - Aussie Crit Crushers Race 2 of 2 (A),Rotor inpower,Tacx neo 2T (zwift),339,336,3
125796,1615226939,neo,Zwift - Forte Race Series (A),Rotor inpower,Tacx neo 2T (zwift),347,343,4
126084,1615298720,neo,Zwift - 3R LaGuardia Super Sprint Race - 1 Lap (3.7km/2.6mi 27m) (A),Rotor inpower,Tacx neo 2T (zwift),390,382,8
127132,1615489195,neo,Zwift - Flanders The BZR Ronde Spring Classics League (A),Rotor inpower,Tacx neo 2T (zwift),404,393,11
127442,1615557895,neo,Zwift - 3R Innsbruckring Flat Race - 2 Laps (17.6km/10.9m 154m) (A),Rotor inpower,Tacx neo 2T (zwift),358,346,12
127735,1615625996,neo,Zwift -  Flanders Toeristenkoers (A),Rotor inpower,Tacx neo 2T (zwift),411,402,9
128964,1615885583,neo,Zwift - 3R Whole Lotta Lava Hilly Race - 2 Laps (28.9km/12.53mi 336m) (A),Rotor inpower,Tacx neo 2T (zwift),393,383,10
1139,1567403501,wahoo,Zwift - Team Dimension Data Zwift Academy Race: Climb (A),Rotor 2Inpower,Wahoo KICKR,0,0,0
2453,1569333538,wahoo,Zwift - Yorkshire World Championships Week - ITT #2 (A),Rotor 2Inpower,Wahoo KICKR,0,0,0
2619,1569506419,wahoo,Zwift - Yorkshire World Championships Week - Road Event #1 (A),Rotor 2Inpower,Wahoo KICKR,0,0,0
2781,1569678346,wahoo,FUSION Development: Zwift - The P Race (A) #11,Rotor 2Inpower,Wahoo KICKR,0,0,0
3063,1570031556,wahoo,Zwift - 3R Tick Tock Flat Race - 2 Lap (36km/22.4mi 100m) (A),Rotor 2Inpower,Wahoo KICKR,0,0,0
3282,1572076314,wahoo,Zwift - 3R Watopia Hilly  Race - 4 Laps (A),Rotor 2Inpower,Wahoo KICKR,0,0,0
3284,1571563801,wahoo,Zwift - 9 Stages of DIRT,Rotor 2Inpower,Wahoo KICKR,0,0,0
3285,1571334013,wahoo,Zwift - FUSION ECT BEUNSTOPPABLE Racing Series (A),Rotor 2Inpower,Wahoo KICKR,0,0,0
3286,1571490713,wahoo,Zwift - Team Italy Gladiators Race (A),Rotor 2Inpower,Wahoo KICKR,0,0,0
3288,1571490713,wahoo,Zwift - 3R Innsbruckring Flat Race - 5 Laps (44km/27.3mi 385m) (A),Rotor 2Inpower,Wahoo KICKR,0,0,0
3289,1571210211,wahoo,Zwift - dPAC.fit Climbers Day (A),Rotor 2Inpower,Wahoo KICKR,0,0,0
6177,1576249203,wahoo,Zwift - 3R Sand and Sequoias Race (A),Rotor 2Inpower,Wahoo KICKR,0,0,0
6496,1576605400,wahoo,Zwift - Danmarks Cykle Union Racing League (A),Rotor 2Inpower,Wahoo KICKR,343,345,-2
8638,1578590320,wahoo,Zwift - Danmarks Cykle Union 2020 Cup (A),Rotor 2Inpower,Wahoo KICKR,298,305,-7
9873,1579337248,wahoo,Zwift - Danmarks Cykle Union 2020 Cup (A),Rotor 2Inpower,Wahoo KICKR,327,327,0
11003,1578753874,wahoo,Zwift - Danmarks Cykle Union 2020 Cup (A),Rotor 2Inpower,Wahoo KICKR,377,380,-3
11337,1580234399,wahoo,Zwift - Danmarks Cykle Union 2020 Cup (A),Rotor 2Inpower,Wahoo KICKR,359,367,-8
11960,1580546789,wahoo,Zwift - Danmarks Cykle Union 2020 Cup (A),Rotor 2Inpower,Wahoo KICKR,390,384,6
12285,1580749246,wahoo,Zwift - Danmarks Cykle Union 2020 Cup (A),Rotor 2Inpower,Wahoo KICKR,370,360,10
12771,1581008929,wahoo,Zwift - Danmarks Cykle Union 2020 Cup (A),Rotor 2Inpower,Wahoo KICKR,356,357,-1
13096,1581238048,wahoo,Zwift - Danmarks Cykle Union 2020 Cup (A),Rotor 2Inpower,Wahoo KICKR,348,356,-8
13099,1581238048,wahoo,Zwift - Tour de Zwift: Stage 7 - Long Distance,Rotor 2Inpower,Wahoo KICKR,327,337,-10
13552,1581433724,wahoo,Zwift - Tour de Zwift: Stage 3 Group Ride - Long Distance,Rotor 2Inpower,Wahoo KICKR,334,342,-8
13553,1581519544,wahoo,Zwift - Tour de Zwift: Stage 5 Long Distance,Rotor 2Inpower,Wahoo KICKR,348,350,-2
13937,1581690816,wahoo,Zwift - Tour de Zwift: Stage 1 Long Distance,Rotor 2Inpower,Wahoo KICKR,364,362,2
14338,1581861472,wahoo,Zwift - KISS at Race 100 - Americas (A),Rotor 2Inpower,Wahoo KICKR,347,355,-8
14633,1582050888,wahoo,Zwift - Feltet.dk Race Series,Rotor 2Inpower,Wahoo KICKR,344,351,-7
15026,1582270382,wahoo,Zwift - Tour of Innsbruck // Stage 1,Rotor 2Inpower,Wahoo KICKR,340,348,-8
15156,1582362053,wahoo,Zwift - Tour of Innsbruck // Stage 2 ,Rotor 2Inpower,Wahoo KICKR,355,362,-7
15252,1582445755,wahoo,Zwift - Tour of Innsbruck // Stage 3,Rotor 2Inpower,Wahoo KICKR,359,362,-3
16001,1582893004,wahoo,Zwift - Zwift Fast Fridays: Tempus Fugit Time Trial (E),Rotor 2Inpower,Wahoo KICKR,355,363,-8
16288,1583070387,wahoo,Zwift - Zwift Medio Fondo,Rotor 2Inpower,Wahoo KICKR,356,362,-6
17495,1583852362,wahoo,Zwift - Stage 1 - Longer Ride - Tour of Watopia 2020,Rotor 2Inpower,Wahoo KICKR,311,318,-7
31718,1588700109,wahoo,Zwift -  RCC Zwift Mens Championships - EMEA Region (E),Rotor 2Inpower,Wahoo KICKR,356,363,-7
32515,1588872803,wahoo,Zwift -  RCC Zwift Mens Championships - Semi Final 1 (EMEA) (E),Rotor 2Inpower,Wahoo KICKR,362,368,-6
32932,1589013564,wahoo,Zwift -  EUROSPORT Polska ,Rotor 2Inpower,Wahoo KICKR,353,359,-6
33318,1589111627,wahoo,Zwift -  RCC Zwift Championships - Men&#039;s Final,Rotor 2Inpower,Wahoo KICKR,370,381,-11
33949,1589295733,wahoo,Zwift - 3R & Wahoo Ride Real Race Series - Round 1 of 7 (A),Rotor 2Inpower,Wahoo KICKR,338,349,-11
35027,1589473206,wahoo,Zwift - Tour for All 2020: Stage 3 Longer Race A/B,Rotor2Inpower,Wahoo KICKR,360,365,-5
35028,1589473206,wahoo,Zwift - FUSION ECT BEUNSTOPPABLE Racing Series (A),Rotor 2Inpower,Wahoo KICKR,373,382,-9
35273,1589618300,wahoo,Zwift - EUROSPORT Polska ,Rotor 2Inpower to Zwift,Wahoo KICKR to Garmin Edge 1050,350,358,-8
36054,1589899451,wahoo,Zwift - 3R & Wahoo Ride Real Race Series - Round 2 of 7 (A),Rotor 2Inpower to Zwift,Wahoo KICKR to Garmin Edge 1050,351,361,-10
37066,1590223272,wahoo,Zwift - EUROSPORT Polska ,Rotor 2Inpower to Zwift,Wahoo KICKR to Garmin Edge 1030,349,356,-7
37402,1590324757,wahoo,Zwift - Tour for All 2020: Stage 2 Longer Race A/B,Rotor 2Inpower to Zwift,Wahoo KICKR to Garmin Edge 1030,374,374,0
37404,1590324757,wahoo,Zwift - Tour for All 2020: Stage 4 Longer Race A/B,Rotor 2Inpower to Zwift,Wahoo KICKR to Garmin Edge 1030,335,339,-4
37825,1590503778,wahoo,Zwift - 3R & Wahoo Ride Real Race Series - Round 3 of 7 (A),Rotor 2Inpower to Zwift,Wahoo KICKR to Garmin Edge 1030,360,356,4
37827,1590503778,wahoo,Zwift - Team 3R&#039;s Choice: Stage 5 Longer Race A/B,Rotor 2Inpower to Zwift,Wahoo KICKR to Garmin Edge 1030,370,367,3
38682,1590827631,wahoo,Zwift - EUROSPORT Polska ,Rotor 2Inpower to Zwift,Wahoo KICKR to Garmin Edge 1030,383,379,4
39087,1591108939,wahoo,Zwift - 3R & Wahoo Ride Real Race Series - Round 4 of 7 (A),Rotor 2Inpower to Zwift,Wahoo KICKR to Garmin Edge 1030,354,351,3
39704,1591202496,wahoo,Zwift - 3R Classique Flat Race - 6 Laps (37.7km/23.4mi 114m) (A),Rotor 2Inpower to Zwift,Wahoo KICKR to Garmin Edge 1030,330,335,-5
39705,1591202496,wahoo,Zwift - British Triathlon Handicap Race (A),Rotor 2Inpower to Zwift,Wahoo KICKR to Garmin Edge 1030,344,338,6
39958,1591431462,wahoo,Zwift - DBR Sufferday League (A),Rotor 2Inpower to Zwift,Wahoo KICKR to Garmin Edge 1030,339,342,-3
41263,1591974249,wahoo,Zwift - 3R Sand and Sequoias Race (A),Rotor 2Inpower to Zwift,Wahoo KICKR to Garmin Edge 1030,335,336,-1
44225,1593526095,wahoo,Zwift - Sydkysten Cycling - Carl Ras Race (A),Rotor 2Inpower to Zwift,Wahoo KICKR to Garmin Edge 1030,347,347,0
44226,1593526095,wahoo,Zwift - 3R Volcano Circuit Flat Race - 8 Laps (35.2km/21.9mi 160m) (A),Rotor 2Inpower to Zwift,Wahoo KICKR to Garmin Edge 1030,305,312,-7
44853,1593845171,wahoo,Zwift - Zwift Fondo 2020 Series (Southern Hemisphere) (C),Rotor 2Inpower to Zwift,Wahoo KICKR to Garmin Edge 1030,359,358,1
44854,1593845171,wahoo,Zwift - L&#039;Etape du Tour Stage 1 - Open,Rotor 2Inpower to Zwift,Wahoo KICKR to Garmin Edge 1030,345,343,2
45889,1594449206,wahoo,Zwift - L&#039;Etape du Tour Stage 2 - Open,Rotor 2Inpower to Zwift,Wahoo KICKR to Garmin Edge 1030,369,366,3
50901,1597921512,wahoo,Zwift - EMU Japan Short Race (A),Rotor 2Inpower to Zwift,Wahoo KICKR to Garmin Edge 1030,371,369,2
54183,1599673069,wahoo,Zwift - DBR Wednesday Race (A),Rotor 2Inpower to Garmin Edge 1030,Wahoo KICKR to Zwift,318,337,-19
54691,1599898083,wahoo,Zwift - DBR SufferDay League II (A),Rotor 2Inpower to Garmin Edge 1030,Wahoo KICKR to Zwift,358,358,0
55089,1600106309,wahoo,Zwift - Invitational League // Qualifying Race #1,Rotor 2Inpower to Garmin Edge 1030,Wahoo KICKR to Zwift,343,346,-3
56232,1600503058,wahoo,Zwift - DBR SufferDay League II (A),Rotor 2Inpower to Garmin Edge 1030,Wahoo KICKR to Zwift,344,351,-7
56450,1600606714,wahoo,Zwift - Invitational League // Qualifying Race #3 (Men) (A),Rotor 2Inpower to Garmin Edge 1030,Wahoo KICKR to Zwift,354,359,-5
57060,1600883093,wahoo,Zwift - DCU powered by Feltet.dk (A),Rotor 2Inpower to Garmin Edge 1030,Wahoo KICKR to Zwift,344,352,-8
57646,1601108993,wahoo,Zwift - DBR SufferDay League II (A),Rotor 2Inpower to Garmin Edge 1030,Wahoo KICKR to Zwift,355,358,-3
59028,1601633097,wahoo,Zwift - 3R Innsbruckring Flat Race - 4 Laps (35.2km/21.9mi 308m) (A),Rotor 2Inpower to Garmin Edge 1030,Wahoo KICKR to Zwift,346,352,-6
59190,1601713794,wahoo,Zwift - DBR SufferDay League II (A),Rotor 2Inpower to Garmin Edge 1030,Wahoo KICKR to Zwift,360,355,5
60270,1602093896,wahoo,Zwift - DBR HEINO CUP III (A),Rotor 2Inpower to Garmin Edge 1030,Wahoo KICKR 5 to Zwift,366,372,-6
60726,1602318593,wahoo,Zwift - DBR SufferDay League II (A),Rotor2Inpower to Garmin Edge 1030,Wahoo KICKR 5 to Zwift,343,349,-6
61525,1602609293,wahoo,Zwift - Zwift Racing League | WTRL,Rotor 2Inpower to Garmin Edge 1030,Wahoo KICKR 5 to Zwift,372,378,-6
62617,1602923394,wahoo,Zwift - DBR SufferDay League II (A),Rotor 2Inpower to Garmin Edge 1030,Wahoo KICKR 5 to Zwift,343,346,-3
63695,1603214404,wahoo,Zwift - Zwift Racing League | WTRL - EMEA E (MEN) - TTT Grp 1,Rotor 2Inpower to Garmin Edge 1030,Wahoo KICKR 5 to Zwift,329,336,-7
64098,1603360794,wahoo,Zwift - KISS at Race - Americas AM (A),Rotor 2Inpower to Garmin Edge 1030,Wahoo KICKR 5 to Zwift,353,355,-2
64556,1603528194,wahoo,Zwift - DBR SufferDay League II (A),Rotor 2Inpower to Garmin Edge 1030,Wahoo KICKR 5 to Zwift,359,369,-10
64885,1603631695,wahoo,Zwift - KISS at Race 100 - Americas (A),Rotor 2Inpower to Garmin Edge 1030,Wahoo KICKR 5 to Zwift,303,304,-1
65458,1603822495,wahoo,Zwift - Zwift Racing League | WTRL - EMEA E (MEN) -  Division 1 (A),Rotor 2Inpower to Garmin Edge 1030,Wahoo KICKR 5 to Zwift,364,373,-9
66011,1603965593,wahoo,Zwift - KISS at Race - Americas AM (A),Rotor 2Inpower to Garmin Edge 1030,Wahoo KICKR 5 to Zwift,354,360,-6
66611,1604136592,wahoo,Zwift - DBR Saturday Race (A),Rotor 2Inpower to Garmin Edge 1030,Wahoo KICKR 5 to Zwift,348,357,-9
66867,1604210393,wahoo,Zwift - KISS at Race 100 - EU (A),Rotor 2Inpower to Garmin Edge 1030,Wahoo KICKR 5 to Zwift,349,351,-2
67969,1604516392,wahoo,DCU – Feltet.dk November series,Rotor 2Inpower to Garmin Edge 1030,Wahoo KICKR 5 to Zwift,375,386,-11
69766,1605032094,wahoo,Zwift - Zwift Racing League | WTRL - EMEA E1 (MEN) -  Division 1 (A),Rotor 2Inpower to Garmin Edge 1030,Wahoo KICKR 5 to Zwift,375,384,-9
70304,1605121193,wahoo,Zwift - DCU – Feltet.dk November series (A),Rotor 2Inpower to Garmin Edge 1030,Wahoo KICKR 5 to Zwift,349,354,-5
71272,1605346194,wahoo,Zwift - DBR Saturday Race (A),Rotor 2Inpower to Garmin Edge 1030,Wahoo KICKR 5 to Zwift,347,351,-4
72243,1605637344,wahoo,Zwift - Zwift Racing League | WTRL - Men&#039;s EMEA E1 DIVISION 1 (A),Rotor 2Inpower to Garmin Edge 1030,Wahoo KICKR 5 to Zwift,343,348,-5
72656,1605725992,wahoo,Zwift - DCU – Feltet.dk November series (A),Rotor 2Inpower to Garmin Edge 1030,Wahoo KICKR 5 to Zwift,318,321,-3
73171,1605814193,wahoo,Zwift - World Championships Experience // Danish Cycling Federation,Rotor 2Inpower to Garmin Edge 1030,Wahoo KICKR 5 to Zwift,324,332,-8
75069,1606241692,wahoo,Zwift - Zwift Racing League | WTRL - Men&#039;s EMEA E1 DIVISION 1,Rotor 2Inpower to Garmin Edge 1030,Wahoo KICKR 5 to Zwift,367,373,-6
75563,1606330792,wahoo,Zwift - 11/25/2020,Rotor 2Inpower to Garmin Edge 1030,Wahoo KICKR 5 to Zwift,336,341,-5
76354,1606417437,wahoo,Zwift - WTRL NOPINZ WORLD TTT CHAMPIONSHIPS - Zone 8 (C),Rotor 2Inpower to Garmin Edge 1030,Wahoo KICKR 5 to Zwift,337,337,0
78035,1606846943,wahoo,Zwift - Zwift Racing League | WTRL - Men&#039;s EMEA E1 DIVISION 1 (A),Rotor 2Inpower to Garmin Edge 1030,Wahoo KICKR 5 to Zwift,348,350,-2
80152,1605540128,wahoo,Zwift - OH MY CRIT - Saturday Smash Race (A),Rotor 2Inpower to Garmin Edge 1030,Wahoo KICKR 5 to Zwift,341,343,-2
80768,1607451294,wahoo,Zwift - 12/08/2020,Rotor 2Inpower to Garmin Edge 1030,Wahoo KICKR 5 to Zwift,340,344,-4
81541,1607597994,wahoo,Zwift - KISS Race Series - Americas AM (A),Rotor 2Inpower to Garmin Edge 1030,Wahoo KICKR 5 to Zwift,333,334,-1
82398,1607786094,wahoo,Zwift - 12/12/2020,Rotor 2Inpower to Garmin Edge 1030,Wahoo KICKR 5 to Zwift,383,385,-2
83547,1608056573,wahoo,Zwift - Zwift Racing League | WTRL - Men&#039;s EMEA E1 DIVISION 1 (A),Rotor 2Inpower to Garmin Edge 1030,Wahoo KICKR 5 to Zwift,342,346,-4
85466,1608473693,wahoo,Zwift - KISS 100 Race Series - Americas (A),Rotor 2Inpower to Garmin Edge 1030,Wahoo KICKR 5 to Zwift,309,310,-1
86050,1608634792,wahoo,Zwift - KISS Race Series - Americas AM (A),Rotor 2Inpower to Garmin Edge 1030,Wahoo KICKR 5 to Zwift,353,362,-9
86815,1608798591,wahoo,Zwift - 12/24/2020,Rotor 2Inpower to Garmin Edge 1030,Wahoo KICKR 5 to Zwift,358,363,-5
86828,1608638692,wahoo,Zwift - 3R Gotham Grind Flat Race - 2 Laps (18.5km/11.6mi 58m) (A),Rotor 2Inpower to Garmin Edge 1030,Wahoo KICKR 5 to Zwift,316,320,-4
87482,1608995691,wahoo,Zwift - 12/26/2020,Rotor 2Inpower to Garmin Edge 1030,Wahoo KICKR 5 to Zwift,345,350,-5
90099,1609578187,wahoo,Zwift - Newbury Velo Weekend TT,Rotor 2Inpower to Garmin Edge 1030,Wahoo KICKR 5 to Zwift,338,348,-10
90829,1609682391,wahoo,Zwift - Zwift Fondo Series 2020/21 (A),Rotor 2Inpower to Garmin Edge 1030,Wahoo KICKR 5 to Zwift,339,344,-5
93868,1610193590,wahoo,Zwift - WKG Winter League 2020 / 2021  (A),Rotor 2Inpower to Garmin Edge 1030,Wahoo KICKR 5 to Zwift,343,345,-2
95637,1610475289,wahoo,Zwift - Zwift Racing League | WTRL - Men&#039;s/Mixed EMEA E1 DIVISION 1 (A),Rotor 2Inpower to Garmin Edge 1030,Wahoo KICKR 5 to Zwift,343,344,-1
98114,1610803189,wahoo,Zwift - 3R Innsbruckring Flat Race - 5 Laps (44km/27.3mi 385m) (A),Rotor 2Inpower to Garmin Edge 1030,Wahoo KICKR 5 to Zwift,325,328,-3
103511,1611684887,wahoo,Zwift Racing League | WTRL EMEA E1 DIVISION,Rotor 2Inpower to Garmin Edge 1030,Wahoo KICKR 5 to Zwift,355,360,-5
107305,1612289687,wahoo,Zwift - Zwift Racing League | WTRL - Men&#039;s/Mixed EMEA E1 DIVISION 1 (A),Rotor 2Inpower to Garmin Edge 1030,Wahoo KICKR 5 to Zwift,371,372,-1
111519,1612895027,wahoo,Zwift - 02/09/2021,Rotor 2Inpower to Garmin Edge 1030,Wahoo KICKR 5 to Zwift,358,363,-5
115815,1613499285,wahoo,Zwift - Zwift Racing League | WTRL - Men&#039;s/Mixed EMEA E1 DIVISION 1 (A),Rotor 2Inpower to Garmin Edge 1030,Wahoo KICKR 5 to Zwift,393,398,-5
119631,1614104094,wahoo,Zwift - Zwift Racing League | WTRL - Men&#039;s/Mixed EMEA E1 DIVISION 1 (A),Rotor 2Inpower to Garmin Edge 1030,Wahoo KICKR 5 to Zwift,340,341,-1
124844,1615022994,wahoo,Zwift - 03/06/2021,Rotor 2Inpower to Garmin Edge 1030,Wahoo KICKR 5 to Zwift,320,323,-3
71197,1605296094,wahoo,Zwift Academy Road: Workout 6 | Alternative Sprints,Stage left crank,Wahoo Kickr Core,289,253,36
71470,1605373267,wahoo,Zwift - London,Stage left crank,Wahoo Kickr Core,336,350,-14
72437,1605668348,wahoo,Zwift - Zwift Racing League | WTRL - Men&#039;s AMERICAS W DIVISION 1 (A),Stage left crank,Wahoo Kickr Core,327,337,-10
73326,1605840489,wahoo,Zwift - Watopia,Stage left crank,Wahoo Kickr Core,327,329,-2
75304,1606273139,wahoo,Zwift - Zwift Racing League | WTRL - Men&#039;s AMERICAS W DIVISION 1,Stage left crank,Wahoo Kickr Core,366,376,-10
78324,1606878136,wahoo,Zwift - Zwift Racing League | WTRL - Men&#039;s AMERICAS W DIVISION 1 (A),Stage left crank,Wahoo Kickr Core,335,345,-10
81301,1607482822,wahoo,Zwift - Zwift Racing League | WTRL - Men&#039;s AMERICAS W DIVISION 1 (A),Stage left crank,Wahoo Kickr Core,355,355,0
81302,1607562292,wahoo,Zwift - Cycling Canada Wednesday Night Race Series (A),Stage left crank,Wahoo Kickr Core,348,346,2
93114,1610067570,wahoo,Zwift - KISS Race Series - Americas PM (A),Stage left crank,Wahoo Kickr Core,353,346,7
94083,1610218804,wahoo,Zwift - EVR Winter Series (A),Stage left crank,Wahoo Kickr Core,304,307,-3
94085,1610211480,wahoo,Zwift - TDZ Stage 2: Longer Ride,Stage left crank,Wahoo Kickr Core,358,352,6
94581,1610300992,wahoo,Zwift - Stages of DIRT (E),Stage left crank,Wahoo Kickr Core,334,330,4
96038,1610506282,wahoo,Zwift - Zwift Racing League | WTRL - Men&#039;s/Mixed AMERICAS W DIVISION 1 (A),Stage left crank,Wahoo Kickr Core,349,343,6
97248,1610672419,wahoo,Zwift - TDZ Stage 3: Longer Ride,Stage left crank,Wahoo Kickr Core,346,340,6
100021,1611112122,wahoo,Zwift - Zwift Racing League | WTRL - Men&#039;s/Mixed AMERICAS W DIVISION 1 (A),Stage left crank,Wahoo Kickr Core,332,334,-2
102572,1611516854,wahoo,Zwift - 3R LaGuardia Super Sprint Race - 1 Lap (3.7km/2.6mi 27m) (A),Stage left crank,Wahoo Kickr Core,368,368,0
102574,1611511140,wahoo,Zwift - TDZ Stage 5: Longer Ride,Stage left crank,Wahoo Kickr Core,373,369,4
103837,1611716266,wahoo,Zwift - Zwift Racing League | WTRL - Men&#039;s/Mixed AMERICAS W DIVISION 1 (A),Stage left crank,Wahoo Kickr Core,337,337,0
105795,1612029673,wahoo,Zwift - Championnat de France Frenchy Fuzion (E),Stage left crank,Wahoo Kickr Core,335,339,-4
106474,1612133915,wahoo,Zwift - TDZ Stage 6: Longer Ride,Stage left crank,Wahoo Kickr Core,360,360,0
107774,1612320995,wahoo,Zwift - Zwift Racing League | WTRL - Men&#039;s/Mixed AMERICAS W DIVISION 1 (A),Stage left crank,Wahoo Kickr Core,360,370,-10
111924,1612926034,wahoo,Zwift - Zwift Racing League | WTRL - Men&#039;s/Mixed AMERICAS W DIVISION 1 (A),Stage left crank,Wahoo Kickr Core,360,358,2
112527,1612994226,wahoo,Zwift - TDZ Stage 8: Group Ride,Stage left crank,Wahoo Kickr Core,329,325,4
112556,1613005309,wahoo,Zwift - Cycling Canada Wednesday Night Race Series (A),Stage left crank,Wahoo Kickr Core,369,368,1
112821,1613059880,wahoo,Zwift - OH MY CRIT!! - The Double Race 1/2 (A),Stage left crank,Wahoo Kickr Core,362,350,12
116537,1613530728,wahoo,Zwift - Zwift Racing League | WTRL - Men&#039;s/Mixed AMERICAS W DIVISION 1 (A),Stage left crank,Wahoo Kickr Core,371,368,3
119999,1614135373,wahoo,Zwift - Zwift Racing League | WTRL - Men&#039;s/Mixed AMERICAS W DIVISION 1 (A),Stage left crank,Wahoo Kickr Core,327,331,-4
123306,1614740027,wahoo,Zwift - Zwift Racing League | WTRL - Men&#039;s/Mixed AMERICAS W DIVISION 1 (A),Stage left crank,Wahoo Kickr Core,328,331,-3
14707,1582053464,neo,3R Volcano Flat Reverse Race - 3 Laps (36.6km/22.7mi 138m) (A),Power2Max NG Eco,Tacx NEO 2T,334,325,9
21592,1585846936,neo,Saris 2.0 Ride (D),Power2Max NG Eco,Tacx Neo 2T,211,202,9
22110,1586024834,neo,Zwift - Japan Endurance 100km Ride 3.0~3.4w/kg (B),Power2Max NG Eco,Tacx Neo 2T,427,413,14
22117,1586024834,neo,Watopia,Power2Max NG Eco,Tacx Neo 2T,239,233,6
22427,1586109652,neo,Zwift - AHDR Bacon Rolls (B),Power2Max NG Eco,Tacx Neo 2T,246,242,4
22430,1586109641,neo,Richmond,Power2Max NG Eco,Tacx Neo 2T,214,211,3
28075,1587838260,neo,Zwift - Japan Endurance [Race & Group Ride]100km-Richmond Fan Flat 20laps (B),Power2Max NG Eco,Tacx Neo 2T,352,342,10
28469,1588005499,neo,TFC Mad Monday World Series iTT (3 of 6) (A),Power2Max NG Eco,Tacx Neo 2T,395,390,5
31360,1588609894,neo,SAS - SUB 2.5 (C),Power2Max NG Eco,Tacx Neo 2T,216,208,8
36066,1589907591,neo,Zwift - Watopia,Power2Max NG Eco,Tacx Neo 2T,185,176,9
43478,1592854413,neo,Zwift - 06/22/2020,Power2Max NG Eco,Tacx Neo 2T,331,323,8
43479,1592854413,neo,Watopia,Power2Max NG Eco,Tacx Neo 2T,221,214,7
47893,1595871511,neo,TFC Mad Monday Summer Series (4 of 10) (A),Power2Max NG Eco,Tacx Neo 2T,371,358,13
48372,1596137650,neo,Koa Sports League Warrior Race (A),Power2Max NG Eco,Tacx Neo 2T,369,351,18
48457,1596225625,neo,Zwift Fondo 2020 Series (Southern Hemisphere) (C),Power2Max NG Eco,Tacx Neo 2T,383,366,17
52800,1598902890,neo,Crit City Race (A),Power2Max NG Eco,Tacx Neo 2T,393,387,6
52801,1598902890,neo,3R London Loop Hilly Race - 2 Laps (29km/18mi 440m) (A),Power2Max NG Eco,Tacx Neo 2T,423,414,9
52802,1598902890,neo,Crit City Race (A),Power2Max NG Eco,Tacx Neo 2T,387,376,11
52803,1598912161,neo,The HERD Mellow Monday (D),Power2Max NG Eco,Tacx Neo 2T,273,265,8
52964,1598986771,neo,JETT ZWIFT Morning Race (A),Power2Max NG Eco,Tacx Neo 2T,391,380,11
52965,1598986771,neo,KISS at Race - EU PM (A),Power2Max NG Eco,Tacx Neo 2T,417,402,15
56271,1600524664,neo,OH MY CRIT - Saturday Smash Race (A),Power2Max NG Eco,Tacx Neo 2T,411,402,9
56635,1600531451,neo,3R Classique Flat Race - 4 Laps (26.9km/16.7mi 76m) (A),Power2Max NG Eco,Tacx Neo 2T,397,385,12
56714,1600708446,neo,DBR Ride´N´Roll League (A),Power2Max NG Eco,Tacx Neo 2T,380,365,15
56716,1600712415,neo,TFC Mad Monday Autumn Series (A),Power2Max NG Eco,Tacx Neo 2T,425,410,15
57117,1600882706,neo,DCU powered by Feltet.dk (A),Power2Max NG Eco,Tacx Neo 2T,409,401,8
57337,1600960359,neo,OH MY CRIT! - The Double Race 1/2 (A),Power2Max NG Eco,Tacx Neo 2T,387,371,16
57338,1600960359,neo,OH MY CRIT! - The Double Race 2/2 (A),Power2Max NG Eco,Tacx Neo 2T,360,346,14
57768,1601129637,neo,OH MY CRIT - Saturday Smash Race (A),Power2Max NG Eco,Tacx Neo 2T,420,408,12
57769,1601129637,neo,TEAM VEGAN Tofu Tornado (A),Power2Max NG Eco,Tacx Neo 2T,400,389,11
58118,1601317183,neo,TFC Mad Monday Autumn Series (A),Power2Max NG Eco,Tacx Neo 2T,388,373,15
58366,1601404781,neo,3R Sundown Race Series  (E),Power2Max NG Eco,Tacx Neo 2T,436,427,9
58640,1601487916,neo,DCU powered by Feltet.dk (A),Power2Max NG Eco,Tacx Neo 2T,382,365,17
58912,1601568176,neo,OH MY CRIT! - The Double Race 2/2 (A),Power2Max NG Eco,Tacx Neo 2T,332,322,10
58913,1601568176,neo,Espresso,Power2Max NG Eco,Tacx Neo 2T,395,383,12
60185,1602092651,neo,DCU powered by Feltet.dk (A),Power2Max NG Eco,Tacx Neo 2T,381,367,14
60359,1602177518,neo,Espresso,Power2Max NG Eco,Tacx Neo 2T,392,382,10
61657,1602614495,neo,Zwift Racing League | WTRL,Power2Max NG Eco,Tacx Neo 2T,412,400,12
62157,1602706383,neo,Espresso,Power2Max NG Eco,Tacx Neo 2T,424,409,15
63515,1603038810,neo,Zwift Racing League | WTRL - EMEA (MEN) - TTT Grp 1,Power2Max NG Eco,Tacx Neo 2T,416,398,18
64281,1603387267,neo,Espresso,Power2Max NG Eco,Tacx Neo 2T,413,401,12
65576,1603827328,neo,Zwift Racing League | WTRL - EMEA W (MEN) -  Division 1 (A),Power2Max NG Eco,Tacx Neo 2T,396,384,12
65828,1603907897,neo,MIDWEEK Autumn Series by SZR (A),Power2Max NG Eco,Tacx Neo 2T,380,366,14
66144,1603995594,neo,WTRL Team Time Trial Platinum League (C),Power2Max NG Eco,Tacx Neo 2T,402,387,15
68108,1604516114,neo,DCU – Feltet.dk November series,Power2Max NG Eco,Tacx Neo 2T,434,422,12
68347,1604602229,neo,Espresso,Power2Max NG Eco,Tacx Neo 2T,415,400,15
68913,1604772128,neo,3R Three Sisters Hilly Race (47km/29.2mi 879m) (A),Power2Max NG Eco,Tacx Neo 2T,419,403,16
69867,1605036832,neo,Zwift Racing League | WTRL - EMEA W1 (MEN) -  Division 1,Power2Max NG Eco,Tacx Neo 2T,446,431,15
70395,1605117460,neo,MIDWEEK Autumn Series by SZR (A),Power2Max NG Eco,Tacx Neo 2T,359,347,12
70938,1605207048,neo,Espresso,Power2Max NG Eco,Tacx Neo 2T,393,378,15
72368,1605642586,neo,Zwift Racing League | WTRL - Men&#039;s EMEA W1 DIVISION 1 (A),Power2Max NG Eco,Tacx Neo 2T,406,392,14
72757,1605725863,neo,DCU – Feltet.dk November series (A),Power2Max NG Eco,Tacx Neo 2T,415,402,13
75227,1606246721,neo,Zwift Racing League | WTRL - Men&#039;s EMEA W1 DIVISION 1,Power2Max NG Eco,Tacx Neo 2T,428,419,9
75683,1606327078,neo,MIDWEEK Autumn Series by SZR (A),Power2Max NG Eco,Tacx Neo 2T,395,380,15
78257,1606852323,neo,Zwift Racing League | WTRL - Men&#039;s EMEA W1 DIVISION 1 (A),Power2Max NG Eco,Tacx Neo 2T,402,389,13
78698,1606931866,neo,MIDWEEK Winter Series by SZR (A),Power2Max NG Eco,Tacx Neo 2T,381,370,11
79151,1607020104,neo,FUSION DECEMBER CUP (A),Power2Max NG Eco,Tacx Neo 2T,371,358,13
80989,1607456331,neo,Zwift Racing League | WTRL - Men&#039;s EMEA W1 DIVISION 1 (A),Power2Max NG Eco,Tacx Neo 2T,380,371,9
83719,1608061715,neo,Zwift Racing League | WTRL - Men&#039;s EMEA W1 DIVISION 1 (A),Power2Max NG Eco,Tacx Neo 2T,398,376,22
84528,1608229639,neo,FUSION DECEMBER CUP (A),Power2Max NG Eco,Tacx Neo 2T,395,382,13
88783,1609267397,neo,Three Sisters ZADA test,Power2Max NG Eco,Tacx Neo 2T,396,387,9
88788,1609265764,neo,Warm up to ZADA test course; pre P2Max calibration via Wahoo Bolt,Power2Max NG Eco,Tacx Neo 2T,273,263,10
88804,1608746312,neo,MIDWEEK Winter Series by SZR (A),Power2Max NG Eco,Tacx Neo 2T,368,357,11
88805,1607624719,neo,FUSION DECEMBER CUP (A),Power2Max NG Eco,Tacx Neo 2T,404,387,17
89641,1609437912,neo,WTRL Team Time Trial - Zone 4 (C),Power2Max NG Eco,Tacx Neo 2T,402,392,10
93091,1610043200,neo,Vienna,Power2Max NG Eco,Tacx Neo 2T,401,384,17
94988,1610392290,neo,Premier Division // Zwift Racing League (men) (A),Power2Max NG Eco,Tacx Neo 2T,380,362,18
96580,1610563313,neo,Danmarks Cykle Union & Partners 1/6 (A),Power2Max NG Eco,Tacx Neo 2T,407,399,8
99198,1610999135,neo,Premier Division // Zwift Racing League (men) (A),Power2Max NG Eco,Tacx Neo 2T,401,389,12
102915,1611601319,neo,Zwift - Premier Division // Zwift Racing League (men) (A),Power2Max NG Eco,Tacx Neo 2T,407,394,13
104843,1611858582,neo,Zwift - FUSION WINTER CUP (A),Power2Max NG Eco,Tacx Neo 2T,422,409,13
106472,1612120911,neo,Three Sisters ZADA test - New power meter (and BB),Power2Max NG Eco / Rotor Cranks,Tacx Neo 2T,417,398,19
106478,1612119200,neo,Warm up to ZADA test course; pre P2Max calibration via Wahoo Bolt,Power2Max NG Eco / Rotor Cranks,Tacx Neo 2T,259,246,13
108439,1612377734,neo,Danmarks Cykle Union & Partners 4/6 (A) - SEE DESCRIPTION,Power2Max NG Eco / Rotor Cranks,Tacx Neo 2T,405,383,22
111000,1612811575,neo,Zwift - Premier Division // Zwift Racing League (men) (A),Power2Max NG Eco / Rotor Cranks,Tacx Neo 2T,432,408,24
117438,1613672920,neo,FUSION WINTER CUP (A),Power2Max NG Eco / Rotor Cranks,Tacx Neo 2T,445,420,25
119102,1614020703,neo,Premier Division // Zwift Racing League (men) (A),Power2Max NG Eco / Rotor Cranks,Tacx Neo 2T,418,394,24
120938,1614277010,neo,FUSION WINTER CUP (A),Power2Max NG Eco / Rotor Cranks,Tacx Neo 2T,438,418,20
122558,1614629358,neo,Premier Division // Zwift Racing League (men) (A),Power2Max NG Eco / Rotor Cranks,Tacx Neo 2T,404,381,23
124256,1614882469,wahoo,FUSION SPRING CUP (A),Power2Max NG Eco / Rotor Cranks,Wahoo Kickr Core,449,442,7
124520,1614967115,wahoo,KIRCHMAIR Race Series,Power2Max NG Eco / Rotor Cranks,Wahoo Kickr Core,358,354,4
124541,1614968462,wahoo,KIRCHMAIR Race Series,Power2Max NG Eco / Rotor Cranks,Wahoo Kickr Core,367,365,2
125113,1615053828,wahoo,3R Three Sisters Hilly Race (47km/29.2mi 879m) (A),Power2Max NG Eco / Rotor Cranks,Wahoo Kickr Core,418,417,1
127559,1615573342,wahoo,KIRCHMAIR March Sprint Series 4/8,Power2Max NG Eco / Rotor Cranks,Wahoo Kickr Core,362,363,-1
128082,1615658724,wahoo,3R Three Sisters Hilly Race (A) - SEE DESCRIPTION for HR avg,Power2Max NG Eco / Rotor Cranks,Wahoo Kickr Core,414,413,1
129151,1615918870,wahoo,CeramicSpeed Race Series: Open Race (A),Power2Max NG Eco / Rotor Cranks,Wahoo Kickr Core,427,429,-2
68679,1604726525,wahoo,Zwift - Watopia,Favero Assioma uno,Wahoo Kickr new,291,296,-5
70871,1605207436,wahoo,Zwift -  Flanders The BZR Ronde  (A),Favero Assioma uno,Wahoo Kickr new,385,396,-11
77897,1606805161,wahoo,Nuchter + test Rotor 2INPOWER,ROTOR IN2POWER,Wahoo Kickr,234,216,18
78091,1606846917,wahoo,Zwift - Zwift Racing League | WTRL - Men&#039;s EMEA E1 DIVISION 2 (A),ROTOR IN2POWER,Wahoo Kickr,417,400,17
79287,1607021816,wahoo,Zwift - BENELIGA 2020-2021 (E),ROTOR IN2POWER,Wahoo Kickr,410,385,25
83583,1608056509,wahoo,Zwift Racing League | WTRL - Mens EMEA E1 DIVISION 2,ROTOR IN2POWER,Wahoo Kickr,374,381,-7
84507,1608231412,wahoo,BENELIGA 2020-2021,ROTOR IN2POWER,Wahoo Kickr,408,409,-1
86614,1608746211,wahoo,MIDWEEK Winter Series by SZR,ROTOR IN2POWER,Wahoo Kickr,391,391,0
86965,1608826314,wahoo,OH MY CRIT! - The Double Race 1/2,ROTOR IN2POWER,Wahoo Kickr,404,395,9
88496,1609239411,wahoo,Zwift - KISS Race Series - Americas AM (A),ROTOR IN2POWER,Wahoo Kickr,396,387,9
89497,1609423301,wahoo,Zwift - 3R Classique Flat Race - 6 Laps (37.7km/23.4mi 114m) (A),ROTOR IN2POWER,Wahoo Kickr,392,387,5
91382,1609787802,wahoo,Zwift - Team TFC Mad Monday Winter Series (A),ROTOR IN2POWER,Wahoo Kickr,392,386,6
93457,1610045797,wahoo,Zwift - BENELIGA 2020-2021 (E),ROTOR IN2POWER,Wahoo Kickr,416,402,14
95713,1610475096,wahoo,Zwift - Zwift Racing League | WTRL - Men&#039;s/Mixed EMEA E1 DIVISION 1 (A),ROTOR IN2POWER,Wahoo Kickr,415,385,30
96402,1610560595,wahoo,Zwift - MIDWEEK Winter Series by SZR (A),ROTOR IN2POWER,Wahoo Kickr,408,397,11
99739,1611080078,wahoo,Zwift - Zwift Racing League | WTRL - Men&#039;s/Mixed EMEA E1 DIVISION 1 (A),ROTOR IN2POWER,Wahoo Kickr,390,379,11
102510,1611501687,wahoo,Zwift - 3R Watopia 65km Race - 6 laps (40mi 324m) (A),ROTOR IN2POWER,Wahoo Kickr,395,383,12
103500,1611684692,wahoo,Zwift - Zwift Racing League | WTRL - Men&#039;s/Mixed EMEA E1 DIVISION 1 (A),ROTOR IN2POWER,Wahoo Kickr,407,401,6
107406,1612289488,wahoo,Zwift - Zwift Racing League | WTRL - Men&#039;s/Mixed EMEA E1 DIVISION 1 (A),ROTOR IN2POWER,Wahoo Kickr,396,395,1
111093,1612811784,wahoo,Zwift - Team TFC Mad Monday Winter Series (A),ROTOR IN2POWER,Wahoo Kickr,354,352,2
112254,1612979783,wahoo,Zwift - MIDWEEK Winter Series by SZR (A),ROTOR IN2POWER,Wahoo Kickr,403,384,19
115323,1613416575,wahoo,Zwift - Team TFC Mad Monday Winter Series (A)WIN!!!,ROTOR IN2POWER,Wahoo Kickr,373,366,7
117372,1613674571,wahoo,BENELIGA 2020-2021,ROTOR IN2POWER,Wahoo Kickr,398,389,9
120289,1614189380,wahoo,Zwift - MIDWEEK Winter Series by SZR (A),ROTOR IN2POWER,Wahoo Kickr,396,385,11
123028,1614708972,wahoo,Zwift - Zwift Racing League | WTRL - Men&#039;s/Mixed EMEA E1 DIVISION 1 (A),ROTOR IN2POWER,Wahoo Kickr,407,399,8
79023,1607020179,wahoo,Zwift - FUSION DECEMBER CUP (A),Power2Max NGeco,Wahoo Kickr Core,270,282,-12
79855,1607186978,wahoo,Zwift - 3R Innsbruckring Flat Race - 3 Laps (26.4km/16.4mi 231m) (A),Power2Max NGeco (Secondary),Wahoo Kickr Core (Primary),265,275,-10
80974,1607456686,wahoo,Zwift - Zwift Racing League | WTRL - Men&#039;s EMEA W1 DIVISION 1 (A),Power2Max NGeco (Secondary),Wahoo Kickr Core (Primary),287,290,-3
83150,1607968736,wahoo,Zwift - 3R Bologna Race - 2 Laps (A),Power2Max NGeco (Primary),Kickr Core (Secondary Wahoo app),316,319,-3
84336,1608224683,wahoo,"Zwift - Para-cycling Virtual Time Trial Series, hosted by U.S. Paralympics Cycling",Power2Max NGeco (Secondary),Wahoo Kickr Core (Primary),279,286,-7
85509,1608483578,wahoo,Zwift - 12/20/2020,Power2Max NGeco (Secondary),Wahoo Kickr Core (Primary),283,286,-3
86572,1608746380,wahoo,Zwift - MIDWEEK Winter Series by SZR (A),Power2Max NGeco (Secondary),Wahoo Kickr Core (Primary),290,296,-6
91809,1609871387,wahoo,Zwift - ZTPL.CC Classic Race (E),Power2Max NGeco (Primary),Kickr Core (Secondary Wahoo app),290,295,-5
33037,1588946695,wahoo,Zwift - 3R Innsbruckring Flat Race - 2 Laps (17.6km/10.9m 154m) (A),Garmin Vector 3,Wahoo Kicker Core,362,352,10
34698,1589469293,wahoo,Zwift - OH CRIT!! - The Double Race - Lockdown Series Round 2 Race 1 (A),Garmin Vector 3,Wahoo Kicker Core,357,339,18
36090,1589912094,wahoo,Zwift - UNO X CUP powered by DCU & Feltet.dk (A),Garmin Vector 3,Wahoo Kicker Core,378,354,24
37397,1590329094,wahoo,Zwift - Tour for All 2020: Stage 1 Longer Race A/B,Garmin Vector 3,Wahoo Kicker Core,334,339,-5
37859,1590516892,wahoo,Zwift - UNO X CUP powered by DCU & Feltet.dk (A),Garmin Vector 3,Wahoo Kicker Core,414,401,13
38778,1590844794,wahoo,Zwift - 3R Innsbruckring Flat Race - 5 Laps (44km/27.3mi 385m) (A),Garmin Vector 3,Wahoo Kicker Core,340,333,7
105233,1611946985,wahoo,Zwift - TDZ Stage 6: Shorter Ride,4iiii Precision  R8000 Ultegra,Wahoo Kickr V5,323,308,15
105594,1612002598,wahoo,Zwift - Strength Development 7 sets,4iiii Precision  R8000 Ultegra,Wahoo Kickr V5,289,276,13
106625,1612186192,wahoo,Zwift - Watopia,4iiii Precision  R8000 Ultegra,Wahoo Kickr V5,286,276,10
107374,1612289704,wahoo,Zwift - Zwift Racing League | WTRL - Men&#039;s/Mixed EMEA E1 DIVISION 1 (A),4iiii Precision  R8000 Ultegra,Wahoo Kickr V5,374,371,3
107988,1612346404,wahoo,Zwift - TDZ Stage 7: Longer Ride,4iiii Precision  R8000 Ultegra,Wahoo Kickr V5,369,363,6
109299,1612465210,wahoo,Zwift - FLANDERS The BZR Ronde Watopian League (A),4iiii Precision  R8000 Ultegra,Wahoo Kickr V5,396,399,-3
110756,1612697403,wahoo,Zwift - Zwift Fondo Series: Gran Fondo,4iiii Precision  R8000 Ultegra,Wahoo Kickr V5,363,362,1
111714,1612894689,wahoo,Zwift - Zwift Racing League | WTRL - Men&#039;s/Mixed EMEA E1 DIVISION 1 (A),4iiii Precision  R8000 Ultegra,Wahoo Kickr V5,373,374,-1
113030,1613070003,wahoo,Zwift - FLANDERS The BZR Ronde Watopian League (A),4iiii Precision  R8000 Ultegra,Wahoo Kickr V5,375,381,-6
114259,1613233802,wahoo,Zwift - TEAM VEGAN Tofu Tornado (A),4iiii Precision  R8000 Ultegra,Wahoo Kickr V5,410,412,-2
115989,1613499304,wahoo,Zwift - Zwift Racing League | WTRL - Men&#039;s/Mixed EMEA E1 DIVISION 1 (A),4iiii Precision  R8000 Ultegra,Wahoo Kickr V5,412,408,4
116460,1613559715,wahoo,Zwift - Zwift Duathlon League - Bike,4iiii Precision  R8000 Ultegra,Wahoo Kickr V5,366,363,3
117715,1613674801,wahoo,Zwift - FLANDERS The BZR Ronde Watopian League (A),4iiii Precision  R8000 Ultegra,Wahoo Kickr V5,381,378,3
119613,1614104104,wahoo,Zwift - Zwift Racing League | WTRL - Men&#039;s/Mixed EMEA E1 DIVISION 1 (A),4iiii Precision  R8000 Ultegra,Wahoo Kickr V5,367,365,2
122397,1614279604,wahoo,Zwift - FLANDERS The BZR Ronde Watopian League (A),4iiii Precision  R8000 Ultegra,Wahoo Kickr V5,370,365,5
122400,1614420016,wahoo,Zwift - Haute Route Watopia 2021 Stage 2 (A),4iiii Precision  R8000 Ultegra,Wahoo Kickr V5,361,359,2
123069,1614709415,wahoo,Zwift - Zwift Racing League | WTRL - Men&#039;s/Mixed EMEA E1 DIVISION 1 (A),4iiii Precision  R8000 Ultegra,Wahoo Kickr V5,360,359,1
124628,1614971101,wahoo,Zwift - Zwift Racing League | WTRL Battle Royale Playoff - Men&#039;s Points Race (A),4iiii Precision  R8000 Ultegra,Wahoo Kickr V5,378,371,7
126275,1615317601,neo,first ride with the new team (WEz),Quarq Dzero DUB dual sided power meter,Tacx Neo smart 2T,391,365,26
127118,1615486559,neo,4th at (WTRL TTT Platinum League),Quarq Dzero DUB dual sided power meter,Tacx Neo smart 2T,418,384,34
127571,1615566600,neo,Absa Cape Epic Stage 3 pb ABUS - Open	,Quarq Dzero DUB dual sided power meter,Tacx Neo smart 2T,424,393,31
128056,1615649422,neo,Zwift - Absa Cape Epic Stage 4 pb Assos - Open (A),Quarq Dzero DUB dual sided power meter,Tacx Neo smart 2T,404,376,28
129205,1615919403,neo,Zwift - CeramicSpeed Race Series: Open Race (A),Quarq Dzero DUB dual sided power meter,Tacx Neo smart 2T,430,406,24
31780,1588703995,wahoo,Zwift - 3R Spring Loaded Race Series - Round 6of6 (A),4iiii Precision 2.0 Shimano 105,Wahoo Kickr 18,400,410,-10
3301,1572113102,wahoo,Zwift - 3R Three Sisters Hilly Race (47km/29.2mi 879m) (A),Stages gen2,Wahoo KICKR ,387,392,-5
3395,1571508300,wahoo,Zwift - 3R Three Sisters Hilly Race (47km/29.2mi 879m) (A),Stages Gen2,Wahoo KICKR ,0,0,0
3446,1572376199,wahoo,Zwift - WORLDOFFUSION Racing League (A),Stages L gen2,Wahoo KICKR ,389,385,4
3582,1572548998,wahoo,FUSION ECT BEUNSTOPPABLE Racing Series,Stages L gen2,Wahoo KICKR ,369,371,-2
3585,1571332683,wahoo,WTRL Team Time Trial - Zone2,Stages L gen2,Wahoo KICKR ,0,0,0
3825,1572980407,wahoo,Zwift - ZwiftTeamPL League – Climbers Series (A),Stages L gen2,Wahoo KICKR ,368,375,-7
3979,1573239598,wahoo,The Friday Criterium Autumn  Series (14 mi / 22 km),Stages L gen2,Wahoo KICKR ,402,409,-7
4016,1573322698,wahoo,Zwift - 3R Three Sisters Hilly Race (47km/29.2mi 879m) (A),Stages L gen2,Wahoo KICKR ,413,422,-9
4067,1573412395,wahoo,BRT Iron Goat Racing League,Stages L gen2,Wahoo KICKR ,418,424,-6
4159,1573585196,wahoo,Zwift - ZwiftTeamPL League – Classic series A (A),Stages L gen2,Wahoo KICKR ,0,0,0
4251,1573755776,wahoo,Zwift - WTRL Team Time Trial (C),Stages L gen2,Wahoo KICKR ,383,379,4
4347,1573896593,wahoo,Zwift - DBR Saturday Race (A),Stages L gen2,Wahoo KICKR ,369,365,4
4493,1574190594,wahoo,Zwift - WORLDOFFUSION Racing Series (A),Stages L gen222,Wahoo KICKR ,394,410,-16
4803,1574604874,wahoo,Zwift - KISS at Race 100 - Americas (A),Stages L gen2,Wahoo KICKR ,375,382,-7
4823,1574621987,wahoo,Zwift - BRT Iron Goat Racing League (A),Stages L gen2,Wahoo KICKR ,374,386,-12
4941,1574794819,wahoo,Zwift - ZwiftTeamPL League – Climbers Series (A),Stages L gen2,Wahoo KICKR ,400,404,-4
5215,1575121484,wahoo,Zwift - WTRL Alpe du Zwift Series (E),Stages L gen2,Wahoo KICKR ,384,392,-8
5403,1575400181,wahoo,Zwift - WORLDOFFUSION Racing Series (A),Stages L gen2,Wahoo KICKR ,432,443,-11
5710,1575726280,wahoo,Zwift - WTRL Alpe du Zwift Series (E),Stages L gen2,Wahoo KICKR ,385,389,-4
5774,1575814465,wahoo,Zwift - KISS at Race 100 - Americas (A),Stages L gen2,Wahoo KICKR 18,382,379,3
5928,1576004977,wahoo,Zwift - WORLDOFFUSION Racing Series (A),Stages L gen2,Wahoo KICKR 18,387,378,9
6071,1576091090,wahoo,Zwift - DBR HEINO CUP (A),Stages L gen2,Wahoo KICKR 18,398,400,-2
6436,1576525200,wahoo,Zwift - Crit City Race (A),Stages L gen2,Wahoo KICKR 18,319,322,-3
6437,1576330702,wahoo,Zwift - WTRL Alpe du Zwift Series (E),Stages L gen2,Wahoo KICKR 18,375,383,-8
6518,1576605901,wahoo,ZwiftTeamPL League – Climbers Series,Stages L gen2,Wahoo KICKR 18,376,383,-7
6928,1576935900,wahoo,Zwift - WTRL Alpe du Zwift Series (E),Stages L gen2,Wahoo KICKR 18,396,402,-6
8083,1578161102,wahoo,Zwift - 3R Three Sisters Hilly Race (47km/29.2mi 879m) (A),Stages L gen2,Wahoo KICKR 18,433,436,-3
8161,1578233327,wahoo,Zwift - KISS at Race 100 - Americas (A),Stages L gen2,Wahoo KICKR 18,378,383,-5
8318,1578423611,wahoo,Zwift - ZTPL.CC League – Classic Series (A),Stages L gen2,Wahoo KICKR 1811,393,403,-10
8676,1578594602,wahoo,Zwift - FUSION ECT BEUNSTOPPABLE Racing Series (A),Stages L gen2,Wahoo KICKR 18,410,409,1
9046,1578838499,wahoo,Zwift - KISS at Race 100 - Americas (A),Stages L gen2,Wahoo KICKR 18,364,370,-6
9720,1579199402,wahoo,Zwift - FUSION ECT BEUNSTOPPABLE Racing Series (A),Stages L gen2,Wahoo KICKR 18,458,465,-7
10190,1579443304,wahoo,Zwift - KISS at Race 100 - Americas (A),Stages L gen2,Wahoo KICKR 18,372,372,0
10191,1579549854,wahoo,Zwift - GGCC Glasgow Green Cycle Club Race Series (A),Stages L gen2,Wahoo KICKR 18,406,409,-3
10296,1579633202,wahoo,Zwift - ZTPL.CC League – Climbers Series (A),Stages L gen2,Wahoo KICKR 18,415,423,-8
10686,1579806897,wahoo,Zwift - Tour de Zwift // Pro-Am Invitational,Stages L gen2,Wahoo KICKR 18,418,426,-8
11573,1580330739,wahoo,Zwift - Watopia,Stages L gen2,Wahoo KICKR 18,393,398,-5
11904,1580491279,wahoo,Zwift - Watopia Abslolute wahoo,Stages L gen2,Wahoo KICKR 18,403,419,-16
12135,1580652901,wahoo,Zwift - KISS at Race 100 - Americas (A),Stages L gen2,Wahoo KICKR 18,388,388,0
12382,1580843702,wahoo,Zwift - Tour de Zwift // Pro-Am Invitational (A),Stages L gen2,Wahoo KICKR 18,394,403,-9
12602,1580925602,wahoo,Zwift - SZR Winter Race Series (A),Stages L gen2,Wahoo KICKR 18,413,403,10
12777,1581015601,wahoo,Zwift - KALAS Cup - Round 2 (A),Stages L gen2,Wahoo KICKR 18,426,433,-7
12937,1581102002,wahoo,Zwift - The Friday Criterium Winter Race Series  (19 mi / 30 km) (A),Stages L gen2,Wahoo KICKR 18,408,415,-7
13174,1581257699,wahoo,Zwift - KISS at Race 100 - Americas (A),Stages L gen2,Wahoo KICKR 18,353,352,1
13417,1581447600,wahoo,Zwift - ZwiftTeamPL League – Climbers Series (A),Stages L gen2,Wahoo KICKR 18,396,394,2
13744,1581620398,wahoo,Zwift - KALAS Cup - Round 3 (A),Stages L gen2,Wahoo KICKR 18,378,390,-12
18175,1584278150,wahoo,Zwift - KISS at Race 100 - Americas (A),Stages L gen2,Wahoo KICKR 18,354,359,-5
19084,1584813900,wahoo,Zwift - 3R Three Sisters Hilly Race (47km/29.2mi 879m) (A),Stages L gen2,Wahoo KICKR 18,418,427,-9
77465,1606672622,wahoo,Zwift - The Alpe Dash by Herd Racing League (A),Stages L gen2,Wahoo KICKR 18,384,389,-5
79780,1607162401,wahoo,Zwift - Nations Challenge // Poland (E),Stages L gen2,Wahoo KICKR 18,360,360,0
95648,1610476050,wahoo,Zwift - Zwift Racing League | WTRL - Men&#039;s/Mixed EMEA E2 DIVISION 5 (A),Stages L gen2,Wahoo KICKR 18,380,384,-4
97006,1610649587,wahoo,Zwift - XRS - ZTR Thursday Night Race (A),Stages L gen2,Wahoo KICKR 18,363,366,-3
99755,1611080714,wahoo,Zwift - Zwift Racing League | WTRL - Men&#039;s/Mixed EMEA E1 DIVISION 6 (A),Stages L gen2,Wahoo KICKR 18,382,379,3
100432,1611169232,wahoo,Zwift - The Carnival Group Ride | ZTPL.CC (A),Stages L gen2,Wahoo KICKR 18,383,392,-9
101073,1611255121,wahoo,Zwift - S6 Sweet Spot + Burnout,Stages L gen2,Wahoo KICKR 18,375,385,-10
101874,1610787570,wahoo,Zwift - ZTPL.CC Classic Race (A),Stages L gen2,Wahoo KICKR 18,397,397,0
101992,1611421184,wahoo,Zwift - The Carnival Race League Stage 2 with ZTPL.CC (A),Stages L gen2,Wahoo KICKR 18,425,426,-1
102357,1611478818,wahoo,Zwift - The Carnival | ZTPL.CC Challenge Ride (A),Stages L gen2,Wahoo KICKR 18,390,394,-4
103561,1611685179,wahoo,Zwift - Zwift Racing League | WTRL - Men&#039;s/Mixed EMEA E1 DIVISION 6 (A),Stages L gen2,Wahoo KICKR 18,399,407,-8
105869,1612029852,wahoo,Zwift - 3R Three Sisters Hilly Race (47km/29.2mi 879m) (A),Stages L gen2,Wahoo KICKR 18,399,398,1
106394,1612102488,wahoo,Zwift - KISS 100 Race Series - Americas (A),Stages L gen2,Wahoo KICKR 18,401,399,2
107455,1612289978,wahoo,Zwift - Zwift Racing League | WTRL - Men&#039;s/Mixed EMEA E1 DIVISION 6 (A),Stages L gen2,Wahoo KICKR 18,389,393,-4
110061,1612630776,wahoo,Zwift - The Carnival Race League Stage 6 with ZTPL.CC (A),Stages L gen2,Wahoo KICKR 18,393,398,-5
111174,1612816500,wahoo,Zwift - Kalibracja  Kickr + Stages L,Stages L gen2,Wahoo KICKR 18,339,342,-3
112505,1612987836,wahoo,Zwift - P Moc pod górę S5 + sprint,Stages L gen2,Wahoo KICKR 18,359,359,0
113626,1613156372,wahoo,Zwift - TFC Xmas Smash Fest (E),Stages L gen2,Wahoo KICKR 18,423,430,-7
114315,1613235563,wahoo,Zwift - ZTPL.CC Winter League 2021 Stage 8 (A),Stages L gen2,Wahoo KICKR 18,394,387,7
114836,1613312063,wahoo,Zwift - KISS 100 Race Series - Americas (A),Stages L gen2,Wahoo KICKR 18,361,364,-3
118381,1609233870,wahoo,Zwift - ZTPL.CC Winter League 2021 Stage 10 (A),Stages L gen2,Wahoo KICKR 18,376,377,-1
118599,1609289671,wahoo,Zwift - Flanders Endurance Race League (A),Stages L gen2,Wahoo KICKR 18,396,398,-2
119844,1609498478,wahoo,Zwift - ZTPL.CC Winter League 2021 Stage 9 (A),Stages L gen2,Wahoo KICKR 18,377,382,-5
120452,1609587153,wahoo,Zwift - EVR Definitely Not the WTNC (A),Stages L gen2,Wahoo KICKR 18,308,321,-13
120917,1614283199,wahoo,Zwift - KISS Race Series - EU PM (A),Stages L gen2,Wahoo KICKR 18,395,397,-2
121573,1614416418,wahoo,Zwift - Haute Route Watopia 2021 Stage 2 (A),Stages L gen2,Wahoo KICKR 18,402,411,-9
121829,1614445168,wahoo,Zwift -  ZTPL.CC Winter League 2021 Stage 12 (A),Stages L gen2,Wahoo KICKR 18,376,377,-1
122151,1614531581,wahoo,Zwift - Haute Route Watopia 2021 Stage 3 (A),Stages L gen2,Wahoo KICKR 18,376,388,-12
124214,1614887997,wahoo,Zwift - KISS Race Series - EU PM (A),Stages L gen2,Wahoo KICKR 18,396,399,-3
125479,1615136375,wahoo,Zwift - MISTRZOSTWA ZTPL.CC (E),Stages L gen2,Wahoo KICKR 18,405,403,2
127810,1615626272,wahoo,Zwift - 3R Endurance Series p/b OTE Sports (E),Stages L gen2,Wahoo KICKR 18,424,428,-4
129384,1615919377,wahoo,Zwift - CeramicSpeed Race Series: Open Race (A),Stages L gen2,Wahoo KICKR 18,409,409,0
123716,1614794399,neo,Zwift - MIDWEEK Crit Race Series by SZR (A) 8th,Favero Assimoa ,Tacx NeoBike,359,365,-6
128647,1615399185,neo,Zwift - MIDWEEK Crit Race Series by SZR (A),Favero Assimoa ,Tacx NeoBike,376,381,-5
84424,1608230174,wahoo,Zwift - Watopia,KICKR core -&gt; zwift,Stages -&gt; Wahoo,294,286,8
84798,1608310799,wahoo,Zwift - Tour of New York Stage 1 - Open Longer,KICKR core -&gt; zwift,Stages -&gt; Wahoo,376,374,2
85529,1608483317,wahoo,Zwift - Tour of New York Stage 3 - Open Longer,KICKR core -&gt; zwift,Stages -&gt; Wahoo,391,387,4
90915,1609700421,wahoo,Zwift - BRT Iron Goat Racing League (A),KICKR core -&gt; zwift,Stages -&gt; Wahoo,382,373,9
91421,1609786795,wahoo,Zwift - TDZ Stage 1: Longer Ride,KICKR core -&gt; zwift,Stages -&gt; Wahoo,376,363,13
93066,1610049423,wahoo,Zwift - KISS Race Series - EU PM (A),KICKR core -&gt; zwift,Stages -&gt; Wahoo,407,398,9
94109,1610218798,wahoo,Zwift - EVR Winter Series (A),KICKR core -&gt; zwift,Stages -&gt; Wahoo,332,335,-3
95035,1610391539,wahoo,Zwift - TDZ Stage 2: Longer Ride,KICKR core -&gt; zwift,Stages -&gt; Wahoo,412,402,10
95782,1610477548,wahoo,Zwift - Team Italy & Frenchy Fuzion League (A),KICKR core -&gt; zwift,Stages -&gt; Wahoo,379,366,13
97120,1610648648,wahoo,Zwift - FUSION WINTER CUP (A),KICKR core -&gt; zwift,Stages -&gt; Wahoo,394,383,11
100569,1611168316,wahoo,Zwift - Danmarks Cykle Union & Partners 2/6 (A),KICKR core -&gt; zwift,Stages -&gt; Wahoo,408,399,9
101167,1611255357,wahoo,Zwift - TDZ Stage 4: Longer Ride,KICKR core -&gt; zwift,Stages -&gt; Wahoo,381,379,2
101530,1611336262,wahoo,Zwift - ZHQ FutureWorks Circuit Race - Anti-sandbagging (A),KICKR Core // Zwift,Stages Gen 1 Left // Wahoo ,352,344,8
101536,1611340132,wahoo,Zwift - KIRCHMAIR Race Series (A),KICKR Core // Zwift,Stages Gen 1 Left // Wahoo ,383,369,14
103168,1611600480,wahoo,Zwift - TDZ Stage 5: Longer Ride,KICKR Core // Zwift,Stages Gen 1 Left // Wahoo ,370,360,10
106864,1612207216,wahoo,Zwift - Team TFC Mad Monday Winter Series (A),KICKR Core // Zwift,xPower spider // Wahoo,401,412,-11
108523,1612378118,wahoo,Zwift - Open - Movistar Team Challenge Community Qualifier Race #1,KICKR Core // Zwift,xPower spider // Wahoo,399,415,-16
109448,1612547665,wahoo,Zwift - LES ROUTES DE ZWIFT Frenchy Fuzion - Etape 3 (E),KICKR Core // Zwift,xPower spider // Wahoo,414,430,-16
110206,1612636093,wahoo,Zwift - Zwift Fondo Series: Gran Fondo,KICKR Core // Zwift,xPower spider // Wahoo,381,377,4
110664,1612724066,wahoo,Zwift - TDZ Stage 7: Longer Ride,KICKR Core // Zwift,xPower spider // Wahoo,375,374,1
111761,1612896637,wahoo,Zwift - Team Italy & Frenchy Fuzion League (A),KICKR Core // Zwift,xPower spider // Wahoo,381,396,-15
112501,1612983322,wahoo,Zwift - TDZ Stage 8: Group Ride,Zwift,xPower spider // Wahoo,382,385,-3
113036,1613068068,wahoo,Zwift - FUSION WINTER CUP (A),KICKR Core // Zwift,xPower spider // Wahoo,374,373,1
113735,1613156168,wahoo,Zwift - Watopia,KICKR Core // Zwift,Stages Gen 1 Left // Wahoo ,0,0,0
114364,1613242440,wahoo,Zwift - EVR Winter Series (A),KICKR Core // Zwift,Stages Gen 1 Left // Wahoo ,379,361,18
103602,1611685094,neo,Zwift - Zwift Racing League | WTRL - Men&#039;s/Mixed EMEA E1 DIVISION 6 (A),QUARQ DZERO,TACX NEO,371,343,28
103604,1611685094,neo,Zwift - Zwift Racing League | WTRL - Men&#039;s/Mixed EMEA E1 DIVISION 6 (A),QUARQ DZERO,TACX NEO,371,343,28
36898,1590161395,wahoo,Zwift - ZRG Race Days 3/5 (A),Power2Max,Wahoo Kickr,338,3,335
37181,1590251397,wahoo,Zwift - ZRG Race Days 4/5 (A),Power2Max,Wahoo Kickr,372,371,1
37426,1590337794,wahoo,Zwift - ZRG Race Days 5/5 (A),Power2Max,Wahoo Kickr,347,355,-8
39103,1591117171,wahoo,Zwift - ZRG Short & Sweet Series  (A),Power2Max,Wahoo Kickr,377,371,6
39823,1591374616,wahoo,Zwift - ZHR Afternoon Tea Race (A),Power2Max,Wahoo Kickr,344,338,6
39824,1591378217,wahoo,Zwift - KIRCHMAIR Race Series (A),Power2Max,Wahoo Kickr,380,376,4
39826,1591379679,wahoo,Zwift - GGCC GlasgowGreen CC TT  (A),Power2Max,Wahoo Kickr,334,326,8
40016,1591459178,wahoo,Zwift - GCA Klassiker #1,Power2Max,Wahoo Kickr,373,375,-2
40539,1591721906,wahoo,Zwift - ZRG Short & Sweet Series  (A),Power2Max,Wahoo Kickr,384,384,0
40814,1591812003,wahoo,Zwift - Zwift NL League - Woensdagavond Competitie (A),Power2Max,Wahoo Kickr,401,385,16
41974,1592326781,wahoo,Zwift - ZRG Short & Sweet Series 4/5 - Crit City  (A),Power2Max,Wahoo Kickr,376,377,-1
42629,1592413164,wahoo,Zwift - MIDWEEK Summer Series by SZR (A),Power2Max,Wahoo Kickr,377,375,2
42630,1592585970,wahoo,Zwift - KIRCHMAIR Race Series (A),Power2Max,Wahoo Kickr,340,341,-1
43235,1592931597,wahoo,Zwift - ZRG Short & Sweet Series 5/5 - New York (A),Power2Max,Wahoo Kickr,385,384,1
60234,1602093916,wahoo,Zwift - DBR HEINO CUP III (A),Stages Power,Wahoo Kickr,365,356,9
94956,1610389792,wahoo,Zwift -  Team CLS Racing - Fast &#039;n&#039; Furious S7 (A),Stages Power,Wahoo Kickr,353,350,3
97038,1610647019,wahoo,Zwift - Doddie Aid Hare and Hounds Race (A),Stages Power,Wahoo Kickr,363,362,1
105742,1612025990,wahoo,Zwift - GCA Liga 2021 #1 Platz 20 :),Power2Max,Wahoo Kickr,411,416,-5
110036,1612630814,wahoo,Zwift - GCA Liga 2021 #2 (A),Stages Power zu SIGMA ROX 12,Wahoo Kickr,376,379,-3
114272,1613235619,wahoo,Zwift - GCA Liga 2021 #3 (A),Stages Power zu SIGMA ROX 12,Wahoo Kickr,387,395,-8
118364,1613840419,wahoo,Zwift - GCA Liga 2021 #4 (A),Stages Power zu SIGMA ROX 12,Wahoo Kickr,400,400,0
121741,1614445211,wahoo,Zwift - GCA Liga 2021 #5 (A),Stages Power zu SIGMA ROX 12,Wahoo Kickr,392,397,-5
127031,1615482294,wahoo,Zwift - OH MY CRIT!! - The Double Race 2/2 (A),Stages Power zu SIGMA ROX 12,Wahoo Kickr,390,388,2
128750,1615832113,wahoo,Zwift -  DBR Monday Race (A),Stages Power to SIGMA ROX 12,Wahoo Kickr,401,408,-7
170,1565805839,wahoo,Zwift - Trofeo Bologna // Zwift Classic ,Favero Assioma DUO,Wahoo KICKR 2018,405,400,5
1335,1567706585,wahoo,Zwift - Watopia Cup // Zwift Classic ,Favero Assioma DUO,Wahoo KICKR 2018,421,400,21
11870,1580498098,wahoo,Zwift - Tour de Zwift // Pro-Am Invitational (A),Favero Assioma DUO,Wahoo KICKR 2018,400,387,13
50567,1597776017,wahoo,Zwift - 3R Turbocharged Team Race Series - Round 6 (A),Favero Assioma DUO,Wahoo KICKR 2018,385,386,-1
50920,1597936502,wahoo,Zwift - OH MY CRIT! - The Double Race 1/2 (A),Favero Assioma DUO,Wahoo KICKR 2018,374,380,-6
51865,1598380802,wahoo,Zwift - 3R Turbocharged Team Race Series - Bonus Round (A),Favero Assioma DUO,Wahoo KICKR 2018,370,371,-1
52765,1598897997,wahoo,Zwift - TFC Mad Monday Summer Series (9 of 10) (A),Favero Assioma DUO,Wahoo KICKR 2018,381,383,-2
52927,1598985634,wahoo,Zwift - 3R Sundown Race Series - Round1 iTT,Favero Assioma DUO,Wahoo KICKR v5,395,398,-3
53231,1599153670,wahoo,Zwift - Espresso,Favero Assioma DUO,Wahoo KICKR v5,372,380,-8
53425,1599228301,wahoo,Zwift - 3R Innsbruckring Flat Race - 2 Laps (17.6km/10.9m 154m) (A),Favero Assioma DUO,Wahoo KICKR v5,384,386,-2
53977,1599590639,wahoo,Zwift - 3R Sundown Race Series  (E),Favero Assioma DUO,Wahoo KICKR v5,391,397,-6
55380,1600195440,wahoo,Zwift - 3R Sundown Race Series  (E),Favero Assioma DUO,Wahoo KICKR v5,387,393,-6
55829,1600367398,wahoo,Zwift - Invitational League // Qualifying Race #2 (Men) ,Favero Assioma DUO,Wahoo KICKR v5,380,381,-1
56852,1600800246,wahoo,Zwift - 3R Sundown Race Series  (E),Favero Assioma DUO,Wahoo KICKR v5,405,413,-8
56949,1600849506,wahoo,Giant Crit Crushers Race 2,Favero Assioma DUO,Wahoo KICKR v5,401,405,-4
57844,1601193911,wahoo,Zwift - Erik Haugen [R3R]&#039;s Meetup,Favero Assioma DUO,Wahoo KICKR v5,396,404,-8
58309,1601405042,wahoo,Zwift - 3R Sundown Race Series  (E),Favero Assioma DUO,Wahoo KICKR v5,383,394,-11
59882,1602009837,wahoo,Zwift - 3R Sundown Race Series - iTT (E),Favero Assioma DUO,Wahoo KICKR v5,387,396,-9
61349,1602528599,wahoo,Zwift - Premier Division // Zwift Racing League (men) ,Favero Assioma DUO,Wahoo KICKR v5,406,414,-8
61853,1602691203,wahoo,Zwift - ZHQ Beta Crit City Race (A),Favero Assioma DUO,Wahoo KICKR v5,398,400,-2
63205,1603130879,wahoo,Zwift - Premier Division // Zwift Racing League (men) ,Favero Assioma DUO,Wahoo KICKR v5,392,394,-2
64195,1603387513,wahoo,Zwift - Espresso,Favero Assioma DUO,Wahoo KICKR v5,383,394,-11
65186,1603742396,wahoo,Zwift - Premier Division // Zwift Racing League (men) (A),Favero Assioma DUO,Wahoo KICKR v5,413,420,-7
67381,1604344073,wahoo,Zwift - Premier Division // Zwift Racing League (men) (A),Favero Assioma DUO,Wahoo KICKR v5,395,395,0
68416,1604646014,wahoo,Race 1 // Men // Z Pro Tri // Community,Favero Assioma DUO,Wahoo KICKR v5,379,381,-2
68417,1604647798,wahoo,Race 2 // Men // Z Pro Tri // Community,Favero Assioma DUO,Wahoo KICKR v5,367,365,2
68419,1604649594,wahoo,Race 3 // Men // Z Pro Tri // Community,Favero Assioma DUO,Wahoo KICKR v5,361,366,-5
68692,1604736298,wahoo,Zwift - 3R Weekend Race Club - Race 1 (A),Favero Assioma DUO,Wahoo KICKR v5,376,380,-4
69410,1604951997,wahoo,Zwift - Premier Division // Zwift Racing League (men) (A),Favero Assioma DUO,Wahoo KICKR v5,453,457,-4
70650,1605200697,wahoo,Zwift - OH MY CRIT! - The Double Race 2/2 (A),Favero Assioma DUO,Wahoo KICKR v5,362,369,-7
71240,1605341105,wahoo,Zwift - 3R Weekend Race Club - Race 1 (A),Favero Assioma DUO,Wahoo KICKR v5,380,384,-4
74108,1606043099,wahoo,Zwift - 3R Innsbruckring Sprint Race - 1 Lap (8.8km/5.5mi 77m) (A),Favero Assioma DUO,Wahoo KICKR v5,387,393,-6
76022,1606415690,wahoo,Zwift - WTRL NOPINZ WORLD TTT CHAMPIONSHIPS - Zone 6 (C),Favero Assioma DUO,Wahoo KICKR v5,397,398,-1
84647,1608289217,wahoo,Zwift - Tour of New York Stage 1 - Open Longer,Favero Assioma DUO,Wahoo KICKR v5,378,379,-1
88300,1609183188,wahoo,Team TFC Mad Monday Winter Series,Favero Assioma DUO,Wahoo KICKR v5,371,371,0
92854,1610044526,wahoo,Zwift - WTRL Team Time Trial - Zone 6 (C),Favero Assioma DUO,Wahoo KICKR v5,390,401,-11
98962,1610982948,wahoo,3R Volcano Circuit Sprint Flat Race - 1 Lap (6.6km/4.1mi 20m),Favero Assioma DUO,Wahoo KICKR v5,384,381,3
100227,1611158987,wahoo,Zwift - 3R Tick Tock Flat Race - 2 Lap (36km/22.4mi 100m) (A),Favero Assioma DUO,Wahoo KICKR v5,367,369,-2
100808,1611245687,wahoo,Zwift - OH MY CRIT! - The Double Race 1/2 (A),Favero Assioma DUO,Wahoo KICKR v5,387,397,-10
100833,1611248698,wahoo,Zwift - OH MY CRIT! - The Double Race 2/2 (A),Favero Assioma DUO,Wahoo KICKR v5,342,334,8
101690,1611397803,wahoo,Zwift - 3R Volcano Climb Race - 1 Lap (22.4km/14mi 204m) (A),Favero Assioma DUO,Wahoo KICKR v5,416,421,-5
102887,1611601480,wahoo,Premier Division // Zwift Racing League (men),Favero Assioma DUO,Wahoo KICKR v5,402,403,-1
106913,1612210029,wahoo,Zwift - Premier Division // Zwift Racing League (men) (A),Favero Assioma DUO,Wahoo KICKR v5,412,406,6
110997,1612811799,wahoo,Zwift - Premier Division // Zwift Racing League (men) (A),Favero Assioma DUO,Wahoo KICKR v5,405,412,-7
115385,1613419301,wahoo,Zwift - Premier Division // Zwift Racing League (men) (A),Favero Assioma DUO,Wahoo KICKR v5,421,425,-4
115744,1613491525,wahoo,Zwift - 3R Volcano Circuit Flat Race - 8 Laps (35.2km/21.9mi 160m) (A),Favero Assioma DUO,Wahoo KICKR v5,361,361,0
118257,1613835015,wahoo,Zwift - Team Draft Crit City Race (A),Favero Assioma DUO,Wahoo KICKR v5,366,379,-13
90301,1609602306,neo,Zwift - Watopia,Assioma duo,Tacx neo 2T,287,285,2
90610,1609661672,neo,Zwift - Team Italy & Frenchy Fuzion Endurance Race (A),Assioma duo,Tacx neo 2T,328,324,4
92043,1609916385,neo,Zwift - 3R Volcano Circuit Flat Race - 4 Laps (18.9km/11.7mi 80m) (A),Assioma duo,Tacx neo 2T,339,334,5
92329,1609955449,neo,Zwift - MIDWEEK Winter Series by SZR (A),Assioma duo,Tacx neo 2T,354,356,-2
92737,1610035910,neo,Zwift - OH MY CRIT! - The Double Race 1/2 (A),Assioma duo,Tacx neo 2T,381,380,1
92783,1610038086,neo,Zwift - OH MY CRIT! - The Double Race 2/2 (A),Assioma duo,Tacx neo 2T,345,342,3
96407,1610559057,neo,Zwift - 01/13/2021,Assioma duo,Tacx neo 2T,362,340,22
97023,1610648261,neo,Zwift - WTRL Team Time Trial - Zone 5 (C),Assioma duo,Tacx neo 2T,349,347,2
98206,1610820093,neo,Zwift - Championnat des departements Frenchy Fuzion (E),Assioma duo,Tacx neo 2T,347,348,-1
98389,1610870796,neo,Zwift - Team Italy & Frenchy Fuzion Endurance Race (A),Assioma duo,Tacx neo 2T,365,365,0
99714,1611080751,neo,Zwift - Zwift Racing League | WTRL - Men&#039;s/Mixed EMEA E2 DIVISION 5 (A),Assioma duo,Tacx neo 2T,353,350,3
100312,1611164704,neo,Zwift - MIDWEEK Winter Series by SZR (A),Assioma duo,Tacx neo 2T,342,342,0
100835,1611244822,neo,Zwift - OH MY CRIT! - The Double Race 1/2 (A),Assioma duo,Tacx neo 2T,359,352,7
100907,1611252379,neo,Zwift - WTRL Team Time Trial - Zone 4 (C),Assioma duo,Tacx neo 2T,353,349,4
102017,1611423268,neo,Zwift - 01/23/2021,Assioma duo,Tacx neo 2T,399,395,4
102242,1611475440,neo,Zwift - Team Italy & Frenchy Fuzion Endurance Race (A),Assioma duo,Tacx neo 2T,382,380,2
102984,1611594295,neo,Zwift -  SCF SWE Cup Men (A),Assioma duo,Tacx neo 2T,373,369,4
103471,1611684107,neo,Zwift - Zwift Racing League | WTRL - Men&#039;s/Mixed EMEA E1 DIVISION 6 (A),Assioma duo,Tacx neo 2T,382,382,0
104124,1611769714,neo,Zwift - MIDWEEK Winter Series by SZR (A),Assioma duo,Tacx neo 2T,0,0,0
104125,1611769714,neo,Zwift - MIDWEEK Winter Series by SZR (A),Assioma duo,Tacx neo 2T,363,361,2
105848,1612028554,neo,Zwift - Championnat de France Frenchy Fuzion (E),Assioma duo,Tacx neo 2T,391,390,1
105850,1612028554,neo,Zwift - Championnat de France Frenchy Fuzion (E),Assioma duo,Tacx neo 2T,391,390,1
107359,1612288971,neo,Zwift - Zwift Racing League | WTRL - Men&#039;s/Mixed EMEA E1 DIVISION 6 (A),Assioma duo,Tacx neo 2T,367,366,1
108768,1612454760,neo,Zwift - OH MY CRIT!! - The Double Race 1/2 (A),Assioma duo,Tacx neo 2T,349,348,1
108776,1612458047,neo,Zwift - 02/04/2021,Assioma duo,Tacx neo 2T,343,340,3
111764,1612895026,neo,Zwift - Zwift Racing League | WTRL - Men&#039;s/Mixed EMEA E1 DIVISION 6 (A),Assioma duo,Tacx neo 2T,391,386,5
112274,1612979999,neo,Zwift - MIDWEEK Winter Series by SZR (A),Assioma duo,Tacx neo 2T,361,345,16
112822,1613060100,neo,Zwift - OH MY CRIT!! - The Double Race 1/2 (A),Assioma duo,Tacx neo 2T,332,320,12
112845,1613063098,neo,Zwift - OH MY CRIT!! - The Double Race 2/2 (A),Assioma duo,Tacx neo 2T,345,337,8
116605,1613584797,neo,Zwift - 02/17/2021,Assioma duo,Tacx neo 2T,322,301,21
117201,1613667897,neo,Zwift - OH MY CRIT!! - The Double Race 2/2 (A),Assioma duo,Tacx neo 2T,355,345,10
117798,1613757598,neo,Zwift - KIRCHMAIR Race Series (A),6297937371_ACTIVITY,Tacx neo 2T,369,360,9
117810,1613759396,neo,Zwift - KIRCHMAIR Race Series (A),Assioma duo,Tacx neo 2T,320,312,8
119562,1614104396,neo,Zwift - 02/23/2021,Assioma duo,Tacx neo 2T,335,327,8
120251,1614189598,neo,Zwift - MIDWEEK Winter Series by SZR (A),Assioma duo,Tacx neo 2T,359,352,7
120684,1614269699,neo,Zwift - OH MY CRIT!! - The Double Race 1/2 (A),Assioma duo,Tacx neo 2T,336,326,10
120735,1614272697,neo,Zwift - OH MY CRIT!! - The Double Race 2/2 (A),Assioma duo,Tacx neo 2T,330,323,7
121196,1614272697,neo,Zwift - 02/26/2021,Assioma duo,Tacx neo 2T,330,115,215
121197,1614357476,neo,Zwift - SZ AW Party by SZR (A),Assioma duo,Tacx neo 2T,364,346,18
123964,1614874516,neo,Zwift - OH MY CRIT!! - The Double Race 1/2 (A),Assioma duo,Tacx neo 2T,378,373,5
124007,1614877521,neo,Zwift - OH MY CRIT!! - The Double Race 2/2 (A),Assioma duo,Tacx neo 2T,358,352,6
124499,1614960294,neo,Zwift - 3R Volcano Flat Race - 3 Laps (36.6km/22.7mi 138m) (A),Assioma duo,Tacx neo 2T,351,342,9
125100,1615043695,neo,Zwift - OH MY CRIT!! - Saturday Smash Race (A),Assioma duo,Tacx neo 2T,346,341,5
125447,1615130997,neo,Zwift - Team Draft Libby Hill After Party Race (A),Assioma duo,Tacx neo 2T,308,303,5
126175,1615307397,neo,Zwift - TEAM VEGAN Tofu Tornado (A),Assioma duo,Tacx neo 2T,387,384,3
127019,1615479296,neo,Zwift - OH MY CRIT!! - The Double Race 1/2 (A),Assioma duo,Tacx neo 2T,324,322,2
127025,1615482296,neo,Zwift - OH MY CRIT!! - The Double Race 2/2 (A),Assioma duo,Tacx neo 2T,346,343,3
128077,1615643998,neo,Zwift - Zwift Insider Badge Hunters - The PRL Full Edition,Assioma duo,Tacx neo 2T,361,359,2
129195,1615919393,neo,Zwift - CeramicSpeed Race Series: Open Race (A),Assioma duo,Tacx neo 2T,359,355,4
81064,1607533495,wahoo,Zwift - Guayaba Race by PETA-Z (A),Stages,Wahoo Kicrk,320,328,-8
81580,1607622355,wahoo,Zwift - Espresso,Stages,Wahoo Kicrk,298,309,-11
109385,1612544701,wahoo,Zwift - Ritxiper&#039;s Marmitako Social Ride con PETA-Z (E),Assioma Duo,Wahoo Kicrk,248,252,-4
122986,1614709456,neo,Zwift - Roll with Castelli & Laura Philipp (C),Assioma DUO,Tacx Neo Bike Smart,307,318,-11
123578,1614794256,neo,Zwift - MIDWEEK Crit Race Series by SZR (A),Assioma DUO,Tacx Neo Bike Smart,365,354,11
124878,1615026296,neo,Zwift - Cycling Weekly Winter Lockdown RR Series (A),Assioma DUO,Tacx Neo Bike Smart,364,364,0
126582,1615399008,neo,Zwift - MIDWEEK Crit Race Series by SZR (A),Assioma DUO,Tacx Neo Bike Smart,348,353,-5
126584,1615400439,neo,Zwift - UKAF Race night hosting the ACU Champs (A),Assioma DUO,Tacx Neo Bike Smart,319,332,-13
127567,1615571236,neo,Zwift - KIRCHMAIR Race Series (A),Assioma DUO,Tacx Neo Bike Smart,350,351,-1
127568,1615573412,neo,Zwift - KIRCHMAIR Race Series (A),Assioma DUO,Tacx Neo Bike Smart,356,358,-2
129221,1615573412,neo,Zwift - CeramicSpeed Race Series: Open Race (A),Assioma DUO,Tacx Neo Bike Smart,356,364,-8
129234,1615918886,neo,Zwift - CeramicSpeed Race Series: Open Race (A),Assioma DUO,Tacx Neo Bike Smart,381,364,17
53802,1598709343,wahoo,Zwift - OH MY CRIT - Saturday Smash Race* (A),Quarq,WAHOO,330,333,-3
53837,1598459502,wahoo,Zwift - MIDWEEK Summer Series by SZR (A),Quarq,Wahoo,309,336,-27
53840,1598187569,wahoo,Zwift - KISS at Race 100 - Americas (A),Qaurq,Wahoo,333,340,-7
53845,1597583339,wahoo,Zwift - KISS at Race 100 - Americas (A),Quarq,Wahoo,347,353,-6
54032,1597936185,wahoo,Zwift - OH MY CRIT! - The Double Race 2/2 (A),Quarq,Wahoo,295,295,0
54036,1597175617,wahoo,Zwift - 3R Volcano Flat Reverse Race - 3 Laps (36.6km/22.7mi 138m) (A),Quarq,Wahoo,311,315,-4
54257,1599689433,wahoo,Zwift - Austin Driveway Series Criterium (A),Quarq,Wahoo,314,322,-8
54918,1600006437,wahoo,Zwift - 3R Alpe Du Zwift KOM Race (20km 1444m) (A),2020-09-13-10-13-57,Wahoo,342,344,-2
55655,1600105754,wahoo,Zwift - TFC Mad Monday Autumn Series (1 of 9) (A),Quarq,Wahoo,297,303,-6
56030,1600375588,wahoo,Zwift - Crit City Race (A),2020-09-17-16-46-28,Wahoo,301,282,19
58124,1600985188,wahoo,Zwift - NYC,2020-09-28-19-12-10,Wahoo,155,163,-8
58125,1600986113,wahoo,Zwift - NYC,2020-09-28-19-26-16,Wahoo,121,163,-42
61378,1589636503,wahoo,Zwift - OCA Indoor Race Series (A),Quarq,Wahoo,373,384,-11
61379,1594473815,wahoo,Zwift - OH MY CRIT!! - Saturday Smash Race (A),Quarq,Wahoo,0,0,0
61380,1594473815,wahoo,Zwift - OH MY CRIT!! - Saturday Smash Race (A),Quarq,Wahoo,319,327,-8
64121,1603234942,wahoo,Zwift - Zwift Racing League | WTRL - AMERICAS E (MEN) - TTT Group 1 (A),Quarq,Wahoo,360,342,18
66654,1603919041,wahoo,Zwift - France,Quarq,Wahoo,303,307,-4
66794,1604155127,wahoo,Zwift - OH MY CRIT - Saturday Smash Race (A),Quarq,Wahoo,327,336,-9
72740,1604591905,wahoo,Zwift - OH MY CRIT! - The Double Race 2/2 (A),Quarq,Wahoo,0,0,0
73288,1605827459,wahoo,Zwift - NYC,Pioneer,Wahoo,133,133,0
74024,1605976636,wahoo,Zwift - Cycling Canada Pre-Worlds Showdown Series (A),Quarq,Wahoo,321,324,-3
74305,1606062062,wahoo,Zwift - 3R Racing (A),Quarq,Wahoo,356,351,5
87048,1608829347,wahoo,Zwift - ZHQ FutureWorks Circuit Race - Anti-sandbagging (A),Quarq,Wahoo,286,281,5
89242,1609367189,neo,Zwift - Watopia,Quarq,Tacx Neo 2,157,151,6
105934,1612046908,neo,Zwift - London,Quarq,Tacx Neo 2,149,143,6
106233,1612106335,neo,Zwift - Watopia,QAURQ RED,Tacx Neo 2,311,306,5
106852,1612209867,neo,Zwift - Premier Division // Zwift Racing League (men) (A),Quarq Red,Tacx Neo 2,325,324,1
110521,1612706150,wahoo,Zwift - KISS 100 Race Series - Americas (A),Quarq,Wahoo,359,353,6
111896,1612908913,wahoo,Zwift - Velocious Sport Tue Night Criterium (Race) (A),Quarq,Wahoo,313,302,11
112392,1612980763,wahoo,Zwift - Movistar Team Challenge // Round 1 (A),Quarq,Wahoo,329,327,2
114290,1613231728,wahoo,Zwift - 3R Classique Flat Race - 4 Laps (26.9km/16.7mi 76m) (A),Quarq,Wahoo,338,330,8
114857,1613313213,wahoo,Zwift - Team Draft Libby Hill After Party Race (A),Quarq,wahooC,296,291,5
73504,1605866400,wahoo,EVO CC 100km Base Ride [3.2-3.8w/kg avg] (B),Quarq D Zero Sram Red ,Wahoo Kickr 2018,308,284,24
94631,1610288098,wahoo,Zwift - KISS 100 Race Series - Americas (A),Garmin Vector 2,Wahoo Kickr 2018,401,396,5
95704,1610475597,wahoo,Zwift - Zwift Racing League | WTRL - Men&#039;s/Mixed EMEA E1 DIVISION 6 (A),Garmin Vector 2,Wahoo Kickr 2018,392,374,18
99751,1611078160,wahoo,Zwift - WTRL,Garmin Vector 2,Wahoo Kickr 2018,387,382,5
105240,1611946415,wahoo,Zwift - GGCC GlasgowGreen CC TT  (E),Garmin Vector 2,Wahoo Kickr 2018,437,424,13
111552,1612892537,wahoo,Zwift - Spin Ups 2.,Garmin Vector 2,Wahoo Kickr 2018,420,406,14
112901,1613060097,wahoo,Zwift - OH MY CRIT!! - The Double Race 1/2 (A),Garmin Vector 2,Wahoo Kickr 2018,394,374,20
112908,1613060097,wahoo,Zwift - OH MY CRIT!! - The Double Race 2/2 (A),Garmin Vector 2,Wahoo Kickr 2018,394,398,-4
115915,1613499599,wahoo,Zwift - Zwift Racing League | WTRL - Men&#039;s/Mixed EMEA E1 DIVISION 6 (A),Garmin Vector 2,Wahoo Kickr 2018,449,457,-8
119666,1614104398,wahoo,Zwift - Zwift Racing League | WTRL - Men&#039;s/Mixed EMEA E1 DIVISION 6 (A),Garmin Vector 2,Wahoo Kickr 2018,398,404,-6
92870,1610044565,neo,Tacx Neo 1 / Quarq Dzero,Quarq Dzero,Tacx Neo 1,0,0,0
92871,1610044565,neo,Tacx Neo 1 / Quarq Dzero,Quarq Dzero,Tacx Neo 1,438,427,11
103467,1611685221,neo,Zwift - Zwift Racing League | WTRL - Men&#039;s/Mixed EMEA E1 DIVISION 6 (A) ,Quarq Dzero,Tacx Neo 1,432,422,10
107318,1612290022,neo,Zwift - Zwift Racing League | WTRL - Men&#039;s/Mixed EMEA E1 DIVISION 6 (A),Quarq Dzero,Tacx Neo 1,411,398,13
111537,1612895239,neo,Zwift - Zwift Racing League | WTRL - Men&#039;s/Mixed EMEA E1 DIVISION 6 (A),Quarq Dzero,Tacx Neo 1,437,423,14
115857,1613499621,neo,Zwift - Zwift Racing League | WTRL - Men&#039;s/Mixed EMEA E1 DIVISION 6 (A),Quarq Dzero,Tacx Neo 1,452,438,14
119991,1614127698,neo,Zwift - Zwift Racing League | WTRL - Men&#039;s/Mixed AMERICAS E DIVISION 3 (A),Zwift,Tacx Neo 2T,352,352,0
121306,1614371123,neo,Zwift - 3R Innsbruckring Flat Race - 4 Laps (35.2km/21.9mi 308m) (A),Tacx Neo 2T,Tacx Neo 2T,414,414,0
124690,1614971093,neo,Zwift - Zwift Racing League | WTRL Battle Royale Playoff - Men&#039;s Points Race (A),Quarq D-Zero,Neo ,383,372,11
125211,1615060498,neo,Zwift - Zwift Racing League | WTRL Battle Royale Playoff - Men&#039;s TTT (A),Quarq D-Zero,Neo ,375,364,11
129215,1615919395,neo,Zwift - CeramicSpeed Race Series: Open Race (A) holy moly that was something else ..... ,Quarq D-Zero,Neo ,369,367,2
96071,1610441142,neo,Zwift Racing League | WTRL - Men&#039;s/Mixed APAC DIVISION 2,Dura-Ace R9100-P Crank-PM, Tacx Neo 2,316,321,-5
34658,1585979199,wahoo,vEverest Alpe du Zwift,Giant Power Pro Ultegra,Wahoo Kickr 2018,284,283,1
34726,1589477155,wahoo,Zwift - WTRL Team Time Trial Premier League (C),Giant Power Pro R8000,Wahoo Kickr 2018,388,391,-3
41058,1591896242,wahoo,Zwift - Espresso,Giant Power Pro R8000,Wahoo Kickr 2018,403,405,-2
49587,1597169649,wahoo,Zwift - ZWIFT NL - WAHOO Kickr Social Race,Giant Power Pro R8000,Wahoo Kickr 2018,380,392,-12
55048,1600106340,wahoo,Zwift - Invitational League // Qualifying Race #1,Giant Power Pro R8000,Wahoo Kickr 2018,403,413,-10
55848,1600367333,wahoo,Zwift - Invitational League // Qualifying Race #2 (Men) ,Giant Power Pro R8000,Wahoo Kickr 2018,393,396,-3
56407,1600606619,wahoo,Zwift - Invitational League // Qualifying Race #3 (Men) (A),Giant Power Pro R8000,Wahoo Kickr 2018,423,429,-6
73119,1605809994,wahoo,Zwift - Espresso,Giant Power Pro R8000,Wahoo Kickr 2018,407,416,-9
73862,1605971721,wahoo,Battery empty on one side,Giant Power Pro R8000,Wahoo Kickr 2018,401,416,-15
76018,1606415176,wahoo,Zwift - WTRL NOPINZ WORLD TTT CHAMPIONSHIPS - Zone 5 (C),Giant Power Pro R8000,Wahoo Kickr 2018,401,406,-5
79121,1607021939,wahoo,BENELIGA 2020-2021,Giant Power Pro R8000,Wahoo Kickr 2018,415,420,-5
80817,1607450447,wahoo,Zwift - Zwift Racing League | WTRL - Men&#039;s EMEA E1 DIVISION 1 (A),dualzwiftdinsdag,Wahoo Kickr 2018,400,409,-9
80823,1607450447,wahoo,Zwift - Zwift Racing League | WTRL - Men&#039;s EMEA E1 DIVISION 1 (A),Giant Power Pro R8000,Wahoo Kickr 2018,400,409,-9
84444,1608231539,wahoo,Zwift - BENELIGA 2020-2021 (E),Giant Power Pro R8000,Wahoo Kickr 2018,436,446,-10
85115,1608390716,wahoo,"Zwift - OH MY CRIT - Saturday Smash Race (A) So close, yet so far away.",Giant Power Pro R8000,Wahoo Kickr 2018,423,433,-10
86562,1608745800,wahoo,Zwift - MIDWEEK Winter Series by SZR (A),Giant Power Pro R8000,Wahoo Kickr 2018,378,389,-11
88298,1609183166,wahoo,Zwift - Team TFC Mad Monday Winter Series (A),Giant Power Pro R8000,Wahoo Kickr 2018,378,389,-11
88703,1609268039,wahoo,Zwift - Team Italy & Frenchy Fuzion League (A),Giant Power Pro R8000,Wahoo Kickr 2018,451,466,-15
93641,1610045902,wahoo,Zwift - BENELIGA 2020-2021 (E),Giant Power Pro R8000,Wahoo Kickr 2018,433,448,-15
97889,1610650541,wahoo,Zwift - BENELIGA 2020-2021 (E),Giant Power Pro R8000,Wahoo Kickr 2018,421,428,-7
102151,1611255546,wahoo,Zwift - BENELIGA 2020-2021 (E),Giant Power Pro R8000,Wahoo Kickr V5 Studio,403,404,-1
103530,1611684854,wahoo,Zwift - Zwift Racing League | WTRL - Men&#039;s/Mixed EMEA E1 DIVISION 1 (A),Giant Power Pro R8000,Wahoo Kickr 2018,416,431,-15
108325,1612378741,wahoo,Zwift - Open - Movistar Team Challenge Community Qualifier Race #1,Giant Power Pro R8000,Wahoo Kickr 2018,428,443,-15
78384,1606848916,wahoo,Zwift - Team Italy & Frenchy Fuzion League (A),Rotor 2 InPower,Wahoo KICKR,293,294,-1
78926,1607015120,wahoo,Zwift - OH MY CRIT! - The Double Race 2/2 (A),Rotor 2 InPower,Wahoo KICKR,282,278,4
80195,1607264124,wahoo,Zwift - KISS 100 Race Series - Americas (A),Rotor 2 InPower,Wahoo KICKR,305,302,3
81081,1607536805,wahoo,Zwift - MIDWEEK Winter Series by SZR (A),Rotor 2 InPower,Wahoo KICKR,294,289,5
81497,1607616914,wahoo,Zwift - OH MY CRIT! - The Double Race 1/2 (A),Rotor 2 InPower,Wahoo KICKR,279,278,1
81511,1607619917,wahoo,Zwift - OH MY CRIT! - The Double Race 2/2 (A),Rotor 2 InPower,Wahoo KICKR,273,276,-3
84316,1608224714,wahoo,Zwift - OH MY CRIT! - The Double Race 2/2 (A),Rotor 2 InPower,Wahoo KICKR,293,292,1
84757,1608310800,wahoo,Zwift - Tour of New York Stage 1 - Open Longer,Rotor 2 InPower,Wahoo KICKR,276,277,-1
86181,1608662112,wahoo,Zwift - Team Sportslab UK Road Race League (A),Rotor 2 InPower,Wahoo KICKR,248,242,6
85288,1608401098,neo,Zwift - 3R Three Sisters Hilly Race (47km/29.2mi 879m) (A),Pioneer Dual Sided Ultegra Crankset,Tacx Neo 2,341,328,13
88782,1608688940,neo,Zwift - Zwift Time Trial Tuesday: Bologna (E),Pioneer Dual Sided Ultegra Crankset,Tacx Neo 2,369,352,17
88786,1609279306,neo,Zwift - Zwift Time Trial Tuesday: Tempus Fugit,Quarq Dzero,Tacx Neo 2,378,357,21
89993,1609451755,neo,Zwift - 3R Alpe Du Zwift KOM Race (20km 1444m) (A),Quarq Dzero,Tacx Neo 2,365,347,18
92016,1609902474,neo,Zwift - Easy Spin,Quarq Dzero,Tacx Neo 2,331,308,23
92510,1609608437,neo,Zwift - 3R Three Sisters Hilly Race (47km/29.2mi 879m) (A),Quarq Dzero,Tacx Neo 2,373,350,23
95964,1610498459,neo,Zwift - Warmup _ Wax Chain Test,Powertap P1s,Tacx Neo 2,330,306,24
96699,1610584792,neo,Zwift - Cycling Canada Wednesday Night Race Series (A),Powertap P1s,Tacx Neo 2,394,366,28
96702,1610590428,neo,Zwift - EVR Definitely Not the WTNC (A),Powertap P1s,Tacx Neo 2,330,306,24
97263,1610679886,neo,Zwift - 3R Greater London Flat Race - 2 Laps (28.5km/17.7mi 90m) (A),Powertap P1s,Tacx Neo 2,357,336,21
113046,1613067504,wahoo,WattBike / Assioma Uno To Wahoo Bolt,WattBike,Assioma Uno To Wahoo Bolt,372,373,-1
115609,1613464430,wahoo,WattBike / Assioma Uno To Wahoo Bolt,WattBike,Assioma Uno To Wahoo Bolt,396,383,13
118232,1613813125,wahoo,WattBike / Assioma Uno To Wahoo Bolt,WattBike,Assioma Uno To Wahoo Bolt,378,366,12
61560,1602609295,neo,Zwift - Zwift Racing League | WTRL 5th,Quarq DZero,taco neo 2t,362,338,24
55839,1600367410,wahoo,Zwift - Invitational League // Qualifying Race #2 (Men) ,Quarq DFour PM,Wahoo Kickr V5,361,349,12
56372,1600597811,wahoo,Stages of DIRT (A),Quarq DFour PM,Wahoo Kickr V5,324,323,1
56375,1600602312,wahoo,Crit City Race (A),Quarq DFour PM,Wahoo Kickr V5,329,333,-4
57745,1601118598,wahoo,Zwift - Jed Scott [DRFT]&#039;s Meetup - Three Sisters,Quarq DFour PM,Wahoo Kickr V5,395,379,16
60594,1602259519,wahoo,Zwift - 3R Volcano Flat Race - 3 Laps (36.6km/22.7mi 138m) (A),Quarq DFour PM,Wahoo Kickr V5,376,388,-12
64840,1603624813,wahoo,Zwift - Ottawa TopSpeed Race (A),Quarq DFour PM,Wahoo Kickr V5,381,371,10
65172,1603742425,wahoo,Zwift - Premier Division // Zwift Racing League (men) (A),Quarq DFour PM,Wahoo Kickr V5,374,362,12
67267,1604344271,wahoo,Zwift - Premier Division // Zwift Racing League (men) (A),Quarq DFour PM,Wahoo Kickr V5,355,349,6
69414,1604952012,wahoo,Zwift - Premier Division // Zwift Racing League (men) (A),Quarq DFour PM,Wahoo Kickr V5,405,395,10
72160,1605553543,wahoo,Zwift - Premier Division // Zwift Racing League (men) (A),Quarq DFour PM,Wahoo Kickr V5,364,353,11
74670,1606161617,wahoo,Zwift - Premier Division // Zwift Racing League (men) (A),Quarq DFour PM,Wahoo Kickr V5,405,396,9
89912,1609520862,wahoo,Zwift - Watopia,Zwift,Threesisterswahoo,375,373,2
94372,1610273425,wahoo,Zwift - 3R Sand & Sequoias - 1 Lap (20km/12.5mi 173m) (A),Garmin Vector 3s to Wahoo Bolt,Wahoo Kickr to Zwift,397,383,14
95050,1610390401,wahoo,Zwift - Premier Division // Zwift Racing League (men) (A),Garmin Vector 3s to Wahoo Bolt,Wahoo Kickr to Zwift,413,365,48
97126,1610653542,wahoo,Zwift - 3R LaGuardia Loop Flat Race - 6 Laps (17.5km/10.9 162m) (A),Garmin Vector 3s to Wahoo Bolt,Wahoo Kickr to Zwift,159,387,-228
97136,1610655418,wahoo,Zwift - 3R LaGuardia Loop Flat Race - 6 Laps (17.5km/10.9 162m) (A),Garmin Vector 3s to Wahoo Bolt,Wahoo Kickr to Zwift,412,387,25
98637,1610734518,wahoo,Zwift - Mikey Mottram &#039;s Meetup - R.G.V.,Garmin Vector 3s to Wahoo Bolt,Wahoo Kickr to Zwift,404,420,-16
98641,1610820009,wahoo,Zwift - 3R Three Sisters Hilly Race (47km/29.2mi 879m) (A),Garmin Vector 3s to Wahoo Bolt,Wahoo Kickr to Zwift,371,379,-8
98732,1610909471,wahoo,Zwift - BRT Iron Goat Racing League (A),Garmin Vector 3s to Wahoo Bolt,Wahoo Kickr to Zwift,397,387,10
99212,1610996516,wahoo,Zwift - Premier Division // Zwift Racing League (men) (A),Garmin Vector 3s to Wahoo Bolt,Wahoo Kickr to Zwift,398,391,7
102384,1611482558,wahoo,Zwift - 3R Sand & Sequoias - 1 Lap (20km/12.5mi 173m) (A),Garmin Vector 3s to Wahoo Bolt,Wahoo Kickr to Zwift,417,444,-27
103001,1611600553,wahoo,Zwift - Premier Division // Zwift Racing League (men) (A),Garmin Vector 3s to Wahoo Bolt,Wahoo Kickr to Zwift,398,430,-32
106711,1612093949,wahoo,Zwift - 3R Whole Lotta Lava Hilly Race - 1 Lap (16.9km/10.5mi 183m) (A),Garmin Vector 3s to Wahoo Bolt,Wahoo Kickr to Zwift,408,398,10
106945,1612209637,wahoo,Zwift - Premier Division // Zwift Racing League (men) (A),Garmin Vector 3s to Wahoo Bolt,Wahoo Kickr to Zwift,436,419,17
110383,1612692622,wahoo,Zwift - 3R Sand & Sequoias - 1 Lap (20km/12.5mi 173m) (A),Garmin Vector 3s to Wahoo Bolt,Wahoo Kickr to Zwift,422,450,-28
110977,1612771338,wahoo,Zwift - 3R Sand & Sequoias - 1 Lap (20km/12.5mi 173m) (A),Garmin Vector 3s to Wahoo Bolt,Wahoo Kickr to Zwift,365,391,-26
110986,1612810827,wahoo,Zwift - Premier Division // Zwift Racing League (men) (A),Garmin Vector 3s to Wahoo Bolt,Wahoo Kickr to Zwift,408,430,-22
115173,1613332399,wahoo,Zwift - KISS Race Series - EU PM (A),Garmin Vector 3s to Wahoo Bolt,Wahoo Kickr to Zwift,0,0,0
115174,1613332399,wahoo,Zwift - KISS Race Series - EU PM (A),Garmin Vector 3s to Wahoo Bolt,Wahoo Kickr to Zwift,399,403,-4
115442,1613418635,wahoo,Zwift - Premier Division // Zwift Racing League (men) (A),Garmin Vector 3s to Wahoo Bolt,Wahoo Kickr to Zwift,431,436,-5
118835,1613931083,wahoo,Zwift - 3R Watopia Hilly Reverse Race - 4 Laps (36.7km/22.8mi 400m) (A),Garmin Vector 3s to Wahoo Bolt,Wahoo Kickr to Zwift,365,382,-17
119265,1614019010,wahoo,Zwift - Premier Division // Zwift Racing League (men) (A),Garmin Vector 3s to Wahoo Bolt,Wahoo Kickr to Zwift,405,424,-19
122584,1614628435,wahoo,Zwift - Premier Division // Zwift Racing League (men) (A),Garmin Vector 3s to Wahoo Bolt,Wahoo Kickr to Zwift,445,438,7
37739,1590484208,wahoo,Zwift - SRAM Send it Series - Race 3 - Men&#039;s (E),Quarq DZero,Wahoo Kickr,406,410,-4
37740,1589880002,wahoo,Zwift - The After Party Race (A),Quarq DZero,Wahoo Kickr,380,383,-3
75451,1606265143,wahoo,Zwift - Zwift Racing League | WTRL - Men&#039;s AMERICAS E DIVISION 1,Quarq DZero,Wahoo Kickr,408,403,5
79901,1588812298,wahoo,Zwift - OH MY CRIT - Saturday Smash Race (A),Quarq DZero,Wahoo Kickr,356,367,-11
79902,1607181300,wahoo,Zwift - OH MY CRIT - Saturday Smash Race (A),Quarq DZero,Wahoo Kickr,372,367,5
49950,1597394910,wahoo,Zwift - Off the MAAP Invitational Race // Stage 1 (Men) (A),rotor inpower bmc,WAHOO kickr,425,383,42
53027,1599045593,wahoo,Zwift - 3R Volcano Circuit Flat Race - 6 Laps (27km/16.8mi 120m) (A),rotor inpower bmc,WAHOO kickr,358,334,24
53053,1599051593,wahoo,Zwift - KISS at Race - Pacific AM (A),rotor inpower bmc,WAHOO kickr,348,319,29
56835,1600797587,wahoo,Zwift - RHYS HOWELL [CANYON]&#039;s Meetup - Road to Ruins,rotor inpower bmc,WAHOO kickr,420,384,36
58879,1601568292,wahoo,Zwift - OH MY CRIT! - The Double Race 2/2 (A),rotor inpower bmc,WAHOO kickr,369,337,32
58881,1601565297,wahoo,Zwift - OH MY CRIT! - The Double Race 1/2 (A),rotor inpower bmc,WAHOO kickr,384,356,28
70728,1605206936,wahoo,Zwift - Espresso,rotor inpower bmc,wahoo kickr core,367,356,11
71890,1605523206,wahoo,Zwift - France,rotor inpower bmc,wahoo kickr core,264,270,-6
72303,1605553532,wahoo,Zwift - Premier Division // Zwift Racing League (men) (A),rotor inpower bmc,WAHOO kickr,0,0,0
72305,1605553532,wahoo,Zwift - Premier Division // Zwift Racing League (men) (A),rotor inpower bmc,WAHOO kickr,394,391,3
73084,1605811075,wahoo,Zwift - Espresso,rotor inpower bmc,wahoo kickr core,369,369,0
74709,1606161486,wahoo,Zwift - Premier Division // Zwift Racing League (men) (A),rotor inpower bmc,wahoo kickr core,375,384,-9
75600,1606330794,wahoo,Zwift - DCU – Feltet.dk November series (A),rotor inpower bmc,wahoo kickr core,386,401,-15
86544,1608739187,wahoo,Zwift - Endurance w/Vo2,rotor inpower,wahoo kickr core,354,358,-4
87055,1608833721,wahoo,Zwift - Vienna,rotor inpower bmc,wahoo kickr core,378,375,3
87896,1609078479,wahoo,Zwift - KISS 100 Race Series - Americas (A),rotor inpower bmc,wahoo kickr core,388,387,1
89117,1609351143,wahoo,Zwift - MIDWEEK Winter Series by SZR (A),rotor inpower bmc,wahoo kickr core,389,399,-10
89328,1609405856,wahoo,Zwift - Jamie Morris[EVOQ]  &#039;s Meetup - Three Sisters,rotor inpower bmc,wahoo kickr core,419,418,1
90854,1609683285,wahoo,Zwift - KISS 100 Race Series - Americas (A),rotor inpower bmc,wahoo kickr core,384,384,0
91865,1609872896,wahoo,wahoo kickr core / rotor inpower bmc,rotor inpower bmc,wahoo kickr core,402,383,19
98890,1610738100,wahoo,Zwift - Jamie Morris[ENSH]  &#039;s Meetup - Three Sisters,rotor inpower,wahoo kickr core,369,357,12
102067,1611424947,wahoo,Zwift - Championnat des Regions Frenchy Fuzion (E),rotor inpower bmc,wahoo kickr core,418,432,-14
102925,1611601326,wahoo,Zwift - Premier Division // Zwift Racing League (men) (A),rotor inpower bmc,wahoo kickr core,391,408,-17
104154,1611770372,wahoo,Zwift - MIDWEEK Winter Series by SZR (A),rotor inpower bmc,wahoo kickr core,364,369,-5
104768,1611858600,wahoo,Zwift - FUSION WINTER CUP (A),rotor inpower bmc,wahoo kickr core,339,359,-20
106914,1612209942,wahoo,Zwift - Premier Division // Zwift Racing League (men) (A),rotor inpower bmc,wahoo kickr core,376,395,-19
108854,1612462415,wahoo,Zwift - Vienna,rotor inpower bmc,wahoo kickr core,380,398,-18
117267,1613672363,wahoo,Zwift -  III Liga ZESP - Etapa 2 (A),rotor inpower bmc,wahoo kickr core,397,390,7
118766,1613916882,wahoo,Zwift - KISS 100 Race Series - Americas (A),rotor inpower bmc,wahoo kickr core,386,385,1
122658,1614629498,wahoo,Zwift - Premier Division // Zwift Racing League (men) (A),rotor inpower bmc,wahoo kickr core,381,386,-5
125473,1615126489,wahoo,Zwift - KISS 100 Race Series (Americas) - The Uber Pretzel Edition (A),rotor inpower bmc,wahoo kickr core,410,414,-4
95912,1610481121,neo,Zwift - Zwift Racing League | WTRL - Men&#039;s/Mixed EMEA W2 DIVISION 1 (A),Quarq Dzero,Tacx Neo 2T,402,373,29
98605,1610892904,neo,Zwift - KISS 100 Race Series - Americas (A),Quarq Dzero,Tacx Neo 2T,365,353,12
99915,1611086341,neo,Zwift - Zwift Racing League | WTRL - Men&#039;s/Mixed EMEA W2 DIVISION 1 (A),Quarq Dzero,Tacx Neo 2T,390,372,18
102262,1611479100,neo,Zwift - Newbury Velo Road Race (A),Quarq Dzero,Tacx Neo 2T,407,384,23
103613,1611690720,neo,Zwift - Zwift Racing League | WTRL - Men&#039;s/Mixed EMEA W2 DIVISION 1 (A),Quarq Dzero,Tacx Neo 2T,408,390,18
105438,1611999000,neo,Zwift - DBR SufferDay League III (A),Quarq Dzero,Tacx Neo 2T,391,355,36
106267,1612102526,neo,Zwift - KISS 100 Race Series - Americas (A),Quarq Dzero,Tacx Neo 2T,406,387,19
122031,1614508201,neo,Zwift - ODZentury Sunday Endurance Ride (B),Quarq Dzero,Tacx Neo 2T,282,274,8
53735,1599478190,wahoo,Zwift - 3R Innsbruckring Flat Race - 3 Laps (26.4km/16.4mi 231m) (A),Garmin 3S Vector Pedals,Wahoo Kickr,314,319,-5
53920,1599567893,wahoo,Zwift - EMU Japan Race (A),Garmin 3S Vector Pedals,Wahoo Kickr,347,353,-6
54097,1599652823,wahoo,Garmin 3S Vector Pedals / Wahoo Kickr,Garmin 3S Vector Pedals,Wahoo Kickr,308,364,-56
54644,1599831301,wahoo,Zwift - Crit City Race (A),Garmin 3S Vector Pedals,Wahoo Kickr,321,323,-2
55031,1600106396,wahoo,Zwift - Invitational League // Qualifying Race #1,Garmin 3S Vector Pedals,Wahoo Kickr,380,360,20
55200,1600111617,wahoo,Zwift - NYC,Garmin 3S Vector Pedals,Wahoo Kickr,282,266,16
55532,1600260043,wahoo,Zwift - Nick Hird [CRYO RDT]&#039;s Meetup - Champs-Élysées,Garmin 3S Vector Pedals,Wahoo Kickr,302,294,8
55861,1600367392,wahoo,Zwift - Invitational League // Qualifying Race #2 (Men) ,Garmin 3S Vector Pedals,Wahoo Kickr,337,338,-1
56251,1600514099,wahoo,Zwift - Herd Summer Racing League Race 5 (A),Garmin 3S Vector Pedals,Wahoo Kickr,331,334,-3
56631,1600691988,wahoo,Zwift - 3R Volcano Climb Race - 1 Lap (22.4km/14mi 204m) (A),Garmin 3S Vector Pedals,Wahoo Kickr,355,361,-6
56805,1600780493,wahoo,Zwift - 3R Figure 8 Hilly Reverse Race - 1 Lap (29.2km/18.1mi 234m ) (A),Garmin 3S Vector Pedals,Wahoo Kickr,324,326,-2
56985,1600862393,wahoo,Zwift - TTR Mini RACE (A),Garmin 3S Vector Pedals,Wahoo Kickr,358,362,-4
57207,1600947005,wahoo,Zwift - Eastern Canadian Quest Racing Series (ECQRS) (A),Garmin 3S Vector Pedals,Wahoo Kickr,361,362,-1
57679,1601118072,wahoo,Zwift - Herd Summer Racing League Series (A),Garmin 3S Vector Pedals,Wahoo Kickr,383,372,11
58229,1601380190,wahoo,Zwift - TTR Weekly  (A),Garmin 3S Vector Pedals,Wahoo Kickr,347,342,5
58467,1601470796,wahoo,Zwift - KISS at Race - Pacific AM (A),Garmin 3S Vector Pedals,Wahoo Kickr,335,333,2
59066,1601647517,wahoo,Zwift - 3R Innsbruckring Flat Race - 2 Laps (17.6km/10.9m 154m) (A),Garmin 3S Vector Pedals,Wahoo Kickr,347,343,4
59430,1601819087,wahoo,Zwift - Herd Summer Racing League Series (A),Garmin 3S Vector Pedals,Wahoo Kickr,334,345,-11
59571,1601905197,wahoo,Zwift - 3R Richmond UCI Hilly Race - 1 Lap (16.2km/10.1mi 142m) (A),Garmin 3S Vector Pedals,Wahoo Kickr,344,348,-4
60573,1602247797,wahoo,Zwift - KISS at Race - Pacific AM (A),Garmin 3S Vector Pedals,Wahoo Kickr,380,372,8
61067,1602423895,wahoo,Zwift - Herd Summer Racing League Series (A),Garmin 3S Vector Pedals,Wahoo Kickr,393,376,17
61686,1602633983,wahoo,Zwift - ZADA Test - Three Sisters,Garmin 3S Vector Pedals,Wahoo Kickr,346,341,5
62086,1602767090,wahoo,Zwift - 3R Knickerbocker Climbing Race - 1 Lap (22.4km/13.9mi 365m) (A),Garmin 3S Vector Pedals,Wahoo Kickr,359,368,-9
62595,1602933321,wahoo,Zwift - Herd Summer Racing League Series (A),Garmin 3S Vector Pedals,Wahoo Kickr,346,351,-5
63503,1603214195,wahoo,Zwift - Zwift Racing League | WTRL - EMEA E (MEN) - TTT Grp 1,Garmin 3S Vector Pedals,Wahoo Kickr,328,342,-14
64208,1603387544,wahoo,Zwift - Espresso,Garmin 3S Vector Pedals,Wahoo Kickr,356,349,7
64694,1603566885,wahoo,Zwift - Herd Summer Racing League Series (A),Garmin 3S Vector Pedals,Wahoo Kickr,320,310,10
65612,1603842295,wahoo,Zwift - Zwift Racing League | WTRL - AMERICAS E (MEN) -  Division 1 (A),Garmin 3S Vector Pedals,Wahoo Kickr,373,364,9
66031,1603970996,wahoo,Zwift - Eastern Canadian Quest Racing Series (ECQRS) (A),Garmin 3S Vector Pedals,Wahoo Kickr,356,367,-11
66406,1604060396,wahoo,Zwift - Peak-PTY Climb Challenge Fridays (A),Garmin 3S Vector Pedals,Wahoo Kickr,339,355,-16
66774,1604170793,wahoo,Zwift - EVR Summer Series (A),Garmin 3S Vector Pedals,Wahoo Kickr,346,338,8
67178,1604321996,wahoo,Zwift - ZA Road 2020 - Segment Ride #1: Three Sisters Course,Garmin 3S Vector Pedals,Wahoo Kickr,343,334,9
67537,1604409292,wahoo,Zwift - 3R Figure 8 Hilly Reverse Race - 1 Lap (29.2km/18.1mi 234m ) (A),Garmin 3S Vector Pedals,Wahoo Kickr,330,330,0
68106,1604581495,wahoo,Zwift - 3R Knickerbocker Climbing Race - 1 Lap (22.4km/13.9mi 365m) (A),Garmin 3S Vector Pedals,Wahoo Kickr,355,380,-25
68894,1604776200,wahoo,Zwift - ZA Road Race #1: 4 - 5 w/kg,Garmin 3S Vector Pedals,Wahoo Kickr,367,361,6
69999,1605055500,wahoo,Zwift - Zwift Racing League | WTRL - AMERICAS E (MEN) -  Division 1 (A),Garmin 3S Vector Pedals,Wahoo Kickr,392,391,1
70603,1605183889,wahoo,Zwift - EMU Japan Race (A),Garmin 3S Vector Pedals,Wahoo Kickr,347,350,-3
71490,1605384000,wahoo,Zwift - Cycling Australia&#039;s PretzHELL by AHDR (B),Garmin 3S Vector Pedals,Wahoo Kickr,324,299,25
72131,1605531588,wahoo,Zwift - ZA Road 2020 - Segment Ride #1: Innsbruck Course,2020-11-16-06-59-48,Wahoo Kickr,343,334,9
72411,1605660774,wahoo,Zwift - Zwift Racing League | WTRL - Men&#039;s AMERICAS E DIVISION 1 (A),Garmin 3S Vector Pedals,Wahoo Kickr,335,337,-2
73446,1605874797,wahoo,Zwift - Peak-PTY Climb Challenge Fridays (A),Garmin 3S Vector Pedals,Wahoo Kickr,356,359,-3
73917,1605978020,wahoo,Zwift - Cycling Canada Pre-Worlds Showdown Series (A),Garmin 3S Vector Pedals,Wahoo Kickr,412,390,22
75273,1606265090,wahoo,Zwift - Zwift Racing League | WTRL - Men&#039;s AMERICAS E DIVISION 1,Garmin 3S Vector Pedals,Wahoo Kickr,372,363,9
75874,1606395896,wahoo,Zwift - 3R Knickerbocker Climbing Race - 1 Lap (22.4km/13.9mi 365m) (A),Garmin 3S Vector Pedals,Wahoo Kickr,386,355,31
76578,1606501791,wahoo,Zwift - Team WEZ Friday Race (E),Garmin 3S Vector Pedals,Wahoo Kickr,354,351,3
77584,1606743593,wahoo,Zwift - 3R Richmond UCI Hilly Race - 1 Lap (16.2km/10.1mi 142m) (A),Garmin 3S Vector Pedals,Wahoo Kickr,350,354,-4
78285,1606870425,wahoo,Zwift - Zwift Racing League | WTRL - Men&#039;s AMERICAS E DIVISION 1 (A),Garmin 3S Vector Pedals,Wahoo Kickr,349,347,2
78869,1607000691,wahoo,Zwift - 3R Knickerbocker Climbing Race - 1 Lap (22.4km/13.9mi 365m) (A),Garmin 3S Vector Pedals,Wahoo Kickr,364,385,-21
79424,1607101240,wahoo,Zwift - Zwift Fast Fridays: Bologna Time Trial (E),Garmin 3S Vector Pedals,Wahoo Kickr,368,345,23
79893,1607191198,wahoo,Zwift - Nations Challenge // USA (E),Garmin 3S Vector Pedals,Wahoo Kickr,346,336,10
80796,1607451299,wahoo,Zwift - Zwift Racing League | WTRL - Men&#039;s EMEA E1 DIVISION 1 (A),Garmin 3S Vector Pedals,Wahoo Kickr,377,367,10
80994,1607474697,wahoo,Zwift - Zwift Racing League | WTRL - Men&#039;s AMERICAS E DIVISION 1 (A),Garmin 3S Vector Pedals,Wahoo Kickr,352,358,-6
81986,1607699685,wahoo,Zwift - 3R Sand and Sequoias Race (A),Garmin 3S Vector Pedals,Wahoo Kickr,328,329,-1
82446,1607790598,wahoo,Zwift - TEAM VEGAN Tofu Tornado (A),Garmin 3S Vector Pedals,Wahoo Kickr,383,377,6
83756,1608080040,wahoo,Zwift - Zwift Racing League | WTRL - Men&#039;s AMERICAS E DIVISION 1 (A),Garmin 3S Vector Pedals,Wahoo Kickr,345,342,3
84250,1608210290,wahoo,Zwift - 3R Knickerbocker Climbing Race - 1 Lap (22.4km/13.9mi 365m) (A),Garmin 3S Vector Pedals,Wahoo Kickr,367,370,-3
85224,1608397190,wahoo,Zwift - Tour of New York Stage 2 - Open Longer,Garmin 3S Vector Pedals,Wahoo Kickr,365,372,-7
85225,1608400978,wahoo,Zwift - World Uniform E-cycling Championship Frenchy Fuzion,Garmin 3S Vector Pedals,Wahoo Kickr,373,363,10
85437,1608476394,wahoo,Zwift - Tour of New York Stage 3 - Open Longer,Garmin 3S Vector Pedals,Wahoo Kickr,345,355,-10
86462,1608731979,wahoo,Zwift - KISS Race Series - Pacific AM (A),Garmin 3S Vector Pedals,Wahoo Kickr,356,371,-15
87191,1608904194,wahoo,Zwift - KISS Race Series - Pacific AM (A),Garmin 3S Vector Pedals,Wahoo Kickr,394,373,21
88985,1609333176,wahoo,Zwift - ZHQ FutureWorks Crit City Race - Boost mode (A),Garmin 3S Vector Pedals,Wahoo Kickr,319,339,-20
88986,1609334972,wahoo,Zwift - ZHQ FutureWorks Circuit Race - Anti-sandbagging (A),Garmin 3S Vector Pedals,Wahoo Kickr,336,336,0
90353,1609604991,wahoo,Zwift - TEAM VEGAN Tofu Tornado (A),Garmin 3S Vector Pedals,Wahoo Kickr,358,353,5
91212,1609767589,wahoo,Zwift - 3R Richmond UCI Hilly Race - 1 Lap (16.2km/10.1mi 142m) (A),Garmin 3S Vector Pedals,Wahoo Kickr,345,346,-1
91669,1609847994,wahoo,Zwift - TDZ Stage 1: Longer Ride,Garmin 3S Vector Pedals,Wahoo Kickr,358,351,7
92225,1609938119,wahoo,Zwift - TDZ Stage 1: Standard Ride,Garmin 3S Vector Pedals,Wahoo Kickr,345,343,2
92700,1610024697,wahoo,Zwift - 3R Knickerbocker Climbing Race - 1 Lap (22.4km/13.9mi 365m) (A),Garmin 3S Vector Pedals,Wahoo Kickr,370,389,-19
94030,1610215319,wahoo,Zwift - TDZ Stage 2: Standard Ride,Garmin 3S Vector Pedals,Wahoo Kickr,348,343,5
94031,1610209798,wahoo,Zwift - TEAM VEGAN Tofu Tornado (A),Garmin 3S Vector Pedals,Wahoo Kickr,355,357,-2
94439,1610290795,wahoo,Zwift - TDZ Stage 2: Longer Ride,Garmin 3S Vector Pedals,Wahoo Kickr,359,347,12
95591,1610475285,wahoo,Zwift - Zwift Racing League | WTRL - Men&#039;s/Mixed EMEA E1 DIVISION 1 (A),Garmin 3S Vector Pedals,Wahoo Kickr,380,371,9
96293,1610550120,wahoo,Zwift - TDZ Stage 2: Standard Ride,Garmin 3S Vector Pedals,Wahoo Kickr,346,333,13
96811,1610625599,wahoo,Zwift - TDZ Stage 3: Longer Ride,Garmin 3S Vector Pedals,Wahoo Kickr,336,332,4
97467,1610726578,wahoo,Zwift - TDZ Stage 3: Shorter Ride,Garmin 3S Vector Pedals,Wahoo Kickr,326,308,18
98178,1610814599,wahoo,Zwift - TEAM VEGAN Tofu Tornado (A),Garmin 3S Vector Pedals,Wahoo Kickr,374,355,19
99982,1611104065,wahoo,Zwift - Zwift Racing League | WTRL - Men&#039;s/Mixed AMERICAS E DIVISION 1 (A),Garmin 3S Vector Pedals,Wahoo Kickr,355,356,-1
100199,1611151200,wahoo,Zwift - KISS Race Series - Pacific AM (A),Garmin 3S Vector Pedals,Wahoo Kickr,345,346,-1
100759,1611233994,wahoo,Zwift - TDZ Stage 4: Longer Ride,Garmin 3S Vector Pedals,Wahoo Kickr,341,337,4
102015,1611419385,wahoo,Zwift - TEAM VEGAN Tofu Tornado (A),Garmin 3S Vector Pedals,Wahoo Kickr,418,404,14
102374,1611493195,wahoo,Zwift - TDZ Stage 5: Standard Ride,Garmin 3S Vector Pedals,Wahoo Kickr,363,349,14
103796,1611708343,wahoo,Zwift - Zwift Racing League | WTRL - Men&#039;s/Mixed AMERICAS E DIVISION 1 (A),Garmin 3S Vector Pedals,Wahoo Kickr,364,363,1
104018,1611756192,wahoo,Zwift - TDZ Stage 5: Shorter Ride,Garmin 3S Vector Pedals,Wahoo Kickr,337,313,24
104524,1611838794,wahoo,Zwift - TDZ Stage 5: Longer Ride,Garmin 3S Vector Pedals,Wahoo Kickr,388,375,13
105084,1611925374,wahoo,Zwift - TDZ Stage 6: Shorter Ride,Garmin 3S Vector Pedals,Wahoo Kickr,318,316,2
105707,1612024191,wahoo,Zwift - Veganuary21 Stage 5 iTT (A),Garmin 3S Vector Pedals,Wahoo Kickr,357,351,6
106626,1612184400,wahoo,Zwift - TDZ Stage 6: Longer Ride,Garmin 3S Vector Pedals,Wahoo Kickr,399,389,10
107729,1612313157,wahoo,Zwift - Zwift Racing League | WTRL - Men&#039;s/Mixed AMERICAS E DIVISION 1 (A),Garmin 3S Vector Pedals,Wahoo Kickr,368,359,9
108318,1612378798,wahoo,Zwift - Open - Movistar Team Challenge Community Qualifier Race #1,Garmin 3S Vector Pedals,Wahoo Kickr,392,385,7
110065,1612627198,wahoo,Zwift - TDZ Stage 7: Longer Ride,Garmin 3S Vector Pedals,Wahoo Kickr,363,364,-1
110877,1612792793,wahoo,Zwift - TDZ Stage 8: Group Ride,Garmin 3S Vector Pedals,Wahoo Kickr,333,333,0
111886,1612918462,wahoo,Zwift - Zwift Racing League | WTRL - Men&#039;s/Mixed AMERICAS E DIVISION 1 (A),Garmin 3S Vector Pedals,Wahoo Kickr,359,364,-5
112108,1612958697,wahoo,Zwift - G7 Cycling Club CHINA Group Training Ride (B),Garmin 3S Vector Pedals,Wahoo Kickr,341,339,2
114226,1613230638,wahoo,Zwift - Chasing Cancellara Time Trial,Garmin 3S Vector Pedals,Wahoo Kickr,381,402,-21
114230,1613233018,wahoo,Zwift - TDZ Stage 2: Standard Ride,Garmin 3S Vector Pedals,Wahoo Kickr,343,326,17
116204,1613522758,wahoo,Zwift - Zwift Racing League | WTRL - Men&#039;s/Mixed AMERICAS E DIVISION 1 (A),Garmin 3S Vector Pedals,Wahoo Kickr,382,390,-8
117128,1613653372,wahoo,Zwift - TDZ Stage 5: Shorter Ride,Garmin 3S Vector Pedals,Wahoo Kickr,345,328,17
117759,1613748598,wahoo,Zwift - BST Mountaingoat Race (A),Garmin 3S Vector Pedals,Wahoo Kickr,359,375,-16
118194,1613822994,wahoo,Zwift - DIRT Dadurday Chase Race  (A),Garmin 3S Vector Pedals,Wahoo Kickr,339,327,12
119943,1614127549,wahoo,Zwift - Zwift Racing League | WTRL - Men&#039;s/Mixed AMERICAS E DIVISION 1 (A),Garmin 3S Vector Pedals,Wahoo Kickr,344,351,-7
120506,1614175199,wahoo,Zwift - KISS Race Series - Pacific AM (A),Garmin 3S Vector Pedals,Wahoo Kickr,398,398,0
121195,1614351592,wahoo,Zwift - Haute Route Watopia 2021 Stage 1 (A),Garmin 3S Vector Pedals,Wahoo Kickr,375,361,14
121718,1614441598,wahoo,Zwift - Haute Route Watopia 2021 Stage 2 (A),Garmin 3S Vector Pedals,Wahoo Kickr,366,369,-3
122081,1614520795,wahoo,Zwift - Haute Route Watopia 2021 Stage 3 (A),Garmin 3S Vector Pedals,Wahoo Kickr,333,333,0
123249,1614732861,wahoo,Zwift - Zwift Racing League | WTRL - Men&#039;s/Mixed AMERICAS E DIVISION 1 (A),Garmin 3S Vector Pedals,Wahoo Kickr,353,353,0
123470,1614780000,wahoo,Zwift - KISS Race Series - Pacific AM (A),Garmin 3S Vector Pedals,Wahoo Kickr,371,369,2
123923,1614863099,wahoo,Zwift - 3R Knickerbocker Climbing Race - 1 Lap (22.4km/13.9mi 365m) (A),Garmin 3S Vector Pedals,Wahoo Kickr,367,388,-21
125053,1615046685,wahoo,Zwift - 3R Endurance Series p/b OTE Sports (E),Garmin 3S Vector Pedals,Wahoo Kickr,336,329,7
125421,1615130992,wahoo,Zwift - Absa Cape Epic Stage 1 pb Oakley - Open (A),Garmin 3S Vector Pedals,Wahoo Kickr,368,376,-8
125742,1615213796,wahoo,Zwift - Aero Army Wyn TT Series (A),Garmin 3S Vector Pedals,Wahoo Kickr,388,390,-2
126066,1615289654,wahoo,Zwift - Absa Cape Epic Stage 2 Time Trial pb Dimension Data - Open (A),Garmin 3S Vector Pedals,Wahoo Kickr,365,374,-9
126730,1615411911,wahoo,Zwift - Absa Cape Epic Stage 2 Time Trial pb Dimension Data - Open (A),Garmin 3S Vector Pedals,Wahoo Kickr,373,399,-26
126973,1615474746,wahoo,Zwift - Watopia,Garmin 3S Vector Pedals,Wahoo Kickr,321,322,-1
127518,1615566592,wahoo,Zwift - Absa Cape Epic Stage 3 pb ABUS - Open	 (A),Garmin 3S Vector Pedals,Wahoo Kickr,357,348,9
127970,1615649393,wahoo,Zwift - Absa Cape Epic Stage 4 pb Assos - Open (A),Garmin 3S Vector Pedals,Wahoo Kickr,364,367,-3
128693,1615818585,wahoo,Zwift - Aero Army Wyn TT Series (A),Garmin 3S Vector Pedals,Wahoo Kickr,339,373,-34
129024,1615897615,wahoo,Zwift - Innsbruck,Garmin 3S Vector Pedals,Wahoo Kickr,354,348,6
60133,1602088766,wahoo,Zwift - DBR HEINO CUP III (A),Assioma,Wahoo kickr 5,352,341,11
61189,1602521270,wahoo,Zwift - DBR Ride´N´Roll League (A),Assioma,Wahoo kickr 5,361,345,16
65445,1603820827,wahoo,Zwift - Zwift Racing League | WTRL - EMEA E (MEN) -  Division 1 (A),Assioma,Wahoo kickr 5,397,386,11
69756,1605031986,wahoo,Zwift - Zwift Racing League | WTRL - EMEA E1 (MEN) -  Division 1 (A),Assioma,Wahoo kickr 5,417,401,16
69757,1605031986,wahoo,Zwift - Zwift Racing League | WTRL - EMEA E1 (MEN) -  Division 1 (A),Assioma,Wahoo kickr 5,417,401,16
73156,1605812058,wahoo,Zwift - World Championships Experience // Danish Cycling Federation,Assioma,Wahoo kickr 5,385,356,29
74340,1606067746,wahoo,Zwift - Watopia,Assioma,Wahoo kickr 5,289,290,-1
75013,1606241486,wahoo,Zwift - Zwift Racing League | WTRL - Men&#039;s EMEA E1 DIVISION 1,Assioma,Wahoo kickr 5,426,398,28
75566,1606326671,wahoo,Zwift - Watopia,Assioma,Wahoo kickr 5,309,299,10
76072,1606415149,wahoo,Zwift - WTRL NOPINZ WORLD TTT CHAMPIONSHIPS - Zone 8 (C),Assioma,Wahoo kickr 5,381,364,17
79385,1606844361,wahoo,Zwift - Zwift Racing League | WTRL - Men&#039;s EMEA E1 DIVISION 1 (A),Assioma,Wahoo kickr 5,358,361,-3
80510,1607362755,wahoo,Zwift -  DBR Monday Race (A),Assioma,Wahoo kickr 5,380,365,15
81172,1607537528,wahoo,Zwift - DBR Wednesday Race (A),Assioma,Wahoo kickr 5,342,340,2
83779,1608053741,wahoo,Zwift - Zwift Racing League | WTRL - Men&#039;s EMEA E1 DIVISION 1 (A),Assioma,Wahoo kickr 5,370,361,9
86194,1608659734,wahoo,Zwift - UK Armed Forces Cycling Community Race Night (A),Assioma,Wahoo kickr 5,375,370,5
95598,1610472813,wahoo,Zwift - GPLAMA - ULTIMATE WARM UP,Assioma,Wahoo kickr 5,375,367,8
97093,1610647613,wahoo,Zwift - FUSION WINTER CUP (A),Assioma,Wahoo kickr 5,396,393,3
99695,1611077922,wahoo,Zwift - zrl race,Assioma,Wahoo kickr 5,385,374,11
103490,1611682110,wahoo,Zwift - Zwift Racing League | WTRL - Men&#039;s/Mixed EMEA E1 DIVISION 1 (A),Assioma,Wahoo kickr 5,401,392,9
107312,1612286942,wahoo,Zwift - Zwift Racing League | WTRL - Men&#039;s/Mixed EMEA E1 DIVISION 1 (A),Assioma,Wahoo kickr 5,385,384,1
108219,1612374734,wahoo,Zwift - Danmarks Cykle Union & Partners 4/6 (A),Assioma,Wahoo kickr 5,393,393,0
111592,1612891990,wahoo,Zwift - Zwift Racing League | WTRL - Men&#039;s/Mixed EMEA E1 DIVISION 1 (A),Assioma,Wahoo kickr 5,400,386,14
115824,1613497367,wahoo,Zwift - Zwift Racing League | WTRL - Men&#039;s/Mixed EMEA E1 DIVISION 1 (A),Assioma,Wahoo kickr 5,421,413,8
119571,1614101846,wahoo,Zwift - Zwift Racing League | WTRL - Men&#039;s/Mixed EMEA E1 DIVISION 1 (A),Assioma,Wahoo kickr 5,396,385,11
119341,1614024901,neo,デュアルレコードtest,assioma duo,tacx neo,183,183,0
119344,1614024897,neo,Zwift - 3R True2 Steady Ride [2.0w/kg avg] (C),assioma duo,tacx neo,187,183,4
119808,1614069955,neo,Zwift - Zwift Racing League | WTRL - Men&#039;s/Mixed APAC DIVISION 2 (A),assioma duo,tacx neo,279,284,-5
123287,1614674943,neo,Zwift - Zwift Racing League | WTRL - Men&#039;s/Mixed APAC DIVISION 2 (A),assioma duo,tacx neo,331,327,4
119144,1614020308,neo,Zwift - Premier Division // Zwift Racing League (men) (A),Stages,Tacx Neo,363,356,7
119150,1613832595,wahoo,Zwift - TDZ Stage 5: Shorter Ride,Stages,Wahoo Kickr v5,338,302,36
120345,1614191847,wahoo,Zwift - Scandinavian Cup 2021 - Round 1 - Men (A),Stages,Wahoo Kickr v5,398,378,20
122360,1614411280,wahoo,Zwift - Jon  Werme [SZ] (Team Car)&#039;s Meetup - Three Sisters,Stages,Wahoo Kickr v5,402,384,18
122364,1609260023,neo,Zada Three Sisters test,Stages,Tacx Neo,402,392,10
122633,1614628680,neo,Zwift - Premier Division // Zwift Racing League (men) (A),Stages,Tacx Neo,378,373,5
123646,1614796287,wahoo,Zwift - Scandinavian Cup 2021 - Round 2 - Men (A),Stages,Wahoo Kickr v5,411,385,26
57456,1601032782,wahoo,Zwift - 3R LaGuardia Loop Reverse Flat Race - 8 Laps (24.5km/15.2mi 216m) (A),Favero Assioma DUO,Wahoo KICKR,362,362,0
59231,1601721795,wahoo,Zwift - Into the Red by RELENTLESS (A),Favero Assioma DUO,Wahoo KICKR,373,364,9
62842,1603011293,wahoo,Zwift - TugaZ Sunday Cake Ride - Passeio do Pastel de Nata (C),Favero Assioma DUO,Wahoo KICKR,269,264,5
64370,1603455536,wahoo,Zwift - Peak-PTY Climb Challenge Fridays (A),Favero Assioma DUO,Wahoo KICKR,371,362,9
64601,1603537994,wahoo,Wahoo KICKR,Favero Assioma DUO,Wahoo KICKR,388,379,9
68313,1604602258,wahoo,Wahoo KICKR / Favero Assioma DUO,Favero Assioma DUO,Wahoo KICKR,367,359,8
70083,1604665107,wahoo,Wahoo KICKR / Favero Assioma DUO,Favero Assioma DUO,Wahoo KICKR,407,404,3
73973,1605977952,wahoo,Wahoo KICKR / Favero Assioma DUO,Favero Assioma DUO,Wahoo KICKR,379,368,11
76387,1606247292,wahoo,Wahoo KICKR / Favero Assioma DUO,Favero Assioma DUO,Wahoo KICKR,398,389,9
113009,1613068212,wahoo,Wahoo KICKR / Favero Assioma DUO,Favero Assioma DUO,Wahoo KICKR,344,344,0
75788,1606327224,wahoo,Zwift - MIDWEEK Autumn Series by SZR (A),Favero Assioma Duo,Wahoo Kickr Core,397,409,-12
83346,1607705892,wahoo,EVO CC / Le Col - Sprint Race Series,Favero Assioma Duo,Wahoo Kickr Core,412,410,2
83348,1607444346,wahoo,Zwift - ZHQ FutureWorks Crit City Race - Anti-sandbagging (A),Favero Assioma Duo,Wahoo Kickr Core,387,399,-12
96097,1610475999,wahoo,Zwift - 8wk Race Day Prep Week 8 PRE-RACE DAY SPIN,Favero Assioma Duo,Wahoo Kickr Core,386,389,-3
100075,1611077521,wahoo,2021/01/19Zwift Racing League,Favero Assioma Duo,Wahoo Kickr Core,381,374,7
54907,1599973194,wahoo,Zwift - KISS at Race 100 - EU (A),Favero Assioma Uno to Garmin 1030,Wahoo Kickr Bike to Zwift,444,452,-8
54938,1600058084,wahoo,Recon - PRE-RACE DAY SPIN,Favero Assioma Uno to Garmin 1030,Wahoo Kickr Bike to Zwift,264,274,-10
55175,1600106373,wahoo,Zwift - Invitational League // Qualifying Race #1,Favero Assioma Uno to Garmin 1030,Wahoo Kickr Bike to Zwift,432,433,-1
55683,1600322702,wahoo,Zwift - SZR Sunrise Ride (C),Favero Assioma Uno to Garmin 1030,Wahoo Kickr Bike to Zwift,243,241,2
55821,1600367391,wahoo,Invitational League // Qualifying Race #2 (Men),Favero Assioma Uno to Garmin 1030,Wahoo Kickr Bike to Zwift,386,386,0
56364,1600579724,wahoo,Zwift - XRS Races: a Longer and Hard race (A),Favero Assioma Uno to Garmin 1030,Wahoo Kickr Bike to Zwift,410,414,-4
56605,1600661403,wahoo,Zwift - INC Steady State 90min  - Group Training Ride 2.9 - 3.5w (B),Favero Assioma Uno to Zwift,Wahoo Kickr Bike to TrainerRoad,236,234,2
56739,1600745855,wahoo,Zwift - INC Relentless Intervals - 3.0 to 4.0w/kg Average (B),Favero Assioma Uno to Zwift,Wahoo Kickr Bike to TrainerRoad,421,419,2
56943,1600836002,wahoo,Zwift - 3R Steady State Endurance Ride [~2.5w/kg avg] (C),Favero Assioma Uno to Zwift,Wahoo Kickr Bike to TrainerRoad,326,331,-5
57302,1600973300,wahoo,WTRL Team Time Trial - Zone6,Favero Assioma Duo to Zwift,Wahoo Kickr Bike to TrainerRoad,436,435,1
57604,1601098154,wahoo,XRS Races - The Saturday Classic,Favero Assioma Duo to Zwift,Wahoo Kickr Bike to TrainerRoad,454,458,-4
57818,1601182504,wahoo,Zwift - KISS at Race 100 - EU (A),Favero Assioma Duo to Zwift,Wahoo Kickr Bike to TrainerRoad,469,466,3
58311,1601404886,wahoo,3R Sundown Race Series,Favero Assioma Duo to Zwift,Wahoo Kickr Bike to TrainerRoad,449,454,-5
58387,1601440744,wahoo,3R Steady State Endurance Ride [~2.5w/kg avg],Favero Assioma Duo to Zwift,Wahoo Kickr Bike to TrainerRoad,306,308,-2
58685,1601529956,wahoo,Zwift - PRE-RACE DAY SPIN,Favero Assioma Duo to Zwift,Wahoo Kickr Bike to TrainerRoad,373,371,2
58686,1601527499,wahoo,Zwift - INC Relentless Intervals - 3.0 to 4.0w/kg Average (B),Favero Assioma Duo to Zwift,Wahoo Kickr Bike to TrainerRoad,383,383,0
58829,1601573377,wahoo,WTRL Team Time Trial - Zone4,Favero Assioma Duo to Zwift,Wahoo Kickr Bike to TrainerRoad,422,419,3
59347,1601787616,wahoo,Zwift - KISS at Race 100 - EU (A),Favero Assioma Duo to Zwift,Wahoo Kickr Bike to TrainerRoad,448,445,3
59524,1601870738,wahoo,Zwift - INC Steady State 90min  - Group Training Ride 2.9 - 3.5w (B),Favero Assioma Duo to Zwift,Wahoo Kickr Bike to TrainerRoad,419,416,3
59712,1601961602,wahoo,iTT 20-min Pre-Race + 3x Race Start SIM,Favero Assioma Duo to Zwift,Wahoo Kickr Bike to TrainerRoad,405,410,-5
59871,1602008537,wahoo,3R Sundown Race Series - iTT,Favero Assioma Duo to Zwift,Wahoo Kickr Bike to TrainerRoad,432,429,3
59973,1602042852,wahoo,3R Steady State Endurance Ride [~2.5w/kg avg],Favero Assioma Duo to Zwift,Wahoo Kickr Bike to TrainerRoad,331,331,0
60205,1602129765,wahoo,Zwift - PRE-RACE DAY SPIN,Favero Assioma Duo to Zwift,Wahoo Kickr Bike to TrainerRoad,378,379,-1
60206,1602132229,wahoo,INC Relentless Intervals - 3.0 to 4.0w/kg Average,Favero Assioma Duo to Zwift,Wahoo Kickr Bike to TrainerRoad,332,336,-4
60908,1602392045,wahoo,Zwift - KISS at Race 100 - EU (A),Favero Assioma Duo to Zwift,Wahoo Kickr Bike to TrainerRoad,417,417,0
61080,1602475689,wahoo,Zwift - INC Steady State 90min  - Group Training Ride 2.9 - 3.5w (B),Favero Assioma Uno to Zwift,Wahoo Kickr Bike to TrainerRoad,341,340,1
61399,1602562339,wahoo,Zwift - 20-min Pre-Race + 3x Race Start,Favero Assioma Duo to Zwift,Wahoo Kickr Bike to TrainerRoad,424,423,1
61576,1602614452,wahoo,Zwift Racing League | WTRL - EMEA W (MEN) - Pool 4,Favero Assioma Duo to Zwift,Wahoo Kickr Bike to TrainerRoad,452,446,6
61580,1602611878,wahoo,Zwift - Leg Openers,Favero Assioma Duo to Zwift,Wahoo Kickr Bike to TrainerRoad,355,356,-1
61744,1602655120,wahoo,Zwift - INC Interval Builder Series - 2.7 - 3.3w/kg (C),Favero Assioma Duo to Zwift,Wahoo Kickr Bike to TrainerRoad,351,354,-3
62027,1602736341,wahoo,INC Relentless Intervals - 3.0 to 4.0w/kg Average,Favero Assioma Duo to Zwift,Wahoo Kickr Bike to TrainerRoad,345,353,-8
62241,1602787304,wahoo,WTRL Team Time Trial - Zone 6,Favero Assioma Uno to Zwift,Wahoo Kickr Bike to TrainerRoad,433,433,0
62559,1602918190,wahoo,Zwift - Matando o Corpo® PETA-Z (A),Favero Assioma Duo to Zwift,Wahoo Kickr Bike to TrainerRoad,446,438,8
62768,1602997147,wahoo,Zwift - KISS at Race 100 - EU (A),Favero Assioma Duo to Zwift,Wahoo Kickr Bike to TrainerRoad,401,404,-3
62953,1603083009,wahoo,Zwift - 3R Octane Interval Ride [~3.2-3.6 w/kg avg] (B),Favero Assioma Duo to Zwift,Wahoo Kickr Bike to TrainerRoad,415,412,3
63278,1603170138,wahoo,Zwift - 20-min Pre-Race + 3x Race Start,Favero Assioma Duo to Zwift,Wahoo Kickr Bike to TrainerRoad,394,396,-2
63489,1603219409,wahoo,Zwift Racing League | WTRL - EMEA (MEN) - TTT Grp 2,Favero Assioma Duo to Zwift,Wahoo Kickr Bike to TrainerRoad,444,438,6
63526,1603217499,wahoo,Zwift - TT warmup,Favero Assioma Duo to Zwift,Wahoo Kickr Bike to TrainerRoad,408,409,-1
63672,1603254895,wahoo,Zwift - 3R Steady State Endurance Ride [~2.5w/kg avg] (C),Favero Assioma Duo to Zwift,Wahoo Kickr Bike to TrainerRoad,250,253,-3
64976,1603688351,wahoo,INC Steady State 90min  - Group Training Ride 2.9 - 3.5w,Favero Assioma Duo to Zwift,Wahoo Kickr Bike to TrainerRoad,309,313,-4
65293,1603777134,wahoo,Zwift - 20min Pre-Race + 3x Race Start2,Favero Assioma Duo to Zwift,Wahoo Kickr Bike to TrainerRoad,407,410,-3
65503,1603825606,wahoo,Zwift Racing League | WTRL - Men&#039;s EMEA W1 DIVISION 1,Favero Assioma Duo to Zwift,Wahoo Kickr Bike to TrainerRoad,474,470,4
66196,1604000477,wahoo,WTRL Team Time Trial - Zone 6,Favero Assioma Duo to Zwift,Wahoo Kickr Bike to TrainerRoad,430,427,3
66846,1604209318,wahoo,Zwift - KISS at Race 100 - EU (A),Favero Assioma Duo to Zwift,Wahoo Kickr Bike to TrainerRoad,449,459,-10
67107,1604293440,wahoo,INC Steady State 90min  - Group Training Ride 2.9 - 3.5w,Favero Assioma Duo to Zwift,Wahoo Kickr Bike to TrainerRoad,315,315,0
67445,1604383127,wahoo,Zwift - 20min Pre-Race + 3x Race Start2,Favero Assioma Duo to Zwift,Wahoo Kickr Bike to TrainerRoad,409,409,0
67447,1604387035,wahoo,ZA Road Group Ride,Favero Assioma Duo to Zwift,Wahoo Kickr Bike to TrainerRoad,318,315,3
67675,1604433571,wahoo,Zwift Racing League | WTRL - Mens EMEA W1 DIVISION 1,Favero Assioma Duo to Zwift,Wahoo Kickr Bike to TrainerRoad,456,457,-1
67806,1604472076,wahoo,Reckon Everething Bagel n.2,Favero Assioma Duo to Garmin 1030,Wahoo Kickr Bike to TrainerRoad,318,322,-4
67963,1604556476,wahoo,3R Watopia Flat Route Race - 3 Laps (30.3km/18.8mi 162m),Favero Assioma Duo to Zwift,Wahoo Kickr Bike to TrainerRoad,484,485,-1
67965,1604553983,wahoo,Zwift - PRE-RACE DAY SPIN,Favero Assioma Uno to Zwift,Wahoo Kickr Bike to TrainerRoad,378,379,-1
68418,1604642158,wahoo,Zwift - Race 1 // Men // Z Pro Tri // Community (A),Favero Assioma Duo to Zwift,Wahoo Kickr Bike to TrainerRoad,429,428,1
68422,1604642158,wahoo,Zwift - Race 2 // Men // Z Pro Tri // Community (A),Favero Assioma Duo to Zwift,Wahoo Kickr Bike to TrainerRoad,418,415,3
68423,1604642158,wahoo,Zwift - Race 3 // Men // Z Pro Tri // Community (A),Favero Assioma Duo to Zwift,Wahoo Kickr Bike to TrainerRoad,450,455,-5
68424,1604642158,wahoo,Zwift - 3R VOLT Interval Ride [~2.6-3.2 w/kg avg] (C),Favero Assioma Duo to Zwift,Wahoo Kickr Bike to TrainerRoad,316,323,-7
68686,1604728467,wahoo,Zwift - XRS Races - The Saturday Classic (A) - 1st,Favero Assioma Duo to Zwift,Wahoo Kickr Bike to Garmin 1030,441,433,8
68947,1604814466,wahoo,Zwift - KISS at Race 100 - EU (A) - 1st,Favero Assioma Duo to Zwift,Wahoo Kickr Bike to TrainerRoad,448,449,-1
69215,1604901114,wahoo,Zwift - 3R VOLT Interval Ride [~2.6-3.2 w/kg avg] (C),Favero Assioma Duo to Zwift,Wahoo Kickr Bike to TrainerRoad,388,391,-3
69216,1604905456,wahoo,Zwift - 3R Watopia Flat Route Race - 3 Laps (30.3km/18.8mi 162m) (A),Favero Assioma Duo to Zwift,Wahoo Kickr Bike to TrainerRoad,453,451,2
69557,1604984768,wahoo,Zwift - INC Relentless Intervals - 3.0 to 4.0w/kg Average (B),Favero Assioma Duo to Zwift,Wahoo Kickr Bike to TrainerRoad,391,393,-2
69848,1605034822,wahoo,Zwift Racing League | WTRL - EMEA W1 (MEN) - Division 1 - 1st,Favero Assioma Duo to Zwift,Wahoo Kickr Bike to TrainerRoad,497,494,3
69895,1605034822,wahoo,Zwift - Leg Openers,Favero Assioma Duo to Zwift,Wahoo Kickr Bike to TrainerRoad,364,368,-4
70038,1605072944,wahoo,Zwift - INC Relentless Intervals - 3.0 to 4.0w/kg Average (B),Favero Assioma Duo to Zwift,Wahoo Kickr Bike to TrainerRoad,322,323,-1
70465,1605158337,wahoo,INC Relentless Intervals - 3.0 to 4.0w/kg Average,Favero Assioma Duo to Zwift,Wahoo Kickr Bike to TrainerRoad,385,384,1
72459,1605676661,wahoo,Zwift - INC Relentless Intervals - 3.0 to 4.0w/kg Average (B),Favero Assioma Duo to Zwift,Wahoo Kickr Bike to TrainerRoad,384,387,-3
72830,1605762589,wahoo,INC Relentless Intervals - 3.0 to 4.0w/kg Average,Favero Assioma Duo to Zwift,Wahoo Kickr Bike to TrainerRoad,360,363,-3
73094,1605809347,wahoo,WTRL Team Time Trial PLATINUM LEAGUE,Favero Assioma Duo to Zwift,Wahoo Kickr Bike to TrainerRoad,451,449,2
74074,1606024166,wahoo,Zwift - KISS 100 Race Series - EU (A) - 1st,Favero Assioma Duo to Zwift,Wahoo Kickr Bike to TrainerRoad,494,488,6
74423,1606108029,wahoo,Zwift - INC Steady State 90min  - Group Training Ride 2.9 - 3.5w (B),Favero Assioma Duo to Zwift,Wahoo Kickr Bike to TrainerRoad,388,389,-1
74816,1606192237,wahoo,INC Relentless Intervals - 3.0 to 4.0w/kg Average,Favero Assioma Duo to Zwift,Wahoo Kickr Bike to TrainerRoad,303,306,-3
75131,1606244837,wahoo,Zwift - Zwift Racing League | WTRL - Men&#039;s EMEA W1 DIVISION 1,Favero Assioma Duo to Zwift,Wahoo Kickr Bike to TrainerRoad,485,480,5
75327,1606282255,wahoo,Zwift - 3R Steady State Endurance Ride [~2.5w/kg avg] (C),Favero Assioma Duo to Zwift,Wahoo Kickr Bike to TrainerRoad,265,267,-2
75758,1606368876,wahoo,Zwift - INC Relentless Intervals - 3.0 to 4.0w/kg Average (B),Favero Assioma Duo to Zwift,Wahoo Kickr Bike to TrainerRoad,287,291,-4
76068,1606413684,wahoo,WTRL WORLD TTT CHAMPIONSHIPS,Favero Assioma Duo to TrainerRoad,Wahoo Kickr Bike to Zwift,407,404,3
76689,1606539729,wahoo,Zwift - INC Relentless VO2 Intervals - 3.5 to 4.5w/kg Average (B),Favero Assioma Duo to TrainerRoad,Wahoo Kickr Bike to Zwift,289,293,-4
76690,1606539729,wahoo,Zwift - SAS - CENTURION 100km (C),Favero Assioma Duo to TrainerRoad,Wahoo Kickr Bike to Zwift,246,243,3
77185,1606629342,wahoo,Zwift - Focus: Colours of PARI - Longer Ride,Favero Assioma Duo to TrainerRoad,Wahoo Kickr Bike to Zwift,420,437,-17
77186,1606629342,wahoo,Zwift - KISS 100 Race Series - EU (A),Favero Assioma Duo to TrainerRoad,Wahoo Kickr Bike to Zwift,429,435,-6
77494,1606712830,wahoo,Zwift - INC Steady State 90min  - Group Training Ride 2.9 - 3.5w (B),Favero Assioma Duo to TrainerRoad,Wahoo Kickr Bike to Zwift,345,353,-8
77844,1606797601,wahoo,INC Relentless Intervals - 3.0 to 4.0w/kg Average,Favero Assioma Duo to TrainerRoad,Wahoo Kickr Bike to Zwift,298,300,-2
78154,1606850374,wahoo,Zwift Racing League | WTRL - Men&#039;s EMEA W1 DIVISION 1,Favero Assioma Duo to TrainerRoad,Wahoo Kickr Bike to Zwift,447,448,-1
79593,1607149395,wahoo,Zwift - XRS Races - The Saturday Classic (A),Favero Assioma Duo to TrainerRoad,Wahoo Kickr Bike to Zwift,434,442,-8
80610,1607402111,wahoo,INC Relentless Intervals - 3.0 to 4.0w/kg Average,Favero Assioma Duo to TrainerRoad,Wahoo Kickr Bike to Zwift,393,400,-7
80893,1607454711,wahoo,Zwift Racing League | WTRL - Men&#039;s EMEA W1 DIVISION 1 - 1st,Favero Assioma Duo to Zwift,Wahoo Kickr Bike to TrainerRoad,488,479,9
81332,1607578475,wahoo,INC Relentless Intervals - 3.0 to 4.0w/kg Average,Favero Assioma Duo to Zwift,Wahoo Kickr Bike to TrainerRoad,383,387,-4
82157,1607759856,wahoo,Zwift - 3R Weekend Race Club - Race 1 (A) - 1st,Favero Assioma Duo to Zwift,Wahoo Kickr Bike to TrainerRoad,518,501,17
82626,1607838438,wahoo,Zwift - KISS 173km Race Series - EU (A) - 1st,Favero Assioma Duo to Zwift,Wahoo Kickr Bike to TrainerRoad,402,405,-3
83006,1607922271,wahoo,Zwift - INC Steady State 90min  - Group Training Ride 2.9 - 3.5w (B),Favero Assioma Duo to Zwift,Wahoo Kickr Bike to TrainerRoad,398,383,15
83306,1608006792,wahoo,INC Relentless Intervals - 3.0 to 4.0w/kg Average,Favero Assioma Duo to Zwift,Wahoo Kickr Bike to TrainerRoad,398,403,-5
83637,1608060115,wahoo,Zwift Racing League | WTRL - Men&#039;s EMEA W1 DIVISION 1,Favero Assioma Duo to Zwift,Wahoo Kickr Bike to TrainerRoad,421,427,-6
85306,1608444082,wahoo,XRS Races: a Longer and Hard race,Favero Assioma Duo to Zwift,Wahoo Kickr Bike to TrainerRoad,476,476,0
85649,1608527112,wahoo,Tour of New York Stage 3,Favero Assioma Duo to Zwift,Wahoo Kickr Bike to TrainerRoad,427,426,1
85972,1608611794,wahoo,Zwift - INC Relentless Intervals (B),Favero Assioma Duo to Zwift,Wahoo Kickr Bike to TrainerRoad,404,411,-7
86193,1608661337,wahoo,Team Italy & Frenchy Fuzion League,Favero Assioma Duo to TrainerRoad,Wahoo Kickr Bike to TrainerRoad,499,491,8
86338,1608696663,wahoo,Zwift - Solos Zwift Race - Alpe du Zwift ,Favero Assioma Duo to Zwift,Wahoo Kickr Bike to TrainerRoad,433,437,-4
86846,1608788723,wahoo,Zwift - INC Relentless Intervals (B),Favero Assioma Duo to Zwift,Wahoo Kickr Bike to TrainerRoad,405,412,-7
87107,1608871225,wahoo,Zwift - INC Relentless Intervals (B),Favero Assioma Duo to Zwift,Wahoo Kickr Bike to TrainerRoad,419,415,4
87313,1608958456,wahoo,Zwift - INC Relentless VO2 Intervals - 3.5 to 4.5w/kg Average (B),Favero Assioma Duo to Zwift,Wahoo Kickr Bike to TrainerRoad,432,433,-1
87314,1608958456,wahoo,Zwift - XRS Races - The Saturday Classic (A),Favero Assioma Duo to Zwift,Wahoo Kickr Bike to TrainerRoad,441,445,-4
88056,1609131909,wahoo,Zwift - INC Steady State 90min  - Group Training Ride 2.9 - 3.5w (B),Favero Assioma Duo to Zwift,Wahoo Kickr Bike to TrainerRoad,322,328,-6
88415,1609216507,wahoo,INC Relentless Intervals,Favero Assioma Duo to Zwift,Wahoo Kickr Bike to TrainerRoad,441,447,-6
89288,1609400397,wahoo,WTRL Team Time Trial - Zone 1,Favero Assioma Duo to Zwift,Wahoo Kickr Bike to TrainerRoad,412,425,-13
90571,1609653129,wahoo,Zwift - KISS 200 Race Series - EU (A) - 1st,Favero Assioma Duo to Zwift,Wahoo Kickr Bike to TrainerRoad,408,416,-8
91054,1609736427,wahoo,Zwift - INC Steady State 90min  - Group Training Ride 2.9 - 3.5w (B),Favero Assioma Duo to TrainerRoad,Wahoo Kickr Bike to Zwift,261,273,-12
91502,1609819272,wahoo,Zwift - Leg Openers,Favero Assioma Duo to TrainerRoad,Wahoo Kickr Bike to Zwift,317,326,-9
91503,1609821585,wahoo,INC Relentless Intervals,Favero Assioma Duo to TrainerRoad,Wahoo Kickr Bike to Zwift,374,381,-7
92040,1609911871,wahoo,Zwift - INC Relentless Intervals - 3.0 to 4.0w/kg Average (B),Favero Assioma Duo to TrainerRoad,Wahoo Kickr Bike to Zwift,325,336,-11
92529,1609993688,wahoo,Zwift - Leg Openers,Favero Assioma Duo to TrainerRoad,Wahoo Kickr Bike to Zwift,323,332,-9
92530,1609993688,wahoo,TDZ Stage 1: Group Ride,Favero Assioma Duo to TrainerRoad,Wahoo Kickr Bike to Zwift,406,409,-3
93150,1610078861,wahoo,Zwift - Leg Openers,Favero Assioma Duo to TrainerRoad,Wahoo Kickr Bike to Zwift,321,328,-7
93151,1610078861,wahoo,INC Relentless Intervals,Favero Assioma Duo to TrainerRoad,Wahoo Kickr Bike to Zwift,422,431,-9
93152,1610078861,wahoo,20 km with Amelia,Favero Assioma Duo to TrainerRoad,Wahoo Kickr Bike to Zwift,284,294,-10
93635,1610166002,wahoo,Zwift - Leg Openers,Favero Assioma Duo to TrainerRoad,Wahoo Kickr Bike to Zwift,319,330,-11
93636,1610166002,wahoo,Zwift - INC Relentless VO2 Intervals - 3.5 to 4.5w/kg Average (B),Favero Assioma Duo to TrainerRoad,Wahoo Kickr Bike to Zwift,385,392,-7
93637,1610166002,wahoo,Zwift - TDZ Stage 1: Longer Ride,Favero Assioma Duo to TrainerRoad,Wahoo Kickr Bike to Zwift,361,367,-6
94223,1610257959,wahoo,XRS Races: a Longer and Hard race,Favero Assioma Duo to TrainerRoad,Wahoo Kickr Bike to Zwift,366,375,-9
94225,1610257959,wahoo,Zwift - Leg Openers,Favero Assioma Duo to TrainerRoad,Wahoo Kickr Bike to Zwift,331,340,-9
94738,1610339103,wahoo,Zwift - Leg Openers,Favero Assioma Duo to TrainerRoad,Wahoo Kickr Bike to Zwift,324,332,-8
94739,1610339103,wahoo,Zwift - TDZ Stage 2: Longer Ride,Favero Assioma Duo to TrainerRoad,Wahoo Kickr Bike to Zwift,392,399,-7
95305,1610424266,wahoo,Zwift - INC Relentless Intervals (B),Favero Assioma Duo to TrainerRoad,Wahoo Kickr Bike to Zwift,388,393,-5
95306,1610424266,wahoo,Zwift - Leg Openers,Favero Assioma Duo to TrainerRoad,Wahoo Kickr Bike to Zwift,317,326,-9
96087,1610516472,wahoo,Zwift - INC Relentless Intervals (B),Favero Assioma Duo to TrainerRoad,Wahoo Kickr Bike to Zwift,383,392,-9
96687,1610600984,wahoo,INC Relentless Intervals,Favero Assioma Duo to TrainerRoad,Wahoo Kickr Bike to Zwift,385,390,-5
96688,1610600984,wahoo,Zwift - Leg Openers,Favero Assioma Duo to TrainerRoad,Wahoo Kickr Bike to Zwift,329,338,-9
97284,1610686607,wahoo,Zwift - INC Relentless Intervals (B),Favero Assioma Duo to TrainerRoad,Wahoo Kickr Bike to Zwift,348,355,-7
97285,1610686607,wahoo,Zwift - TDZ Stage 3: Longer Ride,Favero Assioma Duo to TrainerRoad,Wahoo Kickr Bike to Zwift,385,390,-5
97286,1610684275,wahoo,Zwift - Leg Openers,Favero Assioma Duo to TrainerRoad,Wahoo Kickr Bike to Zwift,329,334,-5
97698,1610771270,wahoo,TDZ Stage 3: Group Ride,Favero Assioma Duo to TrainerRoad,Wahoo Kickr Bike to Zwift,396,402,-6
97700,1610771270,wahoo,Zwift - Leg Openers,Favero Assioma Duo to TrainerRoad,Wahoo Kickr Bike to Zwift,324,333,-9
98358,1610863895,wahoo,XRS Races: a Longer and Hard race - 1st,Favero Assioma Duo to TrainerRoad,Wahoo Kickr Bike to Zwift,417,422,-5
98359,1610863895,wahoo,Zwift - TT warmup,Favero Assioma Duo to TrainerRoad,Wahoo Kickr Bike to Zwift,349,358,-9
98831,1610946153,wahoo,INC Steady State 90min - Group Training Ride 2.9 - 3.5w,Favero Assioma Duo to TrainerRoad,Wahoo Kickr Bike to Zwift,267,279,-12
99426,1611029392,wahoo,Zwift - Leg Openers,Favero Assioma Duo to Garmin 1030+,Wahoo Kickr Bike to Zwift,321,335,-14
100079,1611121480,wahoo,Zwift - INC Relentless Intervals,Favero Assioma Duo to Garmin 1030+,Wahoo Kickr Bike to Zwift,344,358,-14
100083,1611121044,wahoo,Zwift - TT warmup,Favero Assioma Duo to Garmin 1030+,Wahoo Kickr Bike to Zwift,210,224,-14
100617,1611208776,wahoo,Zwift - 01/21/2021,Favero Assioma Duo to Garmin 1030+,Wahoo Kickr Bike to Zwift,425,426,-1
100619,1611207015,wahoo,Zwift - Leg Openers,Favero Assioma Duo to Garmin 1030+,Wahoo Kickr Bike to Zwift,329,336,-7
101255,1611290326,wahoo,Zwift - INC Relentless Intervals (B),Favero Assioma Duo to Garmin 1030+,Wahoo Kickr Bike to Zwift,325,332,-7
101651,1611383396,wahoo,Andy Jacko Meet UP - Four Horsemen,Favero Assioma Duo to Garmin 1030+,Wahoo Kickr Bike to Zwift,391,398,-7
102213,1611478768,wahoo,Zwift - TDZ Stage 5: Longer Ride,Favero Assioma Duo to Garmin 1030+,Wahoo Kickr Bike to Zwift,454,458,-4
102216,1611477089,wahoo,Zwift - TT warmup,Favero Assioma Duo to Garmin 1030+,Wahoo Kickr Bike to Zwift,382,392,-10
102671,1611551403,wahoo,Zwift - INC Steady State 90min - Group Training Ride 2.9 - 3.5w,Favero Assioma Duo to Garmin 1030+,Wahoo Kickr Bike to Zwift,267,277,-10
103188,1611635433,wahoo,Zwift - INC Relentless Intervals,Favero Assioma Duo to Garmin 1030+,Wahoo Kickr Bike to Zwift,378,385,-7
103890,1611725817,wahoo,Zwift - INC Relentless Intervals,Favero Assioma Duo to Garmin 1030+,Wahoo Kickr Bike to Zwift,364,372,-8
104408,1611812655,wahoo,Zwift - 	INC Relentless Intervals,Favero Assioma Duo to Garmin 1030+,Wahoo Kickr Bike to Zwift,359,369,-10
104961,1611895201,wahoo,Zwift - INC Relentless Intervals,Favero Assioma Duo to Garmin 1030+,Wahoo Kickr Bike to Zwift,340,354,-14
105360,1611988199,wahoo,Zwift - Andy JACKO - INNOVATION TEAM / Peaks Sports Coach UK&#039;s Meetup - The PRL Half,Favero Assioma Duo to Garmin 1030+,Wahoo Kickr Bike to Zwift,429,438,-9
106062,1612087182,wahoo,Zwift - TDZ Stage 6: Longer Ride,Favero Assioma Duo to Garmin 1030+,Wahoo Kickr Bike to Zwift,444,451,-7
106063,1612081101,wahoo,Zwift - INC relentless VO2 intervals - Romaric,Favero Assioma Duo to Garmin 1030+,Wahoo Kickr Bike to Zwift,409,413,-4
106530,1612155632,wahoo,INC Steady State 90min  - Group Training Ride 2.9 - 3.5w,Favero Assioma Duo to Garmin 1030+,Wahoo Kickr Bike to Zwift,292,303,-11
107060,1612240743,wahoo,INC Relentless Intervals,Favero Assioma Duo to Garmin 1030+,Wahoo Kickr Bike to Zwift,394,402,-8
107061,1612238969,wahoo,Zwift - Leg Openers,Favero Assioma Duo to Garmin 1030+,Wahoo Kickr Bike to Zwift,326,335,-9
107816,1612326909,wahoo,Zwift - 	Andy JACKO - INNOVATION TEAM / Peaks Sports Coach UK&#039;s,Favero Assioma Duo to Garmin 1030+,Wahoo Kickr Bike to Zwift,331,340,-9
108583,1612416447,wahoo,"Zwift - Build phase, mix up! Training: RR simulation V21",Favero Assioma Duo to Garmin 1030+,Wahoo Kickr Bike to Zwift,357,368,-11
109177,1612499534,wahoo,Zwift - INC Relentless Intervals (B) + Joke Bday,Favero Assioma Duo to Garmin 1030+,Wahoo Kickr Bike to Zwift,358,366,-8
109592,1612591042,wahoo,Zwift - TDZ Stage 7: Longer Ride,Favero Assioma Duo to Garmin 1030+,Wahoo Kickr Bike to Zwift,374,383,-9
109593,1612587541,wahoo,Zwift - INC Relentless VO2 Intervals,Favero Assioma Duo to Garmin 1030+,Wahoo Kickr Bike to Zwift,364,371,-7
109594,1612585742,wahoo,Zwift - Leg Openers,Favero Assioma Duo to Garmin 1030+,Wahoo Kickr Bike to Zwift,324,334,-10
110233,1612673735,wahoo,Zwift - 1028km 24hr NEW World Record by ROMARIC THE LEGEND,Favero Assioma Duo to Garmin 1030+,Wahoo Kickr Bike to Zwift,245,255,-10
110751,1612760663,wahoo,Zwift - INC Steady State 90min  - Group Training Ride 2.9 - 3.5w (B),Favero Assioma Duo to Garmin 1030+,Wahoo Kickr Bike to Zwift,283,292,-9
111296,1612851175,wahoo,Zwift - TTT 9/2 JO Solo,Favero Assioma Duo to Garmin 1030+,Wahoo Kickr Bike to Zwift,362,371,-9
111996,1612934757,wahoo,Zwift - INC Relentless Intervals,Favero Assioma Duo to Garmin 1030+,Wahoo Kickr Bike to Zwift,351,358,-7
111998,1612934757,wahoo,Zwift - TT warmup,Favero Assioma Duo to Garmin 1030+,Wahoo Kickr Bike to Zwift,333,345,-12
112594,1613019580,wahoo,Zwift - TDZ Stage 8: Group Ride,Favero Assioma Duo to Garmin 1030+,Wahoo Kickr Bike to Zwift,368,374,-6
112595,1613017783,wahoo,Zwift - Leg Openers,Favero Assioma Duo to Garmin 1030+,Wahoo Kickr Bike to Zwift,325,334,-9
113306,1613116689,wahoo,Zwift - INC Relentless Winter Training,Favero Assioma Duo to Garmin 1030+,Wahoo Kickr Bike to Zwift,381,380,1
113307,1613116689,wahoo,Zwift - TDZ Stage 8: Group Ride,Favero Assioma Duo to Garmin 1030+,Wahoo Kickr Bike to Zwift,381,388,-7
113799,1613191246,wahoo,Zwift - TDZ Stage 8: Group Ride,Favero Assioma Duo to Garmin 1030+,Wahoo Kickr Bike to Zwift,405,414,-9
113801,1613191246,wahoo,Zwift - INC Relentless VO2 Intervals,Favero Assioma Duo to Garmin 1030+,Wahoo Kickr Bike to Zwift,385,390,-5
113802,1613191246,wahoo,Zwift - Leg Openers,Favero Assioma Duo to Garmin 1030+,Wahoo Kickr Bike to Zwift,239,255,-16
114512,1613285618,wahoo,Zwift - Andy Jackson Peaks WO,Favero Assioma Duo to Garmin 1030+,Wahoo Kickr Bike to Zwift,335,342,-7
114976,1613363745,wahoo,Zwift - TDZ Stage 4: Group Ride Makeup,Favero Assioma Duo to Garmin 1030+,Wahoo Kickr Bike to Zwift,371,376,-5
115562,1613448797,wahoo,Zwift - INC Relentless Intervals + 40min Z2 Endurance,Favero Assioma Duo to Garmin 1030+,Wahoo Kickr Bike to Zwift,386,395,-9
115565,1613448797,wahoo,Zwift - Leg Openers,Favero Assioma Duo to Garmin 1030+,Wahoo Kickr Bike to Zwift,386,284,102
116322,1613537711,wahoo,Zwift - Andy Jackson Peaks WO,Favero Assioma Duo to Garmin 1030+,Wahoo Kickr Bike to Zwift,329,340,-11
116963,1613537900,wahoo,Zwift - Z2-Z3-SS,Favero Assioma Duo to Garmin 1030+,Wahoo Kickr Bike to Zwift,316,325,-9
117603,1613713687,wahoo,Zwift - 3h Endurance Z2-Z3-SS-The Mega Pretzel,Favero Assioma Duo to Garmin 1030+,Wahoo Kickr Bike to Zwift,329,340,-11
118031,1613795007,wahoo,Zwift - INC Relentless VO2 Intervals+ 30&#039; Z2,Favero Assioma Duo to Garmin 1030+,Wahoo Kickr Bike to Zwift,391,397,-6
118032,1613795007,wahoo,Zwift - Pre-Training Plan,Favero Assioma Duo to Garmin 1030+,Wahoo Kickr Bike to Zwift,391,334,57
118584,1613892043,wahoo,Zwift - Vatternrundan Group Ride Series,Favero Assioma Duo to Garmin 1030+,Wahoo Kickr Bike to Zwift,381,390,-9
118629,1613892043,wahoo,Zwift - Pre-Training Plan,Favero Assioma Duo to Garmin 1030+,Wahoo Kickr Bike to Zwift,340,349,-9
119349,1613971724,wahoo,Zwift - Recovery Active,Favero Assioma Duo to Garmin 1030+,Wahoo Kickr Bike to Zwift,316,325,-9
119350,1614052823,wahoo,INC Relentless Intervals,Favero Assioma Duo to Garmin 1030+,Wahoo Kickr Bike to Zwift,377,386,-9
119351,1614052823,wahoo,Zwift - Leg Openers,Favero Assioma Duo to Garmin 1030+,Wahoo Kickr Bike to Zwift,327,335,-8
120026,1614140398,wahoo,Zwift - Andy Jackson Peaks WO,Favero Assioma Duo to Garmin 1030+,Wahoo Kickr Bike to Zwift,330,340,-10
121954,1614491900,wahoo,Zwift - Haute Route Watopia 2021 Stage 3,Favero Assioma Duo to Garmin 1030+,Wahoo Kickr Bike to Zwift,376,389,-13
122281,1614573708,wahoo,Zwift - Recovery Active,Favero Assioma Duo to Garmin 1030+,Wahoo Kickr Bike to Zwift,314,325,-11
122738,1614657877,wahoo,Zwift - INC Relentless Intervals,Favero Assioma Duo to Garmin 1030+,Wahoo Kickr Bike to Zwift,383,393,-10
122739,1614657877,wahoo,Zwift - Leg Openers,Favero Assioma Duo to Garmin 1030+,Wahoo Kickr Bike to Zwift,324,333,-9
123328,1614745771,wahoo,Zwift - Andy Jackson Peaks WO,Favero Assioma Duo to Garmin 1030+,Wahoo Kickr Bike to Zwift,328,340,-12
123798,1614832478,wahoo,Zwift - Z2-Z3-SS,Favero Assioma Duo to Garmin 1030+,Wahoo Kickr Bike to Zwift,317,325,-8
124340,1614918977,wahoo,Zwift - INC Relentless Intervals (B),Favero Assioma Duo to Garmin 1030+,Wahoo Kickr Bike to Zwift,446,453,-7
125619,1615178191,wahoo,Zwift - INC Steady State 90min - Group Training Ride 2.9 - 3.5w,Favero Assioma Duo to Garmin 1030+,Wahoo Kickr Bike to Zwift,319,320,-1
125620,1615178191,wahoo,Zwift - Recovery Active,Favero Assioma Duo to Garmin 1030+,Wahoo Kickr Bike to Zwift,319,330,-11
125939,1615262661,wahoo,Zwift - INC Relentless Intervals,Favero Assioma Duo to Garmin 1030+,Wahoo Kickr Bike to Zwift,369,375,-6
125940,1615262661,wahoo,Zwift - Leg Openers,Favero Assioma Duo to Garmin 1030+,Wahoo Kickr Bike to Zwift,327,334,-7
126363,1615354777,wahoo,Zwift - Andy Jackson Peaks WO,Favero Assioma Duo to Garmin 1030+,Wahoo Kickr Bike to Zwift,327,340,-13
126807,1615437888,wahoo,Zwift -   Romaric INC EuroAliens&#039;s Meetup - Greater London Flat,Favero Assioma Duo to Garmin 1030+,Wahoo Kickr Bike to Zwift,291,302,-11
127051,1615484334,wahoo,Zwift - WTRL Team Time Trial - Zone 4,Favero Assioma Duo to Garmin 1030+,Wahoo Kickr Bike to Zwift,428,435,-7
127053,1615484330,wahoo,Zwift - Leg Openers,Favero Assioma Duo to Garmin 1030+,Wahoo Kickr Bike to Zwift,428,335,93
127324,1615523954,wahoo,Zwift - INC Relentless Intervals (B),Favero Assioma Duo to Garmin 1030+,Wahoo Kickr Bike to Zwift,449,452,-3
128607,1615787857,wahoo,DEFCON 4,Favero Assioma Duo to Garmin 1030+,Wahoo Kickr Bike to Zwift,331,340,-9
128916,1615870003,wahoo,DEFCON 3,Favero Assioma Duo to Garmin 1030+,Wahoo Kickr Bike to Zwift,330,340,-10
20661,1585593965,wahoo,Stage 5 Race (B) - Tour of Watopia 2020,Saris H3 to Zwift,Assioma Duo to Wahoo Elemnt Bolt,310,319,-9
21309,1585820719,wahoo,Koa Sports League Race (A),Assioma Duo to Zwift,Saris H3 to Wahoo Elemnt Bolt,326,320,6
23190,1586425488,wahoo,Koa Sports League Race (A),Assioma Duo to Zwift,Saris H3 to Wahoo Elemnt Bolt,355,341,14
25103,1587030292,wahoo,Koa Sports League Race (A),Assioma Duo to Zwift,Saris H3 to Wahoo Elemnt Bolt,333,334,-1
25455,1587113093,wahoo,Crit City Race (A),Saris H3 to Zwift,Assioma Duo to Wahoo Elemnt Bolt,339,352,-13
26600,1587462602,wahoo,All American Bikes (A),Saris H3 to Zwift,Assioma Duo to Wahoo Elemnt Bolt,351,350,1
52378,1598638600,wahoo,GGCC GlasgowGreen CC TT  (A),Saris H3 to Zwift,Assioma Duo to Wahoo Elemnt Bolt,349,351,-2
52677,1598811296,wahoo,3R Watopia Hilly Reverse Race - 4 Laps (36.7km/22.8mi 400m) (A),Wattbike Atom to Zwift,Assioma Duo to Wahoo Elemnt Bolt,367,370,-3
52923,1598985642,wahoo,3R Sundown Race Series - Round1 iTT (A),Wattbike Atom to Zwift,Assioma Duo to Wahoo Elemnt Bolt,353,353,0
53109,1599071085,wahoo,Zwift - Deeside Thistle and Moray Firth Race (A),Wattbike Atom to Zwift,Assioma Duo to Wahoo Elemnt Bolt,345,343,2
53274,1599158995,wahoo,WTRL TTT Zone 6 - Espresso,Wattbike Atom to Zwift,Assioma Duo to Wahoo Elemnt Bolt,371,373,-2
53691,1599416094,wahoo,3R Watopia Hilly Reverse Race - 4 Laps (36.7km/22.8mi 400m) (A),Wattbike Atom to Zwift,Assioma Duo to Wahoo Elemnt Bolt,368,370,-2
53998,1599590415,wahoo,3R Sundown Race Series - Round2 (A),Wattbike Atom to Zwift,Assioma Duo to Wahoo Elemnt Bolt,346,342,4
54475,1599763736,wahoo,WTRL TTT Zone 6 - Espresso,Wattbike Atom to Zwift,Assioma Duo to Wahoo Elemnt Bolt,402,412,-10
55394,1600195192,wahoo,Zwift - 3R Sundown Race Series  (A),Wattbike Atom to Zwift,Assioma Duo to Wahoo Elemnt Bolt,388,391,-3
55972,1600367390,wahoo,Invitational League // Qualifying Race #2 (Men),Wattbike Atom to Zwift,Assioma Duo to Wahoo Elemnt Bolt,391,387,4
56696,1600712395,wahoo,Zwift - TFC Mad Monday Autumn Series (A),Saris H3 to Zwift,Assioma Duo to Wahoo Elemnt Bolt,383,385,-2
56859,1600799996,wahoo,Zwift - 3R Sundown Race Series  (A),Saris H3 to Zwift,Assioma Duo to Wahoo Elemnt Bolt,380,379,1
68311,1604516392,wahoo,Zwift - Zwift NL Race Day (A),Assioma Duo to Zwift,Wahoo KICKR to Wahoo Elemnt Bolt,431,430,1
68586,1604689294,wahoo,Zwift -  Tour De Spartacus  (E),Assioma Duo to Zwift,Wahoo KICKR to Wahoo Elemnt Bolt,418,417,1
76258,1606420771,wahoo,Zwift - KISS Race Series - EU PM (A),Assioma Duo to Wahoo Elemnt Bolt,Wahoo KICKR to Zwift,378,374,4
78176,1606852470,wahoo,Zwift - Zwift Racing League | WTRL - Men&#039;s EMEA W1 DIVISION 1 (A),Assioma Duo to Wahoo Elemnt Bolt,Wahoo KICKR to Zwift,399,398,1
78644,1606937074,wahoo,Zwift - Deeside Thistle and Moray Firth Race (A),Assioma Duo to Wahoo Elemnt Bolt,Wahoo KICKR to Zwift,393,393,0
80272,1607278493,wahoo,Zwift - 3R Watopia Hilly Reverse Race - 4 Laps (36.7km/22.8mi 400m) (A),Assioma Duo to Wahoo Elemnt Bolt,Wahoo KICKR to Zwift,390,386,4
84437,1608233392,wahoo,Zwift - ZHR Up & Down Race (A),4iiii Precision to Wahoo Elemnt Bolt,Wahoo KICKR to Zwift,386,379,7
84998,1608370194,wahoo,Zwift - DBR Saturday Race (A),4iiii Precision to Wahoo Elemnt Bolt,Wahoo KICKR to Zwift,417,416,1
86553,1608746388,wahoo,Zwift - MIDWEEK Winter Series by SZR (A),4iiii Precision to Wahoo Elemnt Bolt,Wahoo KICKR to Zwift,380,378,2
87470,1608995694,wahoo,Zwift - OH MY CRIT - Saturday Smash Race (A),4iiii Precision to Wahoo Elemnt Bolt,Wahoo KICKR to Zwift,418,413,5
88297,1609183194,wahoo,Zwift - Team TFC Mad Monday Winter Series (A),4iiii Precision to Wahoo Elemnt Bolt,Wahoo KICKR to Zwift,373,375,-2
88440,1609231493,wahoo,Zwift - WTRL Racing (A),4iiii Precision to Wahoo Elemnt Bolt,Wahoo KICKR to Zwift,381,385,-4
90095,1609579795,wahoo,Zwift - DBR SufferDay League III (A),4iiii Precision to Wahoo Elemnt Bolt,Wahoo KICKR to Zwift,439,434,5
91366,1609787992,wahoo,Zwift - Team TFC Mad Monday Winter Series (A),4iiii Precision to Wahoo Elemnt Bolt,Wahoo KICKR to Zwift,371,374,-3
91817,1609872904,wahoo,Zwift - Team Italy & Frenchy Fuzion League (A),4iiii Precision to Wahoo Elemnt Bolt,Wahoo KICKR to Zwift,429,430,-1
93064,1610049167,wahoo,Zwift - WTRL Team Time Trial - Zone 9 (C),4iiii Precision to Wahoo Elemnt Bolt,Wahoo KICKR to Zwift,397,388,9
95781,1610481121,wahoo,Zwift - Zwift Racing League | WTRL - Men&#039;s/Mixed EMEA W2 DIVISION 1 (A),4iiii Precision to Wahoo Elemnt Bolt,Wahoo KICKR to Zwift,407,412,-5
99797,1611086440,wahoo,Zwift - Zwift Racing League | WTRL - Men&#039;s/Mixed EMEA W2 DIVISION 1 (A),4iiii Precision to Wahoo Elemnt Bolt,Wahoo KICKR to Zwift,393,391,2
101823,1611405902,wahoo,Zwift - WTRL Racing (A),4iiii Precision to Wahoo Elemnt Bolt,Wahoo KICKR to Zwift,413,409,4
103624,1611690719,wahoo,Zwift - Zwift Racing League | WTRL - Men&#039;s/Mixed EMEA W2 DIVISION 1 (A),4iiii Precision to Wahoo Elemnt Bolt,Wahoo KICKR to Zwift,384,388,-4
104784,1611863450,wahoo,Zwift - WTRL Team Time Trial - Zone 9 (B),4iiii Precision to Wahoo Elemnt Bolt,Wahoo KICKR to Zwift,383,392,-9
105390,1611995399,wahoo,Zwift - TEAM VEGAN Tofu Tornado XL (A),4iiii Precision to Wahoo Elemnt Bolt,Wahoo KICKR to Zwift,451,453,-2
107476,1612295538,wahoo,Zwift - Zwift Racing League | WTRL - Men&#039;s/Mixed EMEA W2 DIVISION 1 (A),4iiii Precision to Wahoo Elemnt Bolt,Wahoo KICKR to Zwift,415,410,5
108987,1612462346,wahoo,Zwift - WTRL Team Time Trial - Zone 4 (B),4iiii Precision to Wahoo Elemnt Bolt,Wahoo KICKR to Zwift,321,318,3
109381,1612547995,wahoo,Zwift - KIRCHMAIR Race Series (A),4iiii Precision to Wahoo Elemnt Bolt,Wahoo KICKR to Zwift,415,416,-1
109400,1612549794,wahoo,Zwift - KIRCHMAIR Race Series (A),4iiii Precision to Wahoo Elemnt Bolt,Wahoo KICKR to Zwift,374,368,6
111701,1612900847,wahoo,Zwift - Zwift Racing League | WTRL - Men&#039;s/Mixed EMEA W2 DIVISION 1 (A),4iiii Precision to Wahoo Elemnt Bolt,Wahoo KICKR to Zwift,415,412,3
113560,1613155797,wahoo,Zwift - Team CLS Racing - Hills &#039;n&#039; Thrills S5 (E),4iiii Precision to Wahoo Elemnt Bolt,Wahoo KICKR to Zwift,404,394,10
115998,1613505142,wahoo,Zwift - Zwift Racing League | WTRL - Men&#039;s/Mixed EMEA W2 DIVISION 1 (A),4iiii Precision to Wahoo Elemnt Bolt,Wahoo KICKR to Zwift,426,427,-1
118299,1613837122,wahoo,Zwift - 3R Endurance Series p/b OTE Sports- Stage 1 (E),4iiii Precision to Wahoo Elemnt Bolt,Wahoo KICKR to Zwift,368,367,1
119736,1614109922,wahoo,Zwift - Zwift Racing League | WTRL - Men&#039;s/Mixed EMEA W2 DIVISION 1 (A),4iiii Precision to Wahoo Elemnt Bolt,Wahoo KICKR to Zwift,388,385,3
120249,1614189596,wahoo,Zwift - MIDWEEK Winter Series by SZR (A),4iiii Precision to Wahoo Elemnt Bolt,Wahoo KICKR to Zwift,386,397,-11
123688,1614802192,wahoo,Zwift - 6Points Mallorca GGCC Race (A),4iiii Precision to Wahoo Elemnt Bolt,Wahoo KICKR to Zwift,339,333,6
124600,1614971094,wahoo,Zwift - Zwift Racing League | WTRL Battle Royale Playoff - Men&#039;s Points Race (A),4iiii Precision to Wahoo Elemnt Bolt,Wahoo KICKR to Zwift,411,409,2
125152,1615060543,wahoo,Zwift - Zwift Racing League | WTRL Battle Royale Playoff - Men&#039;s TTT (A),4iiii Precision to Wahoo Elemnt Bolt,Wahoo KICKR to Zwift,383,389,-6
127120,1615487413,wahoo,Zwift - FUSION SPRING CUP (A),4iiii Precision to Wahoo Elemnt Bolt,Wahoo KICKR to Zwift,367,360,7
128146,1615663849,wahoo,Zwift - 3R Endurance Series p/b OTE Sports (A),4iiii Precision to Wahoo Elemnt Bolt,Wahoo KICKR to Zwift,416,399,17
41407,1592003457,neo,Zwift - ASIA 120km Endurance Ride (A),4iii FC6800,tacx neo smart,294,294,0
113351,1613070177,wahoo,TDZ stage 8 C,Assioma Duo,Wahoo Kickr,384,394,-10
113711,1613142905,wahoo,Wahoo Kickr / Assioma Duo,Assioma Duo,Wahoo Kickr,416,380,36
115262,1613411122,wahoo,PM test ,Assioma Duo,Wahoo Kickr,370,348,22
117395,1613664915,wahoo,Wahoo Kickr / Assioma Duo,Assioma Duo,Wahoo Kickr,387,403,-16
129056,1615826727,wahoo,Wahoo Kickr / Assioma Duo,Assioma Duo,Wahoo Kickr,357,366,-9
100820,1587289347,neo,Zwift - Danmarks Cykle Union & Partners 2/6 (A),in power,neo tack,267,353,-86
100823,1611168231,neo,Zwift - Danmarks Cykle Union & Partners 2/6 (A),in power,neo tack,375,353,22
100827,1611168231,neo,Zwift - Danmarks Cykle Union & Partners 2/6 (A),in power,neo tack,375,353,22
101788,1611403740,neo,Zwift - DIRT Dadurday Chase Race  (A),in power,neo tack,363,337,26
104190,1611771776,neo,Danmarks Cykle Union & Partners 3/6,in power,neo tack,389,366,23
109691,1612606062,neo,Zwift - Cycling Ireland Spring Australian Handicap Race (A),in power,neo tack,325,325,0
116515,1613492292,wahoo,Zwift - UKAFC Race Night (A),in power,wahoo,0,359,-359
116517,1613573937,wahoo,Zwift - UKAFC Race Night (A),in power,wahoo,358,359,-1
117332,1613672937,wahoo,Zwift - FUSION WINTER CUP (A),in power,wahoo,397,397,0
118240,1613827135,wahoo,Zwift - 3R Innsbruckring Flat Race - 5 Laps (44km/27.3mi 385m) (A),in power,wahoo,368,368,0
119743,1614104273,wahoo,Zwift - Zwift Racing League | WTRL - Men&#039;s/Mixed EMEA E1 DIVISION 5 (A),in power,wahoo,356,362,-6
120364,1614192232,wahoo,Zwift - Scandinavian Cup 2021 - Round 1 - Men (A),2021-02-24-19-43-52,wahoo,374,374,0
120832,1614277731,wahoo,Zwift - FUSION WINTER CUP (A),2021-02-25-19-28-51,wahoo,413,415,-2
124192,1614889179,wahoo,Zwift - 3R LaGuardia Loop Flat Race - 6 Laps (17.5km/10.9 162m) (A),in power,wahoo,415,422,-7
125010,1615036824,wahoo,Zwift - 3R Innsbruckring Flat Race - 5 Laps (44km/27.3mi 385m) (A),B36G0822.FIT,wahoo,130,385,-255
125012,1615036796,wahoo,Zwift - 3R Innsbruckring Flat Race - 5 Laps (44km/27.3mi 385m) (A),B36E1956.FIT,wahoo,315,385,-70
126621,1615401891,wahoo,Zwift - Scandinavian Cup 2021 - Round 3 - Men (A),in power,wahoo,348,373,-25
127522,1615562997,wahoo,Zwift - DBR Friday Race (A),in power,wahoo,376,377,-1
129303,1615919396,wahoo,Zwift - CeramicSpeed Race Series: Open Race (A),in power,wahoo,364,394,-30
51076,1598000871,neo,Zwift - TBR Burrito Race (A),Dura-Ace R9100-P Crank-PM,Tacx Neo,361,349,12
51494,1598261243,neo,Zwift - DIRTy Dozen Sprint League (A),Dura-Ace R9100-P Crank-PM,Tacx Neo,411,396,15
53057,1599051481,neo,Zwift - KISS at Race - Pacific AM (A),Dura-Ace R9100-P Crank-PM,Tacx Neo,369,352,17
57467,1601025249,neo,Zwift - TBR Burrito Race (A),Dura-Ace R9100-P Crank-PM,Tacx Neo,430,404,26
59494,1601837922,neo,Zwift - KISS at Race - EU PM (A),Dura-Ace R9100-P Crank-PM,Tacx Neo,407,380,27
59866,1602006122,neo,Zwift - Team Italy & Frenchy Fuzion League (A),Dura-Ace R9100-P Crank-PM,Tacx Neo,413,402,11
60111,1602088084,neo,Zwift - ZHQ Steering Race // FutureWorks (A),Dura-Ace R9100-P Crank-PM,Tacx Neo,395,382,13
60315,1602172860,neo,Zwift - OH MY CRIT! - The Double Race 2/2 (A),Dura-Ace R9100-P Crank-PM,Tacx Neo,436,409,27
62205,1602782939,neo,Zwift - FUSION ECT BEUNSTOPPABLE Racing Series (A),Dura-Ace R9100-P Crank-PM,Tacx Neo,460,437,23
62903,1602944123,neo,Zwift - OH MY CRIT - Saturday Smash Race (A),Dura-Ace R9100-P Crank-PM,Tacx Neo,407,394,13
62904,1603038307,neo,Zwift - ZHQ Beta Circuit Race  (A),Dura-Ace R9100-P Crank-PM,Tacx Neo,391,384,7
63233,1603131369,neo,Zwift - TFC Mad Monday Autumn Series (A),Dura-Ace R9100-P Crank-PM,Tacx Neo,414,399,15
63916,1603303285,neo,Zwift - DBR HEINO CUP III (A),Dura-Ace R9100-P Crank-PM,Tacx Neo,385,363,22
64147,1603379339,neo,Zwift - OH MY CRIT! - The Double Race 1/2 (A),Dura-Ace R9100-P Crank-PM,Tacx Neo,390,375,15
64669,1603554602,neo,Zwift - ZHQ FutureWorks Crit City Race - Boost mode (A),Dura-Ace R9100-P Crank-PM,Tacx Neo,388,375,13
64806,1603616571,neo,Zwift - Newbury Velo Road Race (A),Dura-Ace R9100-P Crank-PM,Tacx Neo,428,411,17
65135,1603739906,neo,Zwift - TFC Mad Monday Autumn Series (A),Dura-Ace R9100-P Crank-PM,Tacx Neo,379,353,26
65851,1603910809,neo,Zwift - DBR HEINO CUP III (A),Dura-Ace R9100-P Crank-PM,Tacx Neo,407,393,14
66085,1603987555,neo,Zwift - OH MY CRIT! - The Double Race 1/2 (A),Dura-Ace R9100-P Crank-PM,Tacx Neo,407,388,19
67208,1604333345,neo,Zwift - 3R Classique Reverse Flat Race -(A) No riders nearby,Dura-Ace R9100-P Crank-PM,Tacx Neo,403,388,15
68849,1604775856,neo,Zwift - 3R Innsbruckring Sprint Race - 1 Lap (8.8km/5.5mi 77m) (A),Dura-Ace R9100-P Crank-PM - To Garmin 1030,Tacx Neo - To Zwift,384,369,15
69626,1605005973,neo,Zwift - KISS at Race - Americas AM (A) 2nd,Dura-Ace R9100-P Crank-PM,Tacx Neo,482,460,22
70113,1605091439,neo,Zwift - USA Cycling Race League by Indoor Specialist (A),Dura-Ace R9100-P Crank-PM,Tacx Neo,404,377,27
70640,1605197666,neo,Zwift - OH MY CRIT! - The Double Race 1/2 (A),Dura-Ace R9100-P Crank-PM,Tacx Neo,412,398,14
71578,1605438292,neo,Zwift - 3R Innsbruckring Sprint Race - 1 Lap (8.8km/5.5mi 77m) (A),Dura-Ace R9100-P Crank-PM,Tacx Neo,421,402,19
76163,1606415389,neo,Zwift - FUSION ECT BEUNSTOPPABLE Racing Series (A),Dura-Ace R9100-P Crank-PM,Tacx Neo,376,363,13
76969,1606575589,neo,Zwift - Focus: Colours of PARI - Shorter Ride,Dura-Ace R9100-P Crank-PM,Tacx Neo,368,353,15
78003,1606838694,neo,Zwift - 3R Volcano Circuit Flat Race - 8 Laps (35.2km/21.9mi 160m) (A),Dura-Ace R9100-P Crank-PM,Tacx Neo,409,380,29
115718,1613480267,neo,Zwift - TDZ Stage 5: Shorter Ride,Dura-Ace R9100-P Crank-PM,Tacx Neo,359,340,19
115727,1613229297,neo,Zwift - Chasing Cancellara Time Trial,Dura-Ace R9100-P Crank-PM,Tacx Neo,416,408,8
117805,1613757547,neo,Zwift - KIRCHMAIR Race Series (A),Dura-Ace R9100-P Crank-PM,Tacx Neo,391,375,16
118155,1613816972,neo,Zwift - Cycling Weekly Winter Lockdown RR Series (A),Dura-Ace R9100-P Crank-PM,Tacx Neo,393,383,10
118988,1614006898,neo,Zwift - 3R Volcano Circuit Sprint Flat Race - 1 Lap (6.6km/4.1mi 20m) (A),Dura-Ace R9100-P Crank-PM,Tacx Neo,368,352,16
119498,1614094139,neo,Zwift - Team Draft Innsbruckring Race (A),Dura-Ace R9100-P Crank-PM,Tacx Neo,348,332,16
122026,1614511646,neo,Zwift - Stages of DIRT (E),Dura-Ace R9100-P Crank-PM,Tacx Neo,342,329,13
122394,1614614936,neo,Zwift - 3R Classique Reverse Flat Race - 4 Laps (26.9km/16.7mi 57m) (A),Dura-Ace R9100-P Crank-PM,Tacx Neo,357,337,20
124151,1614877446,neo,Zwift - OH MY CRIT!! - The Double Race 2/2 (A),Dura-Ace R9100-P Crank-PM,Tacx Neo,420,405,15
125049,1615045824,neo,Zwift - 3R Endurance Series p/b OTE Sports (A),Dura-Ace R9100-P Crank-PM,Tacx Neo,361,344,17
126539,1615399103,neo,Zwift - MIDWEEK Crit Race Series by SZR (A),Dura-Ace R9100-P Crank-PM,Tacx Neo,383,377,6
128275,1615715936,neo,Zwift - DBR Sunday Race (A),Dura-Ace R9100-P Crank-PM,Tacx Neo,366,290,76
123136,1614709487,wahoo,Zwift - Zwift Racing League | WTRL - Men&#039;s/Mixed EMEA E1 DIVISION 5 (A),Stages L,Wahoo kickr core,342,368,-26
6336,1576414646,wahoo,Zwift - Tour of London // Stage 3 (Men & Women),pioneer pm910h,wahoo kickr core,0,0,0
6771,1576790462,wahoo,Zwift - 3R Alpe Du Zwift KOM Race (20km 1444m) (A),pioneer pm910h,wahoo kickr core,0,0,0
6945,1576940185,wahoo,Zwift - New Workout,favero assioma duo,wahoo kickr core,376,377,-1
13493,1581461854,wahoo,Zwift - Midweek Criterium Race (A),Favero Assioma Duo,Wahoo Kickr Core,439,440,-1
14992,1582231825,wahoo,Zwift - 6wk Beginner FTP Builder Week 2 Foundation,Favero Assioma Duo,Wahoo Kickr Core,257,261,-4
16298,1583070921,wahoo,Zwift - KISS at Race 100 - Americas (A),Pioneer PM910H,Wahoo Kickr Core,433,426,7
16707,1583276168,wahoo,Zwift - Midweek Criterium Race (A),Favero Assioma Duo,Wahoo Kickr Core,364,366,-2
33619,1589211745,wahoo,Zwift - Ramp Test,Favero Assioma Duo,Wahoo Kickr Core,432,444,-12
34892,1589490693,wahoo,Zwift - 3R Alpe Du Zwift KOM Race (20km 1444m) (A),Favero Assioma Duo,Wahoo Kickr Core,378,392,-14
34893,1589490693,wahoo,Zwift - Crit City Race (A),Favero Assioma Duo,Wahoo Kickr Core,395,407,-12
74266,1606054140,wahoo,Zwift - KISS 100 Race Series - Americas (A),Favero Assioma Duo,Wahoo Kickr &#039;18,395,385,10
75251,1606255747,wahoo,Zwift - ZHQ FutureWorks Crit City Race - Anti-sandbagging (A),Favero Assioma Duo,Wahoo Kickr &#039;18,357,346,11
78293,1606865240,wahoo,Zwift - Midweek Criterium Race (A),Favero Assioma Duo,Wahoo Kickr &#039;18,375,366,9
80283,1607273047,wahoo,Zwift - ZHQ FutureWorks Crit City Race - Boost mode (A),Favero Assioma Duo,Wahoo Kickr &#039;18,370,363,7
80285,1607273047,wahoo,Zwift - 3R Watopia Hilly Reverse Race - 4 Laps (36.7km/22.8mi 400m) (A),Favero Assioma Duo,Wahoo Kickr &#039;18,372,361,11
80984,1607467443,wahoo,Zwift - Velocious Sport Tue Night Criterium (Race) (A),Favero Assioma Duo,Wahoo Kickr &#039;18,376,366,10
80985,1607467443,wahoo,Zwift - Midweek Criterium Race (A),Favero Assioma Duo,Wahoo Kickr &#039;18,358,350,8
82858,1607867988,wahoo,Zwift - KISS 100 Race Series - Americas (A),Favero Assioma Duo,Wahoo Kickr &#039;18,413,402,11
83641,1608055772,wahoo,Zwift - Team Italy & Frenchy Fuzion League (A),Favero Assioma Duo,Wahoo Kickr &#039;18,423,410,13
85058,1608304965,wahoo,Zwift - Innsbruck,Favero Assioma Duo,Wahoo Kickr &#039;18 (AFS),264,263,1
85116,1608389213,wahoo,Zwift - Ramp Test Dec. 2020,Favero Assioma Duo,Wahoo Kickr &#039;18 (AFS),420,417,3
85463,1608472238,wahoo,Zwift - KISS 100 Race Series - Americas (A),Favero Assioma Duo,Wahoo Kickr &#039;18 (AFS),399,395,4
88706,1609261298,wahoo,Zwift - Watopia,Favero Assioma Duo,Wahoo Kickr &#039;18 (AFS),347,342,5
90993,1609682676,wahoo,Zwift - KISS 100 Race Series - Americas (A),Favero Assioma Duo,Wahoo Kickr &#039;18 (AFS),427,424,3
91976,1609884507,wahoo,Zwift - ZHQ FutureWorks Crit City Race - Anti-sandbagging (A),Favero Assioma Duo,Wahoo Kickr &#039;18 (AFS),351,347,4
91977,1609884507,wahoo,Zwift - ZHQ FutureWorks Crit City Race - Boost mode (A),Favero Assioma Duo,Wahoo Kickr &#039;18 (AFS),345,342,3
94470,1610287016,wahoo,Zwift - KISS 100 Race Series - Americas (A),Favero Assioma Duo,Wahoo Kickr &#039;18 (AFS),424,419,5
97188,1610655092,wahoo,Zwift - Watopia,Favero Assioma Duo,Wahoo Kickr &#039;18 (AFS),350,346,4
98576,1610891672,wahoo,Zwift - KISS 100 Race Series - Americas (A),Favero Assioma Duo,Wahoo Kickr &#039;18 (AFS),354,350,4
99976,1611098317,wahoo,Zwift - Zwift Racing League | WTRL - Men&#039;s/Mixed AMERICAS E DIVISION 2 (A),Favero Assioma Duo,Wahoo Kickr &#039;18 (AFS),369,374,-5
100535,1611180773,wahoo,Zwift - NYC,Favero Assioma Duo,Wahoo Kickr &#039;18 (AFS),245,243,2
101156,1611262898,wahoo,Zwift - Watopia,Favero Assioma Duo,Wahoo Kickr &#039;18 (AFS),419,414,5
102446,1611497446,wahoo,Zwift - KISS 100 Race Series - Americas (A),Favero Assioma Duo,Wahoo Kickr &#039;18 (AFS),376,373,3
103789,1611703733,wahoo,Zwift - Zwift Racing League | WTRL - Men&#039;s/Mixed AMERICAS E DIVISION 2 (A),Favero Assioma Duo,Wahoo Kickr &#039;18 (AFS),418,414,4
104890,1611866834,wahoo,Zwift - London,Favero Assioma Duo,Wahoo Kickr &#039;18 (AFS),434,433,1
107709,1612309484,wahoo,Zwift - Zwift Racing League | WTRL - Men&#039;s/Mixed AMERICAS E DIVISION 2 (A),Favero Assioma Duo,Wahoo Kickr &#039;18 (AFS),388,378,10
110538,1612705450,wahoo,Zwift - KISS 100 Race Series - Americas (A),Favero Assioma Duo,Wahoo Kickr &#039;18 (AFS),395,391,4
111876,1612914795,wahoo,Zwift - Zwift Racing League | WTRL - Men&#039;s/Mixed AMERICAS E DIVISION 2 (A),Favero Assioma Duo,Wahoo Kickr &#039;18 (AFS),393,389,4
116196,1613518608,wahoo,Zwift - Zwift Racing League | WTRL - Men&#039;s/Mixed AMERICAS E DIVISION 2 (A),Favero Assioma Duo,Wahoo Kickr &#039;18 (AFS),399,397,2
116891,1613595171,wahoo,Zwift - ZWC Morning Hill Climb Race (A),Favero Assioma Duo,Wahoo Kickr &#039;18 (AFS),384,380,4
118751,1613915919,wahoo,Zwift - KISS 100 Race Series - Americas (A),Favero Assioma Duo,Wahoo Kickr &#039;18 (AFS),366,365,1
121646,1614433372,wahoo,Zwift - OH MY CRIT!! - Saturday Smash Race (A),Favero Assioma Duo,Wahoo Kickr &#039;18 (AFS),354,349,5
112462,1612983601,wahoo,Zwift - Movistar Team Challenge // Round 1 (A),Stages Power L - Shimano 105,Wahoo Kickr 2018,388,368,20
113581,1613156410,wahoo,Movistar Team Challenge // Round 1,Stages Power L - Shimano 105,Wahoo Kickr 2018,380,388,-8
115388,1613419320,wahoo,Zwift - Premier Division // Zwift Racing League (men) (A),Stages Power L - Shimano 105,Wahoo Kickr 2018,385,404,-19
116701,1613588400,wahoo,Movistar Team Challenge // Round 2 - Race 3/4,Stages Power L - Shimano 105,Wahoo Kickr 2018,316,379,-63
110542,1612210044,wahoo,Zwift - Premier Division // Zwift Racing League (men) (A),Quarq Dzero,Wahoo kickr,421,424,-3
111001,1612812058,wahoo,Zwift - Premier Division // Zwift Racing League (men) (A),Quarq Dzero,Wahoo kickr,454,450,4
115350,1613419319,wahoo,Zwift - Premier Division // Zwift Racing League (men) (A),Quarq Dzero,Wahoo kickr,464,454,10
122587,1614629973,wahoo,Zwift - Premier Division // Zwift Racing League (men) (A),Quarq Dzero,Wahoo kickr,442,421,21
68706,1604736899,wahoo,Zwift - Matando o Corpo® PETA-Z (A),Power2Max S-Type,Wahoo Kickr V4,299,302,-3
69805,1605032394,wahoo,Zwift - Zwift Racing League | WTRL - EMEA E2 (MEN) -  Division 2 (A),Power2Max S-Type,Wahoo Kickr V4,342,342,0
70750,1605207589,wahoo,Zwift -  Flanders The BZR Ronde  (A),Power2Max S-Type,Wahoo Kickr V5,358,355,3
82240,1607769021,wahoo,Zwift - 3R Volcano Climb Race - 1 Lap (22.4km/14mi 204m) (A),Power2Max S-Type,Wahoo Kickr V5,311,311,0
83342,1608013309,wahoo,France - Ebbetts,Power2Max S-Type,Wahoo Kickr V5,300,303,-3
83821,1608103886,wahoo,Zwift - France - Avalanche Spire -1,Power2Max S-Type,Wahoo Kickr V5,309,311,-2
84477,1608231573,wahoo,Zwift -  Flanders The BZR Ronde  (A),Power2Max S-Type,Wahoo Kickr V5,310,311,-1
84755,1608310779,wahoo,Zwift - Tour of New York Stage 1 - Open Longer,Power2Max S-Type,Wahoo Kickr V5,317,307,10
85065,1608382768,wahoo,Zwift - Tour of New York Stage 2 - Open Longer,Power2Max S-Type,Wahoo Kickr V5,340,345,-5
85344,1608458369,wahoo,Zwift - Tour of New York Stage 3 - Open Longer,Power2Max S-Type,Wahoo Kickr V5,304,304,0
86592,1608740163,wahoo,Zwift - London,Power2Max S-Type,Wahoo Kickr V5,277,282,-5
87787,1609056903,wahoo,Zwift - Granfondoteam Xmas Meetup - The PRL Full,Power2Max S-Type,Wahoo Kickr V5,306,302,4
87788,1609056903,wahoo,Zwift - Granfondoteam Xmas Meetup - The PRL Full,Power2Max S-Type,Wahoo Kickr V5,0,0,0
89729,1609489735,wahoo,Zwift - Flanders Endurance Serie,Power2Max S-Type,Wahoo Kickr V5,341,340,1
90592,1609664376,wahoo,Zwift - Zwift Fondo Series 2020/21 (A),Power2Max S-Type,Wahoo Kickr V5 (Zwift),311,313,-2
91328,1609779585,wahoo,Zwift - TDZ Stage 1: Longer Ride,Power2Max S-Type,Wahoo Kickr V5 (Zwift),316,316,0
91763,1609869636,wahoo,Zwift - Zwift Time Trial Tuesday: Bologna (E),Power2Max S-Type,Wahoo Kickr V5 (Zwift),324,324,0
92619,1610017171,wahoo,Zwift - KISS Race Series - Americas AM (A),Power2Max S-Type,Wahoo Kickr V5 (Zwift),314,310,4
93274,1610100273,wahoo,Zwift - 3R Innsbruckring Flat Race - 4 Laps (35.2km/21.9mi 308m) (A),Power2Max S-Type,Wahoo Kickr V5 (Zwift),314,317,-3
93882,1610180972,wahoo,Zwift - Flanders Endurance Serie,Power2Max S-Type,Wahoo Kickr V5 (Zwift),310,312,-2
94304,1610267385,wahoo,Zwift - Flanders Endurance Series,Power2Max S-Type,Wahoo Kickr V5 (Zwift),309,310,-1
95638,1610475819,wahoo,Zwift - Zwift Racing League | WTRL - Men&#039;s/Mixed EMEA E2 DIVISION 1 (A),Power2Max S-Type,Wahoo Kickr V5 (Zwift),315,312,3
96768,1610622015,wahoo,Zwift - KISS Race Series - Americas AM (A),Power2Max S-Type,Wahoo Kickr V5 (Zwift),309,313,-4
97447,1610724584,wahoo,Zwift - DBR Friday Race (A),Power2Max S-Type,Wahoo Kickr V5 (Zwift),304,307,-3
98436,1610872191,wahoo,Zwift - Flanders Endurance Race League,Power2Max S-Type,Wahoo Kickr V5 (Zwift),307,311,-4
99675,1611080338,wahoo,Zwift - Zwift Racing League | WTRL - Men&#039;s/Mixed EMEA E1 DIVISION 5 (A),Power2Max S-Type,Wahoo Kickr V5 (Zwift),309,312,-3
103509,1611685406,wahoo,Zwift - Zwift Racing League | WTRL - Men&#039;s/Mixed EMEA E2 DIVISION 1 (A),Power2Max S-Type,Wahoo Kickr V5 (Zwift),323,329,-6
104072,1611763180,wahoo,Zwift - TDZ Stage 5: Longer Ride,Power2Max S-Type,Wahoo Kickr V5 (Zwift),315,316,-1
107381,1612290219,wahoo,Zwift - Zwift Racing League | WTRL - Men&#039;s/Mixed EMEA E2 DIVISION 1 (A),Power2Max S-Type,Wahoo Kickr V5 (Zwift),322,325,-3
108304,1612378822,wahoo,Zwift - Open - Movistar Team Challenge Community Qualifier Race #1,Power2Max S-Type,Wahoo Kickr V5 (Zwift),323,326,-3
112718,1613041169,wahoo,KISS Race Series - Americas AM,Power2Max S-Type,Wahoo Kickr V5 (Zwift),321,327,-6
113546,1613149388,wahoo,Zwift - Zwift Fast Fridays: Bologna Time Trial (E),Power2Max S-Type,Wahoo Kickr V5 (Zwift),321,324,-3
115900,1613499782,wahoo,Zwift - Zwift Racing League | WTRL - Men&#039;s/Mixed EMEA E2 DIVISION 1 (A),Power2Max S-Type,Wahoo Kickr V5 (Zwift),346,349,-3
117070,1613645967,wahoo,Zwift - KISS Race Series - Americas AM (A),Power2Max S-Type,Wahoo Kickr V5 (Zwift),322,327,-5
119590,1614104578,wahoo,Zwift - Zwift Racing League | WTRL - Men&#039;s/Mixed EMEA E2 DIVISION 1 (A),Power2Max S-Type (Allez Sprint),Wahoo Kickr V5 (Zwift),322,324,-2
122995,1614709439,wahoo,Zwift - Zwift Racing League | WTRL - Men&#039;s/Mixed EMEA E2 DIVISION 1 (A),Power2Max S-Type (Allez Sprint),Wahoo Kickr V5 (Zwift),312,312,0
124597,1614971044,wahoo,Zwift - Zwift Racing League | WTRL Battle Royale Playoff - Men&#039;s Points Race (A),Power2Max S-Type (Allez Sprint),Wahoo Kickr V5 (Zwift),336,343,-7
125183,1615059898,wahoo,Zwift - Zwift Racing League | WTRL Battle Royale Playoff - Men&#039;s TTT (A),Power2Max S-Type (Allez Sprint),Wahoo Kickr V5 (Zwift),325,327,-2
129204,1615919349,wahoo,Zwift - CeramicSpeed Race Series: Open Race (A),Power2Max S-Type (Allez Sprint),Wahoo Kickr V5 (Zwift),339,330,9
18675,1584619212,wahoo,Stage 3 - Longer Ride - Tour of Watopia 2020 私人活动,quarq,wahoo,324,326,-2
20579,1585568681,wahoo,ftp test,quarq,wahoo,357,367,-10
22013,1586005064,wahoo,Haute Route Stage2,quarq to zwift,wahoo,371,381,-10
40984,1591871668,wahoo,Japan ZWIFT Hill Climb Race,quarq to zwift,wahoo,387,333,54
41420,1592050499,wahoo,Team ODZ Race,quarq to zwift,wahoo,350,358,-8
41621,1592125194,wahoo,dPAC Climbers Day,quarq to zwift,wahoo,329,333,-4
42388,1592479505,wahoo,Eastern Canadian Quest Racing Series (ECQRS) (A),quarq to zwift,wahoo,391,397,-6
42390,1592482686,wahoo,TTR Climb Chase Race (A),quarq to zwift,wahoo,333,337,-4
43217,1592910583,wahoo,Japan Zwift Tuesday Race (A),quarq to zwift,wahoo,365,369,-4
43345,1592991878,wahoo,USA Cycling Race League by Indoor Specialist (A),quarq to zwift,wahoo,382,388,-6
43690,1593172766,wahoo,TEAM G7 and Mysenlan Friday Indoor Race (A),quarq to zwift,wahoo,354,359,-5
43914,1593331157,wahoo, Alpecin Cycling Series,quarq to zwift,wahoo,362,369,-7
44531,1593686102,wahoo,Japan ZWIFT Hill Climb Race,quarq to zwift,wahoo,352,357,-5
45601,1594135800,wahoo,TTR Climb Chase Race (A),quarq to zwift,wahoo,345,350,-5
48901,1596464533,wahoo,European Lunch Ride ,quarq to zwift,wahoo,350,350,0
48903,1596470223,wahoo,G7 Cycling Club CHINA Group Training Ride (B),quarq to zwift,wahoo,295,303,-8
49043,1596553927,wahoo,British Cycling Time Trial Series (A),quarq to zwift,wahoo,352,362,-10
49367,1596892798,wahoo,3R Innsbruckring Flat Race - 5 Laps,quarq to zwift,wahoo,344,351,-7
49704,1597237197,wahoo,Longer Ride - 7 Days of Tarmac SL7: Stage 2,quarq to zwift,wahoo,345,348,-3
49705,1597237197,wahoo,Longer Ride - 7 Days of Tarmac SL7: Stage 2,quarq to zwift,wahoo,345,348,-3
50480,1597669202,wahoo,Off The MAAP Stage 1,quarq to zwift,wahoo,336,336,0
50689,1597832999,wahoo,European Lunch Ride (E),quarq to zwift,wahoo,349,354,-5
51082,1598011199,wahoo,TEAM G7 and Mysenlan Friday Indoor Race,quarq to zwift,wahoo,356,362,-6
51188,1598079597,wahoo,DT Swiss & Immogen Simmonds Reborn Faster Festival - Group Ride (E),quarq to zwift,wahoo,326,333,-7
51347,1598180399,wahoo,CHINA TEAM G7 Sunday Party,quarq to zwift,wahoo,334,343,-9
52136,1598527199,wahoo,Off The MAAP Stage 3,quarq to zwift,wahoo,364,373,-9
52736,1598873398,wahoo,3R Innsbruckring Flat Race - 3 Laps (26.4km/16.4mi 231m) (A),quarq to zwift,wahoo,360,366,-6
53022,1599042600,wahoo,European Lunch Ride,quarq to zwift,wahoo,349,356,-7
55695,1600331400,wahoo,Tri Aus TT (E),quarq to zwift,wahoo,333,338,-5
56119,1600430397,wahoo,TEAM G7 and Mysenlan Friday Indoor Race (A),quarq to zwift,wahoo,340,348,-8
56222,1600506165,wahoo,Newbury Velo Weekend TT (E),quarq to zwift,wahoo,334,340,-6
56223,1600502399,wahoo,Stage 2 // Virtual Haute Route Ventoux (A),quarq to zwift,wahoo,337,343,-6
56625,1600688219,wahoo,TTR mini chase Monday (A),quarq to zwift,wahoo,376,381,-5
56977,1600859309,wahoo,Peak-PTY Midweek TT Climb Challenge (A),quarq to zwift,wahoo,360,363,-3
57186,1600941598,wahoo,KISS at Race - Americas AM (A),quarq to zwift,wahoo,376,384,-8
57466,1601035198,wahoo,TEAM G7 and Mysenlan Friday Indoor Race (A),quarq to zwift,wahoo,344,351,-7
58182,1601370298,wahoo,3R Sundown Race Series (A),quarq to zwift,wahoo,359,368,-9
58406,1601451000,wahoo,Climbers Day p/b dPAC.fit & Precision Hydration (A),quarq to zwift,wahoo,344,345,-1
59048,1601639999,wahoo,TEAM G7 and Mysenlan Friday Indoor Race (A),quarq to zwift,wahoo,342,345,-3
59169,1601715900,wahoo,Frenchy Fuzion ITT Bologna (A),quarq to zwift,wahoo,363,367,-4
60262,1602153299,wahoo,Japan ZWIFT Hill Climb Race (A),quarq to zwift,wahoo,374,378,-4
60736,1602325798,wahoo,3R Volcano Climb Race - 1 Lap (22.4km/14mi 204m) (A),quarq to zwift,wahoo,298,306,-8
64103,1603366199,wahoo,Eastern Canadian Quest Racing Series (ECQRS),quarq to zwift,wahoo,369,373,-4
64318,1603435498,wahoo,Mtri Race (A),quarq to zwift,wahoo,341,345,-4
64358,1603454399,wahoo,TEAM G7 and Mysenlan Friday Indoor Race (A),quarq to zwift,wahoo,362,370,-8
64545,1603524599,wahoo,TEAM VEGAN Tofu Tornado XL (A),quarq to zwift,wahoo,344,348,-4
64788,1603616399,wahoo,ZA Road 2020 - Segment Ride #1,quarq to zwift,wahoo,310,320,-10
66387,1604059499,wahoo,3R Greater London 8 Hilly Race - 1 Lap (23.8km/14.8mi 238m) (A),quarq to zwift,wahoo,343,350,-7
67850,1604478691,wahoo,Flanders Endurance Series,quarq to zwift,wahoo,340,340,0
68461,1604657399,wahoo,ZA Road Race #1: 4 - 5 w/kg,quarq to zwift,wahoo,336,342,-6
68697,1604737800,wahoo,TEAM VEGAN Tofu Tornado XL (A),quarq to zwift,wahoo,341,348,-7
69632,1605006000,wahoo,ZA Road 2020 - Segment Ride #2,quarq to zwift,wahoo,363,377,-14
70512,1605172501,wahoo,Garmin Never Stop Cycling // Stage 2 TT - Open Category,quarq to zwift,wahoo,337,345,-8
71881,1605520797,wahoo,ZA Road 2020 - Segment Ride #1,quarq to zwift,wahoo,340,342,-2
72090,1605610799,wahoo,ZA Road 2020 - Segment Ride #1: Three Sisters Course,quarq to zwift,wahoo,339,343,-4
72517,1605695401,wahoo,European Lunch Ride (E),quarq to zwift,wahoo,326,331,-5
72856,1605775064,wahoo,Tri Aus TT (E),quarq to zwift,wahoo,352,356,-4
74118,1606033795,wahoo,Flanders Endurance Series (E),quarq to zwift,wahoo,340,345,-5
95399,1610443159,wahoo,The After Party Race (A),quarq to zwift,Wahoo,332,339,-7
101289,1611306205,wahoo,Zwift Fast Fridays: Bologna Time Trial,quarq to zwift,Wahoo,355,356,-1
101631,1611383384,wahoo,XRS Races - The Saturday Classic (A),quarq to zwift,Wahoo,363,372,-9
74488,1606035573,neo,Zwift - ZA Road Race #1: 4 - 5 w/kg,Garmin Vector 2/Polar Vantage,tacx neo/appel tv,320,315,5
124641,1614970978,wahoo,Zwift - Team RWB Spring League (A),Power2Max,Wahoo Kickr Core,358,357,1
126289,1615317335,wahoo,Zwift - Luis  Silva (WEz)&#039;s Meetup - Three Sisters,Power2Max,Wahoo Kickr Core,356,355,1
127092,1615486531,wahoo,Zwift - Vienna,Power2Max,Wahoo Kickr Core,377,374,3
110674,1612728898,neo,Zwift - 3R Greater London Flat Race - 3 Laps (40.2km/25mi 135m) (A),Quarq Dzero axs,Tacx Neo 2T,344,331,13
111084,1612811992,neo,Zwift - Team TFC Mad Monday Winter Series (A),Quarq Dzero ,Tacx Neo 2T,349,323,26
111489,1612890589,neo,Zwift - 3R Volcano KOM After Party Race - 2 laps + climb (40.2km/25mi 286m) (A),Quarq Dzero ,Tacx Neo 2T,336,319,17
115300,1613416792,wahoo,Zwift - Team TFC Mad Monday Winter Series (A),Quarq Dzero ,Wahoo Kickr Power V5 (Loes),329,327,2
116761,1613588396,neo,Zwift - Zwift NL Race Day (A),Quarq Dzero ,Tacx Neo 2T,319,311,8
125182,1615060987,neo,Zwift - 3R Flat Race (A),Quarq Dzero ,Tacx Neo 2T,346,328,18
125843,1615231222,wahoo,Zwift - Team TFC Mad Monday Race Series (low-end categories) (A),Quarq Dzero ,Wahoo Kickr Power V5 (Loes),340,336,4
28293,1587908655,wahoo,Zwift - La Bicicletta Toronto & Toronto Hustle Donut Race (A),QUARQ DFour91,Wahoo KICKR V4,381,376,5
28300,1587803234,wahoo,Zwift - Newbury Velo Weekend TT (E),QUARQ DFour91,Wahoo KICKR V4,408,405,3
28479,1588006682,wahoo,Zwift - SCF MTB Challenge 2 (A),QUARQ DFour91,Wahoo KICKR V4,394,386,8
29172,1588176481,wahoo,Zwift - ZHR Hare & Hounds Race (A),QUARQ DFour91,Wahoo KICKR V4,378,373,5
29761,1588258819,wahoo,Zwift - Braquasse cup - 2/4 (A),QUARQ DFour91,Wahoo KICKR V4,427,422,5
30652,1588427920,wahoo,Zwift - XRS Races: Saturday Climbing Series (A) 7e,QUARQ DFour91,Wahoo KICKR V4,404,403,1
34031,1589306097,wahoo,Zwift - Team Italy & Frenchy Fuzion League (A),QUARQ DFour91,Wahoo KICKR V4,414,408,6
96221,1610533769,wahoo,USA Cycling Coffee with Hot Espresso Presented by Team ODZ,Quarq Sram Red DZERO,Wahoo KICKR V4,255,249,6
96453,1610553565,wahoo,Sydkysten Race,Quarq Sram Red DZERO,Wahoo KICKR V4,350,339,11
107157,1612263589,wahoo,CRYO-GEN ZTGR (Zwift Tuesday Group Ride),QUARQ DFour91,Wahoo KICKR V4,288,280,8
108113,1612368612,wahoo,3R Tick Tock Flat Race - 2 Lap (36km/22.4mi 100m),QUARQ DFour91,Wahoo KICKR V4,369,357,12
108745,1612436386,wahoo,Zwift - KISS Race Series - Americas AM (A),QUARQ DFour91,Wahoo KICKR V4,356,352,4
109365,1612541091,wahoo,Zwift - 3R Volcano Flat Race - 3 Laps (36.6km/22.7mi 138m) (A),QUARQ DFour91,Wahoo KICKR V4,439,426,13
110312,1612692844,wahoo,Test ramp Lucas ,Power 2 max,Wahoo KICKR V4,371,369,2
110556,1612711511,wahoo,Zwift - 3R Watopia 65km Race - 6 laps (40mi 324m) (A),QUARQ DFour91,Wahoo KICKR V4,372,361,11
111351,1612863260,wahoo,Zwift - Innsbruck -- Slope -1.5% Quarq,QUARQ DFour91,Wahoo KICKR V4,273,276,-3
112081,1612953865,wahoo,Zwift - The Morning Grind by STPC (A),QUARQ DFour91,Wahoo KICKR V4,423,421,2
107151,1612260486,wahoo,Zwift - Yorkshire,quarq powermeter,Wahoo Kickr ,321,315,6
107991,1612292085,wahoo,Zwift - Team Italy & Frenchy Fuzion League (A),quarq powermeter,Wahoo Kickr ,428,427,1
109408,1612377892,wahoo,Zwift - Danmarks Cykle Union & Partners 4/6 (A),quarq powermeter,Wahoo Kickr ,435,432,3
74683,1606162093,wahoo,Zwift - GGCC Glasgow Green Cycle Club Race Series (A),p2m,Wahoo Kickr,318,330,-12
74921,1606220102,wahoo,Zwift - ODZ Covfefe Ride,p2m,Wahoo Kickr,406,410,-4
75128,1606247120,wahoo,Zwift - Zwift Racing League | WTRL - Men&#039;s EMEA W1 DIVISION 1,p2m,Wahoo Kickr,391,397,-6
77305,1606662000,wahoo,Zwift - Focus: Colours of PARI - Empty Tank,p2m,Wahoo Kickr,310,317,-7
78535,1606925402,wahoo,Zwift - 3R Tick Tock Flat Race - 2 Laps (A),p2m,Wahoo Kickr,348,357,-9
78899,1607010060,wahoo,Zwift - ZA Tri: TT Race - 20k,p2m,Wahoo Kickr,347,353,-6
80988,1607474700,wahoo,Zwift - Zwift Racing League | WTRL - Men&#039;s AMERICAS E DIVISION 1 (A),p2m,Wahoo Kickr,362,369,-7
80999,1607522400,wahoo,Zwift - KISS Race Series - Pacific AM (A),p2m,Wahoo Kickr,387,406,-19
81933,1607694602,wahoo,Zwift - KISS Race Series - Pacific AM (A),p2m,Wahoo Kickr,356,364,-8
82879,1607868914,wahoo,KISS 100 - PRL Full Edition,p2m,Wahoo Kickr,379,384,-5
83752,1608079646,wahoo,Zwift - Zwift Racing League | WTRL - Men&#039;s AMERICAS E DIVISION 1 (A),p2m,Wahoo Kickr,353,355,-2
89597,1609438143,wahoo,🍾🎉 NYE Alpe du Zwift TTT - New PR!,p2m,Wahoo Kickr,361,371,-10
91306,1609779626,wahoo,Zwift - TDZ Stage 1: Gong Show,p2m,Wahoo Kickr,362,362,0
91649,1609848931,wahoo,Zwift - Team ODZ Tuesday Coffee and Espresso Ride ,p2m,Wahoo Kickr (Zwift),386,377,9
96263,1610546401,wahoo,Zwift - KISS Race Series - Pacific AM (A),p2m,Wahoo Kickr (Zwift),361,360,1
96933,1610648220,wahoo,Zwift - WTRL Team Time Trial,p2m,Wahoo Kickr (Zwift),388,362,26
99962,1611097203,wahoo,Zwift - TDZ Stage 4: Surfin� the pack,p2m,Wahoo Kickr (Zwift),368,368,0
100206,1611151201,wahoo,Zwift - KISS Race Series - Pacific AM (A),p2m,Wahoo Kickr (Zwift),370,361,9
100743,1611231324,wahoo,Zwift - Team ODZ Thursday Morning Throwdown (E),p2m,Wahoo Kickr (Zwift),357,359,-2
103632,1611690721,wahoo,Zwift - Zwift Racing League | WTRL - Men&#039;s/Mixed EMEA W2 DIVISION 1 (A),p2m,Wahoo Kickr (Zwift),380,380,0
104335,1611788403,wahoo,Zwift - TDZ Stage 5: Bleh,p2m,Wahoo Kickr (Zwift),387,382,5
109889,1612614782,wahoo,Zwift - Zwift Ultima Fondo - FUBAR,p2m,Wahoo Kickr (Zwift),373,383,-10
111242,1612821601,wahoo,Zwift - TDZ Stage 8: Until Next Year TDZ..!,p2m,Wahoo Kickr (Zwift),397,399,-2
111872,1612918650,wahoo,Zwift - Zwift Racing League | WTRL TTT,p2m,Wahoo Kickr (Zwift),364,377,-13
112762,1613045700,wahoo,Zwift - Team ODZ Thursday Morning Throwdown ,p2m,Wahoo Kickr (Zwift),365,373,-8
116005,1613505121,wahoo,Zwift - Zwift Racing League | EMEA W2 DIVISION 1 (A),p2m,Wahoo Kickr (Zwift),405,423,-18
116915,1613602922,wahoo,Zwift - Zwift Duathlon League - Bike,p2m,Wahoo Kickr (Zwift),369,381,-12
120203,1614175215,wahoo,Zwift - KISS Race Series - Pacific AM (A),p2m,Wahoo Kickr (Zwift),403,396,7
120658,1614255301,wahoo,Zwift - Team ODZ TMT - Surfing,p2m,Wahoo Kickr (Zwift),323,319,4
125737,1615213801,wahoo,Zwift - Aero Army Wyn TT Series (A),p2m,Wahoo Kickr (Zwift),410,420,-10
125770,1615224600,wahoo,Zwift - Absa Cape Epic Stage 1 pb Oakley - Open (A),p2m,Wahoo Kickr (Zwift),365,371,-6
125802,1615227301,wahoo,Zwift -  DBR Monday Race - One Hill too far,p2m,Wahoo Kickr (Zwift),386,379,7
128043,1615644002,wahoo,Zwift - Zwift Insider Badge Hunters - The PRL Full Edition,p2m,Wahoo Kickr (Zwift),368,374,-6
51292,1598123084,wahoo,Zwift - Herd Summer Racing League Race 1 (A),Quarq DZero,Wahoo Kickr &#039;18,320,314,6
51529,1598284825,wahoo,Zwift - Off The MAAP Stage 4 Race (A),Quarq DZero,Wahoo Kickr &#039;18,314,300,14
51878,1598380808,wahoo,Zwift - 3R Turbocharged Team Race Series - Bonus Round (A),Quarq DZero,Wahoo Kickr &#039;18,321,313,8
52392,1598639471,wahoo,Zwift - BRT Ages Racing League (B),Quarq DZero,Wahoo Kickr &#039;18,340,323,17
52706,1598814004,wahoo,Zwift - KISS at Race - EU PM (A),Quarq DZero,Wahoo Kickr &#039;18,294,279,15
52952,1598982907,wahoo,Zwift - Team Italy & Frenchy Fuzion League (A),Quarq DZero,Wahoo Kickr &#039;18,363,350,13
53225,1599149111,wahoo,Zwift - OH MY CRIT! - The Double Race 2/2 (A),Quarq DZero,Wahoo Kickr &#039;18,333,321,12
53457,1599239111,wahoo,Zwift - Team WEZ Friday Race (A),Quarq DZero,Wahoo Kickr &#039;18,303,290,13
53803,1599503830,wahoo,Zwift - ZHR Zwift Handicap Race Britain (A),Quarq DZero,Wahoo Kickr &#039;18,315,307,8
54008,1599589800,wahoo,Zwift - ZHR Masters Britain (B),Quarq DZero,Wahoo Kickr &#039;18,324,300,24
54468,1599764395,wahoo,Zwift - KISS at Race - EU PM (A),Quarq DZero,Wahoo Kickr &#039;18,339,313,26
54749,1599929094,wahoo,Zwift - Crit City Race (A),Quarq DZero,Wahoo Kickr &#039;18,319,307,12
54906,1600017597,wahoo,Zwift - 3R Greater London 8 Hilly Race - 1 Lap (23.8km/14.8mi 238m) (A),Quarq DZero,Wahoo Kickr &#039;18,351,332,19
55235,1600112093,wahoo,Zwift - XRS Races: Monday&#039;s blues (A),Quarq DZero,Wahoo Kickr &#039;18,335,312,23
55378,1600195440,wahoo,Zwift - 3R Sundown Race Series  (E),Quarq DZero,Wahoo Kickr &#039;18,336,319,17
55637,1600282667,wahoo,Zwift - MINI CRIT by WKG (A),Quarq DZero,Wahoo Kickr &#039;18,307,306,1
56021,1600367389,wahoo,Zwift - ZHR Up & Down Race (A),Quarq DZero,Wahoo Kickr &#039;18,332,318,14
56177,1600453856,wahoo,Zwift - BRT Ages Racing League (B),Quarq DZero,Wahoo Kickr &#039;18,334,320,14
56317,1600542001,wahoo,Zwift -  Stage 2 // Virtual Haute Route Ventoux  (A),Quarq DZero,Wahoo Kickr &#039;18,303,290,13
56568,1600628399,wahoo,Zwift -  Stage 3 // Virtual Haute Route Ventoux  (A),Quarq DZero,Wahoo Kickr &#039;18,328,304,24
56569,1600628399,wahoo,Zwift -  Stage 3 // Virtual Haute Route Ventoux  (A),Quarq DZero,Wahoo Kickr &#039;18,328,304,24
56793,1600712397,wahoo,Zwift - TFC Mad Monday Autumn Series (A),Quarq DZero,Wahoo Kickr &#039;18,336,314,22
57368,1600888486,wahoo,Zwift - 3R Tick Tock Flat Race - 2 Lap (36km/22.4mi 100m) (A),Quarq DZero,Wahoo Kickr &#039;18,304,302,2
57369,1600972190,wahoo,Zwift - ZHR Up & Down Race (A),Quarq DZero,Wahoo Kickr &#039;18,350,327,23
57554,1601057386,wahoo,Zwift - 3R Lutscher CCW Climbing Race - 1 Lap (22.1km/13.9mi 827m) (A),Quarq DZero,Wahoo Kickr &#039;18,327,306,21
57919,1601212484,wahoo,Zwift - KISS at Race 100 - Americas (A),Quarq DZero,Wahoo Kickr &#039;18,321,308,13
58129,1601317223,wahoo,Zwift - TFC Mad Monday Autumn Series (A),Quarq DZero,Wahoo Kickr &#039;18,319,319,0
59668,1601924978,wahoo,Zwift - GGCC Glasgow Green Cycle Club Race Series (A),Quarq DZero,Wahoo Kickr &#039;18,314,311,3
59883,1602009826,wahoo,Zwift - 3R Sundown Race Series - iTT (E),Quarq DZero,Wahoo Kickr &#039;18,312,317,-5
60106,1602089989,wahoo,Zwift - MIDWEEK Autumn Series by SZR (A),Quarq DZero,Wahoo Kickr &#039;18,324,323,1
60477,1602173074,wahoo,Zwift - OH MY CRIT! - The Double Race 2/2 (A),Quarq DZero,Wahoo Kickr &#039;18,337,327,10
61064,1602425394,wahoo,Zwift - ZA Road Race #1: 4 - 5 w/kg,Quarq DZero,Wahoo Kickr &#039;18,341,325,16
61971,1602701848,wahoo,Zwift - MINI CRIT by WKG (A),Quarq DZero,Wahoo Kickr &#039;18,311,301,10
61974,1602702868,wahoo,Zwift - 3R Tick Tock Flat Race - 2 Lap (36km/22.4mi 100m) (A),Quarq DZero,Wahoo Kickr &#039;18,328,317,11
62292,1602787467,wahoo,Zwift - XRS - ZTR Thursday Night Race (A),Quarq DZero,Wahoo Kickr &#039;18,286,275,11
62449,1602863075,wahoo,Zwift - Guayaba Race by PETA-Z (A),Quarq DZero,Wahoo Kickr &#039;18,369,352,17
62722,1602962065,wahoo,Zwift - Herd Summer Racing League Series (A),Wahoo Kickr &#039;18,Wahoo Kickr &#039;18,309,329,-20
62723,1602962065,wahoo,Zwift - Herd Summer Racing League Series (A),Quarq DZero,Wahoo Kickr &#039;18,329,309,20
63424,1603131569,wahoo,Zwift - TFC Mad Monday Autumn Series (A),Quarq DZero,Wahoo Kickr &#039;18,324,299,25
63435,1603214429,wahoo,Zwift - Zwift Racing League | WTRL - EMEA E (MEN) - TTT Grp 1,Quarq DZero,Wahoo Kickr &#039;18,321,301,20
63436,1603214429,wahoo,Zwift - Zwift Racing League | WTRL - EMEA E (MEN) - TTT Grp 1,Quarq DZero,Wahoo Kickr &#039;18,0,0,0
63441,1603214429,wahoo,Zwift - Zwift Racing League | WTRL - EMEA E (MEN) - TTT Grp 1,Quarq DZero,Wahoo Kickr &#039;18,321,301,20
73643,1605900825,wahoo,Zwift - 3R Watopia Hilly Race - 3 Laps (27km/16.8mi 300m) (A),Quarq DZero,Wahoo Kickr &#039;18,322,300,22
74243,1606059520,wahoo,Zwift - The Alpe Dash by Herd Racing League (A),Quarq DZero,Wahoo Kickr &#039;18,347,333,14
75082,1606241681,wahoo,Zwift - Zwift Racing League | WTRL - Men&#039;s EMEA E1 DIVISION 2,Quarq DZero,Wahoo Kickr &#039;18,352,326,26
75549,1606327120,wahoo,Zwift - MIDWEEK Autumn Series by SZR (A),Quarq DZero,Wahoo Kickr &#039;18,338,338,0
76237,1606419330,neo,Zwift - Richmond,Quarq DZero,Tacx Neo 2,205,197,8
76544,1606501739,wahoo,Zwift - KIRCHMAIR Race Series (A),Quarq DZero,Wahoo Kickr &#039;18,338,340,-2
90333,1609604886,wahoo,Zwift - TEAM VEGAN Tofu Tornado (A),Quarq DZero,Wahoo Kickr &#039;18,334,324,10
90956,1609702385,wahoo,Zwift - 3R LaGuardia Super Sprint Race - 1 Lap (3.7km/2.6mi 27m) (A),Quarq DZero,Wahoo Kickr &#039;18,362,367,-5
91826,1609855405,wahoo,Zwift - 3R LaGuardia Super Sprint Race - 1 Lap (3.7km/2.6mi 27m) (A),Quarq DZero,Wahoo Kickr &#039;18,344,317,27
93997,1610209677,wahoo,Zwift - TEAM VEGAN Tofu Tornado (A),Quarq DZero,Wahoo Kickr &#039;18,320,312,8
124036,1614880683,wahoo,Hudik Triathlon Time Trial,Assioma Duo,Wahoo Kickr &#039;18,334,334,0
124513,1614963537,wahoo,Zwift - Zwift Fast Fridays: Bologna Time Trial (E),Assioma Duo,Wahoo Kickr &#039;18,342,340,2
125210,1615060630,wahoo,Zwift - Herd Beginner Racing Series (E),Assioma Duo,Wahoo Kickr &#039;18,321,323,-2
125410,1615127233,wahoo,Zwift - Herd Beginner Racing Series (E),Assioma Duo,Wahoo Kickr &#039;18,318,318,0
125746,1615213630,wahoo,Zwift - Aero Army Wyn TT Series (A),Assioma Duo,Wahoo Kickr &#039;18,366,366,0
126552,1615393973,wahoo,Zwift - Absa Cape Epic Stage 2 Time Trial pb Dimension Data - Open (A),Assioma Duo,Wahoo Kickr &#039;18,360,343,17
127286,1615485428,wahoo,Zwift - Braquasse By Frenchy Fuzion (E),Assioma Duo,Wahoo Kickr &#039;18,363,346,17
25642,1587147049,wahoo,Zwift - Richmond Challenge // Zwift Classic (A),pioneer left only,wahoo kickr,471,452,19
34946,1589295898,wahoo,Zwift - 3R & Wahoo Ride Real Race Series - Round 1 of 7 (A),pioneer left only,wahoo kickr,440,425,15
37668,1590427958,wahoo,Zwift - Watopia,4iiii,wahoo kickr,464,465,-1
38389,1590688113,wahoo,Zwift - Tour for All Invitational Race // Men (A),4iiii,wahoo kickr,490,487,3
39399,1591205310,wahoo,Zwift - Zwift NL League - Woensdagavond Competitie (A),4iiii,wahoo kickr,443,451,-8
44277,1593541332,wahoo,Zwift - 3R & Wahoo Ride Real Race Series - Round 7 of 7 (A),4iiii,wahoo kickr,436,437,-1
45989,1594489687,wahoo,Zwift - Lus van Roden&#039;s Meetup - The Fan Flats,4iiii,wahoo kickr,464,478,-14
47764,1595767407,wahoo,Zwift - KISS at Race 100 - Americas (A),4iiii,wahoo kickr,423,435,-12
55948,1600367395,wahoo,Zwift - Invitational League // Qualifying Race #2 (Men) ,4iiii,wahoo kickr,416,415,1
55971,1600106388,wahoo,Zwift - Invitational League // Qualifying Race #1,4iiii,wahoo kickr,455,468,-13
58293,1601385298,wahoo,Zwift - 3R Figure 8 Hilly Reverse Race - 1 Lap (29.2km/18.1mi 234m ) (A),4iiii,wahoo kickr,464,471,-7
61296,1602528544,wahoo,Zwift - Premier Division // Zwift Racing League (men) ,4iiii,wahoo kickr,447,461,-14
65217,1603742395,wahoo,Zwift - Premier Division // Zwift Racing League (men) (A),4iiii,wahoo kickr,448,456,-8
66206,1603996199,wahoo,Zwift - FUSION ECT BEUNSTOPPABLE Racing Series (A),4iiii,wahoo kickr,409,424,-15
67288,1604343931,wahoo,Zwift - Premier Division // Zwift Racing League (men) (A),4iiii,wahoo kickr,456,460,-4
74722,1606161600,wahoo,Zwift - Premier Division // Zwift Racing League (men) (A),4iiii,wahoo kickr,469,478,-9
77722,1606763362,wahoo,Zwift - Premier Division // Zwift Racing League (men) (A),4iiii,wahoo kickr,420,431,-11
93007,1610045993,wahoo,Zwift - BENELIGA 2020-2021 (E),4iiii,wahoo kickr,457,472,-15
99237,1610999840,wahoo,Zwift - Premier Division // Zwift Racing League (men) (A),4iiii,wahoo kickr,429,434,-5
100992,1611255594,wahoo,Zwift - BENELIGA 2020-2021 (E),4iiii,wahoo kickr,438,444,-6
104783,1611860385,wahoo,Zwift - BENELIGA 2020-2021 (E),4iiii,wahoo kickr,425,427,-2
106929,1612209997,wahoo,Zwift - XP short,4iiii,wahoo kickr,458,471,-13
111081,1612812203,wahoo,Zwift - Premier Division // Zwift Racing League (men) (A),4iiii,wahoo kickr,452,463,-11
115407,1613419305,wahoo,Zwift - Premier Division // Zwift Racing League (men) (A),4iiii,wahoo kickr,466,472,-6
115408,1613419305,wahoo,Zwift - Premier Division // Zwift Racing League (men) (A),4iiii,wahoo kickr,466,472,-6
119167,1614020999,wahoo,Zwift - Premier Division // Zwift Racing League (men) (A),4iiii,wahoo kickr,455,465,-10
56570,1600606770,neo,Zwift - Invitational League // Qualifying Race #3 (Men) (A),vector3,neo 2t,353,352,1
97630,1610713799,neo,Zwift - ZHQ FutureWorks Crit City Race - Anti-sandbagging (A),vector3,neo 2t,342,327,15
103682,1611690297,neo,Zwift - Zwift Racing League | WTRL - Men&#039;s/Mixed EMEA W1 DIVISION 1 (A),vector3,neo 2t,389,368,21
111433,1612787666,neo,Zwift - Watopia,vector3,neo 2t,311,314,-3
126438,1615373097,neo,Zwift - The Morning Grind by STPC (A),vector3,neo 2t,379,370,9
52339,1598614225,wahoo,Zwift - Off The MAAP Stage 4 - Longer Ride,Garmin Vector 3S Pedals,Wahoo Kickr,433,417,16
52517,1598703026,wahoo,Zwift - The BMTR Fundo (A),Garmin Vector 3S Pedals,Wahoo Kickr,364,365,-1
54147,1599667815,wahoo,Zwift - 3R Tick Tock Flat Race - 2 Lap (36km/22.4mi 100m) (A),Garmin Vector 3S Pedals,Wahoo Kickr,451,467,-16
54152,1599307796,wahoo,Zwift - The BMTR Fundo (A),Garmin Vector 3S Pedals,Wahoo Kickr,392,395,-3
54788,1599912622,wahoo,Zwift - The BMTR Fundo (A),Garmin Vector 3S Pedals,Wahoo Kickr,425,421,4
55155,1600106363,wahoo,Zwift - Invitational League // Qualifying Race #1,Garmin Vector 3S Pedals,Wahoo Kickr,441,450,-9
56015,1600367324,wahoo,Zwift - Invitational League // Qualifying Race #2 (Men) ,Garmin Vector 3S Pedals,Wahoo Kickr,399,421,-22
56519,1600604960,wahoo,Zwift - Invitational League // Qualifying Race #3 (Men) (A),Garmin Vector 3S Pedals,Wahoo Kickr,469,470,-1
59444,1601817121,wahoo,Zwift - KISS at Race 100 - Americas (A),Garmin Vector 3S Pedals,Wahoo Kickr,461,466,-5
61346,1602524452,wahoo,Zwift - Premier Division // Zwift Racing League (men) ,Garmin Vector 3S Pedals,Wahoo Kickr,480,490,-10
62715,1602933009,wahoo,Zwift - ZA Road Race #1: 4 - 5 w/kg,Garmin Vector 3S Pedals,Wahoo Kickr,457,462,-5
63177,1603125923,wahoo,Zwift - Premier Division // Zwift Racing League (men) ,Garmin Vector 3S Pedals,Wahoo Kickr,468,485,-17
63959,1603299411,wahoo,Zwift - MIDWEEK Autumn Series by SZR (A),Garmin Vector 3S Pedals,Wahoo Kickr,442,466,-24
64700,1603540771,wahoo,Zwift - The BMTR Fundo (A),Garmin Vector 3S Pedals,Wahoo Kickr,448,451,-3
65245,1603741742,wahoo,Zwift - Premier Division // Zwift Racing League (men) (A),Garmin Vector 3S Pedals,Wahoo Kickr,450,465,-15
66673,1604142472,wahoo,Zwift - ZA Road - Race #2 (A),Garmin Vector 3S Pedals,Wahoo Kickr,457,452,5
67353,1604339435,wahoo,Zwift - Premier Division // Zwift Racing League (men) (A),Garmin Vector 3S Pedals,Wahoo Kickr,457,504,-47
68606,1604689257,wahoo,Zwift -  Tour De Spartacus  (E),Garmin Vector 3S Pedals,Wahoo Kickr,520,538,-18
68891,1604775824,wahoo,Zwift -  Tour De Spartacus  (E),Garmin Vector 3S Pedals,Wahoo Kickr,411,414,-3
69149,1604862173,wahoo,Zwift -  Tour De Spartacus  (E),Garmin Vector 3S Pedals,Wahoo Kickr,506,501,5
69493,1604950534,wahoo,Zwift - Premier Division // Zwift Racing League (men) (A),Garmin Vector 3S Pedals,Wahoo Kickr,507,495,12
71374,1605348092,wahoo,Zwift - 3R iTT Race - There will be no draft - Choose your own TT bike (A),Garmin Vector 3S Pedals,Wahoo Kickr,454,462,-8
71686,1605445487,wahoo,Zwift - Rigo Urán: 2020 El Giro de Rigo - Official Route,Garmin Vector 3S Pedals,Wahoo Kickr,458,499,-41
72608,1605719701,wahoo,Zwift - 50-59 years,Garmin Vector 3S Pedals,Wahoo Kickr,455,468,-13
73890,1605547164,wahoo,Zwift - Premier Division // Zwift Racing League (men) (A),Garmin Vector 3S Pedals,Wahoo Kickr,461,479,-18
73901,1605964199,wahoo,Zwift - BMTR Flat 100 (Miles) (A),Garmin Vector 3S Pedals,Wahoo Kickr,321,326,-5
77037,1606568952,wahoo,BMTR 160 - Group managed Negative split 2nd half,Garmin Vector 3S Pedals,Wahoo Kickr,418,436,-18
77386,1606661998,wahoo,Zwift - ZHR Masters Weekender (C),Garmin Vector 3S Pedals,Wahoo Kickr,461,497,-36
82486,1607780759,wahoo,Zwift - MGCC hosts Ontario Cycling Association Virtual Challenge #1,Garmin Vector 3S Pedals,2018 Wahoo Kickr,409,396,13
82487,1607795894,wahoo,Zwift - 3R Three Sisters Hilly Race (47km/29.2mi 879m) (A),Garmin Vector 3S Pedals,2018 Wahoo Kickr,472,462,10
82909,1607868883,wahoo,Zwift - KISS 100 Race Series - Americas (A),Garmin Vector 3S Pedals,2018 Wahoo Kickr,465,454,11
87277,1608919310,wahoo,Zwift - BRT Ages Racing League (D),2020 Garmin Vector 3S Pedals,2018 Wahoo Kickr,482,473,9
87520,1608988175,wahoo,Zwift - BMTR Flat 100 (Miles) (A),2020 Garmin Vector 3S Pedals,2018 Wahoo Kickr,390,384,6
88027,1609115557,wahoo,Toronto Hustle Holiday Classic Stage  Race: Stage One,2020 Garmin Vector 3S Pedals,2018 Wahoo Kickr,416,402,14
88821,1609288187,wahoo,Zwift - Toronto Hustle Holiday Classic Stage Race: Stage Three (A),2020 Garmin Vector 3S Pedals,2018 Wahoo Kickr,443,431,12
89844,1609506532,wahoo,Zwift - BMTR New Year&#039;s Day 100 - Riding For Alzheimer&#039;s (A),2020 Garmin Vector 3S Pedals,2018 Wahoo Kickr,363,351,12
94160,1610197803,wahoo,Zwift - BMTR Flat 100 (Miles) (A),2020 Garmin Vector 3S Pedals,2018 Wahoo Kickr,356,344,12
94840,1610292164,wahoo,A Pacey 60 kms and then some beloved climbing,2020 Garmin Vector 3S Pedals,2018 Wahoo Kickr,418,400,18
95190,1610390464,wahoo,Zwift - Premier Division // Zwift Racing League (men) (A),2020 Garmin Vector 3S Pedals,2018 Wahoo Kickr,445,432,13
99280,1610996212,wahoo,Zwift - Premier Division // Zwift Racing League (men) (A),2020 Garmin Vector 3S Pedals,2018 Wahoo Kickr,449,434,15
103079,1611600829,wahoo,Zwift - Premier Division // Zwift Racing League (men) (A),2020 Garmin Vector 3S Pedals,2018 Wahoo Kickr,440,429,11
106261,1612098572,wahoo,Zwift - The BMTR Fundo (A),2020 Garmin Vector 3S Pedals,2021 Wahoo Kickr v5,421,413,8
106987,1612207663,wahoo,Zwift - Premier Division // Zwift Racing League (men) (A),2020 Garmin Vector 3S Pedals,2021 Wahoo Kickr v5,451,449,2
111234,1612807907,wahoo,Zwift - Premier Division // Zwift Racing League (men) (A),2020 Garmin Vector 3S Pedals,2021 Wahoo Kickr v5,478,484,-6
114162,1613220967,wahoo,Zwift - BMTR Flat 100 (Miles) (A),2020 Garmin Vector 3S Pedals,2021 Wahoo Kickr v5,347,351,-4
114783,1613307719,wahoo,Zwift - The BMTR Fundo (B),2020 Garmin Vector 3S Pedals,2021 Wahoo Kickr v5,454,461,-7
115462,1613419061,wahoo,Zwift - Premier Division // Zwift Racing League (men) (A),2020 Garmin Vector 3S Pedals,2021 Wahoo Kickr v5,469,477,-8
119234,1614017749,wahoo,Zwift - Premier Division // Zwift Racing League (men) (A),2020 Garmin Vector 3S Pedals,2021 Wahoo Kickr v5,389,395,-6
122671,1614629780,wahoo,Zwift - Premier Division // Zwift Racing League (men) (A),2020 Garmin Vector 3S Pedals,2021 Wahoo Kickr v5,462,473,-11
70045,1605062429,wahoo,Zwift Racing League | WTRL - AMERICAS W (MEN) -  Division 1,Powertap P1,Wahoo Kickr,388,411,-23
71596,1605433978,wahoo,Zwift - Climbers Day p/b dPAC.fit & Precision Hydration (A),Powertap P1,Wahoo Kickr,365,377,-12
73009,1605779667,wahoo,Zwift - Espresso,Powertap P1,Wahoo Kickr,308,325,-17
73079,1605807295,wahoo,WTRL Team Time Trial - Zone 4,Powertap P1,Wahoo Kickr,363,373,-10
73371,1605838550,wahoo,Zwift - Espresso,Powertap P1,Wahoo Kickr,364,380,-16
95870,1610479221,wahoo,Zwift - Zwift Racing League | WTRL - Men&#039;s/Mixed EMEA W1 DIVISION 2 (A),Powertap P1,Wahoo Kickr,379,390,-11
104110,1611689218,wahoo,Zwift - Zwift Racing League | WTRL - Men&#039;s/Mixed EMEA W1 DIVISION 2 (A),Powertap P1,Wahoo Kickr,395,413,-18
106338,1612114523,wahoo,Zwift - Stages of DIRT (E),Powertap P1,Wahoo Kickr,380,395,-15
106470,1611715928,wahoo,Zwift - Zwift Racing League | WTRL - Men&#039;s/Mixed AMERICAS W DIVISION 1 (A),Powertap P1,Wahoo Kickr,380,403,-23
106789,1612176559,wahoo,Zwift - TDZ Stage 6: Shorter Ride,Powertap P1,Wahoo Kickr,380,395,-15
107516,1612293545,wahoo,Zwift - Zwift Racing League | WTRL - Men&#039;s/Mixed EMEA W1 DIVISION 2 (A),Powertap P1,Wahoo Kickr,381,402,-21
107827,1612320505,wahoo,Zwift - Zwift Racing League | WTRL - Men&#039;s/Mixed AMERICAS W DIVISION 1 (A),Powertap P1,Wahoo Kickr,368,385,-17
108866,1612462159,wahoo,Zwift - Espresso,Powertap P1,Wahoo Kickr,340,358,-18
109184,1612491784,wahoo,Zwift - WTRL Team Time Trial - Zone 11 (C),Powertap P1,Wahoo Kickr,339,360,-21
109905,1612612699,wahoo,Zwift - DIRT Dadurday Chase Race  (A),Powertap P1,Wahoo Kickr,361,376,-15
110539,1612709410,wahoo,Zwift - TDZ Stage 7: Shorter Ride,Powertap P1,Wahoo Kickr,369,398,-29
111783,1612898072,wahoo,Zwift - Zwift Racing League | WTRL - Men&#039;s/Mixed EMEA W1 DIVISION 2 (A),Powertap P1,Wahoo Kickr,386,403,-17
111932,1612925196,wahoo,Zwift - Zwift Racing League | WTRL - Men&#039;s/Mixed AMERICAS W DIVISION 1 (A),Powertap P1,Wahoo Kickr,395,411,-16
112793,1613038270,wahoo,Zwift - WTRL Team Time Trial - Zone 2 (C),Powertap P1,Wahoo Kickr,329,350,-21
114260,1613234521,wahoo,Zwift - Crit City Race (A),Powertap P1,Wahoo Kickr,353,373,-20
116027,1613503590,wahoo,Zwift - Zwift Racing League | WTRL - Men&#039;s/Mixed EMEA W1 DIVISION 2 (A),Powertap P1,Wahoo Kickr,405,420,-15
116428,1613558072,wahoo,Zwift - Zwift Duathlon League - Bike,Powertap P1,Wahoo Kickr,327,342,-15
117076,1613642798,wahoo,Zwift - WTRL Team Time Trial - Zone 2 (C),Powertap P1,Wahoo Kickr,341,355,-14
118491,1613834714,wahoo,Zwift - TDZ Stage 7: Longer Ride,Powertap P1,Wahoo Kickr,358,377,-19
119864,1614108428,wahoo,Zwift - Zwift Racing League | WTRL - Men&#039;s/Mixed EMEA W1 DIVISION 2 (A),Powertap P1,Wahoo Kickr,356,365,-9
120141,1614163227,wahoo,Zwift - Zwift Duathlon League - Bike (B),Powertap P1,Wahoo Kickr,346,357,-11
123096,1614713421,wahoo,Zwift - Zwift Racing League | WTRL - Men&#039;s/Mixed EMEA W1 DIVISION 2 (A),Powertap P1,Wahoo Kickr,367,378,-11
129373,1615917783,wahoo,Zwift - Jon Poole (DIRT)&#039;s Meetup - Ocean Lava Cliffside Loop,Powertap P1,Wahoo Kickr,364,401,-37
113403,1613128700,wahoo,Zwift - Watopia,Xcadey dual,Wahoo Kickr core,274,289,-15
12327,1580752787,wahoo,Zwift - Tour de Zwift: Stage 6 Group Ride - Long Distance,Stages Dura ace,Wahoo Kickr,372,381,-9
12330,1580623189,wahoo,Zwift - KISS at Race 100 - EU (A),Stages Dura ace,Wahoo Kickr,305,310,-5
12425,1580845187,wahoo,Zwift - 3R Ultimate Racing League - Round 5 (A),Stages Dura ace,Wahoo Kickr,338,350,-12
12811,1581015584,wahoo,Zwift - KALAS Cup - Round 2 (A),Stages Dura ace,Wahoo Kickr,378,384,-6
13032,1581098986,wahoo,Zwift - 3R Lutscher CCW Climbing Race - 1 Lap (22.1km/13.9mi 827m) (A),Stages Dura ace,Wahoo Kickr,368,380,-12
13425,1581449982,wahoo,Zwift - 3R Ultimate Racing League - Round 6 (A),Stages Dura ace,Wahoo Kickr,350,360,-10
13426,1581449982,wahoo,Zwift - 3R Ultimate Racing League - Round 6 (A),Stages Dura ace,Wahoo Kickr,350,360,-10
14519,1581620381,wahoo,Zwift - KALAS Cup - Round 3 (A),Stages Dura ace,Wahoo Kickr,342,349,-7
14641,1582053297,wahoo,Zwift - Feltet.dk Race Series,Stages Dura ace,Wahoo Kickr,359,365,-6
15059,1582225196,wahoo,Zwift - KALAS Cup - Round 4 (A),Stages Dura ace,Wahoo Kickr,351,361,-10
15982,1582829998,wahoo,Zwift - KALAS Cup - Round 5 (A),Stages Dura ace,Wahoo Kickr,345,344,1
16082,1582968597,wahoo,Zwift - DBR Saturday Race (A),Stages Dura ace,Wahoo Kickr,364,370,-6
16495,1583176795,wahoo,Zwift - TFC & WTRL Mad Monday London Series (1 of 6) (A),Stages Dura ace,Wahoo Kickr,364,374,-10
16949,1583434793,wahoo,Zwift - KALAS Cup - Round 6 (A),Stages Dura ace,Wahoo Kickr,338,344,-6
17527,1583867687,wahoo,Zwift - Feltet.dk Race Series (A),Stages Dura ace,Wahoo Kickr,366,373,-7
17832,1584040487,wahoo,Zwift - Tour of Watopia Pro-Am Men&#039;s Race #1 (A),Stages Dura ace,Wahoo Kickr,392,401,-9
18190,1584295799,wahoo,Zwift - Stage 2 Race (A) - Tour of Watopia 2020,Stages Dura ace,Wahoo Kickr,385,397,-12
19116,1584731700,wahoo,Zwift - Tour of Watopia Pro-Am Men&#039;s Race #2 (A),Stages Dura ace,Wahoo Kickr,369,384,-15
19443,1585076399,wahoo,Zwift - NCF Spring Cup (A),Stages Dura ace,Wahoo Kickr,393,408,-15
20283,1585468794,wahoo,Zwift -  KALAS Indoor EFCT race series #Road race (A),Stages Dura ace,Wahoo Kickr,348,355,-7
20656,1585468794,wahoo,Zwift -  KALAS Indoor EFCT race series #Road race (A),Stages Dura ace,Wahoo Kickr,348,355,-7
21484,1585850392,wahoo,Zwift - KALAS Cup - Round 10 (A),Stages Dura ace,Wahoo Kickr,342,359,-17
21545,1585850392,wahoo,Zwift - KALAS Cup - Round 10 (A),Stages Dura ace,Wahoo Kickr,342,359,-17
22164,1586077189,wahoo,Zwift - Ronde van Zwift (A),Stages Dura ace,Wahoo Kickr,367,381,-14
25108,1586887199,wahoo,Zwift - NCF Spring Cup (A),Stages Dura ace,Wahoo Kickr,362,361,1
25999,1587147058,wahoo,Zwift - Richmond Challenge // Zwift Classic (A),Stages Dura ace,Wahoo Kickr,370,372,-2
26482,1587406798,wahoo,Zwift - TFC Mad Monday World Series (2 of 6) (A),Stages Dura ace,Wahoo Kickr,365,370,-5
30601,1588435193,wahoo,Zwift - YANA Pro/AM Invitiational (A),Stages Dura ace,Wahoo Kickr,385,385,0
31679,1588697997,wahoo,Zwift - NCF Grand Prix 2020 - Runde 1 - Elite (A),Stages Dura ace,Wahoo Kickr,387,393,-6
36608,1589907595,wahoo,Zwift - NCF Grand Prix 2020 - Runde 3 - Elite Herrer/Kvinner (A),Stages Dura ace,Wahoo Kickr,365,378,-13
36728,1590085014,wahoo,Zwift - Tour for All Invitational Race // Men (A),Stages Dura ace,Wahoo Kickr,350,360,-10
38366,1590689818,wahoo,Zwift - Tour for All Invitational Race // Men (A),Stages Dura ace,Wahoo Kickr,375,384,-9
55278,1600106393,wahoo,Zwift - Invitational League // Qualifying Race #1,Stages Dura ace,Wahoo Kickr,346,346,0
56436,1600606798,wahoo,Zwift - Invitational League // Qualifying Race #3 (Men) (A),Stages Dura ace,Wahoo Kickr,335,343,-8
56437,1600606798,wahoo,Zwift - Invitational League // Qualifying Race #3 (Men) (A),Stages Dura ace,Wahoo Kickr,335,343,-8
57161,1600883097,wahoo,Zwift - NCF Vinter Cup 2020 - Runde 1 - Herrer (A),Stages Dura ace,Wahoo Kickr,323,324,-1
60208,1602091797,wahoo,Zwift - NCF Vinter Cup 2020 - Runde 3 - Herrer (A),Stages Dura ace,Wahoo Kickr,348,345,3
62034,1602611698,wahoo,Zwift - Team Italy & Frenchy Fuzion League (A),Stages Dura ace,Wahoo Kickr,345,342,3
62035,1602696598,wahoo,Zwift - NCF Vinter Cup 2020 - Runde 4 - Herrer (A),Stages Dura ace,Wahoo Kickr,331,326,5
63971,1603301398,wahoo,Zwift - NCF Vinter Cup 2020 - Runde 5 - Herrer (A),Stages Dura ace,Wahoo Kickr,346,339,7
64324,1603387216,wahoo,Zwift - Espresso,Stages Dura ace,Wahoo Kickr V5,332,329,3
65839,1603909798,wahoo,Zwift - NCF Vinter Cup 2020 - Runde 6 - Herrer (A),Stages Dura ace,Wahoo Kickr V5,357,358,-1
65964,1603909798,wahoo,Zwift - NCF Vinter Cup 2020 - Runde 6 - Herrer (A),Stages Dura ace,Wahoo Kickr V5,357,358,-1
71910,1586887199,wahoo,Zwift - BRT Iron Goat Racing League (A),Favero Assioma,Wahoo Kickr bike ,362,324,38
71911,1605466793,wahoo,Zwift - BRT Iron Goat Racing League (A),Favero Assioma,Wahoo Kickr bike ,325,324,1
72725,1605724192,wahoo,Zwift - NCF Vinter Cup 2020 - Runde 9 - Herrer (A),Favero Assioma to Edge 520,Wahoo Kickr bike ,331,333,-2
73192,1605814191,wahoo,Zwift - World Championships Experience // Danish Cycling Federation,Favero Assioma to Edge 520,Wahoo Kickr bike ,319,324,-5
73195,1605814191,wahoo,Zwift - World Championships Experience // Danish Cycling Federation,Favero Assioma to Edge 520,Wahoo Kickr bike ,0,0,0
73196,1605814191,wahoo,Zwift - World Championships Experience // Danish Cycling Federation,Favero Assioma to Edge 520,Wahoo Kickr bike ,319,324,-5
75557,1606328999,wahoo,Zwift - NCF Vinter Cup 2020 - Runde 10 - Herrer (A),Favero Assioma to Edge 520,Wahoo Kickr bike ,0,0,0
75558,1606328999,wahoo,Zwift - NCF Vinter Cup 2020 - Runde 10 - Herrer (A),Favero Assioma to Edge 520,Wahoo Kickr bike ,339,342,-3
76581,1606502996,wahoo,Zwift - Team CLS Racing - Hills &#039;n&#039; Thrills S5 (E),Favero Assioma to Edge 520,Wahoo Kickr bike ,321,324,-3
77418,1606676396,wahoo,Zwift - Focus: Colours of PARI - Longer Ride,Favero Assioma to Edge 520,Wahoo Kickr bike ,317,321,-4
79649,1607162395,wahoo,Zwift - Nations Challenge // Norway (E),Favero Assioma to Edge 520,Wahoo Kickr bike ,266,271,-5
80269,1607280654,wahoo,Zwift - Watopia,Favero Assioma to Edge 520,Wahoo Kickr bike ,335,338,-3
81616,1607624993,wahoo,Zwift - FUSION DECEMBER CUP (A),Favero Assioma to Edge 520,Wahoo Kickr bike ,349,349,0
83366,1607853592,wahoo,Zwift - Climbers Day p/b dPAC.fit & Precision Hydration (A),Favero Assioma to Edge 520,Wahoo Kickr bike ,307,312,-5
83584,1608058490,wahoo,Zwift - Team Italy & Frenchy Fuzion League (A),Favero Assioma to Edge 520,Wahoo Kickr bike ,352,355,-3
84397,1608229791,wahoo,Zwift - FUSION DECEMBER CUP (A),Favero Assioma to Edge 520,Wahoo Kickr bike ,0,0,0
84399,1608229791,wahoo,Zwift - FUSION DECEMBER CUP (A),Favero Assioma to Edge 520,Wahoo Kickr bike ,0,0,0
84405,1608229791,wahoo,Zwift - FUSION DECEMBER CUP (A),Favero Assioma to Edge 520,Wahoo Kickr bike ,319,323,-4
87549,1609005886,wahoo,Zwift - 3R Three Sisters Hilly Race (47km/29.2mi 879m) (A),Favero Assioma to Edge 520,Wahoo Kickr bike ,343,344,-1
88113,1609151986,wahoo,Zwift - ZWC Hill Climb Battle (A),Favero Assioma to Edge 520,Wahoo Kickr bike ,344,346,-2
89917,1609525784,wahoo,Zwift - Team WEZ Friday Race (E),Favero Assioma to Edge 520,Wahoo Kickr bike ,311,314,-3
91365,1609786781,wahoo,Zwift - TDZ Stage 1: Longer Ride,Favero Assioma to Edge 520,Wahoo Kickr bike ,339,344,-5
92390,1609959881,wahoo,Zwift - DBR Wednesday Race (A),Favero Assioma to Edge 520,Wahoo Kickr bike ,331,336,-5
93072,1610044181,wahoo,Zwift - FUSION WINTER CUP (A),Favero Assioma to Edge 520,Wahoo Kickr bike ,334,339,-5
94052,1610215479,wahoo,Zwift - 3R Three Sisters Hilly Race (47km/29.2mi 879m) (A),Favero Assioma to Edge 520,Wahoo Kickr bike ,347,349,-2
94964,1610392469,wahoo,Zwift - 01/11/2021,Favero Assioma to Edge 520,Wahoo Kickr bike ,358,350,8
96430,1610562576,wahoo,Zwift - NCF Vintercup 2021 - Runde 1 - Herrer (A),Favero Assioma to Edge 520,Wahoo Kickr bike ,346,349,-3
97550,1610737176,wahoo,Zwift - TDZ Stage 3: Longer Ride,Favero Assioma to Edge 520,Wahoo Kickr bike ,323,326,-3
98702,1610909972,wahoo,Zwift - BRT Iron Goat Racing League (A),Favero Assioma to Edge 520,Wahoo Kickr bike ,364,366,-2
100336,1611167370,wahoo,Zwift - NCF Vintercup 2021 - Runde 2 - Herrer (A),Favero Assioma to Edge 520,Wahoo Kickr bike ,291,296,-5
101476,1611338970,wahoo,Zwift - 3R Lutscher CCW Climbing Race - 1 Lap (22.1km/13.9mi 827m) (A),Favero Assioma to Edge 520,Wahoo Kickr bike ,344,346,-2
102881,1611601466,wahoo,Zwift - Premier Division // Zwift Racing League (men) (A),Favero Assioma to Edge 520,Wahoo Kickr bike ,348,351,-3
103642,1611691170,wahoo,Zwift - TDZ Stage 5: Longer Ride,Favero Assioma to Edge 520,Wahoo Kickr bike ,349,350,-1
103935,1611691170,wahoo,Zwift - TDZ Stage 5: Longer Ride,Favero Assioma to Edge 520,Wahoo Kickr bike ,349,350,-1
104152,1611772169,wahoo,Zwift - NCF Vintercup 2021 - Runde 3 - Herrer (A),Favero Assioma to Edge 520,Wahoo Kickr bike ,361,364,-3
108223,1612376966,wahoo,Zwift - NCF Vintercup 2021 - Runde 4 - Herrer (A),Favero Assioma to Edge 520,Wahoo Kickr bike ,341,344,-3
111010,1612811391,wahoo,Zwift - RuhrRiders Pott-Race (A),Favero Assioma to Edge 520,Wahoo Kickr bike ,317,321,-4
112299,1612981793,wahoo,Zwift - NCF Vintercup 2021 - Runde 5 - Herrer (A),Favero Assioma to Edge 520,Wahoo Kickr bike ,350,356,-6
113525,1613151593,wahoo,Full Glaz Challenge 9/10,Favero Assioma to Edge 520,Wahoo Kickr bike ,343,347,-4
115360,1613419309,wahoo,Zwift - Premier Division // Zwift Racing League (men) (A),Favero Assioma to Edge 520,Wahoo Kickr bike ,357,361,-4
116647,1613586588,wahoo,Zwift - NCF Vintercup 2021 - Runde 6 - Herrer (A),Favero Assioma to Edge 520,Wahoo Kickr bike ,314,318,-4
117825,1613758188,wahoo,Zwift - 3R Lutscher CCW Climbing Race - 1 Lap (22.1km/13.9mi 827m) (A),Favero Assioma to Edge 520,Wahoo Kickr bike ,350,353,-3
120337,1614192293,wahoo,Zwift - Scandinavian Cup 2021 - Round 1 - Men (A),Favero Assioma to Edge 520,Wahoo Kickr bike ,343,348,-5
121530,1614423593,wahoo,Zwift - Haute Route Watopia 2021 Stage 2 (A),Favero Assioma to Edge 520,Wahoo Kickr bike ,336,339,-3
122434,1614623394,wahoo,Zwift - Team CLS Racing - Fast &#039;n&#039; Furious S9 (A),Favero Assioma to Edge 520,Wahoo Kickr bike ,352,355,-3
123633,1614797091,wahoo,Zwift - Scandinavian Cup 2021 - Round 2 - Men (A),Favero Assioma to Edge 520,Wahoo Kickr bike ,342,346,-4
126596,1615401892,wahoo,Scandinavian Cup 2021 - Round 3 - Men,Favero Assioma to Edge 520,Wahoo Kickr bike ,343,346,-3
128079,1615658692,wahoo,Zwift - 3R Three Sisters Hilly Race (47km/29.2mi 879m) (A),Favero Assioma to Edge 520,Wahoo Kickr bike ,345,348,-3
129154,1615658692,wahoo,Zwift - CeramicSpeed Race Series: Open Race (A),Favero Assioma to Edge 520,Wahoo Kickr bike ,345,354,-9
129158,1615919395,wahoo,Zwift - CeramicSpeed Race Series: Open Race (A),Favero Assioma to Edge 520,Wahoo Kickr bike ,353,354,-1
8360,1578423300,wahoo,Wahoo Kickr Core,SRM Rotor 3D,Wahoo Kickr Core,360,373,-13
9987,1579426195,wahoo,Wahoo Kickr Core / Srm Rotor 3D,Srm Rotor 3D,Wahoo Kickr Core,374,370,4
10330,1579632897,wahoo,Wahoo Kickr Core / SRM Rotor 3D,SRM Rotor 3D,Wahoo Kickr Core,360,357,3
11498,1580237697,wahoo,Team Italy Gladiators Race,SRM Rotor 3D (power source),Wahoo Kickr Core,366,354,12
12884,1580842498,wahoo,Zwift - Team Italy Gladiators Race (A),SRM Rotor 3D (power source),Wahoo Kickr Core,347,356,-9
13530,1581447294,wahoo,Zwift - Team Italy Gladiators Race (A),SRM Rotor 3D (power source),Wahoo Kickr Core,344,354,-10
15353,1582465249,wahoo,Zwift - Crit City Race (A),SRM Rotor 3D (power source),Wahoo Kickr Core,317,316,1
15630,1582659313,wahoo,Zwift - 3R SuperCRITical Race Series - Round 2of4 (A),SRM Rotor 3D (power source),Wahoo Kickr Core,358,358,0
15789,1582748115,wahoo,Zwift - 3R Classique Flat Race - 5 Laps (32.3km/20.1mi 95m) (A),SRM Rotor 3D (power source),Wahoo Kickr Core,332,335,-3
16669,1583261415,wahoo,Zwift - Team Italy & Frenchy Fuzion League (A),SRM Rotor 3D (power source),Wahoo Kickr Core,368,371,-3
17564,1583866500,wahoo,Zwift - Team Italy & Frenchy Fuzion League (A),SRM Rotor 3D (power source),Wahoo Kickr Core,360,366,-6
18525,1584471298,wahoo,Zwift - Team Italy & Frenchy Fuzion League (A),SRM Rotor 3D (power source),Wahoo Kickr Core,353,354,-1
19680,1585076096,wahoo,Zwift - Team Italy & Frenchy Fuzion League (A),SRM Rotor 3D (power source),Wahoo Kickr Core,375,379,-4
20914,1585677295,wahoo,Zwift - Team Italy & Frenchy Fuzion League (A),SRM Rotor 3D (power source),Wahoo Kickr Core,374,379,-5
22487,1586114998,wahoo,Zwift - Yorkshire Grand Prix Race (A),SRM Rotor 3D (power source),Wahoo Kickr Core,360,362,-2
22833,1586284798,wahoo,Zwift - 3R Spring Loaded Race Series - Round 2of6 (A),SRM Rotor 3D (power source),Wahoo Kickr Core,362,363,-1
24678,1586889595,wahoo,Zwift - 3R Spring Loaded Race Series - Round 3of6 (A),SRM Rotor 3D (power source),Wahoo Kickr Core,385,379,6
28057,1587824099,wahoo,Zwift - OH CRIT!! - Saturday Smash Series (A),SRM Rotor 3D (power source),Wahoo Kickr Core,374,374,0
36183,1588411683,wahoo,Zwift - 3R & Wahoo Ride Real Race Series - Round 2 of 7 (A),SRM Rotor 3D (power source),Wahoo Kickr Core,400,405,-5
36187,1587806883,wahoo,Zwift - 3R & Wahoo Ride Real Race Series - Round 1 of 7 (A),SRM Rotor 3D (power source),Wahoo Kickr Core,400,387,13
36709,1590085018,wahoo,Zwift - Tour for All Invitational Race // Men (A),SRM Rotor 3D (power source),Wahoo Kickr Core,369,370,-1
37923,1590518404,wahoo,Zwift - 3R & Wahoo Ride Real Race Series - Round 3 of 7 (A),SRM Rotor 3D (power source),Wahoo Kickr Core,376,388,-12
38399,1590689328,wahoo,Zwift - Tour for All Invitational Race // Men (A),SRM Rotor 3D (power source),Wahoo Kickr Core,427,438,-11
39153,1591123200,wahoo,Zwift - 3R & Wahoo Ride Real Race Series - Round 4 of 7 (A),SRM Rotor 3D (power source),Wahoo Kickr Core,376,381,-5
40588,1591728000,wahoo,Zwift - 3R & Wahoo Ride Real Race Series - Round 4 of 7 (A),SRM Rotor 3D (power source),Wahoo Kickr Core,387,399,-12
42048,1592332799,wahoo,Zwift - 3R & Wahoo Ride Real Race Series - Round 5 of 7 (A),SRM Rotor 3D (power source),Wahoo Kickr Core,372,382,-10
42413,1592409412,wahoo,Watopia - 3 sisters ZADA test,SRM Rotor 3D (power source),Wahoo Kickr Core,364,373,-9
43274,1592937601,wahoo,Zwift - 3R & Wahoo Ride Real Race Series - Round 6 of 7 (A),SRM Rotor 3D (power source),Wahoo Kickr Core,406,422,-16
44278,1593542398,wahoo,Zwift - 3R & Wahoo Ride Real Race Series - Round 7 of 7 (A),SRM Rotor 3D (power source),Wahoo Kickr Core,380,392,-12
46607,1594890959,wahoo,Zwift - The Lamb Chop p/b Black Sheep (A),SRM Rotor 3D (power source),Wahoo Kickr Core,392,400,-8
49601,1597171199,wahoo,Zwift - 3R Turbocharged Team Race Series - Round 5 (A),SRM Rotor 3D (power source),Wahoo Kickr Core,386,392,-6
50062,1597427999,wahoo,Zwift - RHYS HOWELL [CANYON]&#039;s Meetup - Tour Of Tewit Well,SRM Rotor 3D,Wahoo Kickr Core,360,363,-3
50832,1597913400,wahoo,Zwift - Off the MAAP Invitational Race // Stage 3 (men) ,SRM Rotor 3D,Wahoo Kickr Core,384,392,-8
51700,1598378401,wahoo,Zwift - RHYS HOWELL [CANYON]&#039;s Meetup - Big Foot Hills,SRM Rotor 3D (power source),Wahoo Kickr Core,350,387,-37
54009,1599588000,wahoo,Zwift - RHYS HOWELL [CANYON]&#039;s Meetup - Muir And The Mountain,SRM Rotor 3D,Wahoo Kickr Core,390,394,-4
55030,1600106399,wahoo,Zwift - Invitational League // Qualifying Race #1,SRM Rotor 3D,Wahoo Kickr Core,386,386,0
56426,1600606804,wahoo,Zwift - Invitational League // Qualifying Race #3 (Men) (A),SRM Rotor 3D,Wahoo Kickr Core,386,388,-2
61298,1602528599,wahoo,Zwift - Premier Division // Zwift Racing League (men) ,SRM Rotor 3D,Wahoo Kickr Core,0,0,0
61301,1602528599,wahoo,Zwift - Premier Division // Zwift Racing League (men) ,SRM Rotor 3D,Wahoo Kickr Core,398,404,-6
63171,1603131543,wahoo,Zwift - Premier Division // Zwift Racing League (men) ,SRM Rotor 3D,Wahoo Kickr Core,385,372,13
64661,1603548900,wahoo,Zwift - OH MY CRIT - Saturday Smash Race (A),SRM Rotor 3D (power source),Wahoo Kickr Core,363,363,0
66229,1603998615,wahoo,Zwift - WTRL Team Time Trial - Zone 5 (C),SRM Rotor 3D (power source),Wahoo Kickr Core,358,370,-12
67304,1604344502,wahoo,Zwift - Premier Division // Zwift Racing League (men) (A),SRM Rotor 3D,Wahoo Kickr Core,368,375,-7
68589,1604689292,wahoo,Zwift -  Tour De Spartacus  (E),SRM Rotor 3D (power source),Wahoo Kickr Core,401,402,-1
68886,1604775840,wahoo,Zwift -  Tour De Spartacus  (E),SRM Rotor 3D (power source),Wahoo Kickr Core,351,362,-11
70994,1605206938,wahoo,Zwift - Espresso,SRM Rotor 3D (power source),Wahoo Kickr Core,365,370,-5
73101,1605811110,wahoo,Zwift - Watopia,SRM Rotor 3D (power source),Wahoo Kickr Core,231,384,-153
73107,1605811110,wahoo,Zwift - Espresso,SRM Rotor 3D (power source),Wahoo Kickr Core,375,384,-9
74702,1606161601,wahoo,Zwift - Premier Division // Zwift Racing League (men) (A),SRM Rotor 3D,Wahoo Kickr Core,412,420,-8
77702,1606763578,wahoo,Zwift - Premier Division // Zwift Racing League (men) (A),SRM Rotor 3D,Wahoo Kickr Core,368,374,-6
86355,1608668101,wahoo,Zwift - JETT ZWIFT Morning Race (A),SRM Rotor 3D (power source),Wahoo Kickr Core,390,392,-2
89739,1609496620,wahoo,Zwift - Watopia,SRM Rotor 3D,Wahoo Kickr Core,350,350,0
94222,1610258400,wahoo,Zwift - KISS 100 Race Series - EU (A),SRM Rotor 3D (power source),Wahoo Kickr Core,378,378,0
97058,1610648399,wahoo,Zwift - Vienna,SRM Rotor 3D,Wahoo Kickr Core,369,368,1
99258,1610999961,wahoo,Zwift - Premier Division // Zwift Racing League (men) (A),SRM Rotor 3D,Wahoo Kickr Core,366,368,-2
102954,1611601500,wahoo,Zwift - Premier Division // Zwift Racing League (men) (A),SRM Rotor 3D,Wahoo Kickr Core,390,396,-6
106894,1612210019,wahoo,Zwift - Premier Division // Zwift Racing League (men) (A),SRM Rotor 3D,Wahoo Kickr Core,373,377,-4
111005,1612812029,wahoo,Wahoo Kickr Core / SRM Rotor 3D,SRM Rotor 3D,Wahoo Kickr Core,376,381,-5
115358,1613419323,wahoo,Zwift - Premier Division // Zwift Racing League (men) (A),SRM Rotor 3D,Wahoo Kickr Core,398,408,-10
119101,1614021000,wahoo,Zwift - Premier Division // Zwift Racing League (men) (A),SRM Rotor 3D,Wahoo Kickr Core,343,383,-40
122194,1614541833,wahoo,Zwift - Openers,SRM Rotor 3D,Wahoo Kickr Core,304,314,-10
122593,1614629881,wahoo,Zwift - Premier Division // Zwift Racing League (men) (A),SRM Rotor 3D,Wahoo Kickr Core,362,368,-6
65760,1603820809,wahoo,ZRL Richmond,ZRL_Richmond_Stages,ZRL_Richmond_Wahoo,402,422,-20
120395,1614191403,wahoo,Zwift - 3R Race - France Petit Boucle - 45KM (A),4iiii,Wahoo Kickr,336,316,20
91060,1609648640,wahoo,Zwift - Watopia,Quarq,Wahoo Kickr,406,418,-12
95252,1610392500,wahoo,Zwift - Premier Division // Zwift Racing League (men) (A),Quarq,Wahoo Kickr,396,400,-4
103102,1610999389,wahoo,Zwift - Premier Division // Zwift Racing League (men) (A),Quarq,Wahoo Kickr,388,382,6
119316,1614020492,wahoo,Zwift - Premier Division // Zwift Racing League (men) (A),Quarq,Wahoo Kickr,366,384,-18
122688,1614629563,wahoo,Zwift - Premier Division // Zwift Racing League (men) (A),Quarq,Wahoo Kickr,391,412,-21
62219,1602785402,neo,Zwift - Espresso,Quarq,Tacx Neo,410,397,13
62222,1602785402,neo,Zwift - Espresso,Quarq,Tacx Neo,0,0,0
62227,1602785402,neo,Zwift - Espresso,Quarq,Tacx Neo,410,397,13
63081,1603131721,neo,Zwift - Premier Division // Zwift Racing League (men) ,Quarq,Tacx Neo,0,0,0
63110,1603131721,neo,Zwift - Premier Division // Zwift Racing League (men) ,Quarq,Tacx Neo,401,393,8
11845,1580489093,wahoo,Zwift - Crit City Race (A),Garmin Vector 3 dual pedals,Wahoo kickr 18,348,345,3
12077,1580625897,wahoo,Zwift - Mtri Race (A),Garmin Vector 3 Dual,Wahoo kickr 18,347,347,0
12740,1581008991,wahoo,Zwift - Tour de Zwift: Stage 7 Race (A),Garmin Vector 3 Dual,Wahoo kickr 18,377,380,-3
22929,1586329199,wahoo,Zwift - ZHQ Beta Crit City Race (A),Stage G3 single sided ,Wahoo kickr 18,349,350,-1
23421,1586499000,wahoo,Zwift - 3R Volcano Circuit Flat Race - 4 Laps (18.9km/11.7mi 80m) (A),Stage G3 single sided ,Wahoo kickr 18,347,346,1
23440,1586502000,wahoo,Zwift - ZHQ Beta Crit City Race (A),Stage G3 single sided ,Wahoo kickr 18,315,321,-6
24447,1586845499,wahoo,Zwift - 3R Watopia Flat Route Race - 3 Laps (30.3km/18.8mi 162m) (A),Stage G3 single sided ,Wahoo kickr 18,398,400,-2
24448,1586849398,wahoo,Zwift - Trofeo Bologna Race (A),Stages G3 single sided ,Wahoo kickr 18,433,430,3
48226,1596004200,wahoo,Zwift - ZHQ Beta Crit City Race (A),Stages G3 single sided ,Wahoo kickr 18,348,351,-3
51196,1598075998,wahoo,Zwift - Off The MAAP Stage 3 Race (A),Stages G3 single sided ,Wahoo kickr 18,376,374,2
101418,1611331218,wahoo,Zwift - TDZ Stage 4: Longer Ride,Stages G3 single sided ,Wahoo Kickr 5,397,392,5
102297,1611470869,wahoo,Renegade Race - TT,Stages G2 single sided ,Wahoo Kickr 5,382,389,-7
105085,1611921598,wahoo,Zwift - TDZ Stage 6: Longer Ride,Stages G2 single sided ,Wahoo Kickr 5,383,384,-1
106029,1612072802,wahoo,Zwift - KISS 100 Race Series - EU,Stages G2 single sided ,Wahoo Kickr 5,391,402,-11
110245,1612677601,wahoo,Zwift - KISS 100 Race Series - EU (A),Stages G2 single sided ,Wahoo Kickr 5,388,395,-7
100482,1611164716,wahoo,Zwift - Danmarks Cykle Union & Partners 2/6 (A),Garmin vector 2,Wahoo kickr core,407,410,-3
104241,1611773103,wahoo,Zwift - Danmarks Cykle Union & Partners 3/6 (A),Garmin vector 2,Wahoo kickr core,425,419,6
108239,1612377903,wahoo,Zwift - Danmarks Cykle Union & Partners 4/6 (A),Garmin vector 2,Wahoo kickr core,0,0,0
108242,1612377903,wahoo,Zwift - Danmarks Cykle Union & Partners 4/6 (A),Garmin vector 2,Wahoo kickr core,407,401,6
110035,1612600221,wahoo,Zwift - DBR SufferDay League III (A),Garmin vector 2,Wahoo kickr core,371,366,5
112493,1612982713,wahoo,Zwift - Danmarks Cykle Union & Partners 5/6 (A),Garmin vector 2,Wahoo kickr core,400,398,2
114915,1613205016,wahoo,Zwift - DBR SufferDay League III (A),Garmin vector 2,Wahoo kickr core,398,398,0
95849,1610481103,wahoo,Zwift - Zwift Racing League | WTRL - Men&#039;s/Mixed EMEA W2 DIVISION 1 (A),Assioma Duo,Wahoo Kicker V5,378,387,-9
97132,1610653412,wahoo,Zwift - WTRL Team Time Trial - Zone 9 (C),Assioma Duo,Wahoo Kicker V5,383,378,5
99831,1611086122,wahoo,Zwift - Zwift Racing League | WTRL - Men&#039;s/Mixed EMEA W2 DIVISION 1 (A),Assioma Duo,Wahoo Kicker V5,365,361,4
100454,1611169131,wahoo,Zwift - TDZ Stage 4: Longer Ride,Assioma Duo,Wahoo Kickr V5,378,376,2
101053,1611258523,wahoo,Zwift - WTRL Team Time Trial - Zone 9 (C),Assioma Duo,Wahoo Kickr V5,373,361,12
113076,1613072765,wahoo,Zwift - WTRL Team Time Trial - Zone 11 (C),Assioma Duo,Wahoo Kickr V5,387,377,10
116829,1613586621,wahoo,Zwift - NCF Vintercup 2021 - Runde 6 - Herrer (A),Assioma Duo,Wahoo Kickr V5,394,389,5
117415,1613677680,wahoo,Zwift - WTRL Team Time Trial - Zone 12 (C),Assioma Duo,Wahoo Kickr V5,368,364,4
119798,1614109938,wahoo,Zwift - Zwift Racing League | WTRL - Men&#039;s/Mixed EMEA W2 DIVISION 1 (A),Assioma Duo,Wahoo Kickr V5,396,396,0
120890,1614282301,wahoo,Zwift - WTRL Team Time Trial - Zone 12 (C),Assioma Duo,Wahoo Kickr V5,389,389,0
120893,1614282271,wahoo,Zwift - WTRL Team Time Trial - Zone 12 (C),Assioma Duo,Wahoo Kickr V5,397,389,8
123125,1614714901,wahoo,Zwift - Zwift Racing League | WTRL - Men&#039;s/Mixed EMEA W2 DIVISION 1 (A),Assioma Duo,Wahoo Kickr V5,382,376,6
127205,1615492021,wahoo,Zwift - WTRL Team Time Trial - Zone 12 (C),Assioma Duo,Wahoo Kickr V5,376,369,7
5940,1576005013,neo,Zwift - WORLDOFFUSION Racing Series (B),Power2max NGeco,Tacx Neo,0,0,0
6131,1576178072,neo,Zwift - Zwift NL Ride - Pace and Race - Gaan met die banaan (B),Power2max NGeco,Tacx Neo,0,0,0
6534,1576609869,neo,Zwift - WORLDOFFUSION Racing Series (B),Power2max NGeco,Tacx Neo,0,0,0
8328,1578422925,neo,Zwift - Team Italy Gladiators Race (B),Power2max NGeco,Tacx Neo,294,289,5
9352,1579027984,neo,Zwift - Team Italy Gladiators Race (B),Power2max NGeco,Tacx Neo,296,289,7
10322,1579633056,neo,Zwift - Tour de Zwift: Stage 3 Group Ride - Long Distance,Power2max NGeco,Tacx Neo,297,289,8
11083,1580065607,neo,Zwift - Tour de Zwift: Stage 4 Race (A),Power2max NGeco,Tacx Neo,325,319,6
11371,1580237956,neo,Zwift - ZwiftTeamPL League – Classic Series (B),Power2max NGeco,Tacx Neo,298,295,3
11751,1580241340,neo,Zwift - KALAS Cup - Round 1 (B),Power2max NGeco,Tacx Neo,302,294,8
12047,1580415946,neo,Zwift - Tour de Zwift: Stage 6 Race (A),Power2max NGeco,Tacx Neo,298,293,5
13436,1581447905,neo,&quot;No Pain No Gain&quot; Transparency Racing Series,Power2max NGeco,Tacx Neo,281,275,6
14562,1582053255,neo,Zwift - Feltet.dk Race Series,Power2max NGeco,Tacx Neo,324,316,8
14982,1582227126,neo,Zwift - WTRL Team Time Trial (C),Power2max NGeco,Tacx Neo,296,289,7
15602,1582657217,neo,Zwift - Feltet.dk Race Series (A),Power2max NGeco,Tacx Neo,307,301,6
16651,1583262689,neo,Zwift - Feltet.dk Race Series (A),Power2max NGeco,Tacx Neo,313,307,6
17540,1583867588,neo,Zwift - Feltet.dk Race Series (A),Power2max NGeco,Tacx Neo,291,284,7
18498,1584472328,neo,Zwift - Feltet.dk Race Series (A),Power2max NGeco,Tacx Neo,314,307,7
29765,1588273013,neo,Zwift - KISS at Race - EU PM (A),Power2max NGeco,Tacx Neo,288,274,14
62581,1602930495,neo,Zwift - 3R Volcano Climb Race - 1 Lap (22.4km/14mi 204m) (A),Power2max NGeco,Tacx Neo,316,308,8
63942,1603301997,neo,Zwift - DBR HEINO CUP III (A),Power2max NGeco,Tacx Neo,297,289,8
65950,1603911363,neo,Zwift - Zwift NL Race Day (A),Power2max NGeco,Tacx Neo,303,295,8
66786,1604174134,neo,Zwift - Cycling Australia&#039;s PretzHELL by AHDR (B),Power2max NGeco,Tacx Neo,346,336,10
68591,1604687577,neo,Zwift - TFC Autumn Race Series (A),Power2max NGeco,Tacx Neo,336,328,8
70383,1605120042,neo,Zwift - DCU – Feltet.dk November series (A),Power2max NGeco,Tacx Neo,318,313,5
70563,1605036913,neo,Zwift - Zwift Racing League | WTRL - EMEA W1 (MEN) -  Division 1 (A),Power2max NGeco,Tacx Neo,354,345,9
71085,1605273720,neo,Zwift - DIRT Friday Pacific Sprintapalooza  (C),Power2max NGeco,Tacx Neo,220,214,6
75204,1606244821,neo,Zwift - Zwift Racing League | WTRL - Men&#039;s EMEA W1 DIVISION 1,Power2max NGeco,"Tacx Neo, Garmin 530",322,312,10
79489,1607107190,neo,Zwift - TFC Autumn Race Series (A),Power2max NGeco,"Tacx Neo, Garmin 530",330,322,8
80924,1607454065,neo,Zwift - Zwift Racing League | WTRL - Men&#039;s EMEA W1 DIVISION 1 (A),Power2max NGeco,"Tacx Neo, Garmin 530",320,315,5
81203,1607516748,neo,Zwift - 3R LaGuardia Loop Flat Race - 10 Laps (28.3km/17.6mi 270m) (A),Power2max NGeco,"Tacx Neo, Garmin 530",296,285,11
81210,1605553579,neo,Zwift - TFC Mad Monday Autumn Series (A),Power2max NGeco,"Tacx Neo, Garmin 530",306,299,7
83571,1608056881,neo,Zwift - Team Italy & Frenchy Fuzion League (A),Power2max NGeco,"Tacx Neo, Garmin 530",325,316,9
85106,1608390860,neo,Zwift - OH MY CRIT - Saturday Smash Race (A),Power2max NGeco,"Tacx Neo, Garmin 530",338,332,6
89936,1609011693,neo,Zwift - 3R Flat Race (A),Power2max NGeco,"Tacx Neo, Garmin 530",295,284,11
91844,1609872268,neo,Zwift - Team Italy & Frenchy Fuzion League (A),Power2max NGeco,"Tacx Neo, Garmin 530",322,310,12
93173,1610042983,neo,Zwift - FUSION WINTER CUP (A),Power2max NGeco,"Tacx Neo, Garmin 530",309,301,8
96421,1610561957,neo,Zwift - Danmarks Cykle Union & Partners 1/6 (A),Power2max NGeco,"Tacx Neo, Garmin 530",313,306,7
96796,1610626930,neo,Zwift - EMU Japan Race (A),Power2max NGeco,"Tacx Neo, Garmin 530",291,285,6
97558,1610736803,neo,Zwift - 3R Watopia Hilly Race - 3 Laps (27km/16.8mi 300m) (A),Power2max NGeco,"Tacx Neo, Garmin 530",299,294,5
99049,1610994903,neo,Zwift -  SCF SWE Cup Men (A),Power2max NGeco,"Tacx Neo, Garmin 530",297,286,11
77231,1606641847,wahoo,Zwift - Watopia dietro bot 4.2Wkg,Favero Assioma DUO,Wahoo Kickr Core,262,262,0
79423,1607095818,wahoo,Zwift - BST Mountaingoat Race (A),Garmin Vector 2,Wahoo Kickr Core,240,232,8
74070,1605855696,neo,Zwift Academy Tri: Bike Workout 4 | FTP Development,Quarq Specialized,Tacx Neo,287,287,0
76943,1606553979,neo,ZTS Season II - Race 1,Quarq Dzero Specialized,Tacx Neo,355,352,3
82218,1607761064,neo,Zwift - ZTS Season II - Race 2 (A),Quarq Dzero Specialized,Tacx Neo,357,349,8
3287,1572098307,neo,Zwift - 10/26/2019 P Race,Quarq dfour,Tacx Neo,331,323,8
3343,1572182008,neo,Zwift - 10/27/2019 KISS 100,Quarq dfour,Tacx Neo,0,327,-327
3456,1572365305,neo,Zwift - 3R WATOPIA-Watopia Flat Route Reverse Race - 4 Laps (41km/25.5mi 216m) (A),Quarq dfour,Tacx Neo,341,333,8
3571,1572537805,neo,Zwift - OH CRIT!! - The Double Race - Race 1/2 (A),Quarq dfour,Tacx Neo,0,0,0
3574,1572541403,neo,Zwift - OH CRIT!! - The Double Race - Race 2/2 (A),Quarq dfour,Tacx Neo,321,319,2
3733,1572707603,neo,Zwift - OH CRITT!! - Saturday Smash Series (A),Quarq dfour,Tacx Neo,0,0,0
3736,1572790406,neo,Zwift - KISS at Race 100 - Americas (A),Quarq dfour,Tacx Neo,350,340,10
3793,1572969723,neo,Zwift - 11/05/2019 - Ultimate Racing League,Quarq dfour,Tacx Neo,0,0,0
3959,1573142596,neo,Zwift - OH CRIT!! - The Double Race - Race 1/2 (A),Quarq dfour,Tacx Neo,371,361,10
3961,1573146196,neo,Zwift - OH CRIT!! - The Double Race - Race 2/2 (A),Quarq dfour,Tacx Neo,0,0,0
4009,1573312395,neo,Zwift - OH CRIT!! - Saturday Smash Series (A),Quarq dfour,Tacx Neo,314,305,9
4051,1573395194,neo,Zwift - KISS at Race 100 - Americas (A),Quarq dfour,Tacx Neo,346,333,13
4183,1573574594,neo,Zwift - Ultimate Racing League by 3R & WTRL (A),Quarq dfour,Tacx Neo,0,0,0
4398,1573999989,neo,Zwift - KISS at Race 100 - Americas (A),Quarq dfour,Tacx Neo,331,321,10
83389,1608022472,wahoo,Zwift - Zwift Racing League | WTRL - Men&#039;s APAC DIVISION 1 (A),Direto XR,Quarq dFour91 to Wahoo,372,365,7
80558,1604825946,neo,Zwift - Zwift Fondo Series 2020/21: Gran Fondo ,Shimano Dura-Ace Powermeter with Rotor Q-Rings,Tacx Neo 2T,390,372,18
81155,1607518465,neo,Zwift - ZHQ FutureWorks Crit City Race - Boost mode (A),Shimano Dura-Ace Powermeter with Rotor Q-Rings,Tacx Neo 2T,405,355,50
81545,1607611167,neo,Zwift - Mikkeller and Friends Race (A),Shimano Dura-Ace Powermeter with Rotor Q-Rings,Tacx Neo 2T,386,387,-1
82247,1607761296,neo,Zwift - TEAM VEGAN Tofu Tornado XL (A),Shimano Dura-Ace Powermeter with Rotor Q-Rings,Tacx Neo 2T,435,414,21
83222,1607973586,neo,Zwift - Team TFC Mad Monday Winter Series (A),Shimano Dura-Ace Powermeter with Rotor Q-Rings,Tacx Neo 2T,458,421,37
85639,1608472890,neo,Zwift - KISS 100 Race Series - Americas (A),Shimano Dura-Ace Powermeter with Rotor Q-Rings,Tacx Neo 2T Smart,313,314,-1
85879,1608578390,neo,Zwift - Team TFC Mad Monday Winter Series (A),Shimano Dura-Ace Powermeter with Rotor Q-Rings,Tacx Neo 2T Smart,407,399,8
86818,1608797515,neo,Zwift - KISS Race Series - Down Under (A),Shimano Dura-Ace Powermeter with Rotor Q-Rings,Tacx Neo 2T Smart,421,422,-1
87283,1608901185,neo,Zwift - Watopia,Fahrt_am_Nachmittag-2,Tacx Neo 2T Smart,425,423,2
87486,1608995690,neo,Zwift - OH MY CRIT - Saturday Smash Race (A),Shimano Dura-Ace Powermeter with Rotor Q-Rings,Tacx Neo 2T Smart,396,394,2
87928,1609078103,neo,Zwift - KISS 100 Race Series - Americas (A),Shimano Dura-Ace Powermeter with Rotor Q-Rings,Tacx Neo 2T Smart,388,385,3
89838,1609514759,neo,Zwift - BST Mountaingoat Race (A),Shimano Dura-Ace Powermeter with Rotor Q-Rings,Tacx Neo 2T Smart,399,403,-4
91389,1609787972,neo,Zwift - Team TFC Mad Monday Winter Series (A),Shimano Dura-Ace Powermeter with Rotor Q-Rings,Tacx Neo 2T Smart,368,371,-3
95024,1610389689,neo,Zwift - Premier Division // Zwift Racing League (men) (A),Shimano Dura-Ace Powermeter with Rotor Q-Rings,Tacx Neo 2T Smart,416,394,22
99242,1610998822,neo,Zwift - Premier Division // Zwift Racing League (men) (A),Shimano Dura-Ace Powermeter with Rotor Q-Rings,Tacx Neo 2T Smart,407,392,15
105148,1611932653,neo,Zwift - 01/29/2021,Shimano Dura-Ace Powermeter with Rotor Q-Rings,Tacx Neo 2T Smart,409,419,-10
106959,1612209890,neo,Zwift - Premier Division // Zwift Racing League (men) (A),Shimano Dura-Ace Powermeter with Rotor Q-Rings,Tacx Neo 2T Smart,390,406,-16
125417,1615053864,neo,Zwift - 3R Three Sisters Hilly Race (47km/29.2mi 879m) (A),Assioma Favero Duo,Tacx Neo 2T,403,404,-1
128523,1615576449,neo,DA powermeter vs Tacx neo 2T,Dura Ace Crank,Tacx Neo 2T,290,289,1
68467,1604660084,wahoo,Zwift - Watopia,Stages Ultegra,Wahoo KICKR v5,302,302,0
68518,1604680787,wahoo,Zwift - Crit City Race (A),Stages Ultegra,Wahoo KICKR v5,377,377,0
68821,1604766240,wahoo,Zwift - 3R Innsbruckring Flat Race - 3 Laps (26.4km/16.4mi 231m) (A),Stages Ultegra,Wahoo KICKR v5,360,364,-4
70120,1605089203,wahoo,Zwift - USA Cycling Race League by Indoor Specialist (A),Stages Ultegra,Wahoo KICKR v5,371,366,5
70555,1605178771,wahoo,Zwift - KISS at Race - Americas AM (A),Stages Ultegra,Wahoo KICKR v5,351,344,7
71345,1605351031,wahoo,Zwift - DIRT Dadurday Chase Race  (A),Stages Ultegra,Wahoo KICKR v5,357,346,11
71683,1605448897,wahoo,Zwift - KISS 100 Race Series - Americas (A),Stages Ultegra,Wahoo KICKR v5,315,332,-17
72582,1605692921,wahoo,Zwift - USA Cycling Race League by Indoor Specialist (A),Stages Ultegra,Wahoo KICKR v5,362,372,-10
72922,1605780690,wahoo,Zwift - KISS Race Series - Americas AM (A),Stages Ultegra,Wahoo KICKR v5,338,351,-13
73876,1605970334,wahoo,Zwift - OH MY CRIT - Saturday Smash Race (A),Stages Ultegra,Wahoo KICKR v5,373,381,-8
74196,1606050866,wahoo,Zwift - Crit City Race (A),Stages Ultegra,Wahoo KICKR v5,340,349,-9
74320,1606064365,wahoo,Zwift - 3R Racing (A),Stages Ultegra,Wahoo KICKR v5,358,372,-14
74906,1606213962,wahoo,Zwift - KISS Race Series - Americas AM (A),Stages Ultegra,Wahoo KICKR v5,347,354,-7
75424,1606299646,wahoo,Zwift - USA Cycling Race League by Indoor Specialist (A),Stages Ultegra,Wahoo KICKR v5,355,364,-9
75953,1606406402,wahoo,Zwift - OH MY CRIT! - The Double Race 1/2 (A),Stages Ultegra,Wahoo KICKR v5,360,370,-10
75955,1606406402,wahoo,Zwift - OH MY CRIT! - The Double Race 2/2 (A),Stages Ultegra,Wahoo KICKR v5,360,360,0
76526,1606493738,wahoo,Zwift - ZHQ FutureWorks Crit City Race - Anti-sandbagging (A),Stages Ultegra,Wahoo KICKR v5,351,354,-3
77317,1606661237,wahoo,Zwift - 3R Tick Tock Flat Race - 1 Lap (19km/11.8mi 50m) (A),Stages Ultegra,Wahoo KICKR v5,368,377,-9
77556,1606735709,wahoo,Zwift - 3R Innsbruckring Flat Race - 3 Laps (26.4km/16.4mi 231m) (A),Stages Ultegra,Wahoo KICKR v5,351,361,-10
77949,1606820528,wahoo,Zwift - 3R Volcano Circuit Flat Race - 8 Laps (35.2km/21.9mi 160m) (A),Stages Ultegra,Wahoo KICKR v5,364,369,-5
79442,1607102480,wahoo,Zwift - EVO CC / Le Col - Sprint Race Series (A),Stages Ultegra,Wahoo KICKR v5,349,363,-14
79872,1607185554,wahoo,Zwift - 3R Innsbruckring Flat Race - 3 Laps (26.4km/16.4mi 231m) (A),Stages Ultegra,Wahoo KICKR v5,362,368,-6
80177,1607262801,wahoo,Zwift - Crit City Race (A),Stages Ultegra,Wahoo KICKR v5,338,348,-10
80709,1607424490,wahoo,Zwift - Japan Zwift Tuesday Race (A),Stages Ultegra,Wahoo KICKR v5,354,369,-15
81119,1607536056,wahoo,Zwift - MIDWEEK Winter Series by SZR (A),Stages Ultegra,Wahoo KICKR v5,354,370,-16
81463,1607600855,wahoo,Zwift - 3R Volcano Circuit Flat Race - 8 Laps (35.2km/21.9mi 160m) (A),Stages Ultegra,Wahoo KICKR v5,344,355,-11
81988,1607705060,wahoo,Zwift - Crit City Race (A),Stages Ultegra,Wahoo KICKR v5,356,365,-9
81989,1607705060,wahoo,Zwift - EVO CC / Le Col - Sprint Race Series (A),Stages Ultegra,Wahoo KICKR v5,356,361,-5
82327,1607774504,wahoo,Zwift - DIRT Dadurday Chase Race  (A),Stages Ultegra,Wahoo KICKR v5,340,347,-7
82329,1607778213,wahoo,Zwift - 3R Innsbruckring Flat Race - 5 Laps (44km/27.3mi 385m) (A),Stages Ultegra,Wahoo KICKR v5,328,339,-11
83873,1608114491,wahoo,Zwift - USA Cycling Race League by Indoor Specialist (A),Stages Ultegra,Wahoo KICKR v5,352,357,-5
84762,1608309260,wahoo,Zwift - Crit City Race (A),Stages Ultegra,Wahoo KICKR v5,356,358,-2
84763,1608309260,wahoo,Zwift - EVO CC / Le Col - Sprint Race Series (A),Stages Ultegra,Wahoo KICKR v5,345,355,-10
85067,1608379466,wahoo,Zwift - DIRT Dadurday Chase Race  (A),Stages Ultegra,Wahoo KICKR v5,344,353,-9
85480,1608473539,wahoo,Zwift - KISS 100 Race Series - Americas (A),Stages Ultegra,Wahoo KICKR v5,339,345,-6
85810,1608575070,wahoo,Zwift - NYC,Stages Ultegra,Wahoo KICKR v5,292,295,-3
86438,1608717397,wahoo,Zwift - USA Cycling Race League by Indoor Specialist (A),Stages Ultegra,Wahoo KICKR v5,359,370,-11
86990,1608825417,wahoo,Zwift - OH MY CRIT! - The Double Race 1/2 (A),Stages Ultegra,Wahoo KICKR v5,359,372,-13
86992,1608825417,wahoo,Zwift - OH MY CRIT! - The Double Race 2/2 (A),Stages Ultegra,Wahoo KICKR v5,359,373,-14
87421,1608988931,wahoo,Zwift - ZHQ FutureWorks Circuit Race - Anti-sandbagging (A),Stages Ultegra,Wahoo KICKR v5,341,341,0
88366,1609188569,wahoo,Zwift - 3R Watopia Flat Route Race - 3 Laps (30.8km/19.1mi 162m) (A),Stages Ultegra,Wahoo KICKR v5,360,376,-16
89558,1609426738,wahoo,Zwift - OH MY CRIT! - The Double Race 2/2 (A),Stages Ultegra,Wahoo KICKR v5,351,369,-18
89843,1609517551,wahoo,Zwift - SST (Med),Stages Ultegra,Wahoo KICKR v5,267,281,-14
90316,1609599997,wahoo,Zwift - TEAM VEGAN Tofu Tornado (A),Stages Ultegra,Wahoo KICKR v5,333,359,-26
90805,1609686862,wahoo,Zwift - 3R Watopia 65km Race - 6 laps (40mi 324m) (A),Stages Ultegra,Wahoo KICKR v5,346,366,-20
92168,1609930711,wahoo,Zwift - 3R Volcano Circuit Flat Race - 6 Laps (27km/16.8mi 120m) (A),Stages Ultegra,Wahoo KICKR v5,345,352,-7
93431,1610124642,wahoo,Zwift -  ZRG-CC 2021 Series (A),Stages Ultegra,Wahoo KICKR v5,349,354,-5
93888,1610197556,wahoo,Zwift - 3R Innsbruckring Flat Race - 5 Laps (44km/27.3mi 385m) (A),Stages Ultegra,Wahoo KICKR v5,339,349,-10
95975,1610498012,wahoo,Zwift - Zwift Racing League | WTRL - Men&#039;s/Mixed AMERICAS E DIVISION 4 (A),Stages Ultegra,Wahoo KICKR v5,365,358,7
96185,1610536480,wahoo,Zwift - 3R Volcano Circuit Flat Race - 6 Laps (27km/16.8mi 120m) (A),Stages Ultegra,Wahoo KICKR v5,321,345,-24
96777,1610621345,wahoo,Zwift - KISS Race Series - Americas AM (A),Stages Ultegra,Wahoo KICKR v5,319,333,-14
98001,1610802233,wahoo,Zwift - 3R Innsbruckring Flat Race - 5 Laps (44km/27.3mi 385m) (A),Stages Ultegra,Wahoo KICKR v5,340,359,-19
98002,1610802233,wahoo,Zwift - Crit City Race (A),Stages Ultegra,Wahoo KICKR v5,332,356,-24
98602,1610895819,wahoo,Zwift - 3R Watopia 65km Race - 6 laps (40mi 324m) (A),Stages Ultegra,Wahoo KICKR v5,321,347,-26
100149,1611140473,wahoo,Zwift - 3R Volcano Circuit Flat Race - 6 Laps (27km/16.8mi 120m) (A),Stages Ultegra,Wahoo KICKR v5,338,360,-22
100727,1611226439,wahoo,Zwift - EMU Japan Short Race (A),Stages Ultegra,Wahoo KICKR v5,333,339,-6
102023,1610729489,wahoo,Zwift - 3R Innsbruckring Flat Race - 3 Laps (26.4km/16.4mi 231m) (A),Stages Ultegra,Wahoo KICKR v5,0,350,-350
103986,1611707617,wahoo,Zwift - Zwift Racing League | WTRL - Men&#039;s/Mixed AMERICAS E DIVISION 4 (A),Stages Ultegra,Wahoo KICKR v5,334,355,-21
104479,1611831297,wahoo,Zwift - KISS Race Series - Americas AM (A),Stages Ultegra,Wahoo KICKR v5,346,368,-22
105053,1611918533,wahoo,Zwift - 3R LaGuardia Loop Reverse Flat Race - 8 Laps (24.5km/15.2mi 216m) (A),Stages Ultegra,Wahoo KICKR v5,344,367,-23
105596,1612011174,wahoo,Zwift - 3R Innsbruckring Flat Race - 5 Laps (44km/27.3mi 385m) (A),Stages Ultegra,Wahoo KICKR v5,345,369,-24
107717,1612311158,wahoo,Zwift - Zwift Racing League | WTRL - Men&#039;s/Mixed AMERICAS E DIVISION 4 (A),Stages Ultegra,Wahoo KICKR v5,356,379,-23
107978,1612348506,wahoo,Zwift - The Morning Grind by STPC (A),Stages Ultegra,Wahoo KICKR v5,327,346,-19
108717,1612435617,wahoo,Zwift - KISS Race Series - Americas AM (A),Stages Ultegra,Wahoo KICKR v5,339,360,-21
109967,1612627003,wahoo,Zwift - 3R Classique Flat Race - 4 Laps (26.9km/16.7mi 76m) (A),Stages Ultegra,Wahoo KICKR v5,353,366,-13
110535,1612711328,wahoo,Zwift - 3R Watopia 65km Race - 6 laps (40mi 324m) (A),Stages Ultegra,Wahoo KICKR v5,343,363,-20
112114,1612915725,wahoo,Zwift - Zwift Racing League | WTRL - Men&#039;s/Mixed AMERICAS E DIVISION 4 (A),Stages Ultegra,Wahoo KICKR v5,346,357,-11
112739,1613040517,wahoo,Zwift - KISS Race Series - Americas AM (A),Stages Ultegra,Wahoo KICKR v5,335,342,-7
113382,1613128380,wahoo,Zwift - 3R LaGuardia Loop Reverse Flat Race - 8 Laps (24.5km/15.2mi 216m) (A),Stages Ultegra,Wahoo KICKR v5,349,362,-13
114123,1613230098,wahoo,Zwift - Team Draft Crit City Race (A),Stages Ultegra,Wahoo KICKR v5,345,355,-10
114760,1613315940,wahoo,Zwift - Team Draft Libby Hill After Party Race (A),Stages Ultegra,Wahoo KICKR v5,324,332,-8
114763,1613315940,wahoo,Zwift - Crit City Race (A),Stages Ultegra,Wahoo KICKR v5,363,372,-9
117800,1613755522,wahoo,Zwift - EVO CC / Le Col - Sprint Race Series (A),Stages Ultegra,Wahoo KICKR v5,356,365,-9
118334,1613834442,wahoo,Zwift - 3R Endurance Series p/b OTE Sports- Stage 1 (A),Stages Ultegra,Wahoo KICKR v5,350,358,-8
118762,1613924258,wahoo,Zwift - Crit City Race (A),Stages Ultegra,Wahoo KICKR v5,346,369,-23
119931,1614127497,wahoo,Zwift - Zwift Racing League | WTRL - Men&#039;s/Mixed AMERICAS E DIVISION 4 (A),Stages Ultegra,Wahoo KICKR v5,357,370,-13
120633,1614250147,wahoo,Zwift - KISS Race Series - Americas AM (New Pack Dynamics) (A),Stages Ultegra,Wahoo KICKR v5,348,362,-14
121707,1614441544,wahoo,Zwift - 3R Endurance Series p/b OTE Sports (A),Stages Ultegra,Wahoo KICKR v5,297,355,-58
121713,1614441544,wahoo,Zwift - 3R Endurance Series p/b OTE Sports (A),Stages Ultegra,Wahoo KICKR v5,297,355,-58
122117,1614525721,wahoo,Zwift - 3R Watopia 65km Race - 6 laps (40mi 324m) (A),Stages Ultegra,Wahoo KICKR v5,328,345,-17
125056,1615046267,wahoo,Zwift - 3R Endurance Series p/b OTE Sports (A),Stages Ultegra,Wahoo KICKR v5,344,357,-13
126044,1615288449,wahoo,Zwift - 3R Volcano Circuit Flat Race - 8 Laps (35.2km/21.9mi 160m) (A),Stages Ultegra,Wahoo KICKR v5,355,368,-13
126885,1615460293,wahoo,Zwift - KISS Race Series - Americas AM (A),Stages Ultegra,Wahoo KICKR v5,339,351,-12
128044,1615651339,wahoo,Zwift - 3R Endurance Series p/b OTE Sports (A),Stages Ultegra,Wahoo KICKR v5,370,389,-19
18587,1584554359,wahoo,Zwift - SZR Spring Race Series (A),Stages (Garmin),Wahoo Kickr 18 (Zwift),341,348,-7
19502,1585075208,wahoo,Zwift - Stage 4 Race (A) - Tour of Watopia 2020,Stages (Garmin),Wahoo Kickr 18 (Zwift),370,372,-2
19504,1585078199,wahoo,British Cycling Race Series,Stages (Garmin),Wahoo Kickr 18 (Zwift),383,379,4
20087,1585387797,wahoo,Zwift - DBR Saturday Race (A),Stages (Garmin),Wahoo Kickr 18 (Zwift),453,435,18
21059,1585734295,wahoo,USA Cycling Race League by Indoor Specialist ,Stages (Garmin),Wahoo Kickr 18 (Zwift),375,375,0
21658,1585904393,wahoo,Zwift -  Haute Route Watopia Stage 1 (E),Stages (Garmin),Wahoo Kickr 18 (Zwift),404,395,9
21925,1585990795,wahoo,Zwift -  Haute Route Watopia Stage 2 (E),Stages (Garmin),Wahoo Kickr 18 (Zwift),368,359,9
22275,1586091594,wahoo,Zwift -  Haute Route Watopia Stage 3 (E),Stages (Garmin),Wahoo Kickr 18 (Zwift),405,384,21
23263,1586445291,wahoo,Zwift - OH CRIT!! - The Double Race - Race 1/2 (A),Stages (Garmin),Wahoo Kickr 18 (Zwift),401,393,8
23264,1586448296,wahoo,Zwift - OH CRIT!! - The Double Race - Race 2/2 (A),Stages (Garmin),Wahoo Kickr 18 (Zwift),386,384,2
29689,1588267797,wahoo,Zwift - British Cycling Time Trial Series (A),Stages (Garmin),Wahoo Kickr 18 (Zwift),382,375,7
30877,1588496696,wahoo,Zwift - Newbury Velo Road Race (A),Stages (Garmin),Wahoo Kickr 18 (Zwift),364,363,1
32072,1588787699,wahoo,Zwift - USA Cycling Race League p/b Saris+ThePro&#039;sCloset  (A),Stages (Garmin),Wahoo Kickr 18 (Zwift),389,384,5
34381,1589392500,wahoo,Zwift - USA Cycling Race League by Indoor Specialist (A),Stages (Garmin),Wahoo Kickr 18 (Zwift),406,398,8
35093,1589562198,wahoo,Zwift - Bologna TT  ,Stages (Garmin),Wahoo Kickr 18 (Zwift),410,396,14
36396,1589997303,wahoo,Zwift - USA Cycling Race League by Indoor Specialist (A),Stages (Garmin),Wahoo Kickr 18 (Zwift),398,388,10
36663,1590082799,wahoo,Zwift - Team 3R&#039;s Choice: Stage 5 Longer Race A/B,Stages (Garmin),Wahoo Kickr 18 (Zwift),420,404,16
37048,1590224400,wahoo,Zwift - Cycling Ireland Zwift League Rd 9 (A),Stages (Garmin),Wahoo Kickr 18 (Zwift),394,381,13
37049,1590228604,wahoo,Zwift - Team 3R&#039;s Choice: Stage 5 Longer Race A/B,Stages (Garmin),Wahoo Kickr 18 (Zwift),339,326,13
38116,1590602098,wahoo,Zwift - USA Cycling Race League by Indoor Specialist (A),Stages (Garmin),Wahoo Kickr 18 (Zwift),409,405,4
39368,1591206901,wahoo,Zwift - USA Cycling Race League by Indoor Specialist (A),Stages (Garmin),Wahoo Kickr 18 (Zwift),384,381,3
40796,1591811697,wahoo,Zwift - USA Cycling Race League by Indoor Specialist (A),Stages (Garmin),Wahoo Kickr 18 (Zwift),456,446,10
42206,1592416500,wahoo,Zwift - USA Cycling Race League by Indoor Specialist (A),Stages (Garmin),Wahoo Kickr 18 (Zwift),374,379,-5
42952,1592730298,wahoo,Zwift - Newbury Velo Road Race (A),Stages (Garmin),Wahoo Kickr 18 (Zwift),409,412,-3
43400,1593021296,wahoo,Zwift - USA Cycling Race League by Indoor Specialist (A),Stages (Garmin),Wahoo Kickr 18 (Zwift),394,376,18
44414,1593624598,wahoo,Zwift - 3R & British Cycling South West - Series 2 (A),Stages (Garmin),Wahoo Kickr 18 (Zwift),405,398,7
45463,1594229396,wahoo,Zwift - 3R & British Cycling South West - Series 2 (A),Stages (Garmin),Wahoo Kickr 18 (Zwift),379,370,9
46850,1595088059,wahoo,Zwift - L&#039;Etape du Tour Stage 3 - Open,Stages (Garmin),Wahoo Kickr 18 (Zwift),360,351,9
46958,1595164498,wahoo,Zwift - KISS at Race 100 - Americas (A),Stages (Garmin),Wahoo Kickr 18 (Zwift),339,333,6
47322,1595440497,wahoo,Zwift - USA Cycling Race League by Indoor Specialist (A),Stages (Garmin),Wahoo Kickr 18 (Zwift),369,371,-2
49730,1597254905,wahoo,Zwift - USA Cycling Race League by Indoor Specialist (A),Stages (Garmin),Wahoo Kickr 18 (Zwift),445,440,5
50231,1597582799,wahoo,Zwift - Off The MAAP Stage 1 Race (A),Stages (Garmin),Wahoo Kickr 18 (Zwift),387,381,6
50552,1597770001,wahoo,Zwift - Off The MAAP Stage 2 Race (A),Stages (Garmin),Wahoo Kickr 18 (Zwift),369,369,0
51085,1598014801,wahoo,Zwift - Off The MAAP Stage 3 Race (A),Stages (Garmin),Wahoo Kickr 18 (Zwift),368,360,8
51653,1598360401,wahoo,Zwift - Off The MAAP Stage 4 Race (A),Stages (Garmin),Wahoo Kickr 18 (Zwift),367,368,-1
52171,1598541299,wahoo,Zwift - OH MY CRIT! - The Double Race 1/2 (A),Stages (Garmin),Wahoo Kickr 18 (Zwift),376,379,-3
52172,1598544296,wahoo,Zwift - OH MY CRIT! - The Double Race 2/2 (A),Stages (Garmin),Wahoo Kickr 18 (Zwift),345,345,0
55565,1600275596,wahoo,Zwift - MIDWEEK Autumn Series by SZR (A),Stages (Garmin),Wahoo Kickr 18 (Zwift),391,387,4
57071,1600880398,wahoo,Zwift - MIDWEEK Autumn Series by SZR (A),Stages (Garmin),Wahoo Kickr 18 (Zwift),371,384,-13
63859,1603299595,wahoo,Zwift - MIDWEEK Autumn Series by SZR (A),Stages (Garmin),Wahoo Kickr 18 (Zwift),398,393,5
65825,1603907989,wahoo,Zwift - MIDWEEK Autumn Series by SZR (A),Stages (Garmin),Wahoo Kickr 18 (Zwift),411,395,16
66995,1604246692,wahoo,Zwift - 3R Tick Tock Flat Race - 1 Lap (19km/11.8mi 50m) (A),Stages (Garmin),Wahoo Kickr 18 (Zwift),428,418,10
68008,1604512796,wahoo,Zwift - MIDWEEK Autumn Series by SZR (A),Stages (Garmin),Wahoo Kickr 18 (Zwift),394,390,4
68760,1604747396,wahoo,Zwift - ZA Road Race #1: 4 - 5 w/kg,Stages (Garmin),Wahoo Kickr 18 (Zwift),371,353,18
70230,1605117594,wahoo,Zwift - MIDWEEK Autumn Series by SZR (A),Stages (Garmin),Wahoo Kickr 18 (Zwift),387,378,9
72618,1605722391,wahoo,Zwift - MIDWEEK Autumn Series by SZR (A),Stages (Garmin),Wahoo Kickr 18 (Zwift),414,400,14
73751,1605947388,wahoo,Zwift - TEAM VEGAN Tofu Tornado XL (A),Stages (Garmin),Wahoo Kickr 18 (Zwift),441,440,1
75519,1606327188,wahoo,Zwift - MIDWEEK Autumn Series by SZR (A),Stages (Garmin),Wahoo Kickr 18 (Zwift),409,404,5
78573,1606931983,wahoo,Zwift - MIDWEEK Winter Series by SZR (A),Stages (Garmin),Wahoo Kickr 18 (Zwift),399,388,11
78901,1607012083,wahoo,Zwift - OH MY CRIT! - The Double Race 1/2 (A),Stages (Garmin),Wahoo Kickr 18 (Zwift),389,384,5
81082,1607536785,wahoo,Zwift - MIDWEEK Winter Series by SZR (A),Stages (Garmin),Wahoo Kickr 18 (Zwift),392,408,-16
83999,1608141582,wahoo,Zwift - MIDWEEK Winter Series by SZR (A),Stages (Garmin),Wahoo Kickr 18 (Zwift),390,384,6
86587,1608746378,wahoo,Zwift - MIDWEEK Winter Series by SZR (A),Stages (Garmin),Wahoo Kickr 18 (Zwift),380,383,-3
87722,1609059895,wahoo,Zwift - Newbury Velo Road Race (A),Stages (Garmin),Wahoo Kickr 18 (Zwift),397,394,3
92350,1609955991,wahoo,Zwift - MIDWEEK Winter Series by SZR (A),Stages (Garmin),Wahoo Kickr 18 (Zwift),381,388,-7
96356,1610560786,wahoo,Zwift - MIDWEEK Winter Series by SZR (A),Stages (Garmin),Wahoo Kickr 18 (Zwift),406,395,11
100304,1611165587,wahoo,Zwift - MIDWEEK Winter Series by SZR (A),Stages (Garmin),Wahoo Kickr 18 (Zwift),406,395,11
104134,1611770382,wahoo,Zwift - MIDWEEK Winter Series by SZR (A),Stages (Garmin),Wahoo Kickr 18 (Zwift),388,390,-2
105522,1611998982,wahoo,Zwift - DBR SufferDay League III (A) ,Stages (Garmin),Wahoo Kickr 18 (Zwift),398,391,7
108193,1612375181,wahoo,Zwift - MIDWEEK Winter Series by SZR (A),Stages (Garmin),Wahoo Kickr 18 (Zwift),369,370,-1
109814,1612603780,wahoo,Zwift - DBR SufferDay League III (A),Stages (Garmin),Wahoo Kickr 18 (Zwift),399,387,12
112295,1612979980,wahoo,Zwift - MIDWEEK Winter Series by SZR (A),Stages (Garmin),Wahoo Kickr 18 (Zwift),399,388,11
113951,1613204984,wahoo,Zwift - TEAM VEGAN Tofu Tornado XL (A) + Endurance,Stages (Garmin),Wahoo Kickr 18 (Zwift),414,419,-5
116634,1613584777,wahoo,Zwift - MIDWEEK Winter Series by SZR (A),Stages (Garmin),Wahoo Kickr 18 (Zwift),372,372,0
118218,1613809780,wahoo,Zwift - TEAM VEGAN Tofu Tornado XL (A),Stages (Garmin),Wahoo Kickr 18 (Zwift),400,392,8
120277,1614189575,wahoo,Zwift - MIDWEEK Winter Series by SZR (A),Stages (Garmin),Wahoo Kickr 18 (Zwift),413,410,3
123533,1614794396,wahoo,Zwift - MIDWEEK Crit Race Series by SZR (A),Stages (Garmin),Wahoo Kickr 18 (Zwift),413,416,-3
126564,1615399197,wahoo,Zwift - MIDWEEK Crit Race Series by SZR (A),Stages (Garmin),Wahoo Kickr 18 (Zwift),406,400,6
129219,1615919393,wahoo,Zwift - CeramicSpeed Race Series: Open Race (A),Stages (Garmin),Wahoo Kickr 18 (Zwift),408,398,10
14121,1581772214,wahoo,Zwift - The BMTR Fundo (A),Garmin Vector 3,Wahoo Kickr Core,298,299,-1
14537,1582048799,wahoo,Zwift - ZRG Winter Race Series 6/10 - Crit London Classique (A),Garmin Vector 3,Wahoo Kickr Core,333,331,2
15072,1582308001,wahoo,Zwift - Tour of Innsbruck // Stage 1,Garmin Vector 3,Wahoo Kickr Core,325,333,-8
15187,1582378200,wahoo,Zwift - Tour of Innsbruck // Stage 2 ,Garmin Vector 3,Wahoo Kickr Core,311,313,-2
15296,1582462800,wahoo,Zwift - Tour of Innsbruck // Stage 3,Garmin Vector 3,Wahoo Kickr Core,338,338,0
19017,1584792000,wahoo,Zwift - Stage 4 - Longer Ride - Tour of Watopia 2020,Garmin Vector 3,Wahoo Kickr Core,316,330,-14
24577,1586855499,wahoo,Zwift - 3R Spring Loaded Race Series - Round 3of6 (A),Garmin Vector 3,Wahoo Kickr Core,371,378,-7
25810,1587200695,wahoo,Zwift - 3R Innsbruckring Flat Race - 5 Laps (44km/27.3mi 385m) (A),Garmin Vector 3,Wahoo Kickr Core,335,353,-18
30911,1588506291,wahoo,Zwift - Crit City Race (A),Garmin Vector 3,Wahoo Kickr Core,348,355,-7
35263,1589623734,wahoo,Zwift - Tour for All 2020: Stage 4 Longer Race A/B,Garmin Vector 3,Wahoo Kickr Core,327,335,-8
36035,1589900692,wahoo,Zwift - 3R & Wahoo Ride Real Race Series - Round 2 of 7 (A),Garmin Vector 3,Wahoo Kickr Core,349,358,-9
37603,1590405571,wahoo,Zwift - Crit City Race (A),Garmin Vector 3,Wahoo Kickr Core,352,361,-9
37645,1590426869,wahoo,Zwift - DBR Wahoo League (A),Garmin Vector 3,Wahoo Kickr Core,370,380,-10
41452,1592057700,wahoo,Zwift - OH CRIT!! - Saturday Smash Series (A),Garmin Vector 3,Wahoo Kickr Core,350,360,-10
42431,1592493300,wahoo,Zwift - OH CRIT!! - Lockdown Series - Round 3 Race 1 (A),Garmin Vector 3,Wahoo Kickr Core,362,363,-1
42841,1592662500,wahoo,Zwift - OH CRIT!! - Saturday Smash Series (A),Garmin Vector 3,Wahoo Kickr Core,338,349,-11
43229,1592924651,wahoo,Zwift - 3R & Wahoo Ride Real Race Series - Round 6 of 7 (A),Garmin Vector 3,Wahoo Kickr Core,374,375,-1
43556,1593098100,wahoo,Zwift - OH MY CRIT! - The Double Race 1/2 (A),Garmin Vector 3,Wahoo Kickr Core,341,352,-11
43557,1593101100,wahoo,Zwift - OH MY CRIT! - The Double Race 2/2 (A),Garmin Vector 3,Wahoo Kickr Core,304,309,-5
44232,1593531000,wahoo,Zwift - TEAM VEGAN Tofu Tornado (A),Garmin Vector 3,Wahoo Kickr Core,330,330,0
44552,1593702900,wahoo,Zwift - OH MY CRIT! - The Double Race 1/2 (A),Garmin Vector 3,Wahoo Kickr Core,359,366,-7
44831,1593860455,wahoo,Zwift - L&#039;Etape du Tour Stage 1 - Open,Garmin Vector 3,Wahoo Kickr Core,334,333,1
45265,1594134300,wahoo,Zwift - 3R Volcano Circuit Flat Race - 8 Laps (35.2km/21.9mi 160m) (A),Garmin Vector 3,Wahoo Kickr Core,351,357,-6
45629,1594307701,wahoo,Zwift - OH MY CRIT! - The Double Race 1/2 (A),Garmin Vector 3,Wahoo Kickr Core,372,380,-8
46023,1594458059,wahoo,Zwift - L&#039;Etape du Tour Stage 2 - Open,Garmin Vector 3,Wahoo Kickr Core,356,352,4
46626,1594912500,wahoo,Zwift - OH MY CRIT! - The Double Race 1/2 (A),Garmin Vector 3,Wahoo Kickr Core,370,390,-20
46821,1595070060,wahoo,Zwift - L&#039;Etape du Tour Stage 3 - Open,Garmin Vector 3,Wahoo Kickr Core,316,314,2
47985,1595945026,wahoo,Zwift - Zwift Time Trial Tuesday: Tempus Fugit (E),Garmin Vector 3,Wahoo Kickr Core,357,357,0
48779,1596553499,wahoo,Zwift - 3R Turbocharged Team Race Series - Round 4 (A),Garmin Vector 3,Wahoo Kickr Core,350,356,-6
49834,1597331701,wahoo,Zwift - OH MY CRIT! - The Double Race 1/2 (A),Garmin Vector 3,Wahoo Kickr Core,379,381,-2
50142,1597500900,wahoo,Zwift - OH MY CRIT - Saturday Smash Race (A),Garmin Vector 3,Wahoo Kickr Core,396,402,-6
50536,1597763100,wahoo,Zwift - 3R Turbocharged Team Race Series - Round 6 (A),Garmin Vector 3,Wahoo Kickr Core,363,375,-12
51063,1598002499,wahoo,Zwift - TBR Burrito Race (A),Garmin Vector 3,Wahoo Kickr Core,345,348,-3
51260,1598105699,wahoo,Zwift - OH MY CRIT - Saturday Smash Race* (A),Garmin Vector 3,Wahoo Kickr Core,370,370,0
51632,1598349599,wahoo,Zwift - Off The MAAP Stage 4 Race (A),Garmin Vector 3,Wahoo Kickr Core,335,358,-23
51971,1598443200,wahoo,Zwift - TTR Mini RACE (A),Garmin Vector 3,Wahoo Kickr Core,374,379,-5
51978,1598444999,wahoo,Zwift - 3R LaGuardia Loop Flat Race - 10 Laps (28.3km/17.6mi 270m) (A),Garmin Vector 3,Wahoo Kickr Core,360,361,-1
52164,1598541299,wahoo,Zwift - OH MY CRIT! - The Double Race 1/2 (A),Garmin Vector 3,Wahoo Kickr Core,372,375,-3
53075,1599058794,wahoo,Zwift - Sydkysten / KST Race (A),Garmin Vector 3,Wahoo Kickr Core,328,333,-5
53203,1599146100,wahoo,Zwift - OH MY CRIT! - The Double Race 1/2 (A),Garmin Vector 3,Wahoo Kickr Core,370,374,-4
53548,1599315299,wahoo,Zwift - OH MY CRIT - Saturday Smash Race (A),Garmin Vector 3 S,Wahoo Kickr Core,350,361,-11
53640,1599391200,wahoo,Ottawa  Top speed race,Garmin Vector 3 S,Wahoo Kickr Core,378,399,-21
53900,1599559199,wahoo,Zwift - KISS at Race - Americas AM (A),Garmin Vector 3 S,Wahoo Kickr Core,357,348,9
53933,1599577499,wahoo,Zwift - 3R Sundown Race Series  (A),Garmin Vector 3 S,Wahoo Kickr Core,356,353,3
54126,1599663599,wahoo,Zwift - Sydkysten / KST Race (A),Garmin Vector 3 S,Wahoo Kickr Core,357,361,-4
54553,1599816900,wahoo,Zwift - TBR Burrito Race (A),Garmin Vector 3 S,Wahoo Kickr Core,378,380,-2
54598,1599837299,wahoo,Zwift - 3R Sand and Sequoias Race (A),Garmin Vector 3 S,Wahoo Kickr Core,358,359,-1
57011,1600880399,wahoo,Zwift - MIDWEEK Autumn Series by SZR (A),Garmin Vector 3 S,Wahoo Kickr Core,334,364,-30
57440,1601026499,wahoo,Zwift - TBR Burrito Race (A),Garmin Vector 3 S,Wahoo Kickr Core,372,382,-10
58086,1601317199,wahoo,Zwift - TFC Mad Monday Autumn Series (A),Garmin Vector 3 S,Wahoo Kickr Core,341,352,-11
58428,1601459099,wahoo,Zwift - USA Cycling Race League by Indoor Specialist (A),Garmin Vector 3 S,Wahoo Kickr Core,360,369,-9
58776,1601568300,wahoo,Zwift - OH MY CRIT! - The Double Race 2/2 (A),Garmin Vector 3 S,Wahoo Kickr Core,352,353,-1
58777,1601565300,wahoo,Zwift - OH MY CRIT! - The Double Race 1/2 (A),Garmin Vector 3 S,Wahoo Kickr Core,398,400,-2
59214,1601721894,wahoo,Zwift - Into the Red by RELENTLESS (A),Garmin Vector 3 S,Wahoo Kickr Core,362,380,-18
59382,1601807400,wahoo,Zwift - Stages of DIRT (A),Garmin Vector 3 S,Wahoo Kickr Core,343,360,-17
59829,1602004199,wahoo,Zwift - 3R Volcano KOM After Party Race - 2 laps + climb (40.2km/25mi 286m) (A),Garmin Vector 3 S,Wahoo Kickr Core,364,380,-16
60070,1602086400,wahoo,Zwift - FrenchyFuzion Criterium League (A),Garmin Vector 3 S,Wahoo Kickr Core,329,342,-13
60545,1602237899,wahoo,Zwift - 3R Innsbruckring Flat Race - 4 Laps (35.2km/21.9mi 308m) (A),Garmin Vector 3 S,Wahoo Kickr Core,367,381,-14
60751,1602326699,wahoo,Zwift - Into the Red by RELENTLESS (A),Garmin Vector 3 S,Wahoo Kickr Core,329,345,-16
61530,1602609299,wahoo,Zwift - Zwift Racing League | WTRL,Garmin Vector 3 S,Wahoo Kickr Core,367,384,-17
62125,1602774900,wahoo,Zwift - OH MY CRIT! - The Double Race 1/2 (A),Garmin Vector 3 S,Wahoo Kickr Core,360,371,-11
62596,1602933000,wahoo,Zwift - ZA Road Race #1: 4 - 5 w/kg,Garmin Vector 3 S,Wahoo Kickr Core,354,370,-16
63012,1603116900,wahoo,Zwift - 3R Classique Reverse Flat Race - 5 Laps (32km/20.1mi 76m) (A),Garmin Vector 3 S,Wahoo Kickr Core,315,338,-23
63809,1603299599,wahoo,Zwift - MIDWEEK Autumn Series by SZR (A),Garmin Vector 3 S,Wahoo Kickr Core,355,374,-19
66380,1604054700,neo,Zwift - DIRT FriYay Ride (C),Garmin Vector 3 S,Tacx NEO 2T Smart,239,239,0
66459,1604075399,neo,Zwift - FZR Pre-Sauna ride (C),Garmin Vector 3 S,Tacx NEO 2T Smart,172,169,3
66606,1604141100,wahoo,Zwift - Into the Red by RELENTLESS (A),Garmin Vector 3 S,Wahoo Kickr Core,369,381,-12
66933,1604235899,wahoo,Zwift - 3R Watopia Flat Route Race - 4 Laps (40.5km/25.1mi 216m) (A),Garmin Vector 3 S,Wahoo Kickr Core,366,379,-13
67206,1604333399,neo,Zwift - 3R Classique Reverse Flat Race - 4 Laps (26.9km/16.7mi 57m) (A),Garmin Vector 3 S,Tacx NEO 2T Smart,341,337,4
68183,1604591997,neo,Zwift - DBR Base Endurance Ride (E),Garmin Vector 3 S,Tacx NEO 2T Smart,250,247,3
68534,1604682000,wahoo,Zwift - Skoda presents: Ride with the InternationElles (E),Garmin Vector 3 S,Wahoo Kickr Core,230,237,-7
68754,1604747399,wahoo,Zwift - ZA Road Race #1: 4 - 5 w/kg,Garmin Vector 3 S,Wahoo Kickr Core,346,354,-8
69316,1604938199,wahoo,Zwift - 3R Classique Reverse Flat Race - 4 Laps (26.9km/16.7mi 57m) (A),Garmin Vector 3 S,Wahoo Kickr Core,351,361,-10
69718,1605028200,wahoo,Zwift - 3R Volcano KOM After Party Race - 2 laps + climb (40.2km/25mi 286m) (A),Garmin Vector 3 S,Wahoo Kickr Core,362,374,-12
72092,1605611399,wahoo,Zwift - Japan Zwift Tuesday Race (A),Garmin Vector 3 S,Wahoo Kickr Core,373,384,-11
73020,1605802499,wahoo,Zwift - OH MY CRIT! - The Double Race 1/2 (A),Garmin Vector 3 S,Wahoo Kickr Core,378,391,-13
74195,1606050300,wahoo,Zwift - 3R Watopia Flat Route Race - 4 Laps (40.5km/25.1mi 216m) (A),Garmin Vector 3 S,Wahoo Kickr Core,366,381,-15
75010,1606241700,wahoo,Zwift - Zwift Racing League | WTRL - Men&#039;s EMEA E1 DIVISION 1,Garmin Vector 3 S,Wahoo Kickr Core,367,382,-15
76798,1606560292,wahoo,Zwift - Into the Red by RELENTLESS (A),Garmin Vector 3 S,Wahoo Kickr Core,366,380,-14
78571,1606932004,wahoo,Zwift - MIDWEEK Winter Series by SZR (A),Garmin Vector 3 S,Wahoo Kickr Core,365,375,-10
80777,1607451300,wahoo,Zwift - Zwift Racing League | WTRL - Men&#039;s EMEA E1 DIVISION 1 (A),Garmin Vector 3 S,Wahoo Kickr Core,397,395,2
82342,1607781600,wahoo,Zwift - MGCC hosts Ontario Cycling Association Virtual Challenge #1,Garmin Vector 3 S,Wahoo Kickr Core,346,361,-15
83110,1607962199,wahoo,Zwift - 3R Classique Reverse Flat Race - 4 Laps (26.9km/16.7mi 57m) (A),Garmin Vector 3 S,Wahoo Kickr Core,338,348,-10
83487,1608048299,wahoo,Zwift - 3R Volcano Circuit Flat Race - 8 Laps (35.2km/21.9mi 160m) (A),Garmin Vector 3 S,Wahoo Kickr Core,360,374,-14
85062,1608382799,wahoo,Zwift - Tour of New York Stage 2 - Open Longer,Garmin Vector 3 S,Wahoo Kickr Core,373,386,-13
87153,1608897599,wahoo,Zwift - Best Buddies Challenge - TGIF Ride (E),Garmin Vector 3 S,Wahoo Kickr Core,403,419,-16
87861,1609082700,wahoo,Zwift - 3R Watopia 65km Race - 6 laps (40mi 324m) (A),Garmin Vector 3 S,Wahoo Kickr Core,363,378,-15
88183,1609164899,wahoo,Zwift - 3R Classique Reverse Flat Race - 5 Laps (32km/20.1mi 76m) (A),Garmin Vector 3 S,Wahoo Kickr Core,345,360,-15
88945,1609329599,wahoo,Zwift - TTR Mini RACE (A),Garmin Vector 3 S,Wahoo Kickr Core,345,358,-13
89381,1609417500,wahoo,Zwift - EMU Japan Race (A),Garmin Vector 3 S,Wahoo Kickr Core,333,345,-12
90215,1609593599,wahoo,Zwift - 3R Innsbruckring Flat Race - 5 Laps (44km/27.3mi 385m) (A),Garmin Vector 3 S,Wahoo Kickr Core,309,318,-9
90614,1609674299,wahoo,Zwift - Crit City Race (A),Garmin Vector 3 S,Wahoo Kickr Core,361,379,-18
91243,1609776599,wahoo,Zwift - 3R Classique Reverse Flat Race - 4 Laps (26.9km/16.7mi 57m) (A),Garmin Vector 3 S,Wahoo Kickr Core,353,368,-15
91818,1609872900,wahoo,Zwift - Team Italy & Frenchy Fuzion League (A),Garmin Vector 3 S,Wahoo Kickr Core,392,410,-18
93394,1610125205,wahoo,Zwift - Zwift Fast Fridays: Bologna Time Trial (E),Garmin Vector 3 S,Wahoo Kickr Core,361,395,-34
95639,1610476017,wahoo,Zwift - Zwift Racing League | WTRL - Men&#039;s/Mixed EMEA E2 DIVISION 4 (A),Garmin Vector 3 S,Wahoo Kickr Core,352,351,1
96763,1610621998,wahoo,Zwift - KISS Race Series - Americas AM (A),Garmin Vector 3 S,Wahoo Kickr Core,317,328,-11
97442,1610723699,wahoo,Zwift - 3R Sand and Sequoias Race (A),Garmin Vector 3 S,Wahoo Kickr Core,349,363,-14
98006,1610807399,wahoo,Zwift - VACA Saturday Smackdown (A),Garmin Vector 3 S,Wahoo Kickr Core,361,369,-8
99717,1611081238,wahoo,Zwift - Zwift Racing League | WTRL - Men&#039;s/Mixed EMEA E2 DIVISION 4 (A),Garmin Vector 3 S,Wahoo Kickr Core,346,357,-11
100241,1611158399,wahoo,Zwift - Sydkysten Race (A),Garmin Vector 3 S,Wahoo Kickr Core,324,335,-11
101433,1611334800,wahoo,Zwift -  ZRG-CC 2021 Series (A),Garmin Vector 3 S,Wahoo Kickr Core,331,345,-14
101894,1611412200,wahoo,Zwift - VACA Saturday Smackdown (A),Garmin Vector 3 S,Wahoo Kickr Core,366,383,-17
103462,1611685618,wahoo,Zwift - Zwift Racing League | WTRL - Men&#039;s/Mixed EMEA E2 DIVISION 4 (A),Garmin Vector 3 S,Wahoo Kickr Core,347,371,-24
104466,1611831600,wahoo,Zwift - KISS Race Series - Americas AM (A),Garmin Vector 3 S,Wahoo Kickr Core,382,378,4
105638,1612019699,wahoo,Zwift - OH MY CRIT!! - Saturday Smash Race (A),Garmin Vector 3 S,Wahoo Kickr Core,349,385,-36
107325,1612290420,wahoo,Zwift - Zwift Racing League | WTRL - Men&#039;s/Mixed EMEA E2 DIVISION 4 (A),Garmin Vector 3 S,Wahoo Kickr Core,365,392,-27
108670,1612435641,wahoo,Zwift - KISS Race Series - Americas AM (A),Garmin Vector 3 S,Wahoo Kickr Core,280,339,-59
114071,1613221197,wahoo,Zwift - 111 - Strongman racing series (A),Garmin Vector 3 S,Wahoo Kickr Core,360,374,-14
115843,1613500019,wahoo,Zwift - Zwift Racing League | WTRL - Men&#039;s/Mixed EMEA E2 DIVISION 4 (A),Garmin Vector 3 S,Wahoo Kickr Core,398,411,-13
117186,1613664922,wahoo,Zwift - OH MY CRIT!! - The Double Race 1/2 (A),Garmin Vector 3 S,Wahoo Kickr Core,379,375,4
117193,1613667899,wahoo,Zwift - OH MY CRIT!! - The Double Race 2/2 (A),Garmin Vector 3 S,Wahoo Kickr Core,379,390,-11
118300,1613837158,wahoo,Zwift - 3R Endurance Series p/b OTE Sports- Stage 1 (A),Garmin Vector 3 S,Wahoo Kickr Core,344,353,-9
119573,1614104819,wahoo,Zwift - Zwift Racing League | WTRL - Men&#039;s/Mixed EMEA E2 DIVISION 4 (A),Garmin Vector 3 S,Wahoo Kickr Core,341,351,-10
120230,1614182399,wahoo,Zwift - Sydkysten Race (A),Garmin Vector 3 S,Wahoo Kickr Core,334,345,-11
120621,1614250799,wahoo,Zwift - KISS Race Series - Americas AM (New Pack Dynamics) (A),6331039644_ACTIVITY,Wahoo Kickr Core,345,356,-11
120703,1614272699,wahoo,Zwift - OH MY CRIT!! - The Double Race 2/2 (A),Garmin Vector 3 S,Wahoo Kickr Core,379,385,-6
121679,1614441959,wahoo,Zwift - 3R Endurance Series p/b OTE Sports (A),Garmin Vector 3 S,Wahoo Kickr Core,375,386,-11
122389,1614614999,wahoo,Zwift - 3R Classique Reverse Flat Race - 4 Laps (26.9km/16.7mi 57m) (A),Garmin Vector 3 S,Wahoo Kickr Core,308,322,-14
123535,1614794399,wahoo,Zwift - MIDWEEK Crit Race Series by SZR (A),Garmin Vector 3 S,Wahoo Kickr Core,355,367,-12
123879,1614855599,wahoo,Zwift - KISS Race Series - Americas AM (New Pack Dynamics) (A),Garmin Vector 3 S,Wahoo Kickr Core,337,349,-12
124392,1614943199,wahoo,Zwift - 3R LaGuardia Loop Reverse Flat Race - 8 Laps (24.5km/15.2mi 216m) (A),Garmin Vector 3 S,Wahoo Kickr Core,361,373,-12
125045,1615046760,wahoo,Zwift - 3R Endurance Series p/b OTE Sports (A),Garmin Vector 3 S,Wahoo Kickr Core,330,338,-8
125434,1615130699,wahoo,Zwift - 3R Watopia 65km Race - 6 laps (40mi 324m) (A),Garmin Vector 3 S,Wahoo Kickr Core,347,354,-7
126523,1615399199,wahoo,Zwift - MIDWEEK Crit Race Series by SZR (A),Garmin Vector 3 S,Wahoo Kickr Core,367,378,-11
127002,1615482299,wahoo,Zwift - OH MY CRIT!! - The Double Race 2/2 (A),Garmin Vector 3 S,Wahoo Kickr Core,353,369,-16
127544,1615571999,wahoo,Zwift - KIRCHMAIR Race Series (A),Garmin Vector 3 S,Wahoo Kickr Core,349,365,-16
129135,1615919399,wahoo,Zwift - CeramicSpeed Race Series: Open Race (A),Garmin Vector 3 S,Wahoo Kickr Core,354,349,5
49733,1597225699,wahoo,Zwift - Longer Ride - 7 Days of Tarmac SL7: Stage 2 with Jimmy Guardino,Assioma DUO,Wahoo,408,390,18
49957,1597394386,wahoo,Zwift - Off the MAAP Invitational Race // Stage 1 (Men) (A),Assioma DUO,Wahoo,422,409,13
50514,1597721505,wahoo,Zwift - Watopia,Assioma Duo,Wahoo,244,245,-1
50517,1597683033,wahoo,Zwift - Magnus Haggren [SZ] B1&#039;s Meetup - The Fan Flats,Assioma DUO,Wahoo,397,388,9
51488,1598260685,wahoo,Zwift - Off the MAAP Invitational Race // Stage 4 (men) ,Assioma DUO,Wahoo,413,411,2
55027,1600104885,wahoo,Zwift - Invitational League // Qualifying Race #1,Assioma DUO,Wahoo,405,407,-2
61274,1602528312,wahoo,Zwift - Premier Division // Zwift Racing League (men) ,Assioma DUO,Wahoo,448,447,1
65176,1603741153,wahoo,Zwift - Premier Division // Zwift Racing League (men) (A),Assioma DUO,Wahoo,426,429,-3
66154,1603907072,wahoo,Zwift - MIDWEEK Autumn Series by SZR (A),Assioma DUO,Wahoo,414,404,10
67519,1604342773,wahoo,Zwift - Premier Division // Zwift Racing League (men) (A),Assioma DUO,Wahoo,401,401,0
69417,1604951110,wahoo,Zwift - 11/09/2020,Assioma DUO,Wahoo,450,455,-5
71830,1605419102,wahoo,Zwift - KISS 100 Race Series - EU (A),Assioma DUO,Wahoo,386,388,-2
74681,1606159453,wahoo,Zwift - Premier Division // Zwift Racing League (men) (A),Assioma DUO,Wahoo,447,455,-8
76347,1606418935,wahoo,Zwift - WTRL NOPINZ WORLD TTT CHAMPIONSHIPS - Zone 10 (C),Assioma DUO,Wahoo,435,452,-17
77442,1606639726,wahoo,Zwift - Newbury Velo Road Race (A),Assioma DUO,Wahoo,427,442,-15
77590,1605550880,wahoo,Zwift - Premier Division // Zwift Racing League (men) (A),Assioma DUO,Wahoo,416,407,9
77680,1606761701,wahoo,Zwift - Premier Division // Zwift Racing League (men) (A),Assioma DUO,Wahoo,431,447,-16
78530,1606842171,wahoo,Zwift - Watopia,Assioma DUO,Wahoo,259,269,-10
80844,1607449954,wahoo,Zwift - SZR iTT Winter Racing League (A),Assioma DUO,Wahoo,397,399,-2
81713,1607628154,wahoo,Zwift - Espresso,Assioma DUO,Wahoo,407,417,-10
113859,1613206153,wahoo,Zwift - ZADA Three Sisters test_WAHOO,ASSIOMA_47600,Wahoo,397,393,4
25126,1587030313,neo,Zwift - Koa Sports League Race (A),ZWIFT Team Zwatt Zimanox,Elemnt Bolt Tacx Neo 1 (2018),365,370,-5
25212,1587050099,neo,Zwift - OH CRIT!! - The Double Race - Race 1/2 (A),ZWIFT Team Zwatt Zimanox,Elemnt Bolt Tacx Neo 1 (2018),370,370,0
25214,1587053123,neo,Zwift - OH CRIT!! - The Double Race - Race 2/2 (A),Elemnt Bolt Team Zwatt Zimanox ,ZWIFT Tacx Neo 1 (2018),329,337,-8
26488,1587402908,neo,Zwift - DBR Wahoo League (A),Elemnt Bolt Team Zwatt Zimanox ,ZWIFT Tacx Neo 1 (2018),381,398,-17
26704,1587491698,neo,Zwift - Team Italy & Frenchy Fuzion League (A),Elemnt Bolt Team Zwatt Zimanox ,ZWIFT Tacx Neo 1 (2018),386,374,12
26986,1587571216,neo,Zwift - LES ROUTES DE ZWIFT - ETAPE 2 (A),Elemnt Bolt Team Zwatt Zimanox ,ZWIFT Tacx Neo 1 (2018),333,368,-35
29447,1588239899,neo,Zwift - Koa Sports League Race (A),Elemnt Bolt Team Zwatt Zimanox ,ZWIFT Tacx Neo 1 (2018),375,372,3
30535,1588422867,neo,Zwift - Team ODZ RACE (A),Elemnt Bolt Team Zwatt Zimanox ,ZWIFT Tacx Neo 1 (2018),369,360,9
30811,1588490390,neo,Zwift - Team Italy & Frenchy Fuzion Endurance Race (A),Elemnt Bolt Team Zwatt Zimanox ,ZWIFT Tacx Neo 1 (2018),373,366,7
32310,1588844714,neo,Zwift - Koa Sports League Race (A),Elemnt Bolt Team Zwatt Zimanox ,ZWIFT Tacx Neo 1 (2018),349,369,-20
33685,1589217279,neo,Zwift - DBR Wahoo League (A),Elemnt Bolt Team Zwatt Zimanox ,ZWIFT Tacx Neo 1 (2018),354,356,-2
75400,1606301114,neo,Zwift - USA Cycling Race League by Indoor Specialist (A),ZWIFT Team Zwatt Zimanox,Elemnt Bolt Tacx Neo 1 (2018),350,347,3
75923,1606407319,neo,Zwift - OH MY CRIT! - The Double Race 1/2 (A),Elemnt Bolt Team Zwatt Zimanox ,ZWIFT Tacx Neo 1 (2018),356,354,2
76984,1606576522,neo,Zwift - OH MY CRIT - Saturday Smash Race (A),Elemnt Bolt Team Zwatt Zimanox ,ZWIFT Tacx Neo 1 (2018),333,338,-5
77341,1606661995,neo,Zwift - Focus: Colours of PARI - Longer Ride,Elemnt Bolt Team Zwatt Zimanox ,ZWIFT Tacx Neo 1 (2018),346,345,1
77523,1606727695,neo,Zwift - 3R Watopia Flat Route Race - 4 Laps (41km/25.5mi 216m) (A),Elemnt Bolt Team Zwatt Zimanox ,ZWIFT Tacx Neo 1 (2018),347,354,-7
78422,1606905893,neo,Zwift - USA Cycling Race League by Indoor Specialist (A),Elemnt Bolt Team Zwatt Zimanox ,ZWIFT Tacx Neo 1 (2018),349,355,-6
78843,1606993187,neo,Zwift - KISS Race Series - Americas AM (A),Elemnt Bolt Team Zwatt Zimanox ,ZWIFT Tacx Neo 1 (2018),327,344,-17
79263,1607072682,neo,Zwift - 3R Whole Lotta Lava Hilly Race - 2 Laps (28.9km/12.53mi 336m) (A),Elemnt Bolt Team Zwatt Zimanox ,ZWIFT Tacx Neo 1 (2018),358,376,-18
79711,1607162395,neo,Nations Challenge // France,Elemnt Bolt Team Zwatt Zimanox ,ZWIFT Tacx Neo 1 (2018),321,334,-13
80425,1607350495,neo,Zwift - 3R Classique Reverse Flat Race - 5 Laps (32km/20.1mi 76m) (A),Elemnt Bolt Team Zwatt Zimanox ,ZWIFT Tacx Neo 1 (2018),341,341,0
80842,1607453694,neo,Team Italy & Frenchy Fuzion League,Elemnt Bolt Team Zwatt Zimanox ,ZWIFT Tacx Neo 1 (2018),399,405,-6
81534,1607616914,neo,Zwift - OH MY CRIT! - The Double Race 1/2 (A),ZWIFT Team Zwatt Zimanox,ZWIFT Tacx Neo 1 (2018),362,365,-3
81553,1607619907,neo,Zwift - OH MY CRIT! - The Double Race 2/2 (A),Elemnt Bolt Team Zwatt Zimanox ,ZWIFT Tacx Neo 1 (2018),350,350,0
86485,1608732023,neo,Zwift - KISS Race Series - Pacific AM (A),Elemnt Bolt Team Zwatt Zimanox ,ZWIFT Tacx Neo 1 (2018),379,383,-4
95441,1610449186,neo,Zwift - KISS Race Series - Americas AM (A),Elemnt Bolt Team Zwatt Zimanox ,ZWIFT Tacx Neo 1 (2018),360,370,-10
96172,1610534698,neo,Zwift - The Morning Grind by STPC (A),2021-01-13-104458-ELEMNT BOLT EE6B-120-0,ZWIFT Tacx Neo 1 (2018),345,348,-3
104216,1611770394,neo,Zwift - MIDWEEK Winter Series by SZR (A),Elemnt Bolt Team Zwatt Zimanox ,ZWIFT Tacx Neo 1 (2018),352,352,0
107408,1612290484,neo,Zwift - Zwift Racing League | WTRL - Men&#039;s/Mixed EMEA E2 DIVISION 5 (A),Elemnt Bolt Team Zwatt Zimanox ,ZWIFT Tacx Neo 1 (2018),371,376,-5
108280,1612375191,neo,Zwift - LES ROUTES DE ZWIFT Frenchy Fuzion - Etape 1 (C),Elemnt Bolt Team Zwatt Zimanox ,ZWIFT Tacx Neo 1 (2018),363,368,-5
108898,1612461600,neo,Zwift - LES ROUTES DE ZWIFT Frenchy Fuzion - Etape 2 (E),Elemnt Bolt Team Zwatt Zimanox ,ZWIFT Tacx Neo 1 (2018),377,383,-6
109425,1612547995,neo,Zwift - LES ROUTES DE ZWIFT Frenchy Fuzion - Etape 3 (E),Elemnt Bolt Team Zwatt Zimanox ,ZWIFT Tacx Neo 1 (2018),375,381,-6
109694,1612605958,neo,Zwift - LES ROUTES DE ZWIFT Frenchy Fuzion - Etape 4 (A),Elemnt Bolt Team Zwatt Zimanox ,ZWIFT Tacx Neo 1 (2018),387,375,12
110798,1612630977,neo,Zwift - LES ROUTES DE ZWIFT Frenchy Fuzion - Etape 5 (E),Elemnt Bolt Team Zwatt Zimanox ,ZWIFT Tacx Neo 1 (2018),349,344,5
113339,1613118905,neo,Zwift - TBR Burrito Race (A),Elemnt Bolt / Left Arm Zimanox PM,ZWIFT Tacx Neo 1 (2018),358,360,-2
115847,1613499597,neo,Zwift - Zwift Racing League | WTRL - Men&#039;s/Mixed EMEA E1 DIVISION 6 (A),Elemnt Bolt / Left Arm Zimanox PM,ZWIFT Tacx Neo 1 (2018),371,380,-9
119576,1614104884,neo,Zwift - Zwift Racing League | WTRL - Men&#039;s/Mixed EMEA E2 DIVISION 5 (A),Elemnt Bolt / Left Arm Zimanox PM,ZWIFT Tacx Neo 1 (2018),352,358,-6
120263,1587491698,neo,Zwift - MIDWEEK Winter Series by SZR (A),Elemnt Bolt / Left Arm Zimanox PM,ZWIFT Tacx Neo 1 (2018),386,380,6
120538,1614189599,neo,Zwift - MIDWEEK Winter Series by SZR (A),Elemnt Bolt / Left Arm Zimanox PM,ZWIFT Tacx Neo 1 (2018),366,380,-14
123055,1614709937,neo,Zwift - Zwift Racing League | WTRL - Men&#039;s/Mixed EMEA E1 DIVISION 6 (A),Elemnt Bolt Team Zwatt Zimanox ,ZWIFT Tacx Neo 1 (2018),394,391,3
10348,1579633313,wahoo,Zwift - 3R Ultimate Racing League - Round 3 (B) - 8th,Favero Assioma Duo (Zwift),KICKR Core3 (1.0.12 firmware - Wahoo App),340,343,-3
14292,1581869897,wahoo,Zwift - ZHR Audax 100km (Ride) (B),Favero Assioma Duo (Zwift),KICKR Core3 (1.0.12 firmware - Wahoo App),275,281,-6
15656,1582657204,wahoo,Zwift - 3R SuperCRITical Race Series - Round 2of4 (A) ugh HRM spike,Favero Assioma Duo (Zwift),KICKR Core3 (1.0.12 firmware - Wahoo App),308,314,-6
15779,1582738370,wahoo,Zwift - 3R 100 Steady Ride [~3.0w/kg avg] (B),Favero Assioma Duo (Zwift),KICKR Core3 (1.0.12 firmware - Wahoo App),283,294,-11
16144,1582988837,wahoo,Zwift - OH CRIT!! - Saturday Smash Series (A) - 21st,Favero Assioma Duo (Zwift),KICKR Core3 (1.0.12 firmware - Wahoo App),343,344,-1
16658,1583264229,wahoo,Zwift - 3R SuperCRITical Race Series - Round 3of4 (A) - 26th - over 4.0!,Favero Assioma Duo (Zwift),KICKR Core3 (1.0.12 firmware - Wahoo App),342,345,-3
16803,1583343359,wahoo,Zwift - SZR Spring Race Series (A) - 1st!,Favero Assioma Duo (Zwift),KICKR Core3 (1.0.12 firmware - Wahoo App),348,351,-3
17011,1583434786,wahoo,Zwift - KALAS Cup - Round 6 (A) - 52nd,Favero Assioma Duo (Zwift),KICKR Core3 (1.0.12 firmware - Wahoo App),343,356,-13
17399,1583770171,wahoo,Zwift - Stage 1 Race (A) - Tour of Watopia 2020 - 7th,Favero Assioma Duo (Zwift),KICKR Core3 (1.0.12 firmware - Wahoo App),352,352,0
18273,1584374590,wahoo,Zwift - Stage 2 Race (A) - Tour of Watopia 2020 - 3rd - w/ pros!,Favero Assioma Duo (Zwift),KICKR Core#3 (v1.0.12-WahooApp),333,335,-2
19029,1584720571,wahoo,Zwift - Stage 3 Race (A) - Tour of Watopia 2020,Favero Assioma Duo (Zwift),KICKR Core#3 (v1.0.12-WahooApp),343,347,-4
44447,1593624885,wahoo,Zwift - USA Cycling Race League by Indoor Specialist (A) - 29th,Favero Assioma Duo (Zwift),KICKR Core#3 (v1.0.13-WahooApp),333,334,-1
73928,1605978021,wahoo,Zwift - Cycling Canada Pre-Worlds Showdown Series (A),4iiii Precision,Wahoo Kickr,376,376,0
74362,1606073713,wahoo,Zwift - 3R LaGuardia Super Sprint Race - 1 Lap (3.7km/2.6mi 27m) (A),4iiii Precision,Wahoo Kickr,385,458,-73
74678,1606161615,wahoo,Zwift - Crit City Race (A),4iiii Precision,Wahoo Kickr,362,375,-13
75726,1606352715,wahoo,Zwift - Cycling Canada Wednesday Night Race Series (A),4iiii Precision,Wahoo Kickr,365,363,2
77051,1606582822,wahoo,Zwift - Cycling Canada Pre-Worlds Showdown Series (A),4iiii Precision,Wahoo Kickr,376,366,10
77692,1606760122,wahoo,Zwift -  DBR Monday Race (A),4iiii Precision,Wahoo Kickr,371,362,9
78039,1606847087,wahoo,Zwift - Zwift Racing League | WTRL - Men&#039;s EMEA E1 DIVISION 2 (A),4iiii Precision,Wahoo Kickr,362,364,-2
78744,1606957515,wahoo,Zwift - Cycling Canada Wednesday Night Race Series (A),4iiii Precision,Wahoo Kickr,382,393,-11
80494,1607364922,wahoo,Zwift -  DBR Monday Race (A),4iiii Precision,Wahoo Kickr,349,352,-3
81306,1607562324,wahoo,Zwift - Cycling Canada Wednesday Night Race Series (A),4iiii Precision,Wahoo Kickr,378,376,2
83760,1608080417,wahoo,Zwift - KISS Race Series - Americas PM (A),4iiii Precision,Wahoo Kickr,369,374,-5
84877,1608325217,wahoo,Zwift - Tour of New York Stage 1 - Open Longer,4iiii Precision,Wahoo Kickr,367,356,11
85619,1608490816,wahoo,Zwift - Tour of New York Stage 3 - Open Longer,4iiii Precision,Wahoo Kickr,362,363,-1
86311,1608684322,wahoo,Zwift - 3R Innsbruckring Sprint Race - 1 Lap (8.8km/5.5mi 77m) (A),4iiii Precision,Wahoo Kickr,380,394,-14
89525,1609431322,wahoo,Zwift - OH MY CRIT! - The Double Race 1/2 (A),4iiii Precision,Wahoo Kickr,369,378,-9
89976,1609524925,wahoo,Zwift - Cocorico Race League - Bikes France,4iiii Precision,Wahoo Kickr,397,389,8
90295,1609605017,wahoo,Zwift - TEAM VEGAN Tofu Tornado (A),4iiii Precision,Wahoo Kickr,379,391,-12
91171,1609702513,wahoo,Zwift - 3R LaGuardia Super Sprint Race - 1 Lap (3.7km/2.6mi 27m) (A),4iiii Precision,Wahoo Kickr,0,0,0
91244,1609776615,wahoo,Zwift - 3R Classique Reverse Flat Race - 4 Laps (26.9km/16.7mi 57m) (A),4iiii Precision,Wahoo Kickr,384,385,-1
91697,1609857029,wahoo,Zwift - DBR Tuesday Race (A),4iiii Precision,Wahoo Kickr,391,381,10
92238,1609945513,wahoo,Zwift - 3R LaGurardia Super Sprint Race - 1 Lap (3.7km/2.6mi 27m) (A),4iiii Precision,Wahoo Kickr,375,383,-8
92272,1609949415,wahoo,Zwift - 3R Tick Tock Flat Race - 2 Lap (36km/22.4mi 100m) (A),4iiii Precision,Wahoo Kickr,364,367,-3
93111,1610067618,wahoo,Zwift - KISS Race Series - Americas PM (A),4iiii Precision,Wahoo Kickr,394,383,11
93509,1610133143,wahoo,Zwift - Team IRL Without Borders Chase (A),4iiii Precision,Wahoo Kickr,364,359,5
94023,1610209825,wahoo,Zwift - TEAM VEGAN Tofu Tornado (A),4iiii Precision,Wahoo Kickr,380,372,8
94945,1610387126,wahoo,SWE cup (A),4iiii Precision,Wahoo Kickr,356,373,-17
95587,1610472613,wahoo,Zwift - WTRL Racing (A),4iiii Precision,Wahoo Kickr,371,371,0
97254,1610672423,wahoo,Zwift - KISS Race Series - Americas PM (A),4iiii Precision,Wahoo Kickr,358,357,1
97446,1610724620,wahoo,Zwift - DBR Friday Race (A),4iiii Precision,Wahoo Kickr,346,351,-5
98164,1610814615,wahoo,Zwift - TEAM VEGAN Tofu Tornado (A),4iiii Precision,Wahoo Kickr,380,375,5
98956,1610982966,wahoo,Zwift - 3R Volcano Circuit Sprint Flat Race - 1 Lap (6.6km/4.1mi 20m) (A),4iiii Precision,Wahoo Kickr,338,352,-14
99155,1610997614,wahoo,Zwift - Team TFC Mad Monday Winter Series (A),4iiii Precision,Wahoo Kickr,405,405,0
100448,1611165614,wahoo,Zwift - MIDWEEK Winter Series by SZR (A),4iiii Precision,Wahoo Kickr,373,385,-12
101341,1611270921,wahoo,Zwift - Koa Sports League Warrior Race (A),4iiii Precision,Wahoo Kickr,367,371,-4
102033,1611424997,wahoo,Zwift - Championnat des Regions Frenchy Fuzion (E),4iiii Precision,Wahoo Kickr,427,422,5
106956,1612210021,wahoo,Zwift - Premier Division // Zwift Racing League (men) (A),4iiii Precision,Wahoo Kickr,406,403,3
108394,1612378832,wahoo,Zwift - Open - Movistar Team Challenge Community Qualifier Race #1,4iiii Precision,Wahoo Kickr,381,392,-11
112376,1612983623,wahoo,Zwift - Movistar Team Challenge // Round 1 (A),4iiii Precision,Wahoo Kickr,382,375,7
113674,1613156421,wahoo,Zwift - Movistar Team Challenge // Round 1 (men),4iiii Precision,Wahoo Kickr,411,413,-2
115416,1613419337,wahoo,Zwift - Premier Division // Zwift Racing League (men) (A),4iiii Precision,Wahoo Kickr,425,420,5
116755,1613588419,wahoo,Zwift - Movistar Team Challenge // Round 2 (men) - Race 3/4,4iiii Precision,Wahoo Kickr,366,378,-12
117913,1613761220,wahoo,Zwift - Movistar Team Challenge // Round 2 (men),4iiii Precision,Wahoo Kickr,423,427,-4
119166,1614021021,wahoo,Zwift - Premier Division // Zwift Racing League (men) (A),4iiii Precision,Wahoo Kickr,392,404,-12
124102,1614882616,wahoo,Zwift - FUSION SPRING CUP (A),4iiii Precision,Wahoo Kickr,364,355,9
124496,1614962409,wahoo,Zwift - SZ AW Party by SZR (A),4iiii Precision,Wahoo Kickr,372,364,8
125027,1615043715,wahoo,Zwift - OH MY CRIT!! - Saturday Smash Race (A),4iiii Precision,Wahoo Kickr,357,351,6
125755,1615213814,wahoo,Zwift - Aero Army Wyn TT Series (A),4iiii Precision,Wahoo Kickr,391,378,13
129319,1615919423,wahoo,Zwift - CeramicSpeed Race Series: Open Race (A),4iiii Precision,Wahoo Kickr,368,357,11
11211,1580122227,neo,Zwift - KISS at Base Training Ride (B),Assioma Duo,Tacx Neo,346,339,7
14525,1582049159,neo,Zwift - SZR iTT Winter Racing League (A),Assioma Duo,Tacx Neo,362,360,2
15314,1582467305,neo,KISS at Race 100 - Americas,Assioma Duo,Tacx Neo,311,307,4
19968,1585327003,neo, KALAS Indoor EFCT race series #iTT,Assioma Duo,Tacx Neo,348,343,5
30140,1588345037,neo,Regular Assioma vs Neo calibration check,Assioma Duo,Tacx Neo,335,327,8
42360,1592472586,neo,Zwift - ZHR Up & Down Race (A),Assioma Duo,Tacx Neo,333,330,3
42409,1592493297,neo,Zwift - OH CRIT!! - Lockdown Series - Round 3 Race 1 (A),Assioma Duo,Tacx Neo,341,339,2
52902,1598980045,neo,Zwift - SZR iTT Autumn Racing league (A),Assioma Duo,Tacx Neo,342,340,2
55350,1600189797,neo,Zwift - SZR iTT Autumn Racing league (A),Assioma Duo,Tacx Neo,361,357,4
58725,1601549789,neo,Zwift - Team ODZ Thursday Morning Throwdown (E),Assioma Duo,Tacx Neo,358,353,5
59614,1601915765,neo,Zwift - ZHR Zwift Handicap Race Europe (A),Assioma Duo,Tacx Neo,345,338,7
59616,1601919257,neo,Zwift - Kiss Racing Team / FastFitnessTips iTT series (E),Assioma Duo,Tacx Neo,340,333,7
60011,1602064644,neo,Zwift - Maximus Shootout Time Trial (E),Assioma Duo,Tacx Neo,356,352,4
60264,1602155666,neo,British Cycling Time Trial Series,Assioma Duo,Tacx Neo,352,349,3
60331,1602178169,neo,Zwift - British Cycling Time Trial Series (A),Assioma Duo,Tacx Neo,347,346,1
61169,1602520450,neo,Zwift - ZHR Zwift Handicap Race Europe (A),Assioma Duo,Tacx Neo,345,342,3
62477,1602867707,neo,Zwift - Team WEZ Friday Race (A),Assioma Duo,Tacx Neo,338,325,13
63047,1603128493,neo,Zwift - Kiss Racing Team / FastFitnessTips iTT series (E),Assioma Duo,Tacx Neo,368,359,9
69243,1604917574,neo,DIRTy Dozen Sprint League,Assioma Duo,Tacx Neo,337,331,6
69324,1604942034,neo,Zwift - Kiss Racing Team / FastFitnessTips iTT series (E),Assioma Duo,Tacx Neo,346,341,5
72945,1605788117,neo,Zwift - Team ODZ Thursday Morning Throwdown (E),Assioma Duo,Tacx Neo,356,342,14
73803,1605956695,neo,Team EN Hang-On Ride,Assioma Duo,Tacx Neo,388,372,16
74461,1606127415,neo,Zwift - DIRTy Dozen Sprint League (A),Assioma Duo,Tacx Neo,308,301,7
74556,1606152294,neo,Zwift - Kiss Racing Team / FastFitnessTips iTT series (E) / Sweet Spot,Assioma Duo,Tacx Neo,318,313,5
74917,1606221207,neo,Team ODZ Tuesday Covfefe Espresso Humblebrag Series Finale,Assioma Duo,Tacx Neo,393,382,11
75142,1606247178,neo,Zwift - Zwift Racing League | WTRL - Men&#039;s EMEA W1 DIVISION 3 (A),Assioma Duo,Tacx Neo,341,328,13
75399,1606301107,neo,Zwift - USA Cycling Race League by Indoor Specialist (A),Assioma Duo,Tacx Neo,320,311,9
75871,1606392922,neo,Zwift - Team ODZ Thursday Morning Throwdown (E),Assioma Duo,Tacx Neo,264,251,13
81608,1607624981,neo,Zwift - FUSION DECEMBER CUP (A),Assioma Duo (2nd Pair),Tacx Neo,351,345,6
91764,1609869623,neo,Zwift - KIRCHMAIR TT Race (A),Assioma Duo,Tacx Neo,353,343,10
95433,1610449470,neo,Zwift - MGCC Ride & Race (B),Assioma Duo,Tacx Neo,303,298,5
110900,1612781391,neo,Zwift - KISS at Base Training Ride (B),Assioma Duo,Tacx Neo,333,324,9
68597,1604689371,wahoo,tour de Spartacus,Stages,wahoo kickr core smart trainer,401,397,4
68897,1604775841,wahoo,Zwift - New Workout,Stages,wahoo kickr core smart trainer,326,331,-5
69797,1605032110,wahoo,Zwift - New Workout,Stages,wahoo kickr core smart trainer,384,388,-4
70968,1605215107,wahoo,Zwift - Aquecimento Race pWR,Stages,wahoo kickr core smart trainer,345,359,-14
76213,1606417516,wahoo,Zwift - New Workout,Stages,wahoo kickr core smart trainer,385,373,12
79506,1607106611,wahoo,Zwift - Team WEZ Friday Race (E),Stages,wahoo kickr core smart trainer,367,373,-6
110071,1612630786,wahoo,Zwift - New Workout,6231073301_ACTIVITY,wahoo kickr core smart trainer,350,368,-18
113981,1613206804,wahoo,Zwift - sweet spot series,Stages Ultegra 6700,wahoo kickr core smart trainer,356,361,-5
117305,1613672647,wahoo,WTRL Team Trial Platinum League,Stages Ultegra 6700,wahoo kickr core smart trainer,368,364,4
119730,1614104094,wahoo,Zwift - Aquecimento Race pWR,Stages Ultegra 6700,wahoo kickr core smart trainer,374,375,-1
123190,1614709117,wahoo,Zwift - Aquecimento Race pWR,Stages Ultegra 6700,wahoo kickr core smart trainer,363,378,-15
124868,1615021502,wahoo,3R Endurance Series,Stages Ultegra 6700,wahoo kickr core smart trainer,327,334,-7
127078,1615486556,wahoo,Zwift - Vienna,Stages Ultegra 6700,wahoo kickr core smart trainer,358,362,-4
128004,1615626308,wahoo,Zwift - Aquecimento Race pWR,Stages Ultegra 6700,wahoo kickr core smart trainer,398,397,1
29594,1588230300,wahoo,Zwift - 3R Innsbruckring Flat Race - 5 Laps (44km/27.3mi 385m) (B),Stages Power L - Shimano 105 R7000,Wahoo Kickr Core,288,284,4
31281,1588608000,wahoo,Zwift - EVO CC Vamos 90min Ride [3.5-4w/kg avg] (B),Stages Power L - Shimano 105 R7000,Wahoo Kickr Core,301,292,9
32447,1588869000,wahoo,Zwift - Tour for All 2020: Stage 1 Longer Ride,Stages Power L - Shimano 105 R7000,Wahoo Kickr Core,314,300,14
33835,1589213399,wahoo,Zwift - Tour for All 2020: Stage 2 Longer Race A/B,Stages Power L - Shimano 105 R7000,Wahoo Kickr Core,345,327,18
33955,1589300999,wahoo,Zwift - Tour for All 2020: Stage 3 Longer Ride with Georgia Simmerling,Stages Power L - Shimano 105 R7000,Wahoo Kickr Core,345,338,7
35080,1589562299,wahoo,Zwift - 3R Classique Flat Race - 5 Laps (B),Stages Power L - Shimano 105 R7000,Wahoo Kickr Core,316,301,15
35860,1589817925,wahoo,Zwift - EVO CC Vamos 90min Ride [3.5-4w/kg avg] (B),Stages Power L - Shimano 105 R7000,Wahoo Kickr Core,287,285,2
38087,1590592498,wahoo,Zwift - Tour for All 2020: Stage 2 Longer Race A/B,Stages Power L - Shimano 105 R7000,Wahoo Kickr Core,316,316,0
59607,1601918138,wahoo,Zwift - DBR Ride´N´Roll League (B),Stages Power L - Shimano 105 R7000,Wahoo Kickr Core,347,322,25
59839,1602003699,wahoo,Zwift - ZRG Race (B),Stages Power L - Shimano 105 R7000,Wahoo Kickr Core,0,0,0
59840,1602003699,wahoo,Zwift - ZRG Race (B),Stages Power L - Shimano 105 R7000,Wahoo Kickr Core,313,309,4
61627,1602609337,wahoo,Zwift - Zwift Racing League | WTRL,20201013,Wahoo Kickr Core,340,329,11
62245,1602785676,wahoo,Zwift - Pre Event Ride // Swedish Cycling Federation,Stages Power L - Shimano 105 R7000,Wahoo Kickr Core,348,336,12
63404,1603214295,wahoo,Zwift - Zwift Racing League | WTRL - EMEA E (MEN) - TTT Grp 4 (A),Stages Power L - Shimano 105 R7000,Wahoo Kickr Core,315,302,13
65507,1603822775,wahoo,Zwift - Zwift Racing League | WTRL - EMEA E (MEN) -  Division 5 (B),Stages Power L - Shimano 105 R7000,Wahoo Kickr Core,344,327,17
65824,1603908030,wahoo,Zwift - MIDWEEK Autumn Series by SZR (B),Stages Power L - Shimano 105 R7000,Wahoo Kickr Core,331,320,11
67250,1604340936,wahoo,Zwift -  DBR Monday Race (B),Stages Power L - Shimano 105 R7000,Wahoo Kickr Core,326,311,15
67653,1604428059,wahoo,Zwift - Zwift Racing League | WTRL - Men&#039;s EMEA E2 DIVISION 1 (B),Stages Power L - Shimano 105 R7000,Wahoo Kickr Core,325,310,15
68596,1604689474,wahoo,Zwift -  Tour De Spartacus  (B),Stages Power L - Shimano 105 R7000,Wahoo Kickr Core,363,352,11
68916,1604775634,wahoo,Zwift -  Tour De Spartacus  (B),Stages Power L - Shimano 105 R7000,Wahoo Kickr Core,338,318,20
69762,1605032363,wahoo,Zwift - Zwift Racing League | WTRL - EMEA E2 (MEN) -  Division 1 (B),Stages Power L - Shimano 105 R7000,Wahoo Kickr Core,389,375,14
113464,1613147995,wahoo,Zwift - AW,Stages Power L - Shimano 105 R7000,Wahoo Kickr Core,331,328,3
117771,1613752159,wahoo,Zwift - AW,Stages Power L - Shimano 105 R7000,Wahoo Kickr Core,334,331,3
123562,1614794381,wahoo,Zwift - MIDWEEK Crit,Stages Power L - Shimano 105 R7000,Wahoo Kickr Core,355,348,7
127506,1615567191,wahoo,Zwift - SZ AW Party by SZR (A),Stages Power L - Shimano 105 R7000,Wahoo Kickr Core,334,332,2
85134,1608389099,wahoo,Zwift - OH MY CRIT - Saturday Smash Race (A),2020-12-19-144459-ELEMNT BOLT A5A1-103-0,Wahoo Kickr,404,413,-9
85497,1608473694,wahoo,Zwift - KISS 100 Race Series - Americas (A),4iii left crank only,Wahoo Kickr,343,350,-7
86272,1608665451,wahoo,Zwift - KISS Race Series - EU PM (A),4iii left crank only,Wahoo Kickr,386,388,-2
86489,1608738039,wahoo,Zwift - ZA Tri: TT Race - 20k,4iii left crank only,Wahoo Kickr,349,358,-9
87519,1608993888,wahoo,Zwift - OH MY CRIT - Saturday Smash Race (A),4iii left crank only,Wahoo Kickr,394,387,7
87899,1609084886,wahoo,Zwift - ZHQ FutureWorks Crit City Race - Anti-sandbagging (A),4iii left crank only,Wahoo Kickr V5,368,358,10
88802,1609275848,wahoo,Zwift - Crit City Race (A),4iii left crank only,Wahoo Kickr V5,357,352,5
88803,1609279412,wahoo,Zwift - 3R Classique Flat Race - 5 Laps (32.3km/20.1mi 95m) (A),4iii left crank only,Wahoo Kickr V5,328,321,7
89581,1609429558,wahoo,Zwift - OH MY CRIT! - The Double Race 1/2 (A),4iii left crank only,Wahoo Kickr V5,363,357,6
89584,1609434105,wahoo,Zwift - OH MY CRIT! - The Double Race 2/2 (A),4iii left crank only,Wahoo Kickr V5,354,348,6
90294,1609598775,wahoo,Zwift - OH MY CRIT - Saturday Smash Race (A),4iii left crank only,Wahoo Kickr V5,368,369,-1
90802,1609689754,wahoo,Zwift - ZHQ FutureWorks Crit City Race - Anti-sandbagging (A),4iii left crank only,Wahoo Kickr V5,384,363,21
91963,1609883867,wahoo,Zwift - 3R Classique Flat Race - 5 Laps (32.3km/20.1mi 95m) (A),4iii left crank only,Wahoo Kickr V5,359,347,12
91964,1609880652,wahoo,Zwift - Crit City Race (A),4iii left crank only,Wahoo Kickr V5,394,381,13
93931,1610203510,wahoo,Zwift - OH MY CRIT - Saturday Smash Race (A),4iii left crank only,Wahoo Kickr V5,352,348,4
94564,1610287058,wahoo,Zwift - KISS 100 Race Series - Americas (A),4iii left crank only,Wahoo Kickr V5,399,389,10
96627,1610572035,wahoo,Zwift - Upper z2 - v2,4iii left crank only,Wahoo Kickr V5,358,356,2
97973,1610800297,wahoo,Zwift - TDZ Stage 3: Longer Ride,4iii left crank only,Wahoo Kickr V5,355,356,-1
98625,1610895825,wahoo,Zwift - 3R Watopia 65km Race - 6 laps (40mi 324m) (A),4iii left crank only,Wahoo Kickr V5,352,347,5
100526,1611176384,wahoo,Zwift - TDZ Stage 4: Longer Ride,4iii left crank only,Wahoo Kickr V5,342,342,0
100527,1611093862,wahoo,Zwift - 3R Classique Flat Race - 5 Laps (32.3km/20.1mi 95m) (A),4iii left crank only,Wahoo Kickr V5,356,365,-9
101933,1611414883,wahoo,Zwift - OH MY CRIT!! - Saturday Smash Race (A),4iii left crank only,Wahoo Kickr V5,385,386,-1
105714,1612018185,wahoo,Zwift - OH MY CRIT!! - Saturday Smash Race (A),4iii left crank only,Wahoo Kickr V5,363,372,-9
110570,1612706316,wahoo,Zwift - KISS 100 Race Series - Americas (A),4iii left crank only,Wahoo Kickr V5,377,377,0
114400,1613227424,wahoo,Zwift - OH MY CRIT!! - Saturday Smash Race (A),4iii left crank only,Wahoo Kickr V5,393,391,2
114758,1613311119,wahoo,Zwift - KISS 100 Race Series - Americas (A),4iii left crank only,Wahoo Kickr V5,354,358,-4
117209,1613663153,wahoo,Zwift - OH MY CRIT!! - The Double Race 1/2 (A),4iii left crank only,Wahoo Kickr V5,350,351,-1
117211,1613667829,wahoo,Zwift - OH MY CRIT!! - The Double Race 2/2 (A),4iii left crank only,Wahoo Kickr V5,332,331,1
118351,1613832129,wahoo,Zwift - OH MY CRIT!! - Saturday Smash Race (A),4iii left crank only,Wahoo Kickr V5,358,354,4
118768,1613915872,wahoo,Zwift - KISS 100 Race Series - Americas (A),4iii left crank only,Wahoo Kickr V5,358,355,3
122137,1614520629,wahoo,Zwift - KISS 100 Race Series - Americas (A),4iii left crank only,Wahoo Kickr V5,368,372,-4
125498,1615125428,wahoo,Zwift - KISS 100 Race Series (Americas) - The Uber Pretzel Edition (A),4iii left crank only,Wahoo Kickr V5,383,383,0
128057,1615646759,wahoo,Zwift - OH MY CRIT!! - Saturday Smash Race (A),4iii left crank only,Wahoo Kickr V5,400,400,0
128452,1615730423,wahoo,Zwift - KISS 100 Race Series (Americas) (A),4iii left crank only,Wahoo Kickr V5,366,366,0
22812,1586284798,wahoo,Zwift - 3R Spring Loaded Race Series - Round 2of6 (A),Garmin 2 Pedal,Wahoo kickr,371,394,-23
45842,1594431023,wahoo,Zwift - 07/10/2020,4iiii left,Wahoo kickr,0,362,-362
93112,1610069399,wahoo,Zwift - 01/07/2021,4iiii left,Wahoo kickr,421,412,9
93581,1610148599,wahoo,Wahoo kickr / 4iiii left,4iiii left,Wahoo kickr,391,406,-15
107704,1612313160,wahoo,Zwift - 02/02/2021,4iiii left,Wahoo kickr,435,418,17
112541,1613002202,wahoo,Zwift - 02/10/2021,4iiii,Wahoo kickr,417,408,9
93272,1610043181,wahoo,Zwift - BENELIGA 2020-2021 (E),pioneer,Wahoo,390,380,10
117449,1613673547,wahoo,Zwift - BENELIGA 2020-2021 (E),pioneer,Wahoo,386,374,12
95681,1610475293,wahoo,Zwift - Zwift Racing League | WTRL - Men&#039;s/Mixed EMEA E1 DIVISION 1 (A),Favero Assioma BePro Left Side + Right Side,Wahoo Kickr v4 2018,351,337,14
98463,1610871596,wahoo,Zwift - Team Italy & Frenchy Fuzion Endurance Race (A),Favero Assioma BePro Left Side + Right Side,Wahoo Kickr v4 2018,334,318,16
99816,1611080459,wahoo,Zwift - Zwift Racing League | WTRL - Men&#039;s/Mixed EMEA E1 DIVISION 1 (A),Favero Assioma BePro Left Side + Right Side,Wahoo Kickr v4 2018,332,307,25
103698,1611684892,wahoo,Zwift - Zwift Racing League | WTRL - Men&#039;s/Mixed EMEA E1 DIVISION 1 (A),Favero Assioma BePro Left Side + Right Side,Wahoo Kickr v4 2018,350,323,27
107338,1612289695,wahoo,Zwift - Zwift Racing League | WTRL - Men&#039;s/Mixed EMEA E1 DIVISION 1 (A),Favero Assioma BePro Left Side + Right Side,Wahoo Kickr v4 2018,346,329,17
111581,1612894861,wahoo,Zwift - Zwift Racing League | WTRL - Men&#039;s/Mixed EMEA E1 DIVISION 1 (A),Favero Assioma BePro Left Side + Right Side,Wahoo Kickr v4 2018,343,326,17
115850,1613499298,wahoo,Zwift - Zwift Racing League | WTRL - Men&#039;s/Mixed EMEA E1 DIVISION 1 (A),Favero Assioma BePro Left Side + Right Side,Wahoo Kickr v4 2018,353,341,12
119616,1614104095,wahoo,Zwift - Zwift Racing League | WTRL - Men&#039;s/Mixed EMEA E1 DIVISION 1 (A),Favero Assioma BePro Left Side + Right Side,Wahoo Kickr v4 2018,321,311,10
123104,1614709324,wahoo,Zwift - Zwift Racing League | WTRL - Men&#039;s/Mixed EMEA E1 DIVISION 1 (A),Favero Assioma BePro Left Side + Right Side,Wahoo Kickr v4 2018,318,307,11
123833,1614846862,wahoo,Zwift - Tri Aus TT (E),Favero Assioma BePro Left Side + Right Side,Wahoo Kickr v4 2018,334,317,17
76161,1606415287,wahoo,Wahoo KICKR Core / 4iiii Left crank 105,4iiii Left crank 105,Wahoo KICKR Core,350,359,-9
79144,1607020340,wahoo,Wahoo KICKR Core / 4iiii Left crank 105,4iiii Left crank 105,Wahoo KICKR Core,348,354,-6
80537,1607368654,wahoo,4iiii Left crank 105,4iiii Left crank 105,Wahoo KICKR Core,361,371,-10
82273,1607625014,wahoo,4iiii Left crank 105,4iiii Left crank 105,Wahoo KICKR Core,341,356,-15
52182,1598546734,wahoo,Zwift - WTRL Team Time Trial (C),Assioma,Wahoo kickr core,403,406,-3
52327,1598607150,wahoo,Zwift - TBR Burrito Race (A),Assioma,Wahoo kickr core,396,394,2
52622,1598787550,wahoo,Crit City Race,Assioma,Wahoo kickr core,418,407,11
52770,1598897383,wahoo,Zwift - TFC Mad Monday Summer Series (9 of 10) (A),Assioma,Wahoo kickr core,406,396,10
53067,1599057395,wahoo,Zwift - Crit City Race (A),Assioma Duo,Wahoo kickr core,430,419,11
53255,1599157600,wahoo,WTRL Team Time Trial - Zone6,Assioma Duo,Wahoo kickr core,396,388,8
53953,1599584616,wahoo,SZR iTT Autumn Racing league,Assioma Duo,Wahoo kickr core,388,390,-2
54437,1599762184,wahoo,Zwift - Espresso,Assioma Duo,Wahoo kickr core,413,413,0
54724,1599919665,wahoo,Zwift - OH MY CRIT - Saturday Smash Race (A),Assioma Duo,Wahoo kickr core,421,423,-2
55554,1600275352,wahoo,Zwift - MIDWEEK Autumn Series by SZR (A),Assioma Duo (Zwift),Wahoo kickr core,410,407,3
55857,1600367660,wahoo,Zwift - Espresso,Assioma Duo (Zwift),Wahoo kickr core,399,387,12
56215,1600502030,wahoo,Zwift - 3R Flat Race (A),Assioma Duo (Zwift),Wahoo kickr core,397,391,6
56266,1600524711,wahoo,Zwift - OH MY CRIT - Saturday Smash Race (A),Assioma Duo (Zwift),Wahoo kickr core,367,364,3
57015,1600879803,wahoo,Zwift - MIDWEEK Autumn Series by SZR (A),Assioma Duo (Zwift),Wahoo kickr core,407,412,-5
57715,1601127267,wahoo,DIRT Dadurday Chase Race ,Assioma Duo (Zwift),Wahoo kickr core,401,397,4
57934,1601219763,wahoo,3R Watopia 65km Race - 6 laps (40mi 324m),Assioma Duo (Zwift),Wahoo kickr core,396,388,8
58088,1601315685,wahoo,Zwift - TFC Mad Monday Autumn Series (A),Assioma Duo (Zwift),Wahoo kickr core,400,390,10
58630,1601497024,wahoo,3R Classique Flat Race - 5 Laps (32.3km/20.1mi 95m),Assioma Duo (Zwift),Wahoo kickr core,429,413,16
59622,1601920373,wahoo,Zwift - TFC Mad Monday Autumn Series (A),Assioma Duo (Zwift),Wahoo kickr core,412,412,0
60432,1602183000,wahoo,Zwift - KISS at Race - EU PM (A),Assioma Duo (Zwift),Wahoo kickr core,427,427,0
60807,1602339065,wahoo,Zwift - OH MY CRIT - Saturday Smash Race (A),Assioma Duo (Zwift),Wahoo kickr core,411,402,9
62211,1602785366,wahoo,Zwift - Pre Event Ride // Swedish Cycling Federation,Assioma Duo (Zwift),Wahoo kickr core,408,402,6
62214,1602785366,wahoo,Zwift - Pre Event Ride // Swedish Cycling Federation,Assioma Duo (Zwift),Wahoo kickr core,0,0,0
62218,1602785366,wahoo,Zwift - Pre Event Ride // Swedish Cycling Federation,Assioma Duo (Zwift),Wahoo kickr core,0,0,0
62223,1602785366,wahoo,Zwift - Pre Event Ride // Swedish Cycling Federation,Assioma Duo (Zwift),Wahoo kickr core,0,0,0
62228,1602785366,wahoo,Zwift - Pre Event Ride // Swedish Cycling Federation,Assioma Duo (Zwift),Wahoo kickr core,0,0,0
62230,1602785366,wahoo,Pre Event Ride // Swedish Cycling Federation,Assioma Duo (Zwift),Wahoo kickr core,408,402,6
62644,1602948256,wahoo,ZHQ Beta Crit City Race,Assioma Duo (Zwift),Wahoo kickr core,392,394,-2
62765,1602997218,wahoo,KISS at Race 100 - EU,Assioma Duo (Zwift),Wahoo kickr core,401,387,14
64227,1603391628,wahoo,Zwift - Espresso,Assioma Duo (Zwift),Wahoo kickr core,399,403,-4
64533,1603519503,wahoo,Zwift - 3R Road To Ruins Hilly Race - 1 Lap (29..2km/18.1mi 275m) (A),Assioma Duo (Zwift),Wahoo kickr core,419,417,2
64859,1603631005,wahoo,Zwift - 3R Watopia Flat Route Race - 4 Laps (40.5km/25.1mi 216m) (A),Assioma Duo (Zwift),Wahoo kickr core,411,397,14
65120,1603738127,wahoo,TFC Mad Monday Autumn Series,Assioma Duo (Zwift),Wahoo kickr core,387,383,4
65431,1603820749,wahoo,Zwift Racing League | WTRL - Mens EMEA E1 DIVISION 1,Assioma Duo (Zwift),Wahoo kickr core,423,421,2
66220,1604002483,wahoo,3R LaGuardia Loop Flat Race - 6 Laps (17.5km/10.9 162m),Assioma Duo (Zwift),Wahoo kickr core,423,418,5
66518,1604095273,wahoo,3R Volcano Flat 50k Race - 4 Laps (48.8km/30.7mi 184m),Assioma Duo (Zwift),Wahoo kickr core,408,400,8
67261,1604344416,wahoo,TFC Mad Monday Autumn Series,Assioma Duo (Zwift),Wahoo kickr core,438,439,-1
68557,1604688778,wahoo,Zwift -  Tour De Spartacus  (A),Assioma Duo (Zwift),Wahoo kickr core,433,428,5
68851,1604775023,wahoo,Zwift -  Tour De Spartacus  (A),Assioma Duo (Zwift),Wahoo kickr core,378,376,2
69115,1604861442,wahoo,Zwift -  Tour De Spartacus  (A),Assioma Duo (Zwift),Wahoo kickr core,433,428,5
69770,1605031670,wahoo,Zwift - Zwift Racing League | WTRL - EMEA E1 (MEN) -  Division 1 (A),Assioma Duo (Zwift),Wahoo kickr core,429,423,6
70769,1605209600,wahoo,Zwift - Espresso,Assioma Duo (Zwift),Wahoo kickr core,392,384,8
73874,1605974591,wahoo,3R Classique Flat Race - 4 Laps (26.9km/16.7mi 76m),Assioma Duo (Zwift),Wahoo kickr core,423,411,12
74244,1606058637,wahoo,3R Watopia 65km Race - 6 laps (40mi 324m),Assioma Duo (Zwift),Wahoo kickr core,409,394,15
76507,1606495234,wahoo,Crit City Race,Assioma Duo (Zwift),Wahoo kickr core,424,415,9
78030,1606845842,wahoo,Zwift - Zwift Racing League | WTRL - Men&#039;s EMEA E1 DIVISION 1 (A),Assioma Duo (Zwift),Wahoo kickr core,401,400,1
79788,1607180601,wahoo,Zwift - OH MY CRIT - Saturday Smash Race (A),Assioma Duo (Zwift),Wahoo kickr core,423,416,7
80205,1607273716,wahoo,Zwift - Nations Challenge // Sweden (E),Assioma Duo (Zwift),Wahoo kickr core,387,371,16
80778,1607450836,wahoo,Zwift - Zwift Racing League | WTRL - Men&#039;s EMEA E1 DIVISION 1 (A),Assioma Duo (Zwift),Wahoo kickr core,395,390,5
82257,1607765198,wahoo,Zwift - DBR Saturday Race (A),Assioma Duo (Zwift),Wahoo kickr core,375,351,24
83182,1607973165,wahoo,Zwift - Team TFC Mad Monday Winter Series (A),Assioma Duo (Zwift),Wahoo kickr core,397,391,6
86348,1608703758,wahoo,Zwift - 3R Racing (A),Assioma Duo (Zwift),Wahoo kickr core,399,394,5
86743,1608789983,wahoo,Zwift - 3R Racing (A),Assioma Duo (Zwift),Wahoo kickr core,400,396,4
87678,1609049516,wahoo,Mtri Race,Assioma Duo (Zwift),Wahoo kickr core,334,332,2
88473,1609238741,wahoo,Zwift - SZR Lunch Race (A),Assioma Duo (Zwift),Wahoo kickr core,395,393,2
89005,1609336565,wahoo,Zwift - KISS Race Series - Pacific AM (A),Assioma Duo (Zwift),Wahoo kickr core,381,370,11
89825,1609516431,wahoo,Zwift - 3R Volcano Flat Race - 3 Laps (36.6km/22.7mi 138m) (A),Assioma Duo (Zwift),Wahoo kickr core,425,414,11
93053,1610047773,wahoo,Zwift - WTRL Team Time Trial - Zone 9 (C),Assioma Duo (Zwift),Wahoo kickr core,391,390,1
94919,1610386612,wahoo,Zwift - SCF SWE Cup (A),Assioma Duo (Zwift),Wahoo kickr core,398,389,9
95772,1610480665,wahoo,Zwift - Zwift Racing League | WTRL - Men&#039;s/Mixed EMEA W2 DIVISION 1 (A),Assioma Duo (Zwift),Wahoo kickr core,369,360,9
97460,1610727846,wahoo,ZHQ FutureWorks Crit City Race - Anti-sandbagging,Assioma Duo (Zwift),Wahoo kickr core,395,389,6
99822,1611086057,wahoo,Zwift - Zwift Racing League | WTRL - Men&#039;s/Mixed EMEA W2 DIVISION 1 (A),Assioma Duo (Zwift),Wahoo kickr core,398,394,4
100229,1611158912,wahoo,Zwift - 3R Tick Tock Flat Race - 2 Lap (36km/22.4mi 100m) (A),Assioma Duo (Zwift),Wahoo kickr core,392,379,13
109345,1612542473,wahoo,Zwift - SZ AW Party by SZR (A),Assioma Duo (Zwift),Wahoo kickr core,404,405,-1
113041,1613072151,wahoo,Zwift - WTRL Team Time Trial - Zone 11 (C),Assioma Duo (Zwift),Wahoo kickr core,410,410,0
118340,1613829059,wahoo, Zwift Insider Badge Hunters - The Uber Pretzel Edition (E),Assioma Duo (Zwift),Wahoo kickr core,369,367,2
121677,1614443188,wahoo,Zwift - TEAM VEGAN Tofu Tornado (A),Assioma Duo (Zwift),Wahoo kickr core,417,418,-1
121956,1614493571,wahoo,XRS Races: a Longer and Hard race,Assioma Duo (Zwift),Wahoo kickr core,384,387,-3
127184,1615491734,wahoo,Zwift - WTRL Team Time Trial - Zone 12 (C),Assioma Duo (Zwift),Wahoo kickr core,393,395,-2
118579,1613886252,wahoo,Zwift - KISS 100 Race Series - EU (A),Favero Assioma Duo,Wahoo KICKR v5,315,314,1
120013,1614134310,wahoo,Zwift - Zwift Racing League | WTRL - Men&#039;s/Mixed AMERICAS W DIVISION 1 (A),Favero Assioma Duo,Wahoo KICKR v5,315,315,0
1250,1567590298,wahoo,Zwift - The Morning Grind (A),Powertap P1s,Wahoo Kickr 2018,392,390,2
2048,1568801398,wahoo,Zwift - Yorkshire Power Up Tour: Climber Stage (A),Powertap P1s,Wahoo Kickr 2018,367,372,-5
2659,1569524365,wahoo,Zwift - Yorkshire Gran Prix // Zwift Classic (A),Powertap P1s,Wahoo Kickr 2018,442,449,-7
7674,1577729717,neo,DBR Monday Race,Assioma Duo,Neo 1,381,358,23
8079,1578056608,neo,Zwift - Crit City Race (A),Assioma Duo,Neo 1,416,384,32
8081,1578150898,neo,Zwift - OH CRIT!! - Saturday Smash Series (A),Assioma Duo,Neo 1,353,334,19
8258,1578334518,neo,Zwift - DBR Caresport Crit Cup  (A),Assioma Duo,Neo 1,396,376,20
8935,1578819617,neo,Zwift - Danmarks Cykle Union 2020 Cup (A),Assioma Duo,Neo 1,329,307,22
8937,1578822460,neo,Assioma Duo,Assioma Duo,Neo 1,220,210,10
9175,1578940224,neo,Zwift - Tour de Zwift: Stage 1 Long Distance,Assioma Duo,Neo 1,252,241,11
10171,1579510800,neo,Zwift - Tour de Zwift: Stage 3 Group Ride - Long Distance,Assioma Duo,Neo 1,356,339,17
10724,1579806734,neo,Zwift - Tour de Zwift // Pro-Am Invitational,Assioma Duo,Neo 1,416,392,24
10916,1579944604,wahoo,Zwift - DBR Saturday Race (A),Assioma Duo,Wahoo Kickr Core,343,355,-12
10967,1580029214,wahoo,Zwift - Danmarks Cykle Union 2020 Cup (A),Assioma Duo,Wahoo Kickr Core,389,386,3
11186,1580148913,wahoo,Zwift - DBR Caresport Crit Cup  (A),Assioma Duo,Wahoo Kickr Core,377,377,0
11629,1580382016,wahoo,Zwift - Tour de Zwift: Stage 5 Long Distance,Assioma Duo,Wahoo Kickr Core,381,384,-3
11898,1580497874,wahoo,Zwift - Tour de Zwift // Pro-Am Invitational (A),Assioma Duo,Wahoo Kickr Core,387,394,-7
12014,1580549418,wahoo,Zwift - DBR Saturday Race (A),Assioma Duo,Wahoo Kickr Core,362,373,-11
12249,1580721025,wahoo,Zwift - Tour de Zwift: Stage 6 Race (A),Assioma Duo,Wahoo Kickr Core,394,387,7
12521,1580843618,wahoo,Zwift - Tour de Zwift // Pro-Am Invitational (A),Assioma Duo,Wahoo Kickr Core,394,395,-1
12866,1581015542,wahoo,Zwift - KALAS Cup - Round 2 (A),Assioma Duo,Wahoo Kickr Core,421,427,-6
13050,1581146700,wahoo,Zwift - 3R Tempus Fugit Flat Race - 1 Lap (19.8km/12.3mi 20m) (A),Assioma Duo,Wahoo Kickr Core,349,352,-3
13052,1581149100,wahoo,Zwift - 3R Yorkshire Dutchy Estate Race - 10 Laps (A),Assioma Duo,Wahoo Kickr Core,387,393,-6
13923,1581620310,wahoo,Zwift - KALAS Cup - Round 3 (A),Assioma Duo,Wahoo Kickr Core,354,360,-6
14164,1581779694,wahoo,Zwift - OH CRIT!! - Saturday Smash Series (A),Assioma Duo,Wahoo Kickr Core,385,390,-5
14449,1581930839,wahoo,Zwift - 3R Watopia Flat Route Race - 4 Laps (41km/25.5mi 216m) (A),Assioma Duo,Wahoo Kickr Core,370,378,-8
14594,1582053244,wahoo,Zwift - Feltet.dk Race Series,Assioma Duo,Wahoo Kickr Core,376,377,-1
15019,1582195515,wahoo,Zwift - Crit City Race (A),Assioma Duo,Wahoo Kickr Core,380,375,5
15020,1582197111,wahoo,Zwift - 3R Classique Flat Race - 4 Laps (26.9km/16.7mi 76m) (A),Assioma Duo,Wahoo Kickr Core,337,341,-4
15302,1582451963,wahoo,Zwift - Tour of Innsbruck // Stage 3,Assioma Duo,Wahoo Kickr Core,396,408,-12
15454,1582568102,wahoo,Zwift - DBR Winter Cup (A),Assioma Duo,Wahoo Kickr Core,401,405,-4
16025,1582830014,wahoo,Zwift - KALAS Cup - Round 5 (A),Assioma Duo,Wahoo Kickr Core,349,357,-8
16481,1583172885,wahoo,Zwift - DBR Winter Cup (A),Assioma Duo,Wahoo Kickr Core,376,381,-5
35049,1589480017,wahoo,Zwift - WTRL Team Time Trial (C),Assioma Duo,Wahoo Kickr Core,374,383,-9
35841,1589822117,wahoo,Zwift - DBR Wahoo League (A),Assioma Duo,Wahoo Kickr Core,343,348,-5
50754,1597860313,wahoo,Zwift - DBR Wednesday Race (A),Assioma Uno,Wahoo Kickr Core,416,423,-7
50984,1597946601,wahoo,Zwift - Frappe,Assioma Uno,Wahoo Kickr Core,357,366,-9
51074,1598002431,wahoo,Zwift - TBR Burrito Race (A),Assioma Uno,Wahoo Kickr Core,358,358,0
51444,1598168099,wahoo,Zwift -  30-39 years - ZHR Masters Weekender (A),Assioma Uno,Wahoo Kickr Core,360,364,-4
51656,1598346299,wahoo,Zwift - 3R Turbocharged Team Race Series - Bonus Round (A),Assioma Uno,Wahoo Kickr Core,358,365,-7
52111,1598512927,wahoo,Zwift - FTP Test (shorter),Assioma Uno,Wahoo Kickr Core,390,398,-8
52112,1598517011,wahoo,KISS at Race - Down under,Assioma Uno,Wahoo Kickr Core,370,376,-6
53657,1599400826,wahoo,Zwift - ZHR Masters Weekender (A),Assioma Uno,Wahoo Kickr Core,407,417,-10
53760,1599498831,wahoo,Zwift - DBR Ride´N´Roll League (A),Assioma Uno,Wahoo Kickr Core,390,396,-6
54072,1599638376,wahoo,Zwift - Giant Crit Crushers Race 1 (A),Assioma Uno,Wahoo Kickr Core,394,393,1
54073,1599639576,wahoo,Zwift - Giant Crit Crushers Race 2 (A),Assioma Uno,Wahoo Kickr Core,368,378,-10
54074,1599642270,wahoo,Zwift - 3R Watopia Flat Route Race - 3 Laps (30.3km/18.8mi 162m) (A),Assioma Uno,Wahoo Kickr Core,353,361,-8
54716,1599912597,wahoo,Zwift - The BMTR Fundo (D),Assioma Uno,Wahoo Kickr Core,388,396,-8
54943,1600067096,wahoo,3R Watopia Flat Route Race - 3 Laps (30.3km/18.8mi 162m) (A),Assioma Uno,Wahoo Kickr Core,341,345,-4
56013,1600367304,wahoo,Zwift - Invitational League // Qualifying Race #2 (Men) ,Assioma Uno,Wahoo Kickr Core,386,386,0
57145,1600883038,wahoo,Zwift - DCU powered by Feltet.dk (A),Assioma Uno,Wahoo Kickr Core,376,380,-4
57224,1600936213,wahoo,Zwift - KISS at Race - Down Under (A),Assioma Uno,Wahoo Kickr Core,395,405,-10
57783,1601108997,wahoo,Zwift - DBR SufferDay League II (A),Assioma Uno,Wahoo Kickr Core,387,397,-10
57941,1601212516,wahoo,Zwift - KISS at Race 100 - Americas (A),Assioma Uno,Wahoo Kickr Core,390,393,-3
58546,1601487825,wahoo,Zwift - DCU powered by Feltet.dk (A),Assioma Uno,Wahoo Kickr Core,368,381,-13
59015,1601627415,wahoo,Zwift - The Gorby,Assioma Uno,Wahoo Kickr Core,394,395,-1
59158,1601708620,wahoo,Zwift - 3R Flat Race (A),Assioma Uno,Wahoo Kickr Core,366,368,-2
59358,1601795996,wahoo,Zwift - Team Italy & Frenchy Fuzion Endurance Race (A),Assioma Uno,Wahoo Kickr Core,391,398,-7
59619,1601918081,wahoo,Zwift - DBR Ride´N´Roll League (A),Assioma Uno,Wahoo Kickr Core,358,364,-6
60241,1602140699,wahoo,Zwift - 3R Innsbruckring Flat Race - 5 Laps (44km/27.3mi 385m) (A),Assioma Uno,Wahoo Kickr Core,348,356,-8
60534,1602230695,wahoo,Zwift - 3R Lagurdia Super Sprint Race - 1 Lap (3.7km/2.6mi 27m) (A),Assioma Uno,Wahoo Kickr Core,334,342,-8
60536,1602232495,wahoo,Zwift - TBR Burrito Race (A),Assioma Uno,Wahoo Kickr Core,361,364,-3
60821,1602339296,wahoo,Zwift - OH MY CRIT - Saturday Smash Race (A),Assioma Uno,Wahoo Kickr Core,362,358,4
61123,1602494098,wahoo,Zwift - 3R Watopia Flat Route Race - 4 Laps (41km/25.5mi 216m) (A),Assioma Uno,Wahoo Kickr Core,348,342,6
61564,1602609208,wahoo,Zwift - Zwift Racing League | WTRL,Assioma Uno,Wahoo Kickr Core,421,419,2
62030,1602698713,wahoo,Zwift - DBR HEINO CUP III (A),Assioma Uno,Wahoo Kickr Core,363,365,-2
62261,1602782999,wahoo,Zwift - FUSION ECT BEUNSTOPPABLE Racing Series (A),Assioma Uno,Wahoo Kickr Core,424,432,-8
62643,1602944099,wahoo,Zwift - OH MY CRIT - Saturday Smash Race (A),Assioma Uno,Wahoo Kickr Core,360,364,-4
62801,1603005018,wahoo,Zwift - 3R Figure 8 Hilly Race - 1 Lap (29.2km/18.1m 234m) (A),Assioma Uno,Wahoo Kickr Core,400,408,-8
63021,1603092612,wahoo,Zwift - Flanders Endurance Series (E),Assioma Uno,Wahoo Kickr Core,377,380,-3
63384,1603202432,wahoo,Zwift - Zwift Time Trial Tuesday: Tempus Fugit (E),Assioma Uno,Wahoo Kickr Core,404,403,1
64071,1603360800,wahoo,Zwift - KISS at Race - Americas AM (A),Assioma Uno,Wahoo Kickr Core,429,433,-4
64827,1603615521,wahoo,Zwift - 100km ZESP Fondo (A),Assioma Uno,Wahoo Kickr Core,416,418,-2
65044,1603719531,wahoo,Zwift - 3R Richmond UCI Hilly Race - 1 Lap (16.2km/10.1mi 142m) (A),Assioma Uno,Wahoo Kickr Core,344,349,-5
65442,1603822432,wahoo,Zwift - Zwift Racing League | WTRL - EMEA E (MEN) -  Division 1 (A),Assioma Uno,Wahoo Kickr Bike,382,385,-3
65734,1603888211,wahoo,Zwift - 3R LaGuardia Loop Flat Race - 10 Laps (28.3km/17.6mi 270m) (A),Assioma Uno,Wahoo Kickr Bike,382,383,-1
66015,1603967700,wahoo,Zwift - Japan ZWIFT Hill Climb Race (A),Assioma Uno,Wahoo Kickr Bike,354,357,-3
66735,1604157299,wahoo,Zwift - OH MY CRIT - Saturday Smash Race (A),Assioma Uno,Wahoo Kickr Bike,351,354,-3
67226,1604308511,wahoo,Zwift - 3R Watopia Flat Route Race - 4 Laps (41km/25.5mi 216m) (A),Assioma Uno,Wahoo Kickr Bike,337,340,-3
67227,1604312417,wahoo,Zwift - 3R Volcano Flat Race - 3 Laps (36.6km/22.7mi 138m) (A),Assioma Uno,Wahoo Kickr Bike,337,340,-3
67807,1604429719,wahoo,Zwift - Team Italy & Frenchy Fuzion League (A),Assioma Uno,Wahoo Kickr Bike,412,407,5
68026,1604516709,wahoo,Zwift - DBR HEINO CUP III (A),Assioma Uno,Wahoo Kickr Bike,384,388,-4
68487,1604665200,wahoo,Zwift - Peak-PTY Climb Challenge Fridays (A),Assioma Uno,Wahoo Kickr Bike,403,408,-5
68896,1604741427,wahoo,Zwift - DBR Saturday Race (A),Assioma Uno,Wahoo Kickr Bike,416,416,0
69261,1604916001,wahoo,Zwift - ZA Road 2020 - Segment Ride #1: Three Sisters Course,Assioma Uno,Wahoo Kickr Bike,369,373,-4
69749,1605032070,wahoo,Zwift - Zwift Racing League | WTRL - EMEA E1 (MEN) -  Division 1 (A),Assioma Uno,Wahoo Kickr Bike,425,431,-6
70328,1605121488,wahoo,Zwift - DBR HEINO CUP III (A),Assioma Uno,Wahoo Kickr Bike,344,358,-14
71033,1605263120,wahoo,Zwift - DIRT Friday Morning Sprintapalooza (C),Assioma Uno,Wahoo Kickr Bike,234,244,-10
72223,1605636849,wahoo,Zwift - Zwift Racing League | WTRL - Men&#039;s EMEA E1 DIVISION 1 (A),Assioma Uno,Wahoo Kickr Bike,376,379,-3
72652,1605725855,wahoo,Zwift - DCU – Feltet.dk November series (A),Assioma Uno,Wahoo Kickr Bike,382,389,-7
74317,1606044612,wahoo,Zwift - MGCC Pretzel (B),Assioma Uno,Wahoo Kickr Bike,375,387,-12
75021,1606241645,wahoo,Zwift - Zwift Racing League | WTRL - Men&#039;s EMEA E1 DIVISION 1,Assioma Uno,Wahoo Kickr Bike,396,396,0
77612,1606555816,wahoo,Zwift - DBR Saturday Race (A),Assioma Uno,Wahoo Kickr Bike,406,417,-11
77939,1606760098,wahoo,Zwift -  DBR Monday Race (A),Assioma Uno,Wahoo Kickr Bike,380,388,-8
78053,1606846907,wahoo,Zwift - Zwift Racing League | WTRL - Men&#039;s EMEA E1 DIVISION 1 (A),Assioma Uno,Wahoo Kickr Bike,363,370,-7
79045,1607020201,wahoo,Zwift - FUSION DECEMBER CUP (A),Assioma Uno,Wahoo Kickr Bike,374,386,-12
80531,1607151629,wahoo,Zwift - 3R Mountain Madness Steady Ride [~3.0w/kg avg] (B),Assioma Uno,Wahoo Kickr Bike,360,368,-8
80678,1607417076,wahoo,Zwift - WTRL Racing (A),Assioma Uno,Wahoo Kickr Bike,352,361,-9
81884,1607681126,wahoo,Zwift - 3R Innsbruckring Flat Race - 4 Laps (35.2km/21.9mi 308m) (A),Assioma Uno,Wahoo Kickr Bike,393,391,2
82326,1607760325,wahoo,Zwift - 3R Weekend Race Club - Race 1 (A),Assioma Uno,Wahoo Kickr Bike,377,380,-3
82703,1607847627,wahoo,Zwift - Team Italy & Frenchy Fuzion Endurance Race (A),Assioma Uno,Wahoo Kickr Bike,408,407,1
83528,1608056108,wahoo,Zwift - Zwift Racing League | WTRL - Men&#039;s EMEA E1 DIVISION 1 (A),Assioma Uno,Wahoo Kickr Bike,355,358,-3
84420,1608229815,wahoo,Zwift - FUSION DECEMBER CUP (A),Assioma Uno,Wahoo Kickr Bike,394,394,0
86816,1608798531,wahoo,Zwift - KISS Race Series - Down Under (A),Assioma Uno,Wahoo Kickr Core,407,409,-2
87171,1608904199,wahoo,Zwift - KISS Race Series - Pacific AM (A),Assioma Uno,Wahoo Kickr Core,430,428,2
88094,1609146917,wahoo,Zwift - 3R Watopia Flat Route Race - 4 Laps (41km/25.5mi 216m) (A),Assioma Uno,Wahoo Kickr Core,316,322,-6
89298,1609350981,wahoo,Zwift - MIDWEEK Winter Series by SZR (A),Assioma Uno,Wahoo Kickr Core,389,383,6
89299,1609355058,wahoo,Zwift - DBR Wednesday Race (A),Assioma Uno,Wahoo Kickr Core,392,391,1
89758,1609503615,wahoo,Peak-PTY Climb Challenge Fridays,Assioma Uno,Wahoo Kickr Core,396,399,-3
90108,1609579830,wahoo,Zwift - DBR SufferDay League III (A),Assioma Uno,Wahoo Kickr Core,414,426,-12
90759,1609664713,wahoo,Zwift - Newbury Velo Road Race (A),Assioma Uno,Wahoo Kickr Core,382,387,-5
91595,1609844423,wahoo,Zwift - KISS Race Series - Americas AM (A),Assioma Uno,Wahoo Kickr Core,427,428,-1
92160,1609927194,wahoo,Zwift - EVR Definitely Not the WTNC (A),Assioma Uno,Wahoo Kickr Core,397,395,2
92953,1610044213,wahoo,Zwift - FUSION WINTER CUP (A),Assioma Uno,Wahoo Kickr Core,368,365,3
93659,1610177746,wahoo,Zwift - 40/20&#039;s,Assioma Uno,Wahoo Kickr Core,363,359,4
95596,1610475262,wahoo,Zwift - Zwift Racing League | WTRL - Men&#039;s/Mixed EMEA E1 DIVISION 1 (A),Assioma Uno,Wahoo Kickr Core,378,382,-4
96766,1610621999,wahoo,Zwift - KISS Race Series - Americas AM (A),Assioma Uno,Wahoo Kickr Core,329,329,0
98347,1610785771,wahoo,Zwift - TEAM VEGAN Tofu Tornado XL (A),Assioma Uno,Wahoo Kickr Core,408,411,-3
99651,1611080619,wahoo,Zwift Racing League | WTRL - Mens/Mixed EMEA E1 DIVISION 1,Assioma Uno,Wahoo Kickr Core,371,372,-1
101346,1611320568,wahoo,Zwift Fast Fridays: Tempus Fugit Time Trial,Assioma Uno,Wahoo Kickr Core,408,402,6
102483,1611497725,wahoo,Zwift - KISS 100 Race Series - Americas (A),Assioma Uno,Wahoo Kickr Core,367,368,-1
103614,1611684903,wahoo,Zwift - Zwift Racing League | WTRL - Men&#039;s/Mixed EMEA E1 DIVISION 1 (A),Assioma Uno,Wahoo Kickr Core,386,387,-1
104086,1611744301,wahoo,Zwift - The Morning Grind by STPC (A),Assioma Uno,Wahoo Kickr Core,380,387,-7
104485,1611831598,wahoo,KISS Race Series - Americas AM,Assioma Uno,Wahoo Kickr Core,360,358,2
105480,1611998991,wahoo,Zwift - DBR SufferDay League III (A),Assioma Uno,Wahoo Kickr Core,385,395,-10
110044,1612614720,wahoo,Zwift - Zwift Fondo Series: Bambino Fondo,Assioma Uno,Wahoo Kickr Core,411,417,-6
110787,1612692020,wahoo,Zwift - DBR Sunday Race (A),Assioma Uno,Wahoo Kickr Core,388,402,-14
111542,1612895062,wahoo,Zwift - Zwift Racing League | WTRL - Men&#039;s/Mixed EMEA E1 DIVISION 1 (A),Assioma Uno,Wahoo Kickr Core,411,416,-5
112300,1612982714,wahoo,Zwift - Danmarks Cykle Union & Partners 5/6 (A),Assioma Uno,Wahoo Kickr v5,415,408,7
113874,1613208584,wahoo,Zwift - DBR SufferDay League III (A),Assioma Uno,Wahoo Kickr v5,407,411,-4
115644,1613473226,wahoo,KISS Race Series - Americas AM,Assioma Uno,Wahoo Kickr v5,424,422,2
116658,1613587472,wahoo,Danmarks Cykle Union & Partners 6/6,Assioma Uno,Wahoo Kickr v5,365,365,0
117072,1613645889,wahoo,Zwift - KISS Race Series - Americas AM (A),Assioma Uno,Wahoo Kickr v5,422,421,1
118306,1613829595,wahoo,Zwift - XRS Races: Saturday Climbing Series (A),Assioma Uno,Wahoo Kickr v5,398,396,2
119068,1614017701,wahoo,DBR Monday Race,Assioma Uno,Wahoo Kickr v5,415,411,4
120341,1614192190,wahoo,Zwift - Scandinavian Cup 2021 - Round 1 - Men (A),Assioma Uno,Wahoo Kickr v5,350,351,-1
121438,1614416755,wahoo,Zwift - 3R Endurance Series p/b OTE Sports (A),Assioma Uno,Wahoo Kickr v5,337,338,-1
121961,1614495617,wahoo,Zwift - 02/28/2021,Assioma Uno,Wahoo Kickr v5,367,364,3
122941,1614709061,wahoo,Zwift - Zwift Racing League | WTRL - Men&#039;s/Mixed EMEA E1 DIVISION 1 (A),Assioma Uno,Wahoo Kickr v5,383,383,0
123598,1614796978,wahoo,Zwift - Scandinavian Cup 2021 - Round 2 - Men (A),Assioma Uno,Wahoo Kickr v5,389,390,-1
125327,1615111195,wahoo,Zwift - DBR Sunday Race (A),Assioma Uno,Wahoo Kickr v5,397,401,-4
126023,1615287583,wahoo,Zwift - KISS Race Series - Americas AM (A),Assioma Uno,Wahoo Kickr v5,359,359,0
126640,1615401847,wahoo,Zwift - Scandinavian Cup 2021 - Round 3 - Men (A),Assioma Uno,Wahoo Kickr v5,374,373,1
127915,1615639436,wahoo,Zwift - WTRL Racing (A),Assioma Uno,Wahoo Kickr v5,403,403,0
128481,1615727119,wahoo,Zwift - 3R Watopia Flat Route Race - 4 Laps (40.5km/25.1mi 216m) (A),Assioma Uno,Wahoo Kickr v5,416,417,-1
129157,1615919250,wahoo,Zwift - CeramicSpeed Race Series: Open Race (A),Assioma Uno,Wahoo Kickr v5,384,394,-10
81065,1607525081,neo,Zwift - Men&#039;s Elite // 2020 UCI Cycling Esports World Championships,4iiii Precision Dual Sided,Neo 2T,387,385,2
89025,1609091997,neo,Zwift - Alex TenElshof [Finesse]&#039;s Meetup - Three Sisters,4iiii Precision Dual Sided,Neo 2T,414,410,4
95059,1610392438,neo,Zwift - Premier Division // Zwift Racing League (men) (A),4iiii Precision Dual Sided,Neo 2T,399,394,5
99204,1610999521,neo,Zwift - Premier Division // Zwift Racing League (men) (A),4iiii Precision Dual Sided,Neo 2T,373,368,5
102894,1611601489,neo,Zwift - Premier Division // Zwift Racing League (men) (A),4iiii Precision Dual Sided,Neo 2T,371,366,5
102898,1611601489,neo,Zwift - Premier Division // Zwift Racing League (men) (A),Dual Sided 4iiii Precision ,Neo 2T,371,366,5
110993,1612811979,neo,Zwift - Premier Division // Zwift Racing League (men) (A),4iiii Precision Dual Sided,Neo 2T,371,366,5
115355,1613419269,neo,Zwift - Premier Division // Zwift Racing League (men) (A),4iiii Precision Dual Sided,Neo 2T,377,375,2
119085,1614020936,neo,Zwift - Premier Division // Zwift Racing League (men) (A),4iiii Precision Dual Sided,Neo 2T,347,343,4
122556,1614629696,neo,Zwift - Premier Division // Zwift Racing League (men) (A),4iiii Precision Dual Sided,Neo 2T,367,364,3
48432,1596202489,wahoo,Zwift - Crit City Race (A),Stages LR,Wahoo Kickr,345,346,-1
88349,1609183136,wahoo,Zwift - Team TFC Mad Monday Winter Series (A),Garmin vector 3,Wahoo Kickr Core,379,403,-24
88833,1609288186,wahoo,Zwift - Toronto Hustle Holiday Classic Stage Race: Stage Three (A),Garmin Vector 3 (2019),Wahoo Kickr Core (2019),417,433,-16
91220,1609593623,wahoo,Zwift - 3R Innsbruckring Flat Race - 5 Laps (44km/27.3mi 385m) (A),Garmin Vector 3 (2019),Wahoo Kickr Core (2019),390,410,-20
91222,1609715096,wahoo,Zwift - 3R Achterbahn Climbing Race (47.4km/29.5mi 988m) (A),Garmin Vector 3 (2019),Wahoo Kickr Core (2019),427,441,-14
96029,1610498692,wahoo,Zwift - Zwift Racing League | WTRL - Men&#039;s/Mixed AMERICAS E DIVISION 1 (A),Garmin Vector 3 (2019),Wahoo Kickr Core (2019),432,428,4
128869,1615651500,wahoo,Zwift - 3R Endurance Series p/b OTE Sports (E),Garmin Vector 3 (2019),Wahoo Kickr Core (2019),425,429,-4
128870,1615731310,wahoo,Zwift - KISS 100 Race Series (Americas) (A),Garmin Vector 3 (2019),Wahoo Kickr Core (2019),379,367,12
116415,1613558698,wahoo,Zwift - The Morning Grind by STPC (A),Stages L,Wahoo Kickr,398,410,-12
116472,1613558698,wahoo,Zwift - The Morning Grind by STPC (A),Stages L,Wahoo Kickr,398,410,-12
117641,1613729098,wahoo,Zwift - 3R Innsbruckring Flat Race - 4 Laps (35.2km/21.9mi 308m) (A),Stages L,Wahoo Kickr,412,415,-3
122162,1614536098,wahoo,Zwift - 3R Watopia Hilly Reverse Race - 4 Laps (36.7km/22.8mi 400m) (A),Giant Power Pro Ultegra 2021,Wahoo Kickr,347,335,12
125041,1615043716,wahoo,Zwift - OH MY CRIT!! - Saturday Smash Race (A),Giant Power Pro Ultegra 2021,Wahoo Kickr,388,381,7
126974,1615479299,wahoo,Zwift - OH MY CRIT!! - The Double Race 1/2 (A),Giant Power Pro Ultegra 2021,Wahoo Kickr,383,377,6
52232,1598549055,neo,SRM / Tacx Neo ,SRM,Tacx Neo ,409,414,-5
52491,1598690972,neo,Tacx Neo  / SRM,SRM,Tacx Neo ,300,303,-3
52885,1598966091,neo,Tacx Neo  / SRM,SRM,Tacx Neo ,421,418,3
53626,1599382801,neo,Tacx Neo  / SRM,SRM,Tacx Neo ,391,405,-14
55066,1600106391,neo,Tacx Neo  / SRM,SRM,Tacx Neo ,418,409,9
56070,1600367397,neo,Tacx Neo  / SRM,SRM,Tacx Neo ,387,392,-5
56457,1600606814,neo,Tacx Neo  / SRM,SRM,Tacx Neo ,396,408,-12
57288,1600970637,neo,Zwift - Espresso,SRM,Tacx Neo ,396,400,-4
57633,1601109000,neo,Zwift - DBR SufferDay League II (A),SRM,Tacx Neo ,410,417,-7
58827,1601573174,neo,Zwift - Espresso,SRM,Tacx Neo ,392,394,-2
59172,1601713794,neo,Zwift - DBR SufferDay League II (A),SRM,Tacx Neo ,410,417,-7
60254,1602151185,neo,Zwift - KISS at Race - Americas AM (A),SRM,Tacx Neo ,426,425,1
61515,1602609275,neo,Zwift - Zwift Racing League | WTRL,SRM,Tacx Neo ,413,412,1
62652,1602936382,neo,Zwift - The BMTR Fundo (A),SRM,Tacx Neo ,372,373,-1
63395,1603214336,neo,Zwift - Zwift Racing League | WTRL - EMEA E (MEN) - TTT Grp 1,SRM,Tacx Neo ,0,0,0
63401,1603214336,neo,Zwift Racing League | WTRL - EMEA E (MEN) - TTT Grp 1,SRM,Tacx Neo ,400,402,-2
64377,1603458121,neo,Zwift - Zwift Fast Fridays: Tempus Fugit Time Trial (E),SRM,Tacx Neo ,432,434,-2
64654,1603541331,neo,The BMTR Fundo,SRM,Tacx Neo ,371,368,3
65430,1603822432,neo,Zwift Racing League | WTRL - Mens EMEA E1 DIVISION 1,SRM,Tacx Neo ,426,427,-1
66693,1604146171,neo,Zwift - The BMTR Fundo (A),SRM,Tacx Neo ,374,370,4
66900,1604224784,neo,Zwift - Climbers Day p/b dPAC.fit & Precision Hydration (A),SRM,Tacx Neo ,382,390,-8
67580,1604428459,neo,Zwift - Zwift Racing League | WTRL - Men&#039;s EMEA E1 DIVISION 1 (A),SRM,Tacx Neo ,390,394,-4
68987,1604825958,neo,Zwift - Zwift Fondo Series 2020/21: Gran Fondo ,SRM,Tacx Neo ,397,400,-3
69752,1605032065,neo,Zwift - Zwift Racing League | WTRL - EMEA E1 (MEN) -  Division 1 (A),SRM,Tacx Neo ,427,438,-11
70633,1605195570,neo,Zwift - ZA Tri: TT Race - 40k,SRM,Tacx Neo ,452,453,-1
73092,1605812051,neo,Zwift - Espresso,SRM,Tacx Neo ,399,401,-2
73832,1605959930,neo,Zwift - WKG Winter League 2020 / 2021  (A),SRM,Tacx Neo ,393,397,-4
75025,1606241630,neo,Zwift - Zwift Racing League | WTRL - Men&#039;s EMEA E1 DIVISION 1,SRM,Tacx Neo ,423,423,0
76039,1606416745,neo,Zwift - WTRL NOPINZ WORLD TTT CHAMPIONSHIPS - Zone 7 (C),SRM,Tacx Neo ,402,404,-2
78040,1606847005,neo,Zwift - Zwift Racing League | WTRL - Men&#039;s EMEA E1 DIVISION 1 (A),SRM,Tacx Neo ,396,394,2
79435,1607101293,neo,Zwift - Zwift Fast Fridays: Bologna Time Trial (E),SRM,Tacx Neo ,392,401,-9
79779,1607176746,neo,Zwift - XRS Races: Saturday Climbing Series (A),SRM,Tacx Neo ,422,429,-7
80767,1607451236,neo,Zwift - Zwift Racing League | WTRL - Men&#039;s EMEA E1 DIVISION 1 (A),SRM,Tacx Neo ,412,408,4
81472,1607602789,neo,Zwift - British Cycling Time Trial Series (A),Fahrt_am_Nachmittag(10),Tacx Neo Smart 2,415,406,9
81473,1607605468,neo,Zwift - 3R Knickerbocker Climbing Race - 1 Lap (22.4km/13.9mi 365m) (A),SRM,Tacx Neo Smart 2,409,400,9
82380,1607781556,neo,Zwift - XRS Races: Saturday Climbing Series (A),SRM,Tacx Neo Smart 2,409,400,9
83522,1608056610,neo,Zwift - Zwift Racing League | WTRL - Men&#039;s EMEA E1 DIVISION 1 (A),SRM,Tacx Neo Smart 2,398,389,9
85439,1608469775,neo,The BMTR Fundo,SRM,Tacx Neo Smart 2,382,374,8
87174,1608904177,neo,Zwift - KISS Race Series - Pacific AM (A),SRM,Tacx Neo Smart 2,441,433,8
90574,1609661991,neo,Zwift - Team Italy & Frenchy Fuzion Endurance Race (A),SRM,Tacx Neo Smart 2,413,406,7
92850,1610043561,neo,Zwift - Vienna,SRM,Tacx Neo Smart 2,408,392,16
93856,1610193583,neo,Zwift - WKG Winter League 2020 / 2021  (A),SRM,Tacx Neo Smart 2,404,397,7
96949,1610648303,neo,Zwift - Vienna,SRM,Tacx Neo Smart 2,427,417,10
98398,1610875764,neo,Zwift -  SloZl - Slovenian Zwift League - Weekly Race  (A),SRM,Tacx Neo Smart 2,416,408,8
99696,1611080574,neo,Zwift - Zwift Racing League | WTRL - Men&#039;s/Mixed EMEA E1 DIVISION 1 (A),SRM,Tacx Neo Smart 2,411,401,10
100911,1611253424,neo,Zwift - Vienna,SRM,Tacx Neo Smart 2,400,392,8
102219,1611478800,neo,Zwift - Pushing Limits TT-Race,SRM,Tacx Neo Smart 2,410,401,9
104655,1611858178,neo,Zwift - Vienna,SRM,Tacx Neo Smart 2,411,404,7
106268,1612102487,neo,Zwift - KISS 100 Race Series - Americas (A),SRM,Tacx Neo Smart 2,441,435,6
108855,1612462966,neo,Zwift - Vienna,SRM,Tacx Neo Smart 2,406,400,6
109794,1612603782,neo,Zwift - DBR SufferDay League III (A),SRM,Tacx Neo Smart 2,408,400,8
109796,1612603782,neo,Zwift - DBR SufferDay League III (A),SRM,Tacx Neo Smart 2,408,400,8
112950,1613067752,neo,Zwift - Vienna,SRM,Tacx Neo Smart 2,406,396,10
115802,1613499292,neo,Zwift - Zwift Racing League | WTRL - Men&#039;s/Mixed EMEA E1 DIVISION 1 (A),SRM,Tacx Neo Smart 2,449,442,7
125340,1615111193,neo,Zwift - Climbers Day p/b dPAC.fit & Precision Hydration (A),SRM,Tacx Neo Smart 2,398,393,5
127075,1615486783,neo,Zwift - Vienna,SRM,Tacx Neo Smart 2,408,399,9
95290,1610411892,wahoo,kickr core & pioneer,Pioneer,wahoo kickr core,185,191,-6
95389,1610440993,wahoo,ZRL APAC D2-1,Pioneer,wahoo kickr core,319,325,-6
96755,1610617589,wahoo,jzhr,Pioneer,wahoo kickr core,305,314,-9
99452,1611042838,wahoo,ZRL APAC DIV2-1,Pioneer,wahoo kickr core,342,347,-5
99978,1611101458,wahoo,2021/01/20,Pioneer,wahoo kickr core,282,289,-7
100571,1611190782,wahoo,canada,Pioneer,wahoo kickr core,310,314,-4
100597,1611196924,wahoo,tdz,Pioneer,wahoo kickr core,289,295,-6
107764,1612311070,wahoo,Midweek Crit,Pioneer,wahoo kickr core,309,312,-3
107766,1612315528,wahoo,Mayhem Racing,Pioneer,wahoo kickr core,299,305,-6
108527,1612396501,wahoo,Movistar Team Challenge,Pioneer,wahoo kickr core,327,336,-9
110200,1612649398,wahoo,Zwift Fondo A,XCADEY XPOWER-S,wahoo kickr core,291,291,0
111259,1612825333,wahoo,3r race,XCADEY XPOWER-S,wahoo kickr core,323,321,2
111958,1612927999,wahoo,tdz,XCADEY XPOWER-S,wahoo kickr core,272,273,-1
111959,1612927999,wahoo,tdz,XCADEY XPOWER-S,wahoo kickr core,293,294,-1
115614,1613464817,wahoo,zrl,XCADEY XPOWER-S,wahoo kickr core,336,340,-4
116935,1613603905,wahoo,tdz,XCADEY XPOWER-S,wahoo kickr core,309,311,-2
116936,1613608710,wahoo,cycling canada,XCADEY XPOWER-S,wahoo kickr core,295,296,-1
119381,1614069625,wahoo,zrl,XCADEY XPOWER-S,wahoo kickr core,278,282,-4
120522,1614211049,wahoo,evr,XCADEY XPOWER-S,wahoo kickr core,283,278,5
120523,1614214867,wahoo,cycling canada,XCADEY XPOWER-S,wahoo kickr core,308,307,1
122775,1614674872,wahoo,Zwift - 03/02/2021,XCADEY XPOWER-S,wahoo kickr core,318,318,0
12154,1580659179,neo,Zwift - Tour de Zwift: Stage 6 Group Ride - Long Distance,Rotor InPower,Tacx Neo ,345,346,-1
12732,1581003817,neo,Zwift - Crit City Race (A),Rotor InPower,Tacx Neo ,335,321,14
14740,1582139092,neo,Zwift - DBR Winter Cup (A),Rotor InPower,Tacx Neo ,343,324,19
19665,1585163068,neo,Zwift - DBR Wednesday Race (A),Rotor InPower,Tacx Neo ,344,334,10
26170,1587208135,neo,Zwift - USA Cycling&#039;s Dadurday Chase Race by DIRT (A),Rotor InPower,Tacx Neo ,349,338,11
39867,1591385608,neo,Zwift - 3R Watopia Hilly Race - 3 Laps (27km/16.8mi 300m) (A),Rotor InPower,Tacx Neo ,318,311,7
40600,1591726190,neo,Zwift - UNO X CUP powered by DCU & Feltet.dk (A),Rotor InPower,Tacx Neo ,372,349,23
45330,1594147156,neo,Zwift - 3R NYC Gotham Grind - 4 Laps (A),Rotor InPower,Tacx Neo ,342,317,25
98533,1610892215,neo,Zwift - TDZ Stage 3: Shorter Ride,Rotor InPower,Tacx Neo ,357,334,23
95091,1610392510,wahoo,ZRL Season 2 Race 1,Specialized Power Cranks,Wahoo Kickr Core,0,0,0
96653,1610584622,wahoo,Zwift - TDZ Stage 2: Longer Ride,Specialized Power Cranks,Wahoo Kickr Core,327,323,4
99234,1610998557,wahoo,Zwift - Premier Division // Zwift Racing League (men) (A),Specialized Power Cranks,Wahoo Kickr Core,364,352,12
100832,1611189081,wahoo,Zwift - Cycling Canada Wednesday Night Race Series (A),Specialized Power Cranks,Wahoo Kickr Core,353,349,4
102965,1611599964,wahoo,Zwift - Premier Division // Zwift Racing League (men) (A),Specialized Power Cranks,Wahoo Kickr Core,361,357,4
104928,1611879962,wahoo,Zwift - WTRL Team Time Trial - Zone 10 (C),Specialized Power Cranks,Wahoo Kickr Core,351,351,0
106965,1612208652,wahoo,Zwift - Premier Division // Zwift Racing League (men) (A),Specialized Power Cranks,Wahoo Kickr Core,370,356,14
111068,1612808912,wahoo,Zwift - Premier Division // Zwift Racing League (men) (A),Specialized Power Cranks,Wahoo Kickr Core,377,373,4
111070,1612808912,wahoo,Zwift - Premier Division // Zwift Racing League (men) (A),Specialized Power Cranks,Wahoo Kickr Core,377,373,4
112431,1612981111,wahoo,Zwift - Movistar Team Challenge // Round 1 (A),Specialized Power Cranks,Wahoo Kickr Core,371,349,22
113620,1613154574,wahoo,Zwift - Movistar Team Challenge // Round 1 (men),Specialized Power Cranks,Wahoo Kickr Core,389,383,6
115440,1613417431,wahoo,Zwift - Premier Division // Zwift Racing League (men) (A),Specialized Power Cranks,Wahoo Kickr Core,378,372,6
116780,1613586878,wahoo,Zwift - Movistar Team Challenge // Round 2 (men) - Race 3/4,Specialized Power Cranks,Wahoo Kickr Core,340,344,-4
117922,1613759146,wahoo,Zwift - Movistar Team Challenge // Round 2 (men),Specialized Power Cranks,Wahoo Kickr Core,393,389,4
117923,1613759146,wahoo,Zwift - Movistar Team Challenge // Round 2 (men),Specialized Power Cranks,Wahoo Kickr Core,393,389,4
119220,1614019689,wahoo,Zwift - Premier Division // Zwift Racing League (men) (A),Specialized Power Cranks,Wahoo Kickr Core,364,361,3
122619,1614628034,wahoo,Zwift - Premier Division // Zwift Racing League (men) (A),Specialized Power Cranks,Wahoo Kickr Core,363,357,6
99395,1610795594,wahoo,Zwift - 3R Tick Tock Flat Race - 2 Lap (36km/22.4mi 100m) (A),Quarq Dzero,Wahoo Kickr,389,403,-14
100172,1611104009,wahoo,Zwift - Zwift Racing League | WTRL - Men&#039;s/Mixed AMERICAS E DIVISION 1 (A),Quarq Dzero,Wahoo Kickr,413,425,-12
104361,1611708347,wahoo,Zwift - Zwift Racing League | WTRL - Men&#039;s/Mixed AMERICAS E DIVISION 1 (A),Quarq Dzero,Wahoo Kickr,442,450,-8
88866,1609232068,neo,Zwift - Watopia zada,power2max NGeco,T2800 Neo,387,394,-7
99206,1610999625,neo,Zwift - Premier Division // Zwift Racing League (men) (A),power2max NGeco,T2800 Neo,367,377,-10
102913,1611601493,neo,Zwift - Premier Division // Zwift Racing League (men) (A),power2max NGeco,T2800 Neo,379,387,-8
111051,1612812086,neo,Zwift - Premier Division // Zwift Racing League (men) (A),power2max NGeco,T2800 Neo,397,403,-6
115338,1613419314,neo,Zwift - Premier Division // Zwift Racing League (men) (A),power2max NGeco,T2800 Neo,390,405,-15
119099,1614020997,neo,Zwift - Premier Division // Zwift Racing League (men) (A),power2max NGeco,T2800 Neo,372,373,-1
122594,1614629840,neo,Zwift - Premier Division // Zwift Racing League (men) (A),power2max NGeco,T2800 Neo,367,379,-12
86505,1608738060,wahoo,Zwift - ZA Tri: TT Race - 20k,Favero Assioma Duo,Wahoo Kickr,423,423,0
96277,1610498759,wahoo,Zwift - Zwift Racing League | WTRL - Men&#039;s/Mixed AMERICAS E DIVISION 2 (A),Favero Assioma Duo,Wahoo Kickr,429,437,-8
96283,1610066817,wahoo,Zwift - WTRL Team Time Trial - Zone 10 (C),Favero Assioma Duo,Wahoo Kickr,417,420,-3
107786,1612313192,wahoo,Zwift - Zwift Racing League | WTRL - Men&#039;s/Mixed AMERICAS E DIVISION 2 (A),Favero Assioma Duo,Wahoo Kickr,434,441,-7
109307,1612486204,wahoo,Zwift - WTRL Team Time Trial - Zone 10 (C),Favero Assioma Duo,Wahoo Kickr,404,406,-2
109311,1612378741,wahoo,Zwift - Open - Movistar Team Challenge Community Qualifier Race #1- too many people,Favero Assioma Duo,Wahoo Kickr,428,424,4
115777,1612918523,wahoo,Zwift - Zwift Racing League | WTRL - Men&#039;s/Mixed AMERICAS E DIVISION 2 (A),Favero Assioma Duo,Wahoo Kickr,426,421,5
115779,1613067345,wahoo,Zwift - Espresso,Favero Assioma Duo,Wahoo Kickr,425,422,3
123299,1614732545,wahoo,Zwift - London,Favero Assioma Duo,Wahoo Kickr,433,429,4
123304,1614127440,wahoo,Wahoo Kickr / Favero Assioma Duo,Favero Assioma Duo,Wahoo Kickr,360,363,-3
82944,1607839062,wahoo,Zwift - KISS 100 Race Series - EU (A),Garmin Vector Dual Sided Pedals,Wahoo Kikr 2019,374,371,3
83651,1608062026,wahoo,Zwift - Zwift Racing League | WTRL - Men&#039;s EMEA W1 DIVISION 2 (A),Garmin Vector Dual Sided Pedals,Wahoo Kikr 2019,360,359,1
85307,1608443864,wahoo,Zwift - KISS 100 Race Series - EU (A),Garmin Vector Dual Sided Pedals,Wahoo Kikr 2019,318,316,2
85652,1608530229,wahoo,Zwift - Tour of New York Stage 3,Garmin Vector Dual Sided Pedals,Wahoo Kikr 2019,345,344,1
85976,1608617827,wahoo,Zwift - 3R Watopia Flat Route Race - 3 Laps (30.3km/18.8mi 162m) (A),Garmin Vector Dual Sided Pedals,Wahoo Kikr 2019,352,347,5
86347,1608704493,wahoo,Zwift - British Cycling Crit City Series (A),Garmin Vector Dual Sided Pedals,Wahoo Kikr 2019,384,378,6
87312,1608964174,wahoo,Zwift - XRS Races - The Saturday Classic (A),Garmin Vector Dual Sided Pedals,Wahoo Kikr 2019,377,376,1
87693,1609048827,wahoo,Zwift - KISS 100 Race Series - EU (A),Garmin Vector Dual Sided Pedals,Wahoo Kikr 2019,376,381,-5
88419,1609221497,wahoo,Zwift -  Kiwi Crew Riot Race (A),Garmin Vector Dual Sided Pedals,Wahoo Kikr 2019,352,353,-1
88878,1609309675,wahoo,Zwift - British Cycling Crit City Series (A),Garmin Vector Dual Sided Pedals,Wahoo Kikr 2019,403,400,3
88879,1609311873,wahoo,Zwift - Aussie Crit Crushers Race 1 of 2 (A),Garmin Vector Dual Sided Pedals,Wahoo Kikr 2019,366,365,1
90567,1609653560,wahoo,Zwift - KISS 100 Race Series - EU (A) - 200k special,Garmin Vector Dual Sided Pedals,Wahoo Kikr 2019,342,347,-5
94224,1610257960,wahoo,Zwift - KISS 100 Race Series - EU (A),Garmin Vector Dual Sided Pedals,Wahoo Kikr 2019,405,399,6
95817,1610480626,wahoo,Zwift - Zwift Racing League | WTRL - Men&#039;s/Mixed EMEA W1 DIVISION 1 (A),Garmin Vector Dual Sided Pedals,Wahoo Kikr 2019,366,375,-9
99879,1611085901,wahoo,Zwift - Zwift Racing League | WTRL - Men&#039;s/Mixed EMEA W1 DIVISION 1 (A),Garmin Vector Dual Sided Pedals,Wahoo Kikr 2019,367,354,13
102174,1611467760,wahoo,Zwift - KISS 100 Race Series - EU (A),Garmin Vector Dual Sided Pedals,Wahoo Kikr 2019,355,352,3
103648,1611688626,wahoo,Zwift - Zwift Racing League | WTRL - Men&#039;s/Mixed EMEA W1 DIVISION 1 (A),Garmin Vector Dual Sided Pedals,Wahoo Kikr 2019,378,372,6
107545,1612295087,wahoo,Zwift - Zwift Racing League | WTRL - Men&#039;s/Mixed EMEA W1 DIVISION 1 (A),Garmin Vector Dual Sided Pedals,Wahoo Kikr 2019,377,369,8
114505,1613282188,wahoo,Zwift - KISS 100 Race Series - EU (A),Garmin Vector Dual Sided Pedals,Wahoo Kikr 2019,360,355,5
116078,1613504693,wahoo,Zwift - Zwift Racing League | WTRL - Men&#039;s/Mixed EMEA W1 DIVISION 1 (A),Garmin Vector Dual Sided Pedals,Wahoo Kikr 2019,407,403,4
121376,1614405673,wahoo,Zwift - 3R Road To Ruins Hilly Race - 1 Lap (29..2km/18.1mi 275m) (A),Garmin Vector Dual Sided Pedals,Wahoo Kikr 2019,402,402,0
123086,1614714628,wahoo,Zwift - Zwift Racing League | WTRL - Men&#039;s/Mixed EMEA W1 DIVISION 1 (A),Garmin Vector Dual Sided Pedals,Wahoo Kikr 2019,384,380,4
58415,1601449884,wahoo,ZADA- Three Sisters,SRM PM6,Wahoo KICKR v5,364,359,5
60183,1601632201,wahoo,Zwift - KISS at Base Training Ride (B),SRM PM6,Wahoo KICKR v5,241,233,8
60226,1602145139,wahoo,Zwift - Cycling Australia&#039;s The Chop by AHDR (A),SRM PM6,Wahoo KICKR v5,349,343,6
61251,1602528615,wahoo,Zwift - Premier Division // Zwift Racing League (men) ,SRM PM6,Wahoo KICKR v5,354,342,12
62976,1603092660,wahoo,Zwift - Flanders Endurance Series (E),SRM PM6,Wahoo KICKR v5,246,235,11
63562,1603220031,wahoo,Zwift - AHDR Bacon Rolls with Caffeine  (B),SRM PM6,Wahoo KICKR v5,339,324,15
65160,1603742411,wahoo,Zwift - Premier Division // Zwift Racing League (men) (A),SRM PM6,Wahoo KICKR v5,366,356,10
67256,1604343737,wahoo,Zwift - 11/03/2020,SRM PM6,Wahoo KICKR v5,349,339,10
69415,1604951991,wahoo,Zwift - Premier Division // Zwift Racing League (men) (A),SRM PM6,Wahoo KICKR v5,388,377,11
74677,1606161599,wahoo,Zwift - Premier Division // Zwift Racing League (men) (A),SRM PM6,Wahoo KICKR v5,362,356,6
77689,1606763187,wahoo,Zwift - 12/01/2020,SRM PM6,Wahoo KICKR v5,333,326,7
81368,1607588400,wahoo,Zwift - The Chop by AHDR (A),SRM PM6,Wahoo KICKR v5,348,340,8
83180,1607973597,wahoo,Zwift - Team TFC Mad Monday Winter Series (A),SRM PM6,Wahoo KICKR v5,328,319,9
103226,1611650781,wahoo,Zwift - Zwift Racing League | WTRL - Men&#039;s/Mixed APAC DIVISION 2 (A),SRM PM6,Wahoo KICKR v5,348,342,6
107131,1612255556,wahoo,Zwift Racing League | WTRL - Men&#039;s/Mixed APAC DIVISION 2 (A),SRM PM6,Wahoo KICKR v5,342,327,15
108482,1612396792,wahoo,Zwift Academy Road: Workout 3 | VO2 Capacity,SRM PM6,Wahoo KICKR v5,358,353,5
117012,1613636357,wahoo,Zwift - The Chop by AHDR (A),SRM PM6,Wahoo KICKR v5,356,351,5
119379,1614069959,wahoo,Zwift - 02/23/2021,SRM PM6,Wahoo KICKR v5,295,288,7
120565,1614241138,wahoo,Zwift - 02/25/2021,SRM PM6,Wahoo KICKR v5,371,368,3
123831,1614845957,wahoo,Zwift - The Chop by AHDR (A),SRM PM6,Wahoo KICKR v5,345,343,2
126836,1615450760,wahoo,Zwift - The Chop by AHDR (A),SRM PM6,Wahoo KICKR v5,364,360,4
85447,1608480298,wahoo,3R Tick Tock Flat Race - 1 Lap (19km/11.8mi 50m),Favero Asioma,Wahoo KICKR,394,384,10
85690,1608547200,wahoo,"Zwift - ZWC Hill Climb Battle (A) Very, very bad legs. But it was just for dual recording ",Favero Assioma,Wahoo KICKR,402,395,7
61300,1602527469,wahoo,Zwift Racing League | WTRL - PREMIER DIVISION (MEN),SRAM Red Power to ELEMNT BOLT,wahoo KICKR to Zwift,453,450,3
63061,1603131236,wahoo,Zwift Racing League | WTRL - PREMIER DIVISION (MEN) - TTT,SRAM Red Power to ELEMNT BOLT,wahoo KICKR to Zwift,421,408,13
65202,1603742332,wahoo,Premier Division // Zwift Racing League (men),SRAM Red Power to ELEMNT BOLT,wahoo KICKR to Zwift,438,426,12
67257,1604344214,wahoo,Premier Division // Zwift Racing League (men),2020-11-02-191023-ELEMNT BOLT 423F-242-0,wahoo KICKR to Zwift,427,419,8
69418,1604952013,wahoo,Premier Division // Zwift Racing League (men),2020-11-09-202352-ELEMNT BOLT 423F-249-0,wahoo KICKR to Zwift,435,461,-26
71954,1605553607,wahoo,Zwift - Premier Division // Zwift Racing League (men) (A),SRAM Red Power to ELEMNT BOLT,wahoo KICKR to Zwift,434,418,16
72865,1605770344,wahoo,Zwift - Watopia,4iii to Wahoo ELEMNT BOLT,Wahoo KICKR to Zwift,438,456,-18
73731,1605940214,wahoo,Zwift - XRS Races - The Saturday Classic (A),4iii to Wahoo ELEMNT BOLT,wahoo KICKR to Zwift,411,424,-13
73732,1605936800,wahoo,Zwift - Yorkshire,4iii to Wahoo ELEMNT BOLT,wahoo KICKR to Zwift,324,325,-1
74712,1606161597,wahoo,Zwift - Premier Division // Zwift Racing League (men) (A),4iii to Wahoo ELEMNT BOLT,wahoo KICKR to Zwift,443,455,-12
77662,1606763453,wahoo,Zwift - 11/30/2020,4iii to Wahoo ELEMNT BOLT,wahoo KICKR to Zwift,409,400,9
83391,1608029996,wahoo,Zwift - KISS Race Series - Americas AM (A),4iii to Wahoo ELEMNT BOLT,wahoo KICKR to Zwift,439,427,12
86019,1608633748,wahoo,Zwift - SZR Lunch Race (A),4iii to Wahoo ELEMNT BOLT,wahoo KICKR to Zwift,419,421,-2
88108,1609146837,wahoo,Zwift - ZHR Zwift Handicap Race (A),4iii to Wahoo ELEMNT BOLT,wahoo KICKR to Zwift,408,410,-2
95378,1610441097,wahoo,Zwift - WTRL Racing (A),4iii to Wahoo ELEMNT BOLT,wahoo KICKR to Zwift,408,380,28
95398,1610174976,wahoo,Zwift - Watopia,4iii to Wahoo ELEMNT BOLT,wahoo KICKR to Zwift,291,272,19
95400,1610434326,wahoo,Zwift - Watopia,4iii to Wahoo ELEMNT BOLT,wahoo KICKR to Zwift,294,265,29
111002,1612811961,wahoo,Zwift - Premier Division // Zwift Racing League (men) (A),4iii to Wahoo ELEMNT BOLT,wahoo KICKR to Zwift,384,411,-27
32964,1589022532,wahoo,Zwift - DIRT Dadurday Chase Race  (A),garmin vector 3&#039;s dual side ,wahoo kickr core,342,346,-4
4261,1573751099,wahoo,Zwift - OH CRIT!! - (A) 7th fun times! got impatient and jumped eary,Quarq D Zero,Wahoo Kickr,376,379,-3
89626,1609444796,wahoo,Zwift - KISS Race Series - EU PM (A),Stages Left Crank,Wahoo Kickr Core,336,353,-17
89953,1609535101,wahoo,Zwift - 3R LaGuardia Loop Flat Race - 8 Laps (22.9km/14.2mi 216m) (A),Stages Left Crank,Wahoo Kickr Core,330,349,-19
89957,1609533253,wahoo,1.1.21.Test,Stages Left Crank,Wahoo Kickr Core,254,268,-14
89978,1609538700,wahoo,Zwift - 3R Volcano Flat 50k Race - 4 Laps (48.8km/30.7mi 184m) (A),Stages Left Crank,Wahoo Kickr Core,324,345,-21
90472,1609630200,wahoo,Zwift - TEAM VEGAN Tofu Tornado (A),Stages Left Crank,Wahoo Kickr Core,334,354,-20
93110,1610067601,wahoo,Zwift - KISS Race Series - Americas PM (A),Stages Left Crank,Wahoo Kickr Core,366,386,-20
94110,1610215499,wahoo,Zwift - 3R Three Sisters Hilly Race (47km/29.2mi 879m) (A),Stages Left Crank,Wahoo Kickr Core,334,361,-27
94555,1610301021,wahoo,Zwift - Stages of DIRT (E),Stages Left Crank,Wahoo Kickr Core,337,362,-25
96062,1610506799,wahoo,Zwift - Zwift Racing League | WTRL - Men&#039;s/Mixed AMERICAS W DIVISION 1 (A),Stages Left Crank,Wahoo Kickr Core,347,372,-25
98813,1610824799,wahoo,Zwift - BRT Criterium Training Race  (A),Stages Left Crank,Wahoo Kickr Core,314,328,-14
100016,1611112110,wahoo,Zwift - Zwift Racing League | WTRL - Men&#039;s/Mixed AMERICAS W DIVISION 1 (A),Stages Left Crank,Wahoo Kickr Core,325,353,-28
101199,1611278935,wahoo,Zwift - Cameron O&#039;Reilly (AVRT)&#039;s Meetup - 2018 UCI Worlds Short Lap,Stages Left Crank,Wahoo Kickr Core,324,344,-20
101944,1611420602,wahoo,Zwift - 3R Innsbruckring Flat Race - 3 Laps (26.4km/16.4mi 231m) (A),Stages Left Crank,Wahoo Kickr Core,325,345,-20
102024,1611428701,wahoo,Zwift - 3R Innsbruckring Sprint Race - 1 Lap (8.8km/5.5mi 77m) (A),Stages Left Crank,Wahoo Kickr Core,364,386,-22
103843,1611716402,wahoo,Zwift - Zwift Racing League | WTRL - Men&#039;s/Mixed AMERICAS W DIVISION 1 (A),Stages Left Crank,Wahoo Kickr Core,375,404,-29
104366,1611795901,wahoo,Zwift - Cycling Canada Wednesday Night Race Series (A),Stages Left Crank,Wahoo Kickr Core,343,366,-23
105800,1611972001,wahoo,Zwift - Into the Lion&#039;s Den (C),Stages Left Crank,Wahoo Kickr Core,337,356,-19
105810,1612029781,wahoo,Zwift - Championnat de France Frenchy Fuzion (E),Stages Left Crank,Wahoo Kickr Core,343,371,-28
107772,1612321201,wahoo,Zwift - Zwift Racing League | WTRL - Men&#039;s/Mixed AMERICAS W DIVISION 1 (A),Stages Left Crank,Wahoo Kickr Core,365,390,-25
108495,1612396802,wahoo,Zwift - Open - Movistar Team Challenge Community Qualifier Race #2,Stages Left Crank,Wahoo Kickr Core,346,361,-15
111918,1612926510,wahoo,Zwift - Zwift Racing League | WTRL - Men&#039;s/Mixed AMERICAS W DIVISION 1 (A),Stages Left Crank,Wahoo Kickr Core,339,364,-25
113211,1613091601,wahoo,Zwift - KISS Race Series - Americas PM (A),Stages Left Crank,Wahoo Kickr Core,360,377,-17
114335,1613239500,wahoo,Zwift - 3R Three Sisters Hilly Race (47km/29.2mi 879m) (A),Stages Left Crank,Wahoo Kickr Core,348,374,-26
114958,1613347201,wahoo,Zwift - TDZ Stage 1: Longer Ride,Stages Left Crank,Wahoo Kickr Core,373,389,-16
115238,1613414700,wahoo,Zwift - TDZ Stage 4: Longer Ride,Stages Left Crank,Wahoo Kickr Core,298,319,-21
115413,1613420100,wahoo,Zwift - TDZ Stage 2: Longer Ride,Stages Left Crank,Wahoo Kickr Core,327,358,-31
116260,1613530799,wahoo,Zwift - Zwift Racing League | WTRL - Men&#039;s/Mixed AMERICAS W DIVISION 1 (A),Stages Left Crank,Wahoo Kickr Core,369,367,2
116947,1613617200,wahoo,Zwift - TDZ Stage 5: Longer Ride,Stages Left Crank,Wahoo Kickr Core,391,389,2
117547,1613704500,wahoo,Zwift - TDZ Stage 6: Longer Ride,Stages Left Crank,Wahoo Kickr Core,0,0,0
117548,1613704500,wahoo,Zwift - TDZ Stage 6: Longer Ride,Stages Left Crank,Wahoo Kickr Core,319,342,-23
118013,1613783701,wahoo,Zwift - DIRT Friday Night Battle (A),Stages Left Crank,Wahoo Kickr Core,314,336,-22
118449,1613849399,wahoo,Zwift - 3R Endurance Series p/b OTE Sports- Stage 1 (E),Stages Left Crank,Wahoo Kickr Core,336,356,-20
120000,1614135600,wahoo,Zwift - Zwift Racing League | WTRL - Men&#039;s/Mixed AMERICAS W DIVISION 1 (A),Stages Left Crank,Wahoo Kickr Core,316,343,-27
123300,1614740733,wahoo,Zwift - Zwift Racing League | WTRL - Men&#039;s/Mixed AMERICAS W DIVISION 1 (A),Stages Left Crank,Wahoo Kickr Core,310,341,-31
124029,1614879923,wahoo,Zwift - RRM Munich Super Ride (C),Stages,Wahoo Kickr Power,356,363,-7
124607,1614971091,wahoo,Zwift - Zwift Racing League | WTRL Battle Royale Playoff - Men&#039;s Points Race (A),Stages,Wahoo Kickr Power,442,457,-15
125174,1615060021,wahoo,Zwift - Zwift Racing League | WTRL Battle Royale Playoff - Men&#039;s TTT (A),Stages,Wahoo Kickr Power,410,422,-12
65915,1603922004,wahoo,Zwift - 3R Endurance Steady Ride [~3.0/2.5w/kg avg] (B),Favero Assioma Duo,Wahoo Kickr Core,279,279,0
66112,1603992595,wahoo,Zwift - 3R iTT Race - Watopia Tick Tock - 1 Lap (A),Favero Assioma Duo,Wahoo Kickr Core,337,337,0
67753,1604447989,wahoo,Zwift - ZHR Masters Atlantic (C),Favero Assioma Duo,Wahoo Kickr Core,288,287,1
68653,1604703901,wahoo,Zwift - 3R Innsbruckring Flat Race - 2 Laps (17.6km/10.9m 154m) (A),Favero Assioma Duo,Wahoo Kickr Core,295,293,2
70414,1605141592,wahoo,Zwift - 3R Volcano Circuit Flat Race - 4 Laps (18.9km/11.7mi 80m) (A),Favero Assioma Duo,Wahoo Kickr Core,347,347,0
70714,1605207592,wahoo, Flanders The BZR Ronde ,Favero Assioma Duo,Wahoo Kickr Core,361,365,-4
71471,1605374993,wahoo,Zwift - EVR Summer Series (A),Favero Assioma Duo,Wahoo Kickr Core,343,344,-1
72404,1605655794,wahoo,Zwift - SweatFest Fall/Winter Series 2020/21 (A),Favero Assioma Duo,Wahoo Kickr Core,337,337,0
72778,1605740695,wahoo,Zwift - 3R Volcano Flat Reverse 50k Race - 4 Laps (48.8km/30.7mi 184m) (A),Favero Assioma Duo,Wahoo Kickr Core,316,316,0
74314,1606065598,wahoo,Zwift - 3R Racing (A),Favero Assioma Duo,Wahoo Kickr Core,356,356,0
75998,1606414316,wahoo,Zwift - ZHR Hare & Hounds Race (A),Favero Assioma Duo,Wahoo Kickr Core,310,310,0
81305,1607560195,wahoo,Zwift - Austin Driveway Series Criterium (A),Favero Assioma Duo,Wahoo Kickr Core,291,292,-1
119323,1614038648,wahoo,Zwift - France,Favero Assioma Duo,Wahoo Kickr Core,277,278,-1
8637,1578590988,wahoo,Zwift - Danmarks Cykle Union 2020 Cup (A),Garmin Vector 3s,Wahoo Kickr Core,343,325,18
9376,1579024760,wahoo,Zwift - Danmarks Cykle Union 2020 Cup (A),Garmin Vector 3s,Wahoo Kickr Core,333,327,6
12671,1580920188,wahoo,Zwift - Sydkysten Cycling - Carl Ras Race (A),Garmin Vector 3s,Wahoo Kickr Core,338,365,-27
13091,1581237268,wahoo,Zwift - ZHR Masters Weekender (A),Garmin Vector 3s,Wahoo Kickr Core,362,347,15
14255,1581785062,wahoo,Zwift - Crit City Race (A),Garmin Vector 3s,Wahoo Kickr Core,392,385,7
14259,1581693275,wahoo,Zwift - Build Me Up - Purple Unicorn,Garmin Vector 3s,Wahoo Kickr Core,360,357,3
15028,1582053248,wahoo,Zwift - Feltet.dk Race Series,Garmin Vector 3s,Wahoo Kickr Core,379,371,8
15065,1582301048,wahoo,Zwift - 3R Volcano Flat Race - 3 Laps (36.6km/22.7mi 138m) (A),Garmin Vector 3s,Wahoo Kickr Core,364,345,19
15617,1582658023,wahoo,Zwift - Feltet.dk Race Series (A),Garmin Vector 3s,Wahoo Kickr Core,361,352,9
16165,1582905881,wahoo,Zwift - 3R Volcano Flat Race - 3 Laps (36.6km/22.7mi 138m) (A),Garmin Vector 3s,Wahoo Kickr Core,373,361,12
16167,1582964953,wahoo,Zwift - VZT Tofu Tornado XL (A),Garmin Vector 3s,Wahoo Kickr Core,365,359,6
16268,1583051655,wahoo,Zwift - ZHR Masters Weekender (A),Garmin Vector 3s,Wahoo Kickr Core,346,339,7
16904,1583262838,wahoo,Zwift - Feltet.dk Race Series (A),Garmin Vector 3s,Wahoo Kickr Core,412,381,31
17331,1583658007,wahoo,Danmarks Cykle Union 2020 Cup,Garmin Vector 3s,Wahoo Kickr Core,393,354,39
17630,1583868446,wahoo,Zwift - ZHR Masters (A),Garmin Vector 3s,Wahoo Kickr Core,353,355,-2
18523,1584472438,wahoo,Zwift - Feltet.dk Race Series (A),Garmin Vector 3s,Wahoo Kickr Core,389,371,18
18826,1584698583,wahoo,Zwift - 3R Innsbruckring Flat Race - 4 Laps (35.2km/21.9mi 308m) (A),Garmin Vector 3s,Wahoo Kickr Core,356,346,10
19187,1584867582,wahoo,Zwift - Danmarks Cykle Union 2020 Cup (A),Garmin Vector 3s,Wahoo Kickr Core,377,374,3
19188,1584778438,wahoo,Zwift - EVR Asia Weekend (A),Garmin Vector 3s,Wahoo Kickr Core,317,311,6
19703,1585077213,wahoo,Zwift - Feltet.dk Race Series (A),Garmin Vector 3s,Wahoo Kickr Core,365,346,19
20728,1585386039,wahoo,Danmarks Cykle Union 2020 Cup,Garmin Vector 3s,Wahoo Kickr Core,353,343,10
20872,1585678418,wahoo,Zwift - Feltet.dk Race Series (A),Garmin Vector 3s,Wahoo Kickr Core,385,366,19
21695,1585853235,wahoo,WTRL Team Time Trial - Zone3,Garmin Vector 3s,Wahoo Kickr Core,346,352,-6
31129,1588410152,wahoo,Zwift - 3R Classique Flat Race - 4 Laps (A),Garmin Vector 3s,Wahoo Kickr Core,342,333,9
31749,1588702357,wahoo,DCU Uno-X Cup powered by Feltet.dk,Garmin Vector 3s,Wahoo Kickr Core,384,379,5
34195,1589307319,wahoo,Zwift - UNO X CUP powered by DCU & Feltet.dk (A),Garmin Vector 3s,Wahoo Kickr Core,389,390,-1
34196,1589103753,wahoo,Zwift - Points Race League by Team DIRT (A),Garmin Vector 3s,Wahoo Kickr Core,355,354,1
35113,1589477335,wahoo,Zwift - FUSION ECT BEUNSTOPPABLE Racing Series (A),Garmin Vector 3s,Wahoo Kickr Core,388,388,0
35114,1589551394,wahoo,Zwift - 3R Innsbruckring Flat Race - 2 Laps (17.6km/10.9m 154m) (A),Garmin Vector 3s,Wahoo Kickr Core,367,360,7
35223,1589616862,wahoo,Zwift - EVR Asia Weekend (A),Garmin Vector 3s,Wahoo Kickr Core,351,345,6
36517,1589997840,wahoo,Zwift - DBR Boerkop Cykler Cup (A),Garmin Vector 3s,Wahoo Kickr Core,351,351,0
37026,1590217772,wahoo,Zwift - ZWC Weekend Race  (A),Garmin Vector 3s,Wahoo Kickr Core,362,359,3
37028,1590044648,wahoo,Zwift - 3R Innsbruckring Flat Race - 5 Laps (44km/27.3mi 385m) (A),Garmin Vector 3s,Wahoo Kickr Core,355,349,6
37777,1590304165,wahoo,Zwift - 3R Figure 8 Hilly Race - 1 Lap (29.2km/18.1m 234m) (A),Garmin Vector 3s,Wahoo Kickr Core,335,328,7
37975,1590513063,wahoo,Zwift - Tour for All 2020: Stage 2 Shorter Ride,Garmin Vector 3s,Wahoo Kickr Core,314,315,-1
37976,1590516839,wahoo,Zwift - UNO X CUP powered by DCU & Feltet.dk (A),Garmin Vector 3s,Wahoo Kickr Core,402,397,5
39469,1591207446,wahoo,Zwift - DBR Boerkop Cykler Cup (A),Garmin Vector 3s,Wahoo Kickr Core,362,360,2
39598,1591291711,wahoo,Zwift - FUSION ECT BEUNSTOPPABLE Racing Series (A),Garmin Vector 3s,Wahoo Kickr Core,354,355,-1
40058,1591464534,wahoo,Zwift - Cycling BC Virtual BC Cup (A),Garmin Vector 3s,Wahoo Kickr Core,355,353,2
41748,1591984754,wahoo,Zwift - The Friday Criterium Spring Race Series  (A),Garmin Vector 3s,Wahoo Kickr Core,366,364,2
41749,1591543433,wahoo,Zwift - 3R Watopia 65km Race - 6 laps (40mi 324m) (A),Garmin Vector 3s,Wahoo Kickr Core,335,334,1
53509,1599293119,wahoo,Zwift - 3R Hilly Race - Richmond - Rollercoaster (A),Garmin Vector 3s,Wahoo Kickr Core,364,359,5
53643,1599397488,wahoo,Zwift - 3R Watopia Flat Route Race - 4 Laps (40.5km/25.1mi 216m) (A),Garmin Vector 3s,Wahoo Kickr Core,370,364,6
53756,1599498879,wahoo,Zwift - DBR Ride´N´Roll League (A),Garmin Vector 3s,Wahoo Kickr Core,376,373,3
54178,1599674639,wahoo,Zwift - DBR Wednesday Race (A),Garmin Vector 3s,Wahoo Kickr Core,356,355,1
54369,1599753806,wahoo,Zwift - OH MY CRIT! - The Double Race 2/2 (A),Garmin Vector 3s,Wahoo Kickr Core,366,364,2
54682,1599899398,wahoo,Zwift - DBR SufferDay League II (A),Garmin Vector 3s,Wahoo Kickr Core,385,381,4
55020,1600103669,wahoo,Zwift - DBR Ride´N´Roll League (A),Garmin Vector 3s,Wahoo Kickr Core,372,369,3
55383,1600192469,wahoo,Zwift - Team Italy & Frenchy Fuzion League (A),Garmin Vector 3s,Wahoo Kickr Core,342,344,-2
55761,1600358645,wahoo,Zwift - OH MY CRIT! - The Double Race 2/2 (A),Garmin Vector 3s,Wahoo Kickr Core,392,377,15
56141,1600441164,wahoo,Zwift - ZHQ Beta Crit City Race (A),Garmin Vector 3s,Wahoo Kickr Core,348,355,-7
56661,1600708445,wahoo,Zwift - DBR Ride´N´Roll League (A),Garmin Vector 3s,Wahoo Kickr Core,377,361,16
56848,1600799950,wahoo,Zwift - 3R Sundown Race Series  (A),Garmin Vector 3s,Wahoo Kickr Core,373,376,-3
57048,1600883017,wahoo,DCU powered by Feltet.dk (A),Garmin Vector 3s,Wahoo Kickr Core,360,369,-9
57484,1601042617,wahoo,Zwift - 3R Innsbruckring Flat Race - 2 Laps (17.6km/10.9m 154m) (A),Garmin Vector 3s,Wahoo Kickr Core,371,361,10
57895,1601214256,wahoo,Zwift - Crit City Race (A),Garmin Vector 3s,Wahoo Kickr Core,366,369,-3
58063,1601313208,wahoo,Zwift - DBR Ride´N´Roll League (A),Garmin Vector 3s,Wahoo Kickr Core,358,360,-2
58250,1601391795,wahoo,Zwift - 3R Volcano Circuit Flat Race - 8 Laps (35.2km/21.9mi 160m) (A),Garmin Vector 3s,Wahoo Kickr Core,340,339,1
58799,1601568124,wahoo,Zwift - OH MY CRIT! - The Double Race 2/2 (A),Garmin Vector 3s,Wahoo Kickr Core,357,357,0
59074,1601651661,wahoo,Zwift - 3R Sand and Sequoias Race (A),Garmin Vector 3s,Wahoo Kickr Core,336,332,4
59350,1601795338,wahoo,Zwift - 3R Figure 8 Hilly Race - 1 Lap (29.2km/18.1m 234m) (A),Garmin Vector 3s,Wahoo Kickr Core,358,356,2
59601,1601918047,wahoo,Zwift - DBR Ride´N´Roll League (A),Garmin Vector 3s,Wahoo Kickr Core,368,361,7
60182,1602093727,wahoo,Zwift - DBR HEINO CUP III (A),Garmin Vector 3s,Wahoo Kickr Core,358,345,13
60425,1602167940,wahoo,Zwift - Team Italy Specialissima Race (A),Garmin Vector 3s,Wahoo Kickr Core,363,361,2
61179,1602522687,wahoo,Zwift - DBR Ride´N´Roll League (A),Garmin Vector 3s,Wahoo Kickr Core,328,326,2
62422,1602610135,wahoo,Zwift - 6DQTE - Race 2 (A),Garmin Vector 3s,Wahoo Kickr Core,375,380,-5
62424,1602857008,wahoo,Zwift - 3R Innsbruckring Flat Race - 2 Laps (17.6km/10.9m 154m) (A),Garmin Vector 3s,Wahoo Kickr Core,349,351,-2
63675,1603219767,wahoo,Zwift - Zwift Racing League | WTRL - EMEA (MEN) - TTT Grp 2 (C),Garmin Vector 3s,Wahoo Kickr Core,347,343,4
63843,1603299432,wahoo,Zwift - MIDWEEK Autumn Series by SZR (A),Garmin Vector 3s,Wahoo Kickr Core,378,370,8
64534,1603465994,wahoo,Zwift - 3R Sand and Sequoias Race (A),Garmin Vector 3s,Wahoo Kickr Core,365,353,12
65071,1603524513,wahoo,Zwift - ZHQ FutureWorks Circuit Race - Anti-sandbagging (A),Garmin Vector 3s,Wahoo Kickr Core,381,378,3
65151,1603736045,wahoo,Zwift - DBR Ride´N´Roll League (A),Garmin Vector 3s,Wahoo Kickr Core,379,376,3
66110,1603827739,wahoo,Zwift - Zwift Racing League | WTRL - EMEA W (MEN) -  Division 1 (A),Garmin Vector 3s,Wahoo Kickr Core,378,374,4
66245,1603996188,wahoo,Zwift - FUSION ECT BEUNSTOPPABLE Racing Series (A),Garmin Vector 3s,Wahoo Kickr Core,363,364,-1
67183,1604246338,wahoo,Zwift - 3R Super Six Sunday Race,Garmin Vector 3s,Wahoo Kickr Core,352,343,9
67203,1604333239,wahoo,Zwift - 3R Classique Reverse Flat Race - 4 Laps (26.9km/16.7mi 57m) (A),Garmin Vector 3s,Wahoo Kickr Core,347,358,-11
68624,1604595784,wahoo,Zwift - OH MY CRIT! - The Double Race 2/2 (A),Garmin Vector 3s,Wahoo Kickr Core,383,377,6
68626,1604516305,wahoo,Zwift - DCU – Feltet.dk November series,Garmin Vector 3s,Wahoo Kickr Core,376,378,-2
68627,1604678553,wahoo,Zwift - 3R Volcano Flat Race - 3 Laps (36.6km/22.7mi 138m) (A),Garmin Vector 3s,Wahoo Kickr Core,363,360,3
71367,1605280399,wahoo,Zwift - 3R Sand and Sequoias Race (A),Garmin Vector 3s,Wahoo Kickr Core,343,345,-2
71666,1605429242,wahoo,Zwift - ZHR Masters Weekender (A),Garmin Vector 3s,Wahoo Kickr Core,320,318,2
72682,1605642285,wahoo,Zwift - Zwift Racing League | WTRL - Men&#039;s EMEA W1 DIVISION 1 (A),Garmin Vector 3s,Wahoo Kickr Core,358,354,4
72707,1605726206,wahoo,Zwift - DBR HEINO CUP III (A),Garmin Vector 3s,Wahoo Kickr Core,350,349,1
74596,1605949505,wahoo,Zwift - 3R Weekend Race Club - Race 2 (A),Garmin Vector 3s,Wahoo Kickr Core,374,370,4
74598,1606050264,wahoo,Zwift - 3R Watopia Flat Route Race - 4 Laps (40.5km/25.1mi 216m) (A),Garmin Vector 3s,Wahoo Kickr Core,384,370,14
74600,1606155192,wahoo,Zwift -  DBR Monday Race (A),Garmin Vector 3s,Wahoo Kickr Core,345,342,3
76482,1606331024,wahoo,Zwift - DBR HEINO CUP III (A),Garmin Vector 3s,Wahoo Kickr Core,349,352,-3
76635,1606493052,wahoo,Zwift - 3R Volcano Flat Race - 3 Laps (36.6km/22.7mi 138m) (A),Garmin Vector 3s,Wahoo Kickr Core,361,362,-1
78406,1606760046,wahoo,Zwift -  DBR Monday Race (A),Garmin Vector 3s,Wahoo Kickr Core,388,385,3
78407,1606847589,wahoo,Zwift - Team Sportslab UK Road Race League (A),Garmin Vector 3s,Wahoo Kickr Core,351,348,3
81333,1607364843,wahoo,DBR Monday Race,Garmin Vector 3s,Wahoo Kickr Core,349,349,0
81337,1607452489,wahoo,Team Sportslab UK Road Race League,Garmin Vector 3s,Wahoo Kickr Core,351,348,3
81338,1607530107,wahoo,Zwift - 3R Tick Tock Flat Race - 2 Lap (36km/22.4mi 100m) (A),Garmin Vector 3s,Wahoo Kickr Core,364,365,-1
82894,1607713143,wahoo,Zwift - EVR Europe (A),Garmin Vector 3s,Wahoo Kickr Core,342,339,3
82896,1607875143,wahoo,Zwift - 3R Super Six Sunday Race (A),Garmin Vector 3s,Wahoo Kickr Core,341,339,2
83623,1608061709,wahoo,Zwift - Zwift Racing League | WTRL - Men&#039;s EMEA W1 DIVISION 1 (A),Garmin Vector 3s,Wahoo Kickr Core,335,335,0
84427,1608229759,wahoo,Zwift - FUSION DECEMBER CUP (A),Garmin Vector 3s,Wahoo Kickr Core,364,361,3
86036,1608542038,wahoo,Zwift - 3R Watopia Flat Route Race - 4 Laps (41km/25.5mi 216m) (A),Garmin Vector 3s,Wahoo Kickr Core,345,331,14
86184,1608640148,wahoo,Zwift - ZHQ FutureWorks Crit City Race - Anti-sandbagging (A),Garmin Vector 3s,Wahoo Kickr Core,345,342,3
89802,1609353541,wahoo,Zwift - Danmarks Cykle Union – December Fun  (A),Garmin Vector 3s,Wahoo Kickr Core,358,349,9
89827,1609517044,wahoo,Zwift - 3R Volcano Flat Race - 3 Laps (36.6km/22.7mi 138m) (A),Garmin Vector 3s,Wahoo Kickr Core,365,362,3
91422,1609784047,wahoo,Zwift -  DBR Monday Race (A),Garmin Vector 3s,Wahoo Kickr Core,382,372,10
91430,1609579770,wahoo,Zwift - DBR SufferDay League III (A),Garmin Vector 3s,Wahoo Kickr Core,386,381,5
92453,1609959853,wahoo,Zwift - DBR Wednesday Race (A),Garmin Vector 3s,Wahoo Kickr Core,359,351,8
92923,1610044100,wahoo,Zwift - FUSION WINTER CUP (A),Garmin Vector 3s,Wahoo Kickr Core,356,359,-3
94471,1610292281,wahoo,Zwift - 3R Watopia 65km Race - 6 laps (40mi 324m) (A),Garmin Vector 3s,Wahoo Kickr Core,366,351,15
95852,1610481057,wahoo,Zwift - Zwift Racing League | WTRL - Men&#039;s/Mixed EMEA W2 DIVISION 1 (A),Garmin Vector 3s,Wahoo Kickr Core,371,359,12
97194,1610648925,wahoo,Zwift - FUSION WINTER CUP (A),Garmin Vector 3s,Wahoo Kickr Core,405,389,16
98290,1610813033,wahoo,Zwift - 3R Classique Flat Race - 4 Laps (26.9km/16.7mi 76m) (A),Garmin Vector 3s,Wahoo Kickr Core,375,354,21
98382,1610874816,wahoo,Zwift - Fantasy Nutrinovex Rice (A),Garmin Vector 3s,Wahoo Kickr Core,403,391,12
99697,1611081418,wahoo,Zwift - Zwift Racing League | WTRL - Men&#039;s/Mixed EMEA E2 DIVISION 6 (A),Garmin Vector 3s,Wahoo Kickr Core,372,363,9
101518,1611331475,wahoo,Zwift - Watopia,Garmin Vector 3s,Wahoo Kickr Core,368,349,19
101888,1611412733,wahoo,Zwift - Team Italy Specialissima Race  (A),Garmin Vector 3s,Wahoo Kickr Core,339,329,10
102459,1611501824,wahoo,Zwift - 3R Watopia 65km Race - 6 laps (40mi 324m) (A),Garmin Vector 3s,Wahoo Kickr Core,353,341,12
103952,1611684854,wahoo,Zwift - ZESP ,Garmin Vector 3s,Wahoo Kickr Core,393,380,13
104795,1611858501,wahoo,Zwift - FUSION WINTER CUP (A),Garmin Vector 3s,Wahoo Kickr Core,381,374,7
107002,1612206512,wahoo,Zwift - RuhrRiders Pott-Race,Garmin Vector 3s,Wahoo Kickr Core,349,341,8
107332,1612290481,wahoo,Zwift - Zwift Racing League | WTRL - Men&#039;s/Mixed EMEA E2 DIVISION 6 (A),Garmin Vector 3s,Wahoo Kickr Core,389,388,1
108416,1612377808,wahoo,Zwift - Danmarks Cykle Union & Partners 4/6 (A),Garmin Vector 3s,Wahoo Kickr Core,372,376,-4
109860,1612538885,wahoo,Zwift - DBR Friday Race (A),Garmin Vector 3s,Wahoo Kickr Core,359,359,0
110257,1612628023,wahoo,Zwift - Deeside Snowman Sprint Series (A),Garmin Vector 3s,Wahoo Kickr Core,375,374,1
111578,1612691948,wahoo,Zwift - DBR Sunday Race (A),Garmin Vector 3s,Wahoo Kickr Core,361,368,-7
117213,1612900711,wahoo,Zwift - Zwift Racing League | WTRL - Men&#039;s/Mixed EMEA W2 DIVISION 1 (A),Garmin Vector 3s,Wahoo Kickr Core,385,391,-6
117214,1613503759,wahoo,Zwift - British Cycling Race Series (A),Garmin Vector 3s,Wahoo Kickr Core,344,347,-3
118043,1613672905,wahoo,Zwift - FUSION WINTER CUP (A),Garmin Vector 3s,Wahoo Kickr Core,342,348,-6
118069,1613811571,wahoo,Zwift -  Flanders Toeristenkoers (A),Garmin Vector 3s,Wahoo Kickr Core,333,339,-6
119295,1614017637,wahoo,Zwift -  DBR Monday Race (A),Garmin Vector 3s,Wahoo Kickr Core,360,355,5
119834,1614109877,wahoo,Zwift - Zwift Racing League | WTRL - Men&#039;s/Mixed EMEA W2 DIVISION 1 (A),Garmin Vector 3s,Wahoo Kickr Core,355,348,7
122894,1614622428,wahoo,Zwift -  DBR Monday Race (A),Garmin Vector 3s,Wahoo Kickr Core,344,343,1
123110,1614710087,wahoo,Zwift - Zwift Racing League | WTRL - Men&#039;s/Mixed EMEA E2 DIVISION 6 (A),Garmin Vector 3s,Wahoo Kickr Core,367,371,-4
127632,1615565049,wahoo,Zwift - 3R Volcano Flat Race - 3 Laps (36.6km/22.7mi 138m) (A),Garmin Vector 3s,Wahoo Kickr Core,350,353,-3
128441,1615735437,wahoo,Zwift - 3R Watopia 65km Race - 6 laps (40mi 324m) (A),Garmin Vector 3s,Wahoo Kickr Core,345,343,2
129145,1615919349,wahoo,Zwift - CeramicSpeed Race Series: Open Race (A),Garmin Vector 3s,Wahoo Kickr Core,373,358,15
3218,1570183518,wahoo,Zwift - 3R Innsbruckring Flat Race - 4 Laps (35.2km/21.9mi 308m) (A),Power2Max NGeco,Wahoo Kickr &#039;18,0,0,0
5808,1575882927,wahoo,Zwift - 3R Watopia Flat Route Reverse Race - 4 Laps (41km/25.5mi 216m) (A),Power2Max NGeco,Wahoo Kickr &#039;18,0,0,0
5976,1576061108,wahoo,Zwift - DIRT Cup Series (A),Power2Max NGeco,Wahoo Kickr &#039;18,0,0,0
6467,1576578010,wahoo,Zwift - Eat The Pain Race (A),Power2Max NGeco,Wahoo Kickr &#039;18,0,0,0
8127,1578221113,wahoo,Zwift - The Season - 3 Days of Yorkshire #2 (E),Power2Max NGeco,Wahoo Kickr &#039;18,382,368,14
8415,1578486609,wahoo,Zwift - 3R LaGuardia Loop Flat Race - 10 Laps (28.3km/17.6mi 270m) (A),Power2Max NGeco,Wahoo Kickr &#039;18,374,360,14
8710,1578647108,wahoo,Zwift - 3R Whole Lotta Lava Hilly Race - 2 Laps (28.9km/12.53mi 336m) (A),Power2Max NGeco,Wahoo Kickr &#039;18,385,376,9
8711,1578650716,wahoo,Zwift - 3R Innsbruckring Flat Race - 4 Laps (35.2km/21.9mi 308m) (A),Power2Max NGeco,Wahoo Kickr &#039;18,360,350,10
9161,1578939312,wahoo,Zwift - DBR Caresport Crit Cup  (A),Power2Max NGeco,Wahoo Kickr &#039;18,382,367,15
9448,1579075520,wahoo,Zwift - 3R Tempus Fugit Flat Race - 1 Lap (19.8km/12.3mi 20m) (A),Power2Max NGeco,Wahoo Kickr &#039;18,355,343,12
12499,1580843711,wahoo,Zwift - Tour de Zwift // Pro-Am Invitational (A),Power2Max NGeco,Wahoo Kickr &#039;18,411,402,9
13324,1581361514,wahoo,Zwift - ITT League - The Stampede by Herd Racing League (Europe) (A),Power2Max NGeco,Wahoo Kickr &#039;18,364,356,8
13325,1581364212,wahoo,Zwift - EVR Europe Race (A),Power2Max NGeco,Wahoo Kickr &#039;18,362,358,4
17447,1583832009,wahoo,Zwift - Eat The Pain Race (A),Power2Max NGeco,Wahoo Kickr &#039;18,367,355,12
17835,1584040513,wahoo,Zwift - Tour of Watopia Pro-Am Men&#039;s Race #1 (A),Power2Max NGeco,Wahoo Kickr &#039;18,394,383,11
22168,1586077214,wahoo,Zwift - Ronde van Zwift (A),Power2Max NGeco,Wahoo Kickr &#039;18,394,377,17
56062,1600363897,wahoo,Zwift - FUSION ECT BEUNSTOPPABLE Racing Series (B),Power2Max NGeco,Wahoo Kickr &#039;18,372,351,21
57315,1600708525,wahoo,Zwift - DBR Ride´N´Roll League (A),Power2Max NGeco,Wahoo Kickr &#039;18,334,305,29
57319,1600973113,wahoo,Zwift - XRS - ZTR Thursday Night Race (B),Power2Max NGeco,Wahoo Kickr &#039;18,363,339,24
58605,1601487915,wahoo,Zwift - DCU powered by Feltet.dk (B),Power2Max NGeco,Wahoo Kickr &#039;18,346,336,10
60499,1602183544,wahoo,Zwift - WTRL Team Time Trial - Zone 6 (C),Power2Max NGeco,Wahoo Kickr &#039;18,334,316,18
62471,1602783011,wahoo,Zwift - FUSION ECT BEUNSTOPPABLE Racing Series (A),Power2Max NGeco,Wahoo Kickr &#039;18,379,369,10
66187,1603996244,wahoo,Zwift - FUSION ECT BEUNSTOPPABLE Racing Series (A),Power2Max NGeco,Wahoo Kickr &#039;18,375,339,36
67632,1604429714,wahoo,Zwift - Team Italy & Frenchy Fuzion League (A),Power2Max NGeco,Wahoo Kickr &#039;18,371,353,18
70308,1605121212,wahoo,Zwift - DCU – Feltet.dk November series (A),Power2Max NGeco,Wahoo Kickr &#039;18,391,381,10
70803,1605205812,wahoo,Zwift - FUSION ECT BEUNSTOPPABLE Racing Series (A),Power2Max NGeco,Wahoo Kickr &#039;18,334,322,12
70807,1605205812,wahoo,Zwift - FUSION ECT BEUNSTOPPABLE Racing Series (A),Power2Max NGeco,Wahoo Kickr &#039;18,334,322,12
70811,1605205812,wahoo,Zwift - FUSION ECT BEUNSTOPPABLE Racing Series (A),Power2Max NGeco,Wahoo Kickr &#039;18,334,322,12
73182,1605814212,wahoo,Zwift - World Championships Experience // Danish Cycling Federation,Power2Max NGeco,Wahoo Kickr 5,382,373,9
77656,1606760115,wahoo,Zwift -  DBR Monday Race (A),Power2Max NGeco,Wahoo Kickr 5,372,365,7
79019,1607020214,wahoo,Zwift - FUSION DECEMBER CUP (A),Power2Max NGeco,Wahoo Kickr 5,337,326,11
80536,1607367739,wahoo,Zwift - EVR Europe Race (A),Power2Max NGeco,Wahoo Kickr 5,348,346,2
83778,1608056663,wahoo,Zwift - Zwift Racing League | WTRL - Men&#039;s EMEA E1 DIVISION 1 (A),Power2Max NGeco,Wahoo Kickr 5,374,360,14
84489,1608229794,wahoo,Zwift - FUSION DECEMBER CUP (A),Power2Max NGeco,Wahoo Kickr 5,351,345,6
85817,1608574488,wahoo,Zwift -  DBR Monday Race (A),Power2Max NGeco,Wahoo Kickr 5,340,326,14
90923,1609700385,wahoo,Zwift - BRT Iron Goat Racing League (A),Power2Max NGeco,Wahoo Kickr 5,368,356,12
92981,1610044208,wahoo,Zwift - FUSION WINTER CUP (A),Power2Max NGeco,Wahoo Kickr 5,361,349,12
95647,1610475309,wahoo,Zwift - Zwift Racing League | WTRL - Men&#039;s/Mixed EMEA E1 DIVISION 1 (A),Power2Max NGeco,Wahoo Kickr 5,360,353,7
97317,1610649004,wahoo,Zwift - FUSION WINTER CUP (A),Power2Max NGeco,Wahoo Kickr 5,382,377,5
104764,1611858593,wahoo,Zwift - FUSION WINTER CUP (A),Power2Max NGeco,Wahoo Kickr 5,371,366,5
110991,1612808082,wahoo,Zwift -  DBR Monday Race (A),Power2Max NGeco,Wahoo Kickr 5,399,395,4
111349,1612859389,wahoo,Zwift - DBR Morning Race (A),Power2Max NGeco,Wahoo Kickr 5,346,338,8
113045,1613068189,wahoo,Zwift - FUSION WINTER CUP (A),Power2Max NGeco,Wahoo Kickr 5,377,369,8
116976,1613587476,wahoo,Zwift - Danmarks Cykle Union & Partners 6/6 (A),Power2Max NGeco,Wahoo Kickr 5,353,349,4
120387,1613672976,wahoo,Zwift - FUSION WINTER CUP (A),Power2Max NGeco,Wahoo Kickr 5,349,343,6
120409,1614109895,wahoo,Zwift - Zwift Racing League | WTRL - Men&#039;s/Mixed EMEA W2 DIVISION 1 (A),Power2Max NGeco,Wahoo Kickr 5,359,350,9
125993,1615141808,wahoo,Zwift - SCANNELLATORI SERIALI TOUR,Power2Max NGeco,Wahoo Kickr 5,378,369,9
126908,1615460421,wahoo,Zwift - KISS Race Series - Americas AM (A),Power2Max NGeco,Wahoo Kickr 5,321,309,12
71633,1605429896,wahoo,Favero_Assioma / Wahoo_Kickr,Favero_Assioma,Wahoo_Kickr,386,375,11
73402,1451611519,wahoo,Favero_Assioma / Wahoo_Kickr,Favero_Assioma,Wahoo_Kickr,408,406,2
76831,1606551294,wahoo,Matando o Corpo® Sergio Samitier Edition by PETA-Z,Favero_Assioma,Wahoo_Kickr,410,398,12
103288,1611652517,wahoo,3R Whole Lotta Lava Hilly Race - 2 Laps (28.9km/12.53mi 336m) (A),Favero_Assioma,Wahoo_Kickr,410,399,11
107981,1612349097,wahoo,The Morning Grind by STPC (A),Favero_Assioma,Wahoo_Kickr,382,378,4
29516,1588245600,wahoo,Zwift - British Cycling Time Trial Series (A),Assimo Favero Dual Sided,Wahoo Kickr,351,357,-6
32199,1588787530,wahoo,Zwift - USA Cycling Race League p/b Saris+ThePro&#039;sCloset  (A),Assimo Favero Dual Sided,Wahoo Kickr,359,359,0
32354,1588850376,wahoo,Zwift - British Cycling Time Trial Series (A),Assimo Favero Dual Sided,Wahoo Kickr,0,0,0
32355,1588850376,wahoo,Zwift - British Cycling Time Trial Series (A),Assimo Favero Dual Sided,Wahoo Kickr,0,0,0
32356,1588850376,wahoo,Zwift - British Cycling Time Trial Series (A),Assimo Favero Dual Sided,Wahoo Kickr,0,0,0
32357,1588850376,wahoo,Zwift - British Cycling Time Trial Series (A),Assimo Favero Dual Sided,Wahoo Kickr,361,365,-4
37412,1590329289,wahoo,Zwift - 3R Alpe Du Zwift KOM Race (20km 1444m) (A),Assimo Favero Dual Sided,Wahoo Kickr,362,352,10
8482,1578510001,wahoo,Wahoo Kickr 18 / Garmin vector 3,Garmin vector 3,Wahoo Kickr 18,365,370,-5
12433,1580845199,wahoo,Zwift - 3R Ultimate Racing League - Round 5 (A),Garmin vector 3,Wahoo Kickr 18,391,383,8
12825,1581015598,wahoo,Zwift - KALAS Cup - Round 2 (A),Garmin vector 3,Wahoo Kickr 18,409,398,11
22197,1586077199,wahoo,Ronde van Zwift,Garmin vector 3,Wahoo Kickr 18,381,383,-2
56421,1600606789,wahoo,Invitational League // Qualifying Race #3 (Men),Garmin vector 3,Wahoo Kickr Bike,369,384,-15
60356,1602177712,wahoo,Zwift - Espresso,Garmin vector 3,Wahoo Kickr Bike,347,363,-16
61286,1602528597,wahoo,Zwift - Premier Division // Zwift Racing League (men) ,Garmin vector 3,Wahoo Kickr Bike,376,391,-15
61944,1602693898,wahoo,Zwift - 3R 100 Steady Ride [~3.0w/kg avg] (B),Garmin vector 3,Wahoo Kickr Bike,238,248,-10
62163,1602782579,wahoo,Zwift - Espresso,Garmin vector 3,Wahoo Kickr Bike,348,368,-20
63132,1603131173,wahoo,Zwift - Premier Division // Zwift Racing League (men) ,Garmin vector 3,Wahoo Kickr Bike,366,378,-12
67466,1604344318,wahoo,Zwift - Premier Division // Zwift Racing League (men) (A),Garmin vector 3,Wahoo Kickr Bike,360,390,-30
75594,1606328128,wahoo,Zwift - TBR MounTRONeering (C),Garmin vector 3,Wahoo Kickr Bike,265,264,1
76034,1606414001,wahoo,Zwift - WTRL NOPINZ WORLD TTT CHAMPIONSHIPS - Zone 4 (C),Garmin vector 3,Wahoo Kickr Bike,388,386,2
76970,1606560234,wahoo,Zwift,Garmin vector 3,Wahoo Kickr Bike,376,381,-5
77711,1606760109,wahoo,Zwift - TRI247 Manic Monday Time Trial (E),Garmin vector 3,Wahoo Kickr Bike,376,386,-10
97135,1610650786,wahoo,Zwift - TDZ Stage 3: Longer Ride,Garmin vector 3,Wahoo Kickr Bike,346,355,-9
99243,1610997553,wahoo,Zwift - Etter tempo,Garmin vector 3,Wahoo Kickr Bike,364,372,-8
100456,1611167344,wahoo,Zwift - NCF Vintercup 2021 - Runde 2 - Herrer (A),Garmin vector 3,Wahoo Kickr Bike,329,344,-15
101833,1611403054,wahoo,ZADA Three Sister test,Garmin vector 3,Wahoo Kickr Bike,396,410,-14
102843,1611598793,wahoo,Zwift - TRI247 Manic Monday Time Trial (E),Garmin vector 3,Wahoo Kickr Bike,383,392,-9
104179,1611772170,wahoo,Zwift - NCF Vintercup 2021 - Runde 3 - Herrer (A),Garmin vector 3,Wahoo Kickr Bike,380,400,-20
108355,1612376985,wahoo,Zwift - NCF Vintercup 2021 - Runde 4 - Herrer (A),Garmin vector 3,Wahoo Kickr Bike,362,386,-24
111042,1612812130,wahoo,Zwift - Premier Division // Zwift Racing League (men) (A),Garmin vector 3,Wahoo Kickr Bike,412,418,-6
112318,1612983593,wahoo,Zwift - Movistar Team Challenge // Round 1 (A),Garmin vector 3,Wahoo Kickr Bike,395,400,-5
115341,1613419280,wahoo,Zwift - Premier Division // Zwift Racing League (men) (A),Garmin vector 3,Wahoo Kickr Bike,395,412,-17
116745,1613588347,wahoo,Zwift - Movistar Team Challenge // Round 2 (men) - Race 3/4,Garmin vector 3,Wahoo Kickr Bike,366,377,-11
119171,1614020963,wahoo,Zwift - Premier Division // Zwift Racing League (men) (A),Garmin vector 3,Wahoo Kickr Bike,374,383,-9
120422,1614192283,wahoo,Zwift - Scandinavian Cup 2021 - Round 1 - Men (A),Garmin vector 3,Wahoo Kickr Bike,379,384,-5
122628,1614629909,wahoo,Zwift - Premier Division // Zwift Racing League (men) (A),Garmin vector 3,Wahoo Kickr Bike,386,391,-5
126610,1615401843,wahoo,Zwift - Scandinavian Cup 2021 - Round 3 - Men (A),Assioma Duo,Wahoo Kickr Bike,411,419,-8
128063,1615627790,wahoo,Zwift - [DBR] Saturday Race (A),Assioma Duo,Wahoo Kickr Bike,380,388,-8
129169,1615919391,wahoo,Zwift - CeramicSpeed Race Series: Open Race (A),Assioma Duo,Wahoo Kickr Bike,389,396,-7
110303,1612599520,wahoo,e-liga | eCycling league Austria Race 6 (A),Garmin Vektor,Wahoo kickr,361,364,-3
112674,1613029062,wahoo,Ryzon Days of Dedication: Stage 2,Garmin Vektor,Wahoo kickr,340,329,11
118117,1613811903,wahoo,Zwift - e-liga | eCycling league Austria Race 7 (A),Garmin Vektor,Wahoo kickr,329,333,-4
71294,1605341374,neo,Zwift - e-liga | eCycling league Austria Race 1 (A),Quarq dFour to Zwift ,Tacx NEO 2T to Garmin Edge1030,461,453,8
72598,1605713958,neo,Zwift - 3R Tick Tock Flat Race - 2 Lap (36km/22.4mi 100m) (A),Quarq dFour to Zwift,Tacx NEO 2T to Garmin Edge1030,444,423,21
74328,1606062527,neo,Zwift - Crit City Race (A),Quarq dFour to Zwift,Tacx NEO 2T to Garmin Edge1030,386,378,8
74332,1606057041,neo,Zwift - 2020 UCI Cycling Esports World Championships Practice Event,Quarq dFour to Edge1030,Tacx Neo 2T to Zwift ,431,426,5
76816,1606554182,neo,Zwift - e-liga | eCycling league Austria Race 2 (A),Quarq dFour to Zwift,Tacx NEO 2T to Garmin Edge1030,452,438,14
78553,1606924599,neo,Zwift - Sydkysten / KST Race (A),Quarq dFour to Zwift,Tacx NEO 2T to Garmin Edge1030,445,426,19
78962,1607013901,neo,Zwift - Felix Ritzinger [WSA-KTM] &#039;s Meetup - Champs-Élysées,Quarq dFour to Edge1030,Tacx Neo 2T to Zwift,209,207,2
81028,1607524957,neo,Zwift - Men&#039;s Elite // 2020 UCI Cycling Esports World Championships,Quarq dFour to Edge1030,Tacx Neo 2T to Zwift,440,429,11
83154,1607958161,neo,Zwift - 3R Classique Reverse Flat Race - 4 Laps (26.9km/16.7mi 57m) (A),Quarq dFour AXS1 to Edge 1030,Tacx Neo 2T to Zwift,383,375,8
84996,1608368539,neo,Zwift - e-liga | eCycling league Austria Race 3 (A),Quarq dFour AXS1 to Zwift,Tacx NEO 2T to Garmin Edge1030,447,443,4
92279,1609927083,wahoo,Zwift - EVR Definitely Not the WTNC (A),Quarq dFour AXS1 to Zwift,Wahoo KickrV5 to Edge1030,460,448,12
98005,1610787781,neo,Zwift - e-liga | eCycling league Austria Race 4 (A),Quarq dFour AXS1 to Zwift,Tacx NEO 2T to Garmin Edge1030,476,464,12
108846,1612430042,wahoo,Zwift - Ramp Test 20w/3min,Quarq dFour AXS1 to Edge 1030,Wahoo Kickr V5 to Zwift,469,453,16
109360,1612516663,wahoo,Zwift - Ramp Test 20w/1min,Quarq dFour AXS1 to Edge 1030,Wahoo Kickr V5 to Zwift,492,481,11
109883,1612602106,neo,Zwift - 02/06/2021,Quarq dFour AXS1 to Edge 1030,Tacx Neo 2T to Zwift,409,399,10
110948,1612805285,neo,Zwift -  SCF SWE Cup Men (A),Quarq dFour AXS1 to Zwift,Tacx NEO 2T to Garmin Edge1030,410,403,7
119779,1614104518,neo,Zwift - Zwift Racing League | WTRL - Men&#039;s/Mixed EMEA E2 DIVISION 2 (A),Quarq dFour AXS1 to Zwift,Tacx NEO 2T to Garmin Edge1030,403,381,22
80369,1607328185,neo,Zwift - 3R Sand & Sequoias - 1 Lap (20km/12.5mi 173m) (A),Verve Infocrank,Tacx Neo 2,350,341,9
80623,1607407134,neo,Zwift -  Kiwi Crew Riot Race (A),Verve Infocrank,Tacx Neo 2,281,275,6
81070,1607524935,neo,Zwift - Men&#039;s Elite // 2020 UCI Cycling Esports World Championships,Verve Infocrank,Tacx Neo 2,410,401,9
89266,1608436157,neo,ZADA Three sisters Test - Ben HILL (AERO),Verve Infocrank,Tacx Neo 2,428,416,12
118572,1613895546,neo,Zwift - Team Italy & Frenchy Fuzion Endurance Race (A),Verve Infocrank,Tacx Neo 2,393,383,10
119090,1614020457,neo,Zwift - Premier Division // Zwift Racing League (men) (A),Verve Infocrank,Tacx Neo 2,381,369,12
122544,1614629271,neo,Zwift - Premier Division // Zwift Racing League (men) (A),Verve Infocrank,Tacx Neo 2,362,357,5
127222,1615487182,wahoo,Wahoo Kickr &#039;17 / SRM Dura Ace 9000,SRM Dura Ace 9000,Wahoo Kickr &#039;18,345,361,-16
70093,1605083395,wahoo,Assioma-KickrBike (ERG Smoothing active),Assioma,Wahoo Kickr Bike,243,246,-3
70625,1605173525,wahoo,Assioma vs Wahoo Bike (ERG Smoothing off+Ride+Smothing off again),Assioma,Wahoo Kickr Bike,230,234,-4
71018,1605261602,wahoo,Assioma Duo vs Wahoo Bike RIDE (no Workout),Assioma,Wahoo Kickr Bike,240,242,-2
71337,1605341694,wahoo,Assioma Duo vs Wahoo Bike RACE (Matando o Corpo),Assioma,Wahoo Kickr Bike,292,295,-3
124803,1615018181,wahoo,Movistar eTeam 1,roam assioma (2),Wahoo Kickr Bike,341,350,-9
125769,1615192220,wahoo,Zwift - Flanders Endurance Series (E),Assioma,Wahoo Kickr Bike,272,276,-4
125771,1615222798,wahoo,Queens Highway Race,Assioma,Wahoo Kickr Bike,319,317,2
126400,1615281373,wahoo,Suave mas sorints,Assioma,Wahoo Kickr Bike,217,222,-5
127720,1615622992,wahoo,Movistar eTeam 2,Assioma,Wahoo Kickr Bike,295,301,-6
128243,1615712396,wahoo,Movistar eTeam 3,Assioma,Wahoo Kickr Bike,323,328,-5
4480,1574190599,wahoo,Zwift - WORLDOFFUSION Racing Series (A),FSA powerbox ,Wahoo Kick18,366,375,-9
4913,1574795400,wahoo,Zwift - WORLDOFFUSION Racing Series (A),FSA powerbox ,Wahoo Kick18,375,374,1
5249,1575187214,wahoo,Zwift - Giro di Castelli // Stage 3 (A),FSA powerbox ,Wahoo Kick18,430,422,8
5486,1575486311,wahoo,Zwift - Watopia,FSA powerbox ,Wahoo Kick18,365,368,-3
5932,1576005011,wahoo,Zwift - WORLDOFFUSION Racing Series (A),FSA powerbox ,Wahoo Kick18,388,382,6
5961,1576046691,wahoo,Zwift - Watopia,FSA powerbox ,Wahoo Kick18,353,343,10
6016,1576091100,wahoo,Zwift - DBR HEINO CUP (A),FSA powerbox ,Wahoo Kick18,403,400,3
6451,1576537481,wahoo,Zwift - ,FSA powerbox ,Wahoo Kick18,250,246,4
6554,1576631063,wahoo,Zwift - London,FSA powerbox ,Wahoo Kick18,264,266,-2
6628,1576695915,wahoo,Zwift - DBR HEINO CUP (A),FSA powerbox ,Wahoo Kick18,386,384,2
6786,1576824512,wahoo,Zwift - Watopia,FSA powerbox ,Wahoo Kick18,340,333,7
6889,1576909967,wahoo,Zwift - Watopia,FSA powerbox ,Wahoo Kick18,348,341,7
6992,1576997715,wahoo,Zwift - SZR Aktivitus 2h v5,FSA powerbox ,Wahoo Kick18,380,374,6
7220,1577252117,wahoo,Zwift - 3R Igniter Interval Ride [~3-3.5w/kg avg] (B),FSA powerbox ,Wahoo Kick18,339,336,3
7772,1577861460,wahoo,Zwift - NYC,FSA powerbox ,Wahoo Kick18,346,347,-1
8013,1578121404,wahoo,MAP 1 on 1 off x 12,FSA powerbox ,Wahoo Kick18,378,382,-4
8801,1578724941,wahoo,Zwift - Watopia,FSA powerbox ,Wahoo Kick18,399,398,1
9062,1578856201,wahoo,Zwift - Tour de Zwift: Stage 1 Race (A),FSA powerbox ,Wahoo Kick18,363,357,6
9402,1579041398,wahoo,openers,FSA powerbox ,Wahoo Kick18,312,311,1
9519,1579115698,wahoo,Zwift - Tour de Zwift // Pro-Am Invitational (A),FSA powerbox ,Wahoo Kick18,420,416,4
9849,1579330114,wahoo,Zwift,FSA powerbox ,Wahoo Kick18,418,412,6
9961,1579406494,wahoo,Zwift - crisscross + vo2 max,FSA powerbox ,Wahoo Kick18,372,368,4
10473,1579719221,wahoo,Zwift - Watopia,FSA powerbox ,Wahoo Kick18,316,315,1
10648,1579806899,wahoo,Zwift - Tour de Zwift // Pro-Am Invitational,FSA powerbox ,Wahoo Kick18,468,461,7
10727,1579849885,wahoo,Zwift - Watopia,FSA powerbox ,Wahoo Kick18,301,292,9
10952,1580017072,wahoo,Zwift - crisscross + vo2 max,FSA powerbox ,Wahoo Kick18,416,412,4
12867,1581058854,wahoo,Zwift - Ramp Test,FSA powerbox ,Wahoo Kick18,477,479,-2
14124,1581793923,wahoo,Zwift - New Workout,FSA powerbox ,Wahoo Kick18,405,413,-8
17438,1583831995,wahoo,Zwift - Eat The Pain Race (A),FSA powerbox ,wahoo kickr gen 1 (overseas),418,426,-8
20245,1585436380,wahoo,NZ champs ,FSA powerbox (primary),Wahoo Kickr 18 (secondary),355,355,0
21626,1585897128,wahoo,Zwift -  Haute Route Watopia Stage 1 (E),FSA powerbox (primary),Wahoo Kickr 18 (secondary),431,437,-6
22171,1586077151,wahoo,Zwift - Ronde van Zwift (A),FSA powerbox (primary),Wahoo Kickr 18 (secondary),395,402,-7
23299,1586455722,wahoo,Zwift - London International // Zwift Classic (A),FSA powerbox (primary),Wahoo Kickr 18 (secondary),458,461,-3
25104,1587030313,wahoo,Zwift - Koa Sports League Race (A),FSA powerbox (primary),Wahoo Kickr 18 (secondary),389,388,1
25597,1587147042,wahoo,Zwift - Richmond Challenge // Zwift Classic (A),FSA powerbox secondary ,wahoo kickr 18 primary ,422,428,-6
27207,1587635112,wahoo,Zwift - Koa Sports League Race (A),Verve Infocrank (primary),Wahoo Kickr 18 (secondary),391,374,17
27781,1587787230,wahoo,Zwift - SAS -  Centurion 100km (C),Verve Infocrank (primary),Wahoo Kickr 18 (secondary),269,259,10
28011,1587838214,wahoo,Zwift - Crit City Slam // Zwift Classic (A),Verve Infocrank (primary),Wahoo Kickr 18 (secondary),429,418,11
28363,1587962338,wahoo,Zwift - Over-unders,Verve Infocrank (primary),Wahoo Kickr 18 (secondary),412,405,7
28575,1588045490,wahoo,Zwift - London,Verve Infocrank (primary),Wahoo Kickr 18 (secondary),455,451,4
30608,1588435218,wahoo,Zwift - YANA Pro/AM Invitiational (A),Verve Infocrank (primary),Wahoo Kickr 18 (secondary),457,446,11
30792,1588482758,wahoo,Zwift - Tempo with short spikes,Verve Infocrank (primary),Wahoo Kickr 18 (secondary),361,351,10
31462,1588655556,wahoo,Zwift - Ramp ups,Verve Infocrank (primary),Wahoo Kickr 18 (secondary),413,405,8
31954,1588761413,wahoo,Zwift - Richmond,Verve Infocrank (primary),Wahoo Kickr 18 (secondary),180,0,180
32218,1588815173,wahoo,Zwift - Bicicletta Vancouver Group Ride (C),Infocrank garmin ,wahoo kickr 18 primary ,329,335,-6
32318,1588844714,wahoo,Zwift - Koa Sports League Race (A),Infocrank garmin ,wahoo kickr 18 primary ,402,391,11
33822,1589274596,wahoo,Zwift - SRAM Send it Series - Race 1 - Men&#039;s (E),Verve Infocrank (primary),Wahoo Kickr 18 (secondary),433,421,12
34578,1589449513,wahoo,Zwift - Koa Sports League Race (A),Verve Infocrank (primary),Wahoo Kickr 18 (secondary),377,367,10
35969,1589879422,wahoo,Zwift - SRAM Send it Series - Race 2 - Men&#039;s (E),Verve Infocrank (primary),Wahoo Kickr 18 (secondary),440,428,12
36695,1590085034,wahoo,Zwift - Tour for All Invitational Race // Men (A),Verve Infocrank (primary),Wahoo Kickr 18 (secondary),431,425,6
37734,1590484219,wahoo,Zwift - Ramp ups,Verve Infocrank (primary),Wahoo Kickr 18 (secondary),433,425,8
38387,1590689833,wahoo,Zwift - Tour for All Invitational Race // Men (A),Verve Infocrank (primary),Wahoo Kickr 18 (secondary),454,455,-1
39030,1591089020,wahoo,SRAM send it series ,Verve Infocrank (primary),Wahoo Kickr 18 (secondary),455,448,7
39497,1591263334,wahoo,KOA Sports warrior race ,Infocrank garmin ,wahoo kickr 18 primary ,390,382,8
40671,1591764797,wahoo,Zwift - Watopia,Infocrank garmin ,wahoo kickr 18 primary ,469,458,11
46226,1594713639,wahoo,Zwift - Virtual Tour de France - Open - Stage 3 Discovery Ride,Infocrank garmin ,wahoo kickr 18 primary ,388,378,10
49797,1597305353,wahoo,Zwift - Paris,Infocrank garmin ,wahoo kickr 18 primary ,339,330,9
49941,1597395013,wahoo,Zwift - Off the MAAP Invitational Race // Stage 1 (Men) (A),Infocrank garmin ,wahoo kickr 18 primary ,429,422,7
50372,1597657812,wahoo,Zwift - Off the MAAP Invitational Race // Stage 2 (Men) (A),Infocrank garmin ,wahoo kickr 18 primary ,473,464,9
50842,1597913413,wahoo,Zwift - Off the MAAP Invitational Race // Stage 3 (men) ,Infocrank garmin ,wahoo kickr 18 primary ,450,435,15
51328,1598169741,wahoo,Zwift -  KRT/KISS 100km Endurance Ride (C),Infocrank garmin ,wahoo kickr 18 primary ,334,325,9
51485,1598261712,wahoo,Zwift - Off the MAAP Invitational Race // Stage 4 (men) ,Infocrank garmin ,wahoo kickr 18 primary ,430,421,9
52473,1598688533,wahoo,Zwift,Infocrank garmin ,wahoo kickr 18 primary ,349,343,6
54677,1599898516,wahoo,Zwift - ZHR Audax (E),Infocrank garmin ,wahoo kickr 18 primary ,325,323,2
54953,1600070905,wahoo,Zwift - Watopia,Evening_Ride (2),wahoo kickr 18 primary ,352,353,-1
55056,1600105503,wahoo,Zwift - Invitational League // Qualifying Race #1,Infocrank garmin ,wahoo kickr 18 primary ,402,401,1
55916,1600366439,wahoo,Zwift - Invitational League // Qualifying Race #2 (Men) ,Infocrank garmin ,wahoo kickr 18 primary ,399,392,7
56468,1600605663,wahoo,Zwift - Invitational League // Qualifying Race #3 (Men) (A),Infocrank garmin ,wahoo kickr 18 primary ,428,422,6
61291,1602528610,wahoo,Zwift - Premier Division // Zwift Racing League (men) ,Infocrank garmin ,wahoo kickr 18 primary ,441,439,2
63121,1603131393,wahoo,Zwift - Premier Division // Zwift Racing League (men) ,Morning_Ride (2),Wahoo Kickr 18 (secondary),423,425,-2
63126,1603131393,wahoo,Zwift - Premier Division // Zwift Racing League (men) ,Morning_Ride (2),Wahoo Kickr 18 (secondary),423,425,-2
65192,1603742205,wahoo,Zwift - Premier Division // Zwift Racing League (men) (A),Infocrank garmin ,wahoo kickr 18 primary ,429,426,3
67311,1604343504,wahoo,Zwift - Premier Division // Zwift Racing League (men) (A),Infocrank garmin ,wahoo kickr 18 primary ,430,432,-2
69424,1604951994,wahoo,Zwift - Premier Division // Zwift Racing League (men) (A),Infocrank garmin ,wahoo kickr 18 primary ,445,448,-3
74690,1606161603,wahoo,Zwift - Premier Division // Zwift Racing League (men) (A),Infocrank garmin ,wahoo kickr 18 primary ,461,460,1
76364,1606414348,wahoo,Zwift - WTRL NOPINZ WORLD TTT CHAMPIONSHIPS - Zone 4 (C),Infocrank garmin ,wahoo kickr 18 primary ,431,431,0
77710,1606763711,wahoo,Zwift - Premier Division // Zwift Racing League (men) (A),Infocrank garmin ,wahoo kickr 18 primary ,419,419,0
95010,1610392507,wahoo,Zwift - Premier Division // Zwift Racing League (men) (A),Infocrank garmin ,wahoo kickr 18 primary ,385,378,7
99327,1610999874,wahoo,Zwift - Premier Division // Zwift Racing League (men) (A),Infocrank garmin ,wahoo kickr 18 primary ,400,402,-2
111038,1612812280,wahoo,Zwift - Premier Division // Zwift Racing League (men) (A),Infocrank garmin 520,wahoo kickr 18 primary ,425,424,1
115332,1613419287,wahoo,Zwift - Premier Division // Zwift Racing League (men) (A),Infocrank garmin ,wahoo kickr 18 primary ,434,434,0
119098,1614020816,wahoo,Zwift - Premier Division // Zwift Racing League (men) (A),Infocrank garmin ,wahoo kickr 18 primary ,369,361,8
122600,1614630042,wahoo,Zwift - Premier Division // Zwift Racing League (men) (A),Infocrank garmin ,wahoo kickr 18 primary ,412,403,9
119307,1614029411,neo,Zwift - France,2021-02-22-213018-ELEMNT ROAM AD23-19-0,Tacx Neo,152,154,-2
124712,1614974636,neo,Zwift - Endurance (65%) 1.5 hrs,stages,Tacx Neo,257,259,-2
124713,1614888241,neo,Zwift - Tempo 2x20,stages,Tacx Neo,309,316,-7
124960,1615037783,neo,Zwift - 4x5 RPE 9 1:1,stages,Tacx Neo,414,435,-21
125579,1615153705,neo,Zwift - 2x15 88% (1.5 hrs),stages,Tacx Neo,348,348,0
126983,1615471202,neo,Zwift - TWENTY24 Road To Tokyo (D),stages,Tacx Neo,320,326,-6
55141,1600106386,neo,Zwift - Invitational League // Qualifying Race #1,Quarq DFour,Tacx Neo 2,415,389,26
55617,1600274382,neo,Zwift - LEQP Provence Rose Ride (C),Quarq DFour,Tacx Neo 2,259,249,10
55618,1600276943,neo,Zwift - The HERD Bull Run,Quarq DFour,Tacx Neo 2,232,223,9
55938,1600367400,neo,Zwift - Invitational League // Qualifying Race #2 (Men) ,Quarq DFour,Tacx Neo 2,371,356,15
56466,1600606788,neo,Zwift - Invitational League // Qualifying Race #3 (Men) (A),Quarq DFour,Tacx Neo 2,389,378,11
61660,1602614686,neo,Zwift - Zwift Racing League | WTRL,Quarq DFour,Tacx Neo 2,387,372,15
63578,1603220212,neo,Zwift - Zwift Racing League | WTRL - EMEA (MEN) - TTT Grp 1 (C),Quarq DFour,Tacx Neo 2,365,347,18
64238,1603387071,neo,Zwift - Espresso,Quarq DFour,Tacx Neo 20,373,352,21
65598,1603827617,neo,Zwift - Zwift Racing League | WTRL - EMEA W (MEN) -  Division 1 (A),Quarq DFour,Tacx Neo 2,390,374,16
67706,1604432122,neo,Zwift - Zwift Racing League | WTRL - Men&#039;s EMEA W1 DIVISION 1 (A),Quarq DFour,Tacx Neo 2,375,356,19
69914,1605037252,neo,Zwift - Zwift Racing League | WTRL - EMEA W1 (MEN) -  Division 1 (A),Quarq DFour,Tacx Neo 2,409,393,16
70737,1605199924,neo,Zwift - OH MY CRIT! - The Double Race 2/2 (A),Quarq DFour,Tacx Neo 2,347,338,9
70770,1605207077,neo,Zwift - Espresso,Quarq DFour,Tacx Neo 2,348,336,12
72385,1605640854,neo,Zwift - Zwift Racing League | WTRL - Men&#039;s EMEA W1 DIVISION 1 (A),Quarq DFour,Tacx Neo 2,360,344,16
75221,1606246901,neo,Zwift - Zwift Racing League | WTRL - Men&#039;s EMEA W1 DIVISION 1,Quarq DFour,Tacx Neo 2,407,392,15
78259,1606849561,neo,Zwift Racing League | WTRL - Men&#039;s EMEA W1 DIVISION 1 (A),Quarq DFour,Tacx Neo 2,379,359,20
83684,1608059693,neo,Zwift - Zwift Racing League | WTRL - Men&#039;s EMEA W1 DIVISION 1 (A),Quarq DFour,Tacx Neo 2,361,340,21
86570,1608742832,neo,Zwift - EVO CC Mini Vamos! 90 Min Ride Cat C [~2.8-3.2w/kg avg] (C) + 1m Test,Quarq DFour,Tacx Neo 2,305,286,19
88555,1609244088,neo,Zwift - Team ODZ Tuesday Coffee and Espresso Ride (C),Quarq DFour,Tacx Neo 2,402,382,20
92856,1610041654,neo,Zwift - WTRL Platinum League,Quarq DFour,Tacx Neo 2,381,361,20
95815,1610478437,neo,Zwift - Zwift Racing League | WTRL - Men&#039;s/Mixed EMEA W2 DIVISION 1 (A),Quarq DFour,Tacx Neo 2,356,337,19
99866,1611083929,neo,ZRL TTT,Quarq DFour,Tacx Neo 2,362,343,19
100380,1611160950,neo,Zwift - TDZ Stage 4: Shorter Ride,Quarq DFour,Tacx Neo 2,376,362,14
100393,1611160950,neo,Zwift - TDZ Stage 4: Standard Ride,Quarq DFour,Tacx Neo 2,391,373,18
103718,1611688275,neo,ZRL - Innsbruck,Quarq DFour,Tacx Neo 2,379,358,21
107592,1612293189,neo,Zwift - Harrogate ZRL,Quarq DFour,Tacx Neo 2,413,385,28
110160,1612628787,neo,RGT Echelon Series JMSR Stage 2 RR,Quarq DFour,Tacx Neo 2,391,367,24
114247,1613211439,neo,Uber Pretzel,Quarq DFour,Tacx Neo 2,348,339,9
114905,1613305000,neo,Zwift - ODZentury Endurance Builder Ride (B),Quarq DFour,Tacx Neo 2,312,296,16
116098,1613502871,neo,Zwift - Zwift Racing League | WTRL - Men&#039;s/Mixed EMEA W2 DIVISION 1 (A),Quarq DFour,Tacx Neo 2,408,383,25
128185,1615642596,neo,Zwift - Zwift Insider Badge Hunters - The PRL Full Edition,Quarq DFour,Tacx Neo 2,392,376,16
34515,1589434798,neo,Tacx Neo 2T / Vector 3,Vector 3,Tacx Neo 2T,241,233,8
34752,1589476980,neo,TTT,Vector 3,Tacx Neo 2T,318,315,3
9698,1579198450,wahoo,Zwift - FUSION ECT BEUNSTOPPABLE Racing Series (A) - winner winner chicken dinner,SRM,Wahoo KICKR,369,360,9
9884,1579337990,wahoo,Zwift - Danmarks Cykle Union 2020 Cup (A) - ingen bjergben endnu,SRM,Wahoo KICKR,384,370,14
10150,1579539840,wahoo,Zwift - Danmarks Cykle Union 2020 Cup (A)-2nd,SRM,Wahoo KICKR,361,352,9
11173,1580133006,wahoo,Zwift - Tour de Zwift: Stage 4 Race (A) - 2nd,SRM,Wahoo KICKR,420,391,29
11775,1580406380,wahoo,Zwift - Tour de Zwift: Stage 5 Race (A),SRM,Wahoo KICKR,336,348,-12
11776,1580406380,wahoo,Zwift - Tour de Zwift: Stage 5 Race (A),SRM,Wahoo KICKR,336,322,14
116709,1613585010,wahoo,Zwift - Danmarks Cykle Union & Partners 6/6 (A),SRM,Wahoo KICKR,365,371,-6
47650,1595686499,wahoo,OH MY CRIT!!! - Saturday Smash Race,Favero Assioma Duo,Wahoo Kickr Core,364,383,-19
48190,1596047100,wahoo,Zwift - Deeside Thistle and Moray Firth Race (A),Favero Assioma Duo,Wahoo Kickr Core,319,332,-13
48441,1596216228,wahoo,KIRCHMAIR Race Series,Favero Assioma Duo,Wahoo Kickr Core,328,343,-15
48489,1596279827,wahoo,Zwift - DIRT Dadurday Chase Race  (A),Favero Assioma Duo,Wahoo Kickr Core,351,363,-12
48560,1596356630,wahoo,ZZRC Sunday Club Ride,Favero Assioma Duo,Wahoo Kickr Core,339,348,-9
48590,1596375525,wahoo,Zwift - Herd Summer Racing League Race 8 (A),Favero Assioma Duo,Wahoo Kickr Core,343,343,0
48658,1596470624,wahoo,3R Classique Reverse Flat Race - 2nd,Favero Assioma Duo,Wahoo Kickr Core,370,362,8
48662,1596473624,wahoo,Zwift - 3R Queens Highway Race - 6 Laps (A),Favero Assioma Duo,Wahoo Kickr Core,379,379,0
48918,1596643724,wahoo,Zwift - Namibian League Race (A),Favero Assioma Duo,Wahoo Kickr Core,314,318,-4
49034,1596707628,wahoo,Zwift - DIRTy USA Cycling Ride (C),Favero Assioma Duo,Wahoo Kickr Core,274,274,0
49069,1596726523,wahoo,OH MY CRIT! - The Double Race 1/2,Favero Assioma Duo,Wahoo Kickr Core,370,371,-1
49071,1596728321,wahoo,Crit City Race (A) - 1st,Favero Assioma Duo,Wahoo Kickr Core,364,363,1
49195,1596815919,wahoo,Zwift - 3R Volcano Flat Race - 3 Laps (36.6km/22.7mi 138m) (A),Favero Assioma Duo,Wahoo Kickr Core,358,363,-5
75509,1606325396,wahoo,Zwift - EVO CC Sprint Race Series  (A),Favero Assioma Duo,Wahoo Kickr Core,309,311,-2
76531,1606498209,wahoo,ZHQ FutureWorks Circuit Race - Anti-sandbagging,Favero Assioma Duo,Wahoo Kickr Core,339,346,-7
77615,1606755595,wahoo,Zwift - 3R Queens Highway Race - 6 Laps (A),Favero Assioma Duo,Wahoo Kickr Core,354,354,0
78027,1606842594,wahoo,Zwift - 3R Volcano KOM After Party Race - 2 laps + climb (40.2km/25mi 286m) (A),Favero Assioma Duo,Wahoo Kickr Core,367,372,-5
78840,1606996496,wahoo,Zwift - DIRT Doozy Race (A),Favero Assioma Duo,Wahoo Kickr Core,337,342,-5
79698,1607166895,wahoo,Zwift - 3R Tick Tock Flat Race - 2 Lap (36km/22.4mi 100m) (A),Favero Assioma Duo,Wahoo Kickr Core,338,342,-4
80484,1607362197,wahoo,Zwift - ZHQ FutureWorks Circuit Race - Anti-sandbagging (A),Favero Assioma Duo,Wahoo Kickr Core,313,318,-5
80503,1607364894,wahoo,Zwift -  DBR Monday Race (A),Favero Assioma Duo,Wahoo Kickr Core,323,329,-6
80780,1607447994,wahoo,Zwift - WKG - CRITTY CRITTY BANG BANG (A),Favero Assioma Duo,Wahoo Kickr Core,343,348,-5
82011,1607709595,wahoo,ZRG-CC Falling Leaves Tour (A),Favero Assioma Duo,Wahoo Kickr Core,341,341,0
83518,1608056274,wahoo,Zwift - Zwift Racing League | WTRL - Men&#039;s EMEA E1 DIVISION 2 (A),Favero Assioma Duo,Wahoo Kickr Core,343,348,-5
84260,1608211796,wahoo,ZHQ FutureWorks Circuit Race - Anti-sandbagging,Favero Assioma Duo,Wahoo Kickr Core,294,302,-8
85746,1608560098,wahoo,3R Classique Reverse Flat Race - 5 Laps (32km/20.1mi 76m) (A),Favero Assioma Duo,Wahoo Kickr Core,326,328,-2
86386,1608656396,wahoo,Zwift - ZHQ FutureWorks Crit City Race - Boost mode (A),Favero Assioma Duo,Wahoo Kickr Core,338,344,-6
88684,1609262998,wahoo,Zwift - WTRL Racing (A),Favero Assioma Duo,Wahoo Kickr Core,333,343,-10
91807,1609867800,wahoo,Zwift - WTRL Racing (A),Favero Assioma Duo,Wahoo Kickr Core,328,334,-6
93399,1610127002,wahoo,EVO CC / Le Col - Sprint Race Series (A),Favero Assioma Duo,Wahoo Kickr Core,356,355,1
93743,1610190177,wahoo,Zwift - TDZ Stage 2: Shorter Ride,Favero Assioma Duo,Wahoo Kickr Core,346,338,8
93746,1610186396,wahoo,Zwift - TDZ Stage 2: Longer Ride,Favero Assioma Duo,Wahoo Kickr Core,343,346,-3
96912,1610643598,wahoo,Zwift - TDZ Stage 3: Longer Ride,Favero Assioma Duo,Wahoo Kickr Core,322,330,-8
97036,1610649896,wahoo,XRS - ZTR Thursday Night Race (A),Favero Assioma Duo,Wahoo Kickr Core,355,359,-4
97503,1610729576,wahoo,TDZ Stage 3: Shorter Ride & 3 sprints,Favero Assioma Duo,Wahoo Kickr Core,360,363,-3
97739,1610787269,wahoo,Zwift - 3R Weekend Race Club - Race 2 (A),Favero Assioma Duo,Wahoo Kickr Core,316,323,-7
98427,1610881495,wahoo,Zwift - 3R Innsbruckring Sprint Race - 1 Lap (8.8km/5.5mi 77m) (A),Favero Assioma Duo,Wahoo Kickr Core,340,341,-1
99686,1611080305,wahoo,Zwift Racing League | WTRL - Men&#039;s/Mixed EMEA E1 DIVISION 2 (A),Favero Assioma Duo,Wahoo Kickr Core,339,349,-10
100672,1610902861,wahoo,Zwift - 3R Racing (A),Favero Assioma Duo,Wahoo Kickr Core,398,406,-8
100863,1611248393,wahoo,Zwift - TDZ Stage 4: Longer Ride,Favero Assioma Duo,Wahoo Kickr Core,314,316,-2
102237,1611478232,wahoo,Zwift - TDZ Stage 5: Standard Ride,Favero Assioma Duo,Wahoo Kickr Core,365,368,-3
102291,1611481942,wahoo,Zwift - TDZ Stage 5: Shorter Ride,Favero Assioma Duo,Wahoo Kickr Core,298,302,-4
103444,1611684954,wahoo,Zwift Racing League | WTRL - Men&#039;s/Mixed EMEA E1 DIVISION 2 (A),Favero Assioma Duo,Wahoo Kickr Core,385,392,-7
104625,1611852573,wahoo,Zwift - TDZ Stage 5: Group Ride (A),Favero Assioma Duo,Wahoo Kickr Core,387,393,-6
105479,1612004125,wahoo,TDZ Stage 6: Group Ride,Favero Assioma Duo,Wahoo Kickr Core,304,307,-3
105735,1612021655,wahoo,Zwift - TDZ Stage 6: Longer Ride,Favero Assioma Duo,Wahoo Kickr Core,362,364,-2
105754,1612025995,wahoo,Zwift - INC Relentless Steady State (B),Favero Assioma Duo,Wahoo Kickr Core,384,392,-8
107298,1612289754,wahoo,Zwift Racing League | WTRL - Men&#039;s/Mixed EMEA E1 DIVISION 2 (A),Favero Assioma Duo,Wahoo Kickr Core,377,381,-4
108918,1612466066,wahoo,Zwift - BRT Criterium Racing League (A),Favero Assioma Duo,Wahoo Kickr Core,356,360,-4
109006,1612468974,wahoo,Zwift - TDZ Stage 7: Shorter Ride,Favero Assioma Duo,Wahoo Kickr Core,397,403,-6
109371,1612545489,wahoo,Zwift - ZHQ FutureWorks Circuit Race - Anti-sandbagging (A),Favero Assioma Duo,Wahoo Kickr Core,346,356,-10
109818,1612603795,wahoo,Zwift - DBR SufferDay League III (A),Favero Assioma Duo,Wahoo Kickr Core,380,382,-2
110318,1612690253,wahoo,Zwift - Zwift Fondo Series: Medio Fondo,Favero Assioma Duo,Wahoo Kickr Core,346,354,-8
110916,1612803713,wahoo,Zwift - TDZ Stage 8: Group Ride,Favero Assioma Duo,Wahoo Kickr Core,342,345,-3
111506,1612894707,wahoo,Zwift - Zwift Racing League | WTRL - Men&#039;s/Mixed EMEA E1 DIVISION 2 (A),Favero Assioma Duo,Wahoo Kickr Core,359,368,-9
112920,1613066392,wahoo,TDZ Stage 8: Group Ride,Favero Assioma Duo,Wahoo Kickr Core,349,350,-1
114250,1613235595,wahoo,Zwift - TDZ Stage 5: Longer Ride,Favero Assioma Duo,Wahoo Kickr Core,386,393,-7
114540,1613293494,wahoo,Zwift - Newbury Velo Road Race (A),Favero Assioma Duo,Wahoo Kickr Core,398,402,-4
115178,1613408569,wahoo,Zwift - TDZ Stage 5: Shorter Ride,Favero Assioma Duo,Wahoo Kickr Core,312,327,-15
115819,1613499355,wahoo,Zwift - Zwift Racing League | WTRL - Men&#039;s/Mixed EMEA E1 DIVISION 2 (A),Favero Assioma Duo,Wahoo Kickr Core,406,420,-14
117124,1613653374,wahoo,TDZ Stage 5: Shorter Ride,Favero Assioma Duo,Wahoo Kickr Core,314,319,-5
117852,1613756871,wahoo,Zwift - TDZ Stage 8: Group Ride,Favero Assioma Duo,Wahoo Kickr Core,333,340,-7
119022,1614012529,wahoo,Zwift - INC Relentless Steady State (C),Favero Assioma Duo,Wahoo Kickr Core,215,226,-11
119046,1614016795,wahoo,Zwift - Mike Debney&#039;s Meetup - 2015 UCI Worlds Course,Favero Assioma Duo,Wahoo Kickr Core,228,236,-8
119554,1614104157,wahoo,Zwift - Zwift Racing League | WTRL - Men&#039;s/Mixed EMEA E1 DIVISION 2 (A),Favero Assioma Duo,Wahoo Kickr Core,349,357,-8
121230,1614358796,wahoo,Zwift - Haute Route Watopia 2021 Stage 1 (A),Favero Assioma Duo,Wahoo Kickr Core,392,397,-5
122414,1614618893,wahoo,Zwift - ZZRC Wrecked Legs - Recovery Ride (C),Favero Assioma Duo,Wahoo Kickr Core,322,321,1
122918,1614709129,wahoo,Zwift - Zwift Racing League | WTRL - Men&#039;s/Mixed EMEA E1 DIVISION 2 (A),Favero Assioma Duo,Wahoo Kickr Core,357,362,-5
125142,1615057914,wahoo,Zwift - TBR Pancake Chase Race! (A),Favero Assioma Duo,Wahoo Kickr Core,380,379,1
125774,1615224594,wahoo,Zwift - Absa Cape Epic Stage 1 pb Oakley - Open (A),Favero Assioma Duo,Wahoo Kickr Core,369,380,-11
126200,1615314596,wahoo,Zwift - ZTPL.CC Classic Race,Favero Assioma Duo,Wahoo Kickr Core,382,385,-3
126495,1615394124,wahoo,Absa Cape Epic Stage 2 Time Trial,Favero Assioma Duo,Wahoo Kickr Core,391,395,-4
126522,1615395506,wahoo,Zwift - France 2x20 SST,Favero Assioma Duo,Wahoo Kickr Core,320,326,-6
126892,1615462194,wahoo,Zwift - Absa Cape Epic Stage 3 pb ABUS - Open	 (A),Favero Assioma Duo,Wahoo Kickr Core,352,360,-8
127744,1615627799,wahoo,Zwift - Absa Cape Epic Stage 4 pb Assos - Open (A),Favero Assioma Duo,Wahoo Kickr Core,373,380,-7
128728,1615826645,wahoo,Zwift - ZZRC Wrecked Legs - Recovery Ride (C),Favero Assioma Duo,Wahoo Kickr Core,322,332,-10
129123,1615919416,wahoo,ZTPL.CC Classic Race,Favero Assioma Duo,Wahoo Kickr Core,373,379,-6
114988,1613365465,wahoo,Zwift - 3R Watopia - Volcano CCW - 5 Laps (A),Garmin Vector 3,Wahoo Kickr Core,361,355,6
115601,1613465067,wahoo,Zwift - Zwift Racing League | WTRL - Men&#039;s/Mixed APAC DIVISION 1 (A),Vector 3,Wahoo Kickr Core,390,392,-2
9924,1579360499,neo,Zwift - OH CRIT!! - Saturday Smash Series (A),4iiii Precision,Tacx Neo 2,331,338,-7
10025,1579443301,neo,Zwift - KISS at Race 100 - Americas (A),4iiii Precision,Tacx Neo 2,349,349,0
20186,1585408461,neo,Zwift - OH CRIT!! - Saturday Smash Series (A),4iiii Precision,Tacx Neo 2,370,376,-6
20437,1585484137,neo,Zwift - KISS at Race 100 - Americas (A),4iiii Precision,Tacx Neo 2,371,372,-1
77318,1606659325,neo,Zwift - KISS 100 Race Series - Americas (A),4iiii Precision,Tacx Neo 2,369,370,-1
80169,1607264080,neo,Zwift - KISS 100 Race Series - Americas (A),4iiii Precision,Tacx Neo 2,360,358,2
85502,1608473717,neo,Zwift - KISS 100 Race Series - Americas (A),4iiii Precision,Tacx Neo 2,347,342,5
87895,1609078522,neo,Zwift - KISS 100 Race Series - Americas (A),4iiii Precision,Tacx Neo 2,379,383,-4
94520,1610288115,neo,Zwift - KISS 100 Race Series - Americas (A),4iiii Precision,Tacx Neo 2,380,385,-5
98618,1610892913,neo,Zwift - KISS 100 Race Series - Americas (A),4iiii Precision,Tacx Neo 2,344,348,-4
99986,1611103979,neo,Zwift - Zwift Racing League | WTRL - Men&#039;s/Mixed AMERICAS E DIVISION 1 (A),4iiii Precision,Tacx Neo 2,363,363,0
103811,1611708374,neo,Zwift - Zwift Racing League | WTRL - Men&#039;s/Mixed AMERICAS E DIVISION 1 (A),4iiii Precision,Tacx Neo 2,366,371,-5
107707,1612313158,neo,Zwift - Zwift Racing League | WTRL - Men&#039;s/Mixed AMERICAS E DIVISION 1 (A),4iiii Precision,Tacx Neo 2,377,378,-1
110545,1612707297,neo,Zwift - KISS 100 Race Series - Americas (A),4iiii Precision,Tacx Neo 2,346,358,-12
114731,1612918491,neo,Zwift - KISS 100 Race Series - Americas (A),4iiii Precision,Tacx Neo 2,373,378,-5
116223,1613522759,neo,Zwift - Zwift Racing League | WTRL - Men&#039;s/Mixed AMERICAS E DIVISION 1 (A),4iiii Precision,Tacx Neo 2,401,408,-7
118759,1613916898,neo,Zwift - KISS 100 Race Series - Americas (A),4iiii Precision,Tacx Neo 2,342,350,-8
119966,1614127559,neo,Zwift - Zwift Racing League | WTRL - Men&#039;s/Mixed AMERICAS E DIVISION 1 (A),4iiii Precision,Tacx Neo 2,361,371,-10
122147,1614521699,neo,Zwift - KISS 100 Race Series - Americas (A),4iiii Precision,Tacx Neo 2,362,367,-5
126768,1615421399,neo,Zwift - La Classique du Clan Knox (A),4iiii Precision,Tacx Neo 2,378,379,-1
128478,1615731297,neo,Zwift - KISS 100 Race Series (Americas) (A),4iiii Precision,Tacx Neo 2,342,352,-10
342,1565967646,wahoo,Power2Max S-type / Wahoo Kickr 2nd gen,Power2Max S-type,Wahoo Kickr 2nd gen,379,377,2
3664,1572703293,wahoo,Slovenian Zwift League presented by VS Bike - stage 1,Power2Max NG,Wahoo Kickr 2nd gen,416,408,8
3876,1573067113,wahoo,Wahoo Kickr 2nd gen / Power2Max NG,Power2Max NG,Wahoo Kickr 2nd gen,404,405,-1
3919,1573150760,wahoo,Zwift - WTRL Team Time Trial (EU-TTT),Power2Max NG,Wahoo Kickr 2nd gen,410,418,-8
4004,1573308308,wahoo,Slovenian Zwift League - Autumn Series (Stage 2),Power2Max NG,Wahoo Kickr 2nd gen,0,0,0
4198,1573670788,wahoo,Zwift - 11/13/2019,Power2Max NG,Wahoo Kickr 2nd gen,401,395,6
4337,1573911995,wahoo,Slovenian Zwift League - Autumn Series,Power2Max NG,Wahoo Kickr 2nd gen,368,363,5
4568,1574276003,wahoo,DBR HEINO CUP,Power2Max NG,Wahoo Kickr 2nd gen,0,0,0
4720,1574517346,wahoo,Slovenian Zwift League - Autumn Series (Stage 4),Power2Max NG,Wahoo Kickr 2nd gen,444,447,-3
5006,1574881520,wahoo,Zwift - DBR HEINO CUP (A),Power2Max NG,Wahoo Kickr 2nd gen,0,0,0
5201,1575121981,wahoo,Zwift - Slovenian Zwift League - Autumn Series (Stage 5),Power2Max NG,Wahoo Kickr 2nd gen,0,0,0
5369,1575392949,wahoo,3R Volcano KOM After Party Race - 2 laps + climb (40.2km/25mi 286m),Power2Max NG,Wahoo Kickr 2nd gen,456,458,-2
5747,1575796996,wahoo,Slovenian Zwift League - Autumn Series - Stage 6,Power2Max NG,Wahoo Kickr 2nd gen,422,422,0
6048,1576090070,wahoo,DBR HEINO CUP,Power2Max NG,Wahoo Kickr 2nd gen,445,453,-8
6114,1576172563,wahoo,Power2Max NG / Wahoo Kickr 2nd gen,Power2Max NG,Wahoo Kickr 2nd gen,0,0,0
6254,1576331397,wahoo,Slovenian Zwift League - Autumn Series,Power2Max NG,Wahoo Kickr 2nd gen,0,0,0
7017,1577005227,wahoo,Slovenian Zwift League - Autumn Series,Power2Max NG,Wahoo Kickr 2nd gen,419,406,13
7264,1577291604,wahoo,Crit City Race,Power2Max NG,Wahoo Kickr 2nd gen,361,358,3
7266,1577291604,wahoo,ZA Tri 2020 TT Race,Power2Max NG,Wahoo Kickr 2nd gen,0,0,0
7486,1577540572,wahoo,Slovenian Zwift League - Autumn Series (Stage 9),Power2Max NG,Wahoo Kickr 2nd gen,431,431,0
7748,1577806959,wahoo,Ultimate - Goodby 2019 by 3R,Power2Max NG,Wahoo Kickr 2nd gen,459,460,-1
8468,1578509397,wahoo,Zwift - DBR HEINO CUP (A),Power2Max NG,Wahoo Kickr 2nd gen,439,431,8
8815,1578734103,wahoo,Power2Max NG / Wahoo Kickr 2nd gen,Power2Max NG,Wahoo Kickr 2nd gen,398,394,4
9530,1579113429,wahoo,Power2Max NG / Wahoo Kickr 2nd gen,Power2Max NG,Wahoo Kickr 2nd gen,377,375,2
9974,1579425964,wahoo,Slovenian Zwift League - Fight for the Jersey,Power2Max NG,Wahoo Kickr 2nd gen,477,472,5
10632,1579799867,wahoo,Power2Max NG / Wahoo Kickr 2nd gen,Power2Max NG,Wahoo Kickr 2nd gen,468,471,-3
12045,1580579503,wahoo,3R Three Sisters Hilly Race (47km/29.2mi 879m),Power2Max NG,Wahoo Kickr 2nd gen,446,450,-4
12098,1580635043,wahoo,SloZL - Fight for Jersey (Stage 3),Power2Max NG,Wahoo Kickr 2nd gen,427,430,-3
12923,1581097253,wahoo,3R Lutscher CCW Climbing Race - 1 Lap (22.1km/13.9mi 827m),Power2Max NG,Wahoo Kickr 2nd gen,452,455,-3
13094,1581239816,wahoo,Slovenian Zwift League - Fight for the Jersey - stage 4,Power2Max NG,Wahoo Kickr 2nd gen,415,412,3
13294,1581356908,wahoo,DBR Winter Cup,Power2Max NG,Wahoo Kickr 2nd gen,452,452,0
14192,1581845423,wahoo,Slovenian Zwift League - Fight for Jersey! - Stage 5,Power2Max NG,Wahoo Kickr 2nd gen,430,432,-2
14541,1582047680,wahoo,Zwift - ZRG Winter Race Series 6/10 - Crit London Classique (A),Power2Max NG,Wahoo Kickr 2nd gen,396,393,3
15077,1582307987,wahoo,Power2Max NG to Zwift / Wahoo Kickr 2nd gen to Wahoo Bolt,Power2Max NG to Zwift,Wahoo Kickr 2nd gen to Wahoo Bolt,440,439,1
15253,1582448928,wahoo,Slovenian Zwift League - Fight for Jersey! - Stage 6,Power2Max NG to Zwift,Wahoo Kickr 2nd gen to Wahoo Bolt,387,373,14
15449,1582566531,wahoo,DBR Winter Cup,Power2Max NG to Zwift,Wahoo Kickr 2nd gen to Wahoo Bolt,435,435,0
15582,1582652615,wahoo,ZRG Winter Race Series 7/10 - Muir and the Mountain,Power2Max NG to Zwift,Wahoo Kickr 2nd gen to Wahoo Bolt,448,454,-6
16241,1582450322,wahoo,Slovenian Zwift League - Fight for Jersey! - Stage 6 (Criterium),Power2Max NG to Zwift,Wahoo Kickr 2nd gen to Wahoo Bolt,420,421,-1
16614,1583256810,wahoo,ZRG Winter series 8/10 - TT Bologna,Power2Max NG to Zwift,Wahoo Kickr 2nd gen to Wahoo Bolt,436,419,17
17844,1584038083,wahoo,Zwift - KALAS Cup - Round 7 (A),Power2Max NG to Zwift,Wahoo Kickr 2nd gen to Wahoo Bolt,394,393,1
18121,1584263649,wahoo,Slovenian Zwift League - Fight for Jersey! - Stage 9,Power2Max NG to Zwift,Wahoo Kickr 2nd gen to Wahoo Bolt,486,482,4
18432,1584466503,wahoo,ZRG Winter Race Series 10/10 (Road to Sky),Power2Max NG to Zwift,Wahoo Kickr 2nd gen to Wahoo Bolt,423,417,6
19166,1584882059,wahoo,Zwift - KISS 100km - Americas (A),Power2Max NG to Zwift,Wahoo Kickr 2nd gen to Wahoo Bolt,394,400,-6
19354,1584986204,wahoo,DBR Monday Race (Watopia Figure 8),Power2Max NG to Zwift,Wahoo Kickr 2nd gen to Wahoo Bolt,445,445,0
22295,1586091576,wahoo,Zwift - KISS 100km Race,Power2Max NG to Zwift,Wahoo Kickr 2nd gen to Wahoo Bolt,469,467,2
24302,1586797292,wahoo,Power2Max NG to Zwift / Wahoo Kickr 2nd gen to Wahoo Bolt,Power2Max NG to Zwift,Wahoo Kickr 2nd gen to Wahoo Bolt,401,402,-1
28237,1587906526,wahoo,Zwift - KISS 100km Race,Power2Max NG to Zwift,Wahoo Kickr 2nd gen to Wahoo Bolt,395,398,-3
38796,1590909630,wahoo,Zwift - ZHR Masters Weekender (B),Power2Max NG to Zwift,Wahoo Kickr 2nd gen to Wahoo Bolt,418,425,-7
71568,1605431881,wahoo,Zwift -  SloZl - Slovenian Zwift League - Weekly Race  (A),Power2Max NG to Zwift,Wahoo Kickr 2nd gen to Wahoo Bolt,469,469,0
72823,1605718798,wahoo,Virtuslo.cc Runda:Mariborska runda (Vodušek),Power2Max NG to Zwift,Wahoo Kickr 2nd gen to Wahoo Bolt,265,300,-35
73118,1605811746,wahoo,Power2Max NG to Zwift / Wahoo Kickr 2nd gen to Wahoo Bolt,Power2Max NG to Zwift,Wahoo Kickr 2nd gen to Wahoo Bolt,417,414,3
74101,1606036502,wahoo,Power2Max NG to Zwift / Wahoo Kickr 2nd gen to Wahoo Bolt,Power2Max NG to Zwift,Wahoo Kickr 2nd gen to Wahoo Bolt,400,400,0
77225,1606641411,wahoo,Slovenian Zwift League - La guardia Loop,Power2Max NG to Zwift,Wahoo Kickr 2nd gen to Wahoo Bolt,372,367,5
79015,1607021285,wahoo,WTRL Team Time Trial - Zone 7 (Harrogate reverse),Power2Max NG -&gt; Zwift,Wahoo Kickr 2018 -&gt; Wahoo Bolt,425,435,-10
80034,1607246361,wahoo,SloZl - Slovenian Zwift League - Bologna climb (A),Power2Max NG -&gt; Zwift,Wahoo Kickr 2018 -&gt; Wahoo Bolt,464,462,2
81069,1607535030,wahoo,Cycling Weekly Club 10mile TT,Power2Max NG -&gt; Zwift,Wahoo Kickr 2018 -&gt; Wahoo Bolt,415,423,-8
81647,1607624914,wahoo,WTRL TTT Platinum League (Greater London Flat),Power2Max NG -&gt; Zwift,Wahoo Kickr 2018 -&gt; Wahoo Bolt,412,410,2
81652,1607624914,wahoo,Crit City Race,Power2Max NG -&gt; Zwift,Wahoo Kickr 2018 -&gt; Wahoo Bolt,383,382,1
82779,1607850829,wahoo,Zwift -  SloZl - Slovenian Zwift League - Weekly Race  (A),Power2Max NG -&gt; Zwift,Wahoo Kickr 2018 -&gt; Wahoo Bolt,414,416,-2
84381,1608227111,wahoo,Power2Max NG -&gt; Zwift / Wahoo Kickr 2018 -&gt; Wahoo Bolt,Power2Max NG -&gt; Zwift,Wahoo Kickr 2018 -&gt; Wahoo Bolt,414,417,-3
85029,1608369637,wahoo,DBR Saturday Race,Power2Max NG -&gt; Zwift,Wahoo Kickr 2018 -&gt; Wahoo Bolt,410,405,5
85470,1608473135,wahoo,Zwift - KISS 100 Race Series - Americas (A),Power2Max NG -&gt; Zwift,Wahoo Kickr 2018 -&gt; Wahoo Bolt,369,366,3
87223,1608911225,wahoo,Virtuslo.cc New Year Tour - Stage 1/7 - Gorca vineyards,Power2Max NG -&gt; RGT Cycling,Wahoo Kickr 2018 - &gt; Wahoo Bolt,395,436,-41
98415,1610875310,wahoo,Power2Max NG -&gt; Zwift / Wahoo Kickr 2018 - &gt; Wahoo Bolt,Power2Max NG -&gt; Zwift,Wahoo Kickr 2018 - &gt; Wahoo Bolt,452,449,3
102244,1611479820,wahoo,SloZL - Fight for Jersey (2/11),Power2Max NG -&gt; Zwift,Wahoo Kickr 2018 - &gt; Wahoo Bolt,370,383,-13
106167,1612084234,wahoo,SloZL - Fight for Jersey (3/11),Power2Max NG -&gt; Zwift,Wahoo Kickr 2018 - &gt; Wahoo Bolt,435,436,-1
110291,1612690094,wahoo,SloZL - Fight for Jersey (4/11),Power2Max NG -&gt; Zwift,Wahoo Kickr 2018 - &gt; Wahoo Bolt,445,441,4
112907,1613063876,wahoo,3R iTT Race - Tick Tok - 1 Lap,Power2Max NG -&gt; Zwift,Wahoo Kickr 2018 - &gt; Wahoo Bolt,418,423,-5
114547,1613294513,wahoo,SloZl - Fight for Jersey,Power2Max NG -&gt; Zwift,Wahoo Kickr 2018 - &gt; Wahoo Bolt,438,430,8
118610,1613898999,wahoo,SloZl - Fight for Jersey (6/11),Power2Max NG -&gt; Zwift,Wahoo Kickr 2018 - &gt; Wahoo Bolt,430,428,2
121482,1614417836,wahoo,Zwift - DBR SufferDay League III (A),Power2Max NG -&gt; Zwift,Wahoo Kickr 2018 - &gt; Wahoo Bolt,435,437,-2
122001,1614503512,wahoo,SloZl - Fight for Jersey (7/11),Power2Max NG -&gt; Zwift,Wahoo Kickr 2018 - &gt; Wahoo Bolt,424,424,0
128305,1615713040,wahoo,SloZl - Fight for Jersey (9/11),Power2Max NG -&gt; Zwift,Wahoo Kickr 2018 - &gt; Wahoo Bolt,435,421,14
13916,1581686495,wahoo,Tour de Zwift: Stage 6 Group Ride,Assioma Duo Pedals,Wahoo KICKR v2,369,381,-12
14038,1581749908,wahoo,Zwift - 3R Mountain Madness Steady Ride [~3.0w/kg avg] (B),Assioma Duo Pedals,Wahoo KICKR v2,348,343,5
14039,1581753585,wahoo,Zwift NL Mega Pretzel - Lekker tochtje hoor!,Assioma Duo Pedals,Wahoo KICKR v2,346,351,-5
15039,1582291232,wahoo,Zwift - Tour of Innsbruck // Stage 1,Assioma Duo Pedals,Wahoo KICKR v2,379,374,5
15066,1582305928,wahoo,Zwift - 3R PedalPlay Interval Ride [~3.5-4+w/kg avg] (B),Assioma Duo Pedals,Wahoo KICKR v2,296,298,-2
15145,1582357501,wahoo,Zwift - 3R 160 Steady Ride [~3.0w/kg avg] (B),Assioma Duo Pedals,Wahoo KICKR v2,258,261,-3
41054,1591894827,wahoo,Zwift - Espresso,Assioma Duo Pedals,Wahoo KICKR 2018,381,388,-7
41353,1592031354,wahoo,Zwift - 3R Hilly Race - Yorkshire Tour of Tewit Well - 3 Laps (A),Assioma Duo Pedals,Wahoo KICKR 2018,403,411,-8
41454,1592057051,wahoo,Zwift - OH CRIT!! - Saturday Smash Series (A),Assioma Duo Pedals,Wahoo KICKR 2018,406,410,-4
42018,1592331509,wahoo,Zwift - 3R & Wahoo Ride Real Race Series - Round 5 of 7 (A),Assioma Duo Pedals,Wahoo KICKR 2018,401,407,-6
51543,1598292883,wahoo,Zwift - TFC Mad Monday Summer Series (8 of 10) (A),Assioma Duo Pedals,Wahoo KICKR 2018,414,418,-4
52203,1598549756,wahoo,Zwift - WTRL Team Time Trial (C),Assioma Duo Pedals,Wahoo KICKR 2018,386,397,-11
52342,1598599488,wahoo,Zwift - Off The MAAP Stage 4 - Longer Ride,Assioma Duo Pedals,Wahoo KICKR 2018,312,314,-2
55062,1600105402,wahoo,Zwift - Invitational League // Qualifying Race #1,Assioma Duo Pedals,Wahoo KICKR 2018,390,408,-18
55402,1600194162,wahoo,Zwift - 3R Sundown Race Series  (E),Assioma Duo Pedals,Wahoo KICKR 2018,390,397,-7
56454,1600605464,wahoo,Zwift - Invitational League // Qualifying Race #3 (Men) (A),Assioma Duo Pedals,Wahoo KICKR 2018,410,413,-3
56969,1600853679,wahoo,Zwift - USA Cycling Race League by Indoor Specialist (A),Assioma Duo Pedals,Wahoo KICKR 2018,368,373,-5
57846,1601193090,wahoo,Zwift - Erik Haugen [R3R]&#039;s Meetup - Three Sisters,Assioma Duo Pedals,Wahoo KICKR 2018,400,408,-8
58019,1601295155,wahoo,Zwift - Zach Harner [R3R]&#039;s Meetup - Three Sisters,Assioma Duo Pedals,Wahoo KICKR 2018,384,380,4
61310,1602527931,wahoo,Zwift - Premier Division // Zwift Racing League (men) ,Assioma Duo Pedals,Wahoo KICKR 2018,407,405,2
61446,1602582927,wahoo,Zwift - KISS at Race - Americas AM (A),Assioma Duo Pedals,Wahoo KICKR 2018,357,355,2
63120,1603129759,wahoo,Zwift - Premier Division // Zwift Racing League (men) ,Assioma Duo Pedals,Wahoo KICKR 2018,399,393,6
65171,1603740812,wahoo,Zwift - Premier Division // Zwift Racing League (men) (A),Assioma Duo Pedals,Wahoo KICKR 2018,394,388,6
67284,1604342647,wahoo,Zwift - Premier Division // Zwift Racing League (men) (A),Assioma Duo Pedals,Wahoo KICKR 2018,409,399,10
74708,1606160212,wahoo,Zwift - Premier Division // Zwift Racing League (men) (A),Assioma Duo Pedals,Wahoo KICKR 2018,374,368,6
76052,1606414515,wahoo,Zwift - WTRL NOPINZ WORLD TTT CHAMPIONSHIPS - Zone 6 (C),Assioma Duo Pedals,Wahoo KICKR 2018,378,377,1
77676,1606761562,wahoo,Zwift - Premier Division // Zwift Racing League (men) (A),Assioma Duo Pedals,Wahoo KICKR 2018,376,370,6
100655,1610998097,wahoo,Zwift - Premier Division // Zwift Racing League (men) (A),Assioma Duo Pedals,Wahoo KICKR 2018,25,409,-384
115434,1613417666,wahoo,Zwift - Premier Division // Zwift Racing League (men) (A),Assioma Duo Pedals,Wahoo KICKR 2018,358,350,8
122563,1614628258,wahoo,Zwift - Premier Division // Zwift Racing League (men) (A),Assioma Duo Pedals,Wahoo KICKR 2018,412,405,7
122564,1614628258,wahoo,Zwift - Premier Division // Zwift Racing League (men) (A),Assioma Duo Pedals,Wahoo KICKR 2018,412,405,7
77709,1606763160,neo,Zwift - Premier Division // Zwift Racing League (men) (A),quarq dzero,Neo,414,410,4
110362,1612686596,neo,7 Feb 2021 Zwift France Tire-Bouchon - Flanders Endurance Race League (A) 12/121 on companion app and 12th on ZwiftPower,Garmin Vector 3S,Tacx Neo 2,376,399,-23
112442,1612982990,neo,10 Feb 2021 Zwift Yorkshire Harrogate Reverse - ATR Clubhouse Bash 4WAY (A) 5/56 on Companion app,Garmin Vector 3S,Tacx Neo 2,371,393,-22
114894,1613291395,neo,"14 Feb 2021 Zwift London - Flanders Endurance Race League (A) 8/75 on companion app leading group of 9, powerdrop on final climb",Garmin Vector 3S,Tacx Neo 2,396,429,-33
115978,1613494020,neo,16 Feb 2021 Zwift France - TDZ Stage 4: Standard Ride,Garmin Vector 3S,Tacx Neo 2,240,240,0
116810,1613587796,neo,17 Feb 2021 Zwift Richmond - ATR Clubhouse Bash 4WAY (A) 3/32 on Companion app and 3rd on ZwiftPower	,Favero Assioma DUO,Tacx Neo 2,393,398,-5
120374,1614192596,neo,24 Feb 2021 Zwift London - ATR Clubhouse Bash 4WAY (A) 4/29 on Companion app,Favero Assioma DUO,Tacx Neo 2,397,405,-8
123682,1614797396,neo,3 Mrt 2021 Zwift New York - ATR Clubhouse Bash 4WAY (A) New York KOM after party 5/39 on Companion app,Favero Assioma DUO,Tacx Neo 2,389,395,-6
126664,1615402196,neo,10 Mrt 2021 Zwift Watopia - ATR Clubhouse Bash 4WAY (A) 10/74,Favero Assioma DUO,Tacx Neo 2,399,400,-1
127198,1615489197,neo,11 Mrt 2021 Zwift Watopia - Flanders The BZR Ronde Spring Classics League (A) 5/50,Favero Assioma DUO,Tacx Neo 2,395,400,-5
71668,1605445356,wahoo,Zwift - Rigo Urán: 2020 El Giro de Rigo - Official Route,Shimano Dura Ace FC-R9100-P,Wahoo Kickr V5,340,342,-2
73768,1605950399,wahoo,Zwift - DBR Saturday Race (A),Shimano Dura Ace FC-R9100-P,Wahoo Kickr V5,350,355,-5
79372,1607084194,wahoo,Zwift - Peak-PTY Climb Challenge Fridays (A),Shimano Dura Ace FC-R9100-P,Wahoo Kickr V5,378,386,-8
79685,1607160178,wahoo,Zwift - DBR Saturday Race (A),Shimano Dura Ace FC-R9100-P,Wahoo Kickr V5,361,371,-10
110076,1612603278,wahoo,Zwift - DBR SufferDay League III (A),Shimano Dura Ace FC-R9100-P,Wahoo Kickr V5,345,347,-2
110077,1612603278,wahoo,Zwift - DBR SufferDay League III (A),Shimano Dura Ace FC-R9100-P,Wahoo Kickr V5,345,347,-2
110078,1612603278,wahoo,Zwift - DBR SufferDay League III (A),Shimano Dura Ace FC-R9100-P,Wahoo Kickr V5,0,0,0
116121,1613502808,wahoo,Zwift - Zwift Racing League | WTRL - Men&#039;s/Mixed EMEA W1 DIVISION 1 (A),Shimano Dura Ace FC-R9100-P,Wahoo Kickr V5,383,387,-4
119787,1614107890,wahoo,Zwift - Zwift Racing League | WTRL - Men&#039;s/Mixed EMEA W1 DIVISION 1 (A),Shimano Dura Ace FC-R9100-P,Wahoo Kickr V5,342,342,0
122793,1614672020,wahoo,Zwift - DBR Morning Race (A),Shimano Dura Ace FC-R9100-P,Wahoo Kickr V5,355,351,4
123679,1614795355,wahoo,Zwift - Scandinavian Cup 2021 - Round 2 - Men (A),Shimano Dura Ace FC-R9100-P,Wahoo Kickr V5,385,385,0
125305,1615096040,wahoo,Zwift COMPLETED - KISS 100 Race Series (EU) - The Uber Pretzel Edition (A),Shimano Dura Ace FC-R9100-P,Wahoo Kickr V5,0,0,0
125306,1615096040,wahoo,Zwift COMPLETED - KISS 100 Race Series (EU) - The Uber Pretzel Edition (A),Shimano Dura Ace FC-R9100-P,Wahoo Kickr V5,352,367,-15
99130,1610996907,neo,Zwift - Premier Division // Zwift Racing League (women) (A),quark crank powermeter,taxc neo 2,276,278,-2
103074,1611604941,neo,Zwift - Premier Division // Zwift Racing League (women) (A),quark crank powermeter,taxc neo 2,282,288,-6
106828,1612206128,neo,Zwift - Premier Division // Zwift Racing League (women) (A),quark crank powermeter,taxc neo 2,266,272,-6
111167,1612814436,neo,Zwift - Premier Division // Zwift Racing League (women) (A),quark crank powermeter,taxc neo 2,275,278,-3
115302,1613415764,neo,Zwift - Premier Division // Zwift Racing League (women) (A),quark crank powermeter,taxc neo 2,274,278,-4
129262,1615919356,neo,Zwift - CeramicSpeed Race Series: Open Race (A),quark crank powermeter,taxc neo 2,275,275,0
46494,1594832214,neo,Zwift - MIDWEEK Summer Series by SZR (A),Vector 3,Neo 2t,348,348,0
46912,1595145048,neo,Zwift - L&#039;Etape du Tour Stage 3 - Open,Favero Assioma DUO,Neo 2t,360,349,11
47130,1595322104,neo,Zwift - 3R Turbocharged Team Race Series - Round 2 (A),Favero Assioma DUO,Neo 2t,324,316,8
47949,1595926883,neo,Zwift - 3R Turbocharged Team Race Series - Round 3 (A),Favero Assioma DUO,Neo 2t,356,352,4
48157,1596041782,neo,Zwift - MIDWEEK Summer Series by SZR (A),Favero Assioma DUO,Neo 2t,339,333,6
