,zwift_id,time,group,title,pm,st,p300s_pm,p300s_st,delta
7932,320,2020-01-02 21:20:46,neo,Zwift - XRS - ZTR Thursday Night Race (B),Assioma Duo Pedals,Neo 1,237,238,-1
12843,320,2020-02-06 21:38:17,neo,Zwift - Tour de Zwift: Stage 7 Race (B),Assioma Duo Pedals,Neo 1,252,248,4
27433,320,2020-04-23 19:17:09,neo,Zwift - Japan Base Ride (2.7~4.5w/kg) 75km (C),Assioma Duo Pedals,Neo 1,239,235,4
54237,320,2020-09-09 20:12:22,neo,Zwift - 3R Classique Flat Race - 5 Laps (32.3km/20.1mi 95m) (B),Assioma Duo Pedals,Neo 1,268,262,6
82359,320,2020-12-06 14:01:35,neo,Zwift - KISS 100 Race Series - Americas (B),Assioma Duo Pedals,Neo 1,252,248,4
82370,320,2020-12-08 21:50:46,neo,Zwift - 3R Classique Flat Race - 5 Laps (32.3km/20.1mi 95m) (B),Assioma Duo Pedals,Neo 1,242,239,3
83740,320,2020-12-15 22:14:46,neo,Zwift - ZHQ FutureWorks Crit City Race - Boost mode (B),Assioma Duo Pedals,Neo 1,263,258,5
94511,320,2021-01-10 14:47:54,neo,Zwift - 3R Endurance Steady Ride [~3.0//2.5w/kg avg] (B),Assioma Duo Pedals,Neo 1,232,229,3
97216,320,2021-01-14 21:35:50,neo,Zwift - TDZ Stage 3: Longer Ride,Assioma Duo Pedals,Neo 1,233,235,-2
105706,320,2021-01-30 14:37:02,neo,Zwift - 3R Endurance Steady Ride [~3.0//2.5//2w/kg avg] (C),Assioma Duo Pedals,Neo 1,238,234,4
119317,320,2021-02-22 20:57:21,neo,Zwift - 3R Watopia Flat Route Reverse Race - 3 Laps (30.8km/19.1mi 162m) (B),Assioma Duo Pedals,Neo 1,270,269,1
120504,320,2021-02-24 21:32:54,neo,Zwift - Long Island Cranx Race (B),Assioma Duo Pedals,Neo 1,271,267,4
75361,365,2020-11-24 17:59:28,neo,WTRL,Assioma,Tacx Neo,309,314,-5
81356,365,2020-12-08 17:52:38,neo,WTRL,Assioma,Tacx Neo,333,339,-6
93216,365,2021-01-07 17:36:01,neo,Korte VO2,P2M,Tacx Neo,263,267,-4
95862,365,2021-01-12 17:50:31,neo,WTRL,Assioma,Tacx Neo,277,273,4
103194,365,2021-01-25 18:07:08,neo,5x 2 min interval,Assioma,Tacx Neo,264,271,-7
112658,365,2021-02-10 17:40:09,neo,Up the Alpe,P2M,Tacx Neo,300,300,0
7590,1412,2019-12-29 18:59:19,wahoo,Zwift - BRT Iron Goat Racing League (A),Duo-Zwift,Kickr &#039;18,369,366,3
7673,1412,2019-12-30 18:15:04,wahoo,Zwift - DBR Monday Race (A),Duo-Zwift,Kickr &#039;18,339,338,1
7694,1412,2019-12-31 01:00:01,wahoo,Zwift - EVR Americas Race (A),Duo-Zwift,Kickr &#039;18,304,294,10
8220,1412,2020-01-06 18:15:12,wahoo,Zwift - DBR Caresport Crit Cup  (A),Duo-Zwift,Zwift - Kickr&#039;18,339,330,9
8684,1412,2020-01-10 00:19:28,wahoo,Zwift - WTRL Team Time Trial (C),Duo-Zwift,Kickr &#039;18,353,348,5
10703,1412,2020-01-24 00:38:14,wahoo,Zwift - WTRL &#039;Ray Mondo&#039; Team Time Trial  (C),Assioma,Kickr &#039;18,365,370,-5
12445,1412,2020-02-04 18:26:25,wahoo,Zwift - Warmup,Assioma,Kickr &#039;18,387,382,5
12585,1412,2020-02-05 17:52:08,wahoo,SZR Winter Race Series,Assioma,Kickr &#039;18,390,382,8
12849,1412,2020-02-07 00:11:25,wahoo,WTRL Team Time Trial - Zone4,Assioma,Kickr &#039;18,357,357,0
13219,1412,2020-02-09 18:50:34,wahoo,Zwift - Zwift Gran Fondo,Stages,Kickr &#039;18,354,359,-5
15002,1412,2020-02-21 00:36:36,wahoo,Zwift - WTRL Team Time Trial (C),Assioma,Kickr &#039;18,357,363,-6
18777,1412,2020-03-19 22:56:21,wahoo,Zwift - KOA Sports Warrior Race (A),Assioma,Kickr &#039;18,376,368,8
22102,1412,2020-04-04 19:54:24,wahoo,Zwift - Japan Endurance 100km Ride 3.0~3.4w/kg (B),Assioma,Kickr &#039;18,278,280,-2
22876,1412,2020-04-07 23:25:07,wahoo,Zwift - Midweek Criterium Race (A),Assioma,Kickr &#039;18,360,356,4
24724,1412,2020-04-14 23:19:48,wahoo,Midweek Criterium Race,Assioma,Kickr &#039;18,365,352,13
24939,1412,2020-04-15 17:26:47,wahoo,Zwift - Watopia,Assioma,Kickr &#039;18,342,338,4
25378,1412,2020-04-16 21:54:24,wahoo,Zwift - XRS - ZTR Thursday Night Race (A),Assioma,Kickr &#039;18,345,339,6
25380,1412,2020-04-16 22:57:13,wahoo,Zwift - Koa Sports League Warrior Race (A),Assioma,Kickr &#039;18,373,367,6
25636,1412,2020-04-17 19:23:50,wahoo,Zwift - Watopia,Assioma,Kickr &#039;18,365,356,9
27356,1412,2020-04-23 17:26:28,wahoo,Zwift - FUSION ECT BEUNSTOPPABLE Racing Series (A),Assioma,Kickr &#039;18,372,365,7
28529,1412,2020-04-27 21:56:31,wahoo,Zwift - ZHQ Beta Crit City Race (A),Assioma,Kickr &#039;18,337,337,0
29157,1412,2020-04-29 17:28:39,wahoo,Zwift - Bullseye Points Race Event (A),Assioma,Kickr &#039;18,347,353,-6
48033,1412,2020-07-28 17:33:26,wahoo,Zwift - Base Building,Stages,Kickr &#039;18,269,267,2
59492,1412,2020-10-04 19:50:32,wahoo,ZA Road WO #1 - Aerobic Power,Assioma,Kickr &#039;18,312,309,3
59818,1412,2020-10-06 16:37:50,wahoo,Zwift - Team Italy Specialissima Race (B),Assioma,Kickr &#039;18,349,341,8
61517,1412,2020-10-13 16:59:21,wahoo,Zwift - Zwift Racing League | WTRL,Assioma,Kickr &#039;18,338,333,5
65434,1412,2020-10-27 17:51:28,wahoo,Zwift - Zwift Racing League | WTRL - EMEA E (MEN) -  Division 2 (B),Assioma,Kickr &#039;18,335,332,3
65799,1412,2020-10-28 17:21:14,wahoo,Zwift - Watopia,Assioma,Kickr &#039;18,301,287,14
67573,1412,2020-11-03 18:17:00,wahoo,Zwift Racing League | WTRL - Mens EMEA E1 DIVISION 2,Assioma,Kickr &#039;18,331,330,1
69775,1412,2020-11-10 17:50:08,wahoo,Zwift - Zwift Racing League | WTRL - EMEA E1 (MEN) -  Division 2 (B),Assioma,Kickr &#039;18,388,380,8
72215,1412,2020-11-17 18:16:59,wahoo,Zwift Racing League | WTRL - Mens EMEA E1 DIVISION 2,Assioma,Kickr &#039;18,331,320,11
75024,1412,2020-11-24 17:57:15,wahoo,Zwift - Zwift Racing League | WTRL - Men&#039;s EMEA E1 DIVISION 2,Assioma,Kickr &#039;18,348,340,8
76552,1412,2020-11-27 17:00:41,wahoo,Zwift - Focus: Colours of PARI - Longer Ride,Assioma,Kickr &#039;18,333,319,14
76555,1412,2020-11-27 17:59:47,wahoo,Zwift - FOCUS: Colours of PARI / Stage Lilac - Focus Team (A),Assioma,Kickr &#039;18,286,270,16
77641,1412,2020-11-30 18:09:42,wahoo,Zwift -  DBR Monday Race (B),Assioma,Kickr &#039;18,339,337,2
78037,1412,2020-12-01 18:16:59,wahoo,Zwift - Zwift Racing League | WTRL - Men&#039;s EMEA E1 DIVISION 2 (B),Assioma,Kickr &#039;18,328,322,6
79188,1412,2020-12-04 00:13:17,wahoo,Zwift - WTRL Team Time Trial - Zone 10 (A),Assioma,Kickr &#039;18,322,312,10
80793,1412,2020-12-08 17:58:16,wahoo,Zwift - Zwift Racing League | WTRL - Men&#039;s EMEA E1 DIVISION 2 (B),Assioma,Kickr &#039;18,350,349,1
83716,1412,2020-12-15 18:16:59,wahoo,Zwift - Zwift Racing League | WTRL - Men&#039;s EMEA E1 DIVISION 2 (B),Assioma,Kickr &#039;18,329,313,16
84560,1412,2020-12-18 00:34:50,wahoo,Zwift - WTRL Team Time Trial - Zone 10 (A),Assioma,Kickr &#039;18,316,314,2
95604,1412,2021-01-12 18:00:32,wahoo,Zwift - Zwift Racing League | WTRL - Men&#039;s/Mixed EMEA E1 DIVISION 2 (B),Assioma0,Kickr &#039;18,335,350,-15
99648,1412,2021-01-19 18:16:54,wahoo,Zwift - Zwift Racing League | WTRL - Men&#039;s/Mixed EMEA E1 DIVISION 2 (B),Assioma,Kickr &#039;18,327,332,-5
101181,1412,2021-01-22 00:34:59,wahoo,Zwift - WTRL Team Time Trial - Zone 10 (A),Assioma,Kickr &#039;18,318,316,2
103514,1412,2021-01-26 17:56:15,wahoo,Zwift - Zwift Racing League | WTRL - Men&#039;s/Mixed EMEA E1 DIVISION 2 (B),Assioma,Kickr &#039;18,343,332,11
109961,1412,2021-02-06 16:20:16,wahoo,Zwift - Watopia,Assioma,Kickr &#039;18,194,186,8
110042,1412,2021-02-06 16:59:26,wahoo,Zwift - 1-14ENDURANCE with NP Bursts 5 x :08 (2:15:04) 10&#039; WU 5&#039; CD,Assioma,Kickr &#039;18,239,234,5
110707,1412,2021-02-07 19:32:26,wahoo,Zwift - Zwift Fondo Series: Ultima Fondo,Assioma,Kickr &#039;18,246,245,1
111858,1412,2021-02-09 18:16:59,wahoo,Zwift - Zwift Racing League | WTRL - Men&#039;s/Mixed EMEA E1 DIVISION 2 (B),Assioma,Kickr &#039;18,348,343,5
113200,1412,2021-02-12 00:34:59,wahoo,Zwift - WTRL Team Time Trial - Zone 12 (A),Assioma,Kickr &#039;18,320,316,4
116209,1412,2021-02-17 00:10:16,wahoo,Zwift - Zwift Racing League | WTRL - Men&#039;s/Mixed AMERICAS E DIVISION 1 (B),Assioma,Kickr &#039;18,364,357,7
116945,1412,2021-02-18 02:04:12,wahoo,Zwift - TDZ Stage 2: Longer Ride,Assioma,Kickr &#039;18,296,284,12
117504,1412,2021-02-19 00:29:31,wahoo,Zwift - WTRL Team Time Trial - Zone 13 (A),Assioma,Kickr &#039;18,315,311,4
117531,1412,2021-02-19 02:24:18,wahoo,Zwift - WTRL Team Time Trial - Zone 14 (D),Assioma,Kickr &#039;18,311,306,5
119583,1412,2021-02-23 18:16:50,wahoo,Zwift - Zwift Racing League | WTRL - Men&#039;s/Mixed EMEA E1 DIVISION 2 (B),Assioma,Kickr &#039;18,333,311,22
119939,1412,2021-02-24 00:30:48,wahoo,Zwift - Zwift Racing League | WTRL - Men&#039;s/Mixed AMERICAS E DIVISION 1 (B),Assioma,Kickr &#039;18,346,339,7
121001,1412,2021-02-26 02:07:29,wahoo,Zwift - WTRL Team Time Trial - Zone 14 (D),Assioma,Kickr &#039;18,309,305,4
121762,1412,2021-02-27 16:42:59,wahoo,Zwift - General Elost&#039;s Meetup - Sand And Sequoias,Assioma,Kickr &#039;18,320,312,8
122929,1412,2021-03-02 18:16:54,wahoo,Zwift - Zwift Racing League | WTRL - Men&#039;s/Mixed EMEA E1 DIVISION 2 (B),Assioma,Kickr &#039;18,321,316,5
124251,1412,2021-03-04 18:19:59,wahoo,Zwift - WTRL Team Time Trial - Zone 6 (A),Assioma,Kickr &#039;18,337,332,5
124300,1412,2021-03-05 02:32:59,wahoo,Zwift - WTRL Team Time Trial - Zone 14 (D),Assioma,Kickr &#039;18,325,324,1
16858,1435,2020-03-05 05:00:02,wahoo,Zwift - Vikings Valhalla Fatburn Ride (D),Assioma,Kickr,290,295,-5
17034,1435,2020-03-06 02:14:41,wahoo,Road To Sky,Assioma,Kickr,274,272,2
17215,1435,2020-03-08 04:59:58,wahoo,SAS - ULTRA 200km (B),Assioma,Kickr,221,228,-7
17620,1435,2020-03-11 03:23:56,wahoo,Epic KOM Reverse,Assioma,Kickr,280,279,1
17746,1435,2020-03-12 01:59:59,wahoo,Zwift - Stage 1 - Longer Ride - Tour of Watopia 2020,Assioma,Kickr,269,270,-1
17991,1435,2020-03-13 23:00:57,wahoo,Zwift - Stage 2 - Shorter Ride - Tour of Watopia 2020,Assioma,Kickr,322,331,-9
35470,1435,2020-05-16 20:59:57,wahoo,Zwift - Cycling Australia&#039;s Triple LoopyHELL by AHDR (B),Assioma Dual,Kickr,326,321,5
36748,1435,2020-05-21 04:09:55,wahoo,Zwift - INC Interval Builder Series - 3.0 - 4.2w/kg (B),Assioma Dual,Kickr,306,314,-8
26031,1548,2020-04-18 17:11:28,wahoo,Escape Velocity Spring Series,Power2Max NG,Kickr18,326,314,12
93124,1548,2021-01-08 01:47:33,wahoo,Zwift - TDZ Stage 1: Longer Ride,Power2Max Type S,Kickr18,296,286,10
93143,1548,2021-01-08 05:39:00,wahoo,Zwift - NYC,Power2Max Type S,Kickr18,124,118,6
93605,1548,2021-01-08 23:35:32,wahoo,Zwift - NYC,Power2Max Type S,Kickr18,184,174,10
93607,1548,2021-01-08 23:35:32,wahoo,Zwift - NYC,Power2Max Type S,Kickr18,167,162,5
94560,1548,2021-01-10 17:33:50,wahoo,Zwift - Wilson Tran&#039;s Meetup - Figure 8,Power2Max NG,Kickr18,324,304,20
95287,1548,2021-01-12 01:39:05,wahoo,Zwift - TDZ Stage 2: Standard Ride,Power2Max NG,Kickr18,359,338,21
95288,1548,2021-01-12 01:39:05,wahoo,Zwift - Yorkshire,Power2Max NG,Kickr18,180,170,10
96025,1548,2021-01-13 01:35:04,wahoo,Zwift - T HrillhouseCycling (THC)&#039;s Meetup - Tick Tock,Power2Max Type S,Kickr18,285,282,3
97247,1548,2021-01-15 00:32:06,wahoo,Zwift - TDZ Stage 3: Longer Ride,Power2Max Type S,Kickr18,312,302,10
98688,1548,2021-01-17 17:49:22,wahoo,Zwift - Wilson Tran&#039;s Meetup - Classique,Power2Max NG,Kickr18,258,243,15
99419,1548,2021-01-19 02:42:02,wahoo,Zwift - France,Power2Max Type S,Kickr18,185,184,1
99574,1548,2021-01-19 13:46:25,wahoo,TDZ Stage 4: Group Ride,Power2Max NG,Kickr18,331,315,16
100589,1548,2021-01-21 01:30:23,wahoo,Zwift - T HrillhouseCycling (THC)&#039;s Meetup - Beach Island Loop,Power2Max NG,Wahoo Kickr 2018,313,295,18
101188,1548,2021-01-22 01:36:33,wahoo,Zwift - NYC,Power2Max NGeco,Wahoo Kickr 2018,194,189,5
101602,1548,2021-01-23 01:34:55,wahoo,Zwift - Innsbruck,Power2Max NGeco,Wahoo Kickr 2018,239,231,8
102144,1548,2021-01-24 00:52:23,wahoo,Zwift - Innsbruck,Power2Max NGeco,Wahoo Kickr 2018,278,266,12
102538,1548,2021-01-24 18:12:41,wahoo,Zwift - Wilson Tran&#039;s Meetup - Classique,Power2Max NG,Wahoo Kickr 2018,208,198,10
103164,1548,2021-01-26 01:46:30,wahoo,Zwift - TDZ Stage 5: Longer Ride,Power2Max NG,Wahoo Kickr 2018,338,322,16
103814,1548,2021-01-27 01:02:38,wahoo,Zwift - Watopia,Power2Max NGeco,Wahoo Kickr 2018,245,239,6
104394,1548,2021-01-28 01:39:10,wahoo,Zwift - T HrillhouseCycling (THC)&#039;s Meetup - Tick Tock,Power2Max NG,Wahoo Kickr 2018,297,283,14
104926,1548,2021-01-29 00:51:11,wahoo,Zwift - London,Power2Max NG,Wahoo Kickr 2018,336,314,22
105326,1548,2021-01-30 01:22:36,wahoo,Zwift - NYC,Power2Max NG,Wahoo Kickr 2018,220,218,2
105966,1548,2021-01-30 21:18:23,wahoo,Zwift - Watopia,Power2Max NG,Wahoo Kickr 2018,243,225,18
106402,1548,2021-01-31 18:21:18,wahoo,Zwift - Wilson Tran&#039;s Meetup - The Fan Flats,Power2Max NG,Wahoo Kickr 2018,253,244,9
106404,1548,2021-01-31 19:54:25,wahoo,Zwift - TDZ Stage 6: Standard Ride,Power2Max NG,Wahoo Kickr 2018,302,291,11
107032,1548,2021-02-02 02:25:35,wahoo,Zwift - Watopia,Power2Max NG,Wahoo Kickr 2018,229,212,17
107696,1548,2021-02-03 00:27:11,wahoo,Zwift - Yorkshire,Power2Max NGeco,Wahoo Kickr 2018,172,165,7
110182,1548,2021-02-06 18:50:23,wahoo,Zwift - TDZ Stage 7: Longer Ride,Power2Max NGeco,Wahoo Kickr 2018,285,283,2
110183,1548,2021-02-06 18:50:23,wahoo,Zwift - Watopia,Power2Max NGeco,Wahoo Kickr 2018,240,236,4
111730,1548,2021-02-09 19:56:59,wahoo,Zwift - Ouch,Power2Max NGeco,Wahoo Kickr 2018,292,294,-2
112141,1548,2021-02-10 13:52:21,wahoo,Zwift - TDZ Stage 8: Group Ride,Power2Max NGeco,Wahoo Kickr 2018,281,277,4
112572,1548,2021-02-11 01:32:26,wahoo,Zwift - T HrillhouseCycling (THC)&#039;s Meetup - 2015 UCI Worlds Course,Power2Max NG,Wahoo Kickr 2018,332,321,11
113208,1548,2021-02-12 00:41:25,wahoo,Zwift - 6x4mins,Power2Max NGeco,Wahoo Kickr 2018,280,285,-5
114487,1548,2021-02-13 22:12:46,wahoo,Zwift - SST (Long),Power2Max NGeco,Wahoo Kickr 2018,238,238,0
114926,1548,2021-02-14 21:13:36,wahoo,Zwift - London,Power2Max NGeco,Wahoo Kickr 2018,288,286,2
115490,1548,2021-02-15 20:02:21,wahoo,Zwift - 12wk Winter plan (advanced) Week 6 Endurance & FTP,Power2Max NGeco,Wahoo Kickr 2018,257,258,-1
116239,1548,2021-02-17 01:26:57,wahoo,Zwift - 6x4mins,Power2Max NGeco,Wahoo Kickr 2018,288,288,0
116942,1548,2021-02-18 01:29:09,wahoo,Zwift - T HrillhouseCycling (THC)&#039;s Meetup - Volcano Flat,Power2Max NGeco,Wahoo Kickr 2018,314,307,7
117529,1548,2021-02-19 02:02:52,wahoo,Zwift - 6x4&#039;s,Power2Max NGeco,Wahoo Kickr 2018,287,286,1
119982,1548,2021-02-24 01:32:35,wahoo,Zwift - 6x4&#039;s w/ modified rest,Power2Max NGeco,Wahoo Kickr 2018,285,288,-3
120525,1548,2021-02-25 01:42:53,wahoo,Zwift - T HrillhouseCycling (THC)&#039;s Meetup - Beach Island Loop,Power2Max NGeco,Wahoo Kickr 2018,295,310,-15
120994,1548,2021-02-26 01:16:44,wahoo,Zwift - 6x4&#039;s w/ modified rest,Power2Max NGeco,Wahoo Kickr 2018,282,289,-7
121939,1548,2021-02-28 01:03:37,wahoo,Zwift - France,Power2Max NGeco,Wahoo Kickr 2018,233,223,10
122237,1548,2021-02-28 19:56:27,wahoo,Zwift - Endurance & SST,Power2Max NGeco,Wahoo Kickr 2018,249,246,3
124279,1548,2021-03-03 01:55:45,wahoo,Zwift - Watopia,Power2Max NGeco,Wahoo Kickr 2018,166,162,4
124280,1548,2021-03-05 00:10:15,wahoo,Zwift - France,Power2Max NGeco,Wahoo Kickr 2018,173,168,5
125253,1548,2021-03-06 20:49:58,wahoo,Zwift - Endurance & FTP,Power2Max NGeco,Wahoo Kickr 2018,274,272,2
125550,1548,2021-03-07 19:59:58,wahoo,Zwift - FTP Test,Power2Max NGeco,Wahoo Kickr 2018,306,300,6
125924,1548,2021-03-09 01:52:04,wahoo,Zwift - Watopia,Power2Max NGeco,Wahoo Kickr 2018,168,165,3
126335,1548,2021-03-10 00:26:01,wahoo,Zwift - 6x4&#039;s,Power2Max NGeco,Wahoo Kickr 2018,305,304,1
126789,1548,2021-03-11 01:40:43,wahoo,Zwift - T HrillhouseCycling (THC)&#039;s Meetup - Tick Tock,Power2Max NGeco,Wahoo Kickr 2018,301,293,8
127299,1548,2021-03-12 01:59:57,wahoo,Zwift - London,Power2Max NGeco,Wahoo Kickr 2018,218,212,6
127669,1548,2021-03-13 01:11:07,wahoo,Zwift - 6x4&#039;s,Power2Max NGeco,Wahoo Kickr 2018,300,296,4
8905,1623,2019-12-17 00:56:16,wahoo,Zwift - SAS - Sequoias 50km (C),Favero Duo,Kickr 18,226,230,-4
99619,1765,2021-01-19 16:30:18,wahoo,Stages Zwift / Kickr,Stages Zwift,Kickr,372,348,24
103408,1765,2021-01-26 16:30:23,wahoo,Stages Zwift / Kickr,Stages Zwift,Kickr,341,342,-1
105142,1765,2021-01-29 15:15:14,wahoo,Stages Zwift / Kickr,Stages Zwift,Kickr,357,339,18
105650,1765,2021-01-30 15:15:22,wahoo,Stages Zwift / Kickr,Stages Zwift,Kickr,384,381,3
109335,1765,2021-02-05 15:15:14,wahoo,Stages Zwift / Kickr,Stages Zwift,Kickr,358,344,14
114174,1765,2021-02-13 15:15:22,wahoo,Stages Zwift / Kickr,Stages Zwift,Kickr,399,427,-28
119021,1765,2021-02-22 16:40:27,wahoo,Stages Zwift / Kickr,Stages Zwift,Kickr,353,350,3
121683,1765,2021-02-27 16:30:26,wahoo,Stages Zwift / Kickr,Stages Zwift,Kickr,371,351,20
123471,1765,2021-03-03 14:00:16,wahoo,Stages Zwift / Kickr,Stages Zwift,Kickr,387,374,13
126138,1765,2021-03-09 16:05:25,wahoo,Stages Zwift / Kickr,Stages Zwift,Kickr,341,353,-12
127475,1765,2021-03-12 15:15:15,wahoo,Stages Zwift / Kickr,Stages Zwift,Kickr,372,348,24
129076,1765,2021-03-16 16:30:18,wahoo,Stages Zwift / Kickr,Stages Zwift,Kickr,335,334,1
323,1978,2019-08-16 15:14:49,neo,Zwift - 3R Sand and Sequoias Race (A),Stages G2 Dura-ace,Neo,347,350,-3
1738,1978,2019-09-12 17:12:21,neo,Zwift - ZHR Hare & Hounds Race (A),Stages G2 Dura-ace,Neo,342,346,-4
2360,1978,2019-09-22 17:03:36,neo,Zwift - Yorkshire Power Up Tour: Climber Stage (A),Stages G2 Dura-ace,Neo,331,341,-10
2399,1978,2019-09-23 18:13:12,neo,Zwift - Yorkshire World Championships Week - ITT #1 (A),Stages G2 Dura-ace,Neo,350,343,7
2455,1978,2019-09-24 16:05:00,neo,Zwift - Yorkshire World Championships Week - ITT #2 (A),Stages G2 Dura-ace,Neo,328,343,-15
2557,1978,2019-09-25 15:28:21,neo,Zwift Academy 2019 Workout #7: VO2max Development,Stages G2 Dura-ace,Neo,364,367,-3
2730,1978,2019-09-27 16:00:01,neo,Zwift - KISS AT Base (B),Stages G2 Dura-ace,Neo,267,263,4
2835,1978,2019-09-29 08:05:16,neo,Zwift - Yorkshire World Championships Week - Road Event #4 (A),Stages G2 Dura-ace,Neo,322,326,-4
40285,1978,2020-04-17 14:46:55,wahoo,ZHQ Beta Crit City Race,Stages G2 Dura-ace,Kickv4,354,361,-7
89395,1978,2020-12-31 12:00:44,wahoo,Zwift - Roll with Castelli - Let&#039;s Climb (C),Rotor Inspider,Kickv5,263,257,6
101971,1978,2021-01-23 16:59:35,wahoo,INC Relentless Steady State,Rotor Inspider,Kickv5,375,365,10
103656,1978,2021-01-26 19:44:53,wahoo,Zwift Racing League | WTRL - Mens/Mixed EMEA W1 DIVISION 2,Rotor Inspider,Kickv5,358,348,10
105156,1978,2021-01-29 16:00:22,wahoo,Zwift - TDZ Stage 6: Longer Ride,Rotor Inspider,Kickv5,347,346,1
106075,1978,2021-01-31 10:11:46,wahoo,z1 for late breakfast,Rotor Inspider,Kickv5-bolt,258,254,4
107503,1978,2021-02-02 19:41:18,wahoo,Zwift - Zwift Racing League | WTRL - Men&#039;s/Mixed EMEA W1 DIVISION 2 (A),Rotor Inspider,Kickv5,365,358,7
108853,1978,2021-02-04 18:03:57,wahoo,WTRL TTT PL - PedalPower,Rotor Inspider,Kickv5,357,357,0
110345,1978,2021-02-07 09:20:32,wahoo,Zwift - Zwift Fondo Series: Gran Fondo,Rotor Inspider,Kickv5,346,344,2
112962,1978,2021-02-11 17:54:43,wahoo,Donny Chain Gang,Rotor Inspider,Kickv5,365,364,1
113468,1978,2021-02-12 16:58:38,wahoo,Zwift - TDZ Stage 8: Group Ride,Rotor Inspider,Kickv5,347,350,-3
119024,1978,2021-02-22 16:48:32,wahoo,Zwift - INC Relentless Steady State (C),Rotor Inspider,Kickv5,223,220,3
123133,1978,2021-03-02 19:46:30,wahoo,Zwift Racing League | WTRL - Mens/Mixed EMEA W1 DIVISION 2,Rotor Inspider,Kickv5,361,362,-1
123318,2492,2021-03-03 00:56:31,wahoo,Zwift - Zwift Racing League | WTRL - Men&#039;s/Mixed AMERICAS E DIVISION 3 (B),SRM X-Power Green,Kickr,391,368,23
123321,2492,2021-02-24 00:48:53,wahoo,Zwift - Zwift Racing League | WTRL - Men&#039;s/Mixed AMERICAS E DIVISION 3 (B),SRM X-Power Black,Kickr,365,349,16
128555,2492,2021-03-14 18:14:55,wahoo,Zwift - SAS - Brekki at Minks (B),Rally,Kickr,352,339,13
31669,2580,2020-05-05 15:31:46,wahoo,Zwift - 5x5&#039; HS VO2supermax,Stages Gen 3 L,Wahoo KICKR 18,416,412,4
31676,2580,2020-05-05 15:31:46,wahoo,Zwift - BST Happy Mountaingoats&#039; Hill Climb TT (A),Gen 3 Stages Power L,Wahoo KICKR 17,374,360,14
32154,2580,2020-05-06 15:35:19,wahoo,Zwift - Richmond,Gen 3 Stages Power L,Wahoo KICKR &#039;17,217,229,-12
32536,2580,2020-05-07 16:30:43,wahoo,Zwift - WTRL Team Time Trial (C),Gen 3 Stages Power L,Wahoo KICKR &#039;17,379,392,-13
33065,2580,2020-05-09 14:27:59,wahoo,Zwift - Team ODZ Spokane Cat and Mouse (A),Gen 3 Stages Power L,Wahoo KICKR &#039;17,387,395,-8
33321,2580,2020-05-10 13:11:01,wahoo,Zwift - KISS at Race 100 - Americas (A),Gen 3 Stages Power L,Wahoo KICKR &#039;17,367,377,-10
33942,2580,2020-05-12 14:29:18,wahoo,Zwift - Hard-start VO2max,Gen 3 Stages Power L,Wahoo KICKR &#039;17,422,429,-7
33944,2580,2020-05-12 14:29:21,wahoo,BST Happy Mountaingoats&#039; Hill Climb TT (A),Gen 3 Stages Power L,Wahoo KICKR &#039;17,369,367,2
34856,2580,2020-05-14 16:47:13,wahoo,Zwift - WTRL Team Time Trial Premier League (C),Gen 3 Stages Power L,Wahoo KICKR &#039;17,366,368,-2
35640,2580,2020-05-17 12:45:22,wahoo,Zwift - KISS at Race 100 - Americas (A),Gen 3 Stages Power L,Wahoo KICKR &#039;17,362,373,-11
36717,2580,2020-05-21 16:37:18,wahoo,Zwift - WTRL Team Time Trial (C),Gen 3 Stages Power L,Wahoo KICKR &#039;17,366,377,-11
36933,2580,2020-05-22 21:30:06,wahoo,Zwift - JETT TT Race (E),Gen 3 Stages Power L,Wahoo KICKR &#039;17,387,396,-9
37155,2580,2020-05-23 13:56:57,wahoo,Zwift - OCA Indoor Race Series (A),Gen 3 Stages Power L,Wahoo KICKR &#039;17,365,373,-8
37596,2580,2020-05-25 12:58:14,wahoo,Zwift - Crit City Race (A),Gen 3 Stages Power L,Wahoo KICKR &#039;17,364,380,-16
37814,2580,2020-05-26 14:41:10,wahoo,Zwift - BST Happy Mountaingoats&#039; Hill Climb TT (A),Gen 3 Stages Power L,Wahoo KICKR &#039;17,355,353,2
38400,2580,2020-05-28 16:37:37,wahoo,Zwift - WTRL Team Time Trial Premier League (C),Gen 3 Stages Power L,Wahoo KICKR &#039;17,387,396,-9
38696,2580,2020-05-30 12:49:05,wahoo,Zwift - 3R Innsbruckring Flat Race - 5 Laps (44km/27.3mi 385m) (A),Gen 3 Stages Power L,Wahoo KICKR &#039;17,378,388,-10
38833,2580,2020-05-31 12:42:15,wahoo,Zwift - KISS at Race 100 - Americas (A),Gen 3 Stages Power L,Wahoo KICKR &#039;17,346,359,-13
39146,2580,2020-06-02 17:09:41,wahoo,Zwift - 3R & Wahoo Ride Real Race Series - 4 of 7 (A),Gen 3 Stages Power L,Wahoo KICKR &#039;17,360,368,-8
39651,2580,2020-06-04 16:37:11,wahoo,Zwift - WTRL Team Time Trial - Zone3 (Espresso),Gen 3 Stages Power L,Wahoo KICKR &#039;17,366,372,-6
40000,2580,2020-06-06 13:10:54,wahoo,Zwift - Team Italy Specialissima Race  (A),Gen 3 Stages Power L,Wahoo KICKR &#039;17,333,345,-12
40200,2580,2020-06-07 12:42:33,wahoo,Zwift - KISS at Race 100 - Americas (A),Gen 3 Stages Power L,Wahoo KICKR &#039;17,398,392,6
41048,2580,2020-06-11 15:57:08,wahoo,Zwift - Unstructured Test,Gen 3 Stages Power L,Wahoo KICKR &#039;17,372,371,1
41626,2580,2020-06-13 13:50:25,wahoo,Zwift - CCBoucherville-V2000 FUN Races (A),Gen 3 Stages Power L,Wahoo KICKR &#039;17,357,367,-10
41966,2580,2020-06-16 14:43:17,wahoo,Zwift - BST Happy Mountaingoats&#039; Hill Climb TT (A),Gen 3 Stages Power L,Wahoo KICKR &#039;17,389,387,2
42215,2580,2020-06-17 16:33:37,wahoo,Zwift - USA Cycling Race League by Indoor Specialist (A),Gen 3 Stages Power L,Wahoo KICKR &#039;17,342,356,-14
42670,2580,2020-06-19 22:59:05,wahoo,Zwift - VIRTUAL JOE MARTIN STAGE RACE ITT,Gen 3 Stages Power L,Wahoo KICKR &#039;17,381,387,-6
42890,2580,2020-06-20 15:10:48,wahoo,Zwift - VIRTUAL JOE MARTIN STAGE RACE,Gen 3 Stages Power L,Wahoo KICKR &#039;17,379,387,-8
42993,2580,2020-06-21 15:04:22,wahoo,Zwift - VIRTUAL JOE MARTIN STAGE RACE (A),Gen 3 Stages Power L,Wahoo KICKR &#039;17,367,375,-8
43604,2580,2020-06-25 17:28:49,wahoo,Zwift - Espresso,Gen 3 Stages Power L,Wahoo KICKR &#039;17,370,378,-8
44589,2580,2020-07-02 17:29:57,wahoo,Zwift - Espresso,Gen 3 Stages Power L,Wahoo KICKR &#039;17,383,382,1
45670,2580,2020-07-09 17:30:09,wahoo,Zwift - WTRL Team Time Trial - Espresso,Gen 3 Stages Power L,Wahoo KICKR &#039;17,359,371,-12
47467,2580,2020-07-23 16:45:36,wahoo,Zwift - WTRL Team Time Trial - Espresso (C),Gen 3 Stages Power L,Wahoo KICKR &#039;17,373,379,-6
47652,2580,2020-07-25 13:43:50,wahoo,Zwift - OH MY CRIT!! - Saturday Smash Race (A),Gen 3 Stages Power L,Wahoo KICKR &#039;17,386,378,8
47774,2580,2020-07-26 12:47:41,wahoo,Zwift - KISS at Race 100 - Americas (A),Gen 3 Stages Power L,Wahoo KICKR &#039;17,357,363,-6
47997,2580,2020-07-28 14:41:16,wahoo,BST Happy Mountaingoats&#039; Hill Climb TT (A),Gen 3 Stages Power L,Wahoo KICKR &#039;17,359,366,-7
48333,2580,2020-07-30 16:46:22,wahoo,Zwift - Espresso,Gen 3 Stages Power L,Wahoo KICKR &#039;17,389,391,-2
48497,2580,2020-08-01 13:42:34,wahoo,Zwift - DIRT Dadurday Chase Race  (A),Gen 3 Stages Power L,Wahoo KICKR &#039;17,375,380,-5
48592,2580,2020-08-02 12:46:47,wahoo,Zwift - KISS at Race 100 - Americas (A),Gen 3 Stages Power L,Wahoo KICKR &#039;17,382,375,7
49090,2580,2020-08-06 16:49:00,wahoo,Zwift -  Espresso,Gen 3 Stages Power L,Wahoo KICKR &#039;17,392,388,4
49305,2580,2020-08-08 14:00:24,wahoo,Zwift - EVR Summer Series (A),Gen 3 Stages Power L,Wahoo KICKR &#039;17,400,404,-4
49375,2580,2020-08-09 12:47:10,wahoo,Zwift - KISS at Race 100 - Americas (A),Gen 3 Stages Power L,Wahoo KICKR &#039;17,374,369,5
49846,2580,2020-08-13 16:48:21,wahoo,Zwift -  Espresso,Gen 3 Stages Power L,Wahoo KICKR &#039;17,378,378,0
50150,2580,2020-08-15 13:47:10,wahoo,Zwift - OH MY CRIT - Saturday Smash Race (A),Gen 3 Stages Power L,Wahoo KICKR &#039;17,400,407,-7
50240,2580,2020-08-16 12:49:19,wahoo,Zwift - KISS at Race 100 - Americas (A),Gen 3 Stages Power L,Wahoo KICKR &#039;17,388,392,-4
50550,2580,2020-08-18 14:45:54,wahoo,Zwift - BST Happy Mountaingoats&#039; Hill Climb TT (A),Gen 3 Stages Power L,Wahoo KICKR &#039;17,399,396,3
50719,2580,2020-08-19 14:40:49,wahoo,Zwift - Off The MAAP Stage 2 Race (A),Gen 3 Stages Power L,Wahoo KICKR &#039;17,324,328,-4
50943,2580,2020-08-20 16:47:32,wahoo,Zwift -  Espresso,Gen 3 Stages Power L,Wahoo KICKR &#039;17,384,386,-2
51259,2580,2020-08-22 13:33:42,wahoo,Zwift - XRS Races: Saturday Climbing Series (A),Gen 3 Stages Power L,Wahoo KICKR &#039;17,389,397,-8
51361,2580,2020-08-23 12:49:25,wahoo,Zwift - KISS at Race 100 - Americas (A),Gen 3 Stages Power L,Wahoo KICKR &#039;17,399,399,0
52186,2580,2020-08-27 16:33:21,wahoo,Zwift - WTRL Team Time Trial (Espresso),Gen 3 Stages Power L,Wahoo KICKR &#039;17,389,396,-7
52510,2580,2020-08-29 13:46:36,wahoo,Zwift - OH MY CRIT - Saturday Smash Race* (A),Gen 3 Stages Power L,Wahoo KICKR &#039;17,399,401,-2
53229,2580,2020-09-03 16:40:33,wahoo,Zwift - WTRL Team Time Trial (Espresso),Gen 3 Stages Power L,Wahoo KICKR &#039;17,373,380,-7
53952,2580,2020-09-08 15:17:37,wahoo,Zwift - BST Happy Mountaingoats&#039; Hill Climb TT (A),Gen 3 Stages Power L,Wahoo KICKR &#039;17,398,409,-11
54730,2580,2020-09-12 13:44:07,wahoo,Zwift - OH MY CRIT - Saturday Smash Race (A),Gen 3 Stages Power L,Wahoo KICKR &#039;17,427,399,28
55035,2580,2020-09-14 17:16:18,wahoo,Zwift - Invitational League // Qualifying Race #1,Gen 3 Stages Power L,Wahoo KICKR &#039;17,383,395,-12
55348,2580,2020-09-15 14:44:38,wahoo,Zwift - BST Happy Mountaingoats&#039; Hill Climb TT (A),Gen 3 Stages Power L,Wahoo KICKR &#039;17,368,369,-1
55929,2580,2020-09-17 17:08:20,wahoo,Zwift - Invitational League // Qualifying Race #2 (Men) ,Gen 3 Stages Power L,Wahoo KICKR &#039;17,361,380,-19
56167,2580,2020-09-18 16:23:39,wahoo,Zwift - GGCC GlasgowGreen CC TT (A),Gen 3 Stages Power L,Wahoo KICKR &#039;17,351,371,-20
56464,2580,2020-09-20 12:10:49,wahoo,Zwift - Invitational League // Qualifying Race #3 (Men) (A),Gen 3 Stages Power L,Wahoo KICKR &#039;17,369,380,-11
57272,2580,2020-09-24 16:44:47,wahoo,Zwift - WTRL Team Time Trial (Espresso),Gen 3 Stages Power L,Wahoo KICKR &#039;17,384,394,-10
57748,2580,2020-09-26 14:32:27,wahoo,Zwift - Three Sisters Test,Gen 3 Stages Power L,Wahoo KICKR &#039;17,393,414,-21
58532,2580,2020-09-30 16:40:17,wahoo,Zwift - Watopia,Rotor 2InPower,Wahoo KICKR &#039;17,239,243,-4
58836,2580,2020-10-01 16:47:50,wahoo,Zwift - WTRL Team Time Trial (Espresso),Gen 3 Stages Power L,Wahoo KICKR &#039;17,362,378,-16
60989,2580,2020-10-11 12:24:32,wahoo,2020 USA Cycling Esports Trials (RGT Cycling),Gen 3 Stages Power L,Wahoo KICKR &#039;17,370,378,-8
62168,2580,2020-10-15 16:28:00,wahoo,Zwift - WTRL Team Time Trial (Espresso),Gen 3 Stages Power L,Wahoo KICKR &#039;17,356,374,-18
63428,2580,2020-10-20 16:34:22,wahoo,Zwift - Zwift Racing League | WTRL - EMEA E (MEN) - TTT Grp 2 (B),Gen 3 Stages Power L,Wahoo KICKR &#039;17,366,386,-20
64197,2580,2020-10-22 16:42:19,wahoo,Zwift - WTRL Team Time Trial (Espresso),Gen 3 Stages Power L,Wahoo KICKR &#039;17,372,386,-14
65449,2580,2020-10-27 17:30:32,wahoo,Zwift - Zwift Racing League | WTRL - EMEA E (MEN) -  Division 1 (A),Gen 3 Stages Power L,Wahoo KICKR &#039;17,367,392,-25
66429,2580,2020-10-29 17:38:23,wahoo,Zwift - WTRL Team Time Trial Platinum League (C),Gen 3 Stages Power L,Wahoo KICKR &#039;17,357,385,-28
66720,2580,2020-10-31 14:56:04,wahoo,Zwift - Halloween Horrur Record Attempt,Gen 3 Stages Power L,Wahoo KICKR &#039;17,339,367,-28
67603,2580,2020-11-03 17:56:44,wahoo,Zwift - Zwift Racing League | WTRL - Men&#039;s EMEA E1 DIVISION 1 (A),Gen 3 Stages Power L,Wahoo KICKR &#039;17,385,397,-12
68238,2580,2020-11-05 18:09:52,wahoo,Zwift - Espresso,Gen 3 Stages Power L,Wahoo KICKR &#039;17,377,379,-2
69791,2580,2020-11-10 17:27:32,wahoo,Zwift - Zwift Racing League | WTRL - EMEA E1 (MEN) -  Division 1 (A),Gen 3 Stages Power L,Wahoo KICKR &#039;17,402,414,-12
70846,2580,2020-11-12 18:07:24,wahoo,Zwift - WTRL Team Time Trial (Espresso),Gen 3 Stages Power L,Wahoo KICKR &#039;17,368,380,-12
73653,2580,2020-11-19 18:09:20,wahoo,Zwift - WTRL Team Time Trial - Espresso,Gen 3 Stages Power L,Wahoo KICKR &#039;17,374,387,-13
75050,2580,2020-11-24 17:29:07,wahoo,Zwift - Zwift Racing League | WTRL - Men&#039;s EMEA E1 DIVISION 1,Gen 3 Stages Power L (BT),Wahoo KICKR &#039;17,381,400,-19
76004,2580,2020-11-26 17:02:41,wahoo,Zwift - WTRL NOPINZ WORLD TTT CHAMPIONSHIPS - Zone 3 (C),Gen 3 Stages Power L (BT),Wahoo KICKR &#039;17,387,409,-22
78025,2580,2020-12-01 16:45:28,wahoo,Zwift - BST Happy Mountaingoats&#039; Hill Climb TT (A),Gen 3 Stages Power L (BT),Wahoo KICKR &#039;17,367,378,-11
79087,2580,2020-12-03 18:02:18,wahoo,Zwift - WTRL Team Time Trial (Espresso) - PL,Gen 3 Stages Power L (BT),Wahoo KICKR &#039;17,381,393,-12
79784,2580,2020-12-05 13:49:13,wahoo,Zwift - VACA Saturday Smackdown (A),Gen 3 Stages Power L (BT),Wahoo KICKR &#039;17,351,368,-17
80828,2580,2020-12-08 17:32:33,wahoo,Zwift - Zwift Racing League | WTRL - Men&#039;s EMEA E1 DIVISION 1 (A),Gen 3 Stages Power L (BT),Wahoo KICKR &#039;17,369,395,-26
81604,2580,2020-12-10 18:16:59,wahoo,Zwift - WTRL Team Time Trial - Espresso,Gen 3 Stages Power L (BT),Wahoo KICKR &#039;17,366,401,-35
87053,2580,2020-12-24 18:44:42,wahoo,Zwift - WTRL Team Time Trial - Zone 8 (C),Gen 3 Stages Power L (BT),Wahoo KICKR &#039;17,366,384,-18
89608,2580,2020-12-31 18:05:53,wahoo,Zwift - WTRL Team Time Trial (Doppio) PL,Gen 3 Stages Power L (BT),Wahoo KICKR &#039;17,348,365,-17
92880,2580,2021-01-07 17:31:09,wahoo,Zwift - Vienna,Gen 3 Stages Power L (BT),Wahoo KICKR &#039;17,376,389,-13
95650,2580,2021-01-12 17:32:46,wahoo,Zwift - Zwift Racing League | WTRL - Men&#039;s/Mixed EMEA E1 DIVISION 1 (A),Gen 3 Stages Power L (BT),Wahoo KICKR &#039;17,356,381,-25
96975,2580,2021-01-14 17:29:31,wahoo,Zwift - Vienna,Gen 3 Stages Power L (BT),Wahoo KICKR &#039;17,366,390,-24
99773,2580,2021-01-19 17:40:25,wahoo,Zwift - Zwift Racing League | WTRL - Men&#039;s/Mixed EMEA E1 DIVISION 1 (A),Gen 3 Stages Power L (ANT+),Wahoo KICKR &#039;17,369,395,-26
105060,2580,2021-01-28 17:36:01,wahoo,Zwift - WTRL Team Time Trial Platinum League (Doppio),Gen 3 Stages Power L (BT),Wahoo KICKR &#039;17,348,375,-27
107320,2580,2021-02-02 17:51:41,wahoo,Zwift - Zwift Racing League | WTRL - Men&#039;s/Mixed EMEA E1 DIVISION 1 (A),Gen 3 Stages Power L (BT),Wahoo KICKR &#039;17,367,393,-26
109043,2580,2021-02-04 17:31:43,wahoo,Zwift - WTRL Team Time Trial Platinum League (Doppio),Gen 3 Stages Power L (BT),Wahoo KICKR &#039;17,354,381,-27
110361,2580,2021-02-06 17:47:51,wahoo,Zwift - 3R Three Sisters Hilly Race (47km/29.2mi 879m) (A),Gen 3 Stages Power L (BT),Wahoo KICKR &#039;17,378,392,-14
112150,2580,2021-02-09 17:33:51,wahoo,Zwift - Zwift Racing League | WTRL - Men&#039;s/Mixed EMEA E1 DIVISION 1 (A),Gen 3 Stages Power L (BT),Wahoo KICKR &#039;17,370,391,-21
113033,2580,2021-02-11 17:37:15,wahoo,Zwift - WTRL Team Time Trial Platinum League (Doppio),Gen 3 Stages Power L (BT),Wahoo KICKR &#039;17,354,376,-22
115840,2580,2021-02-16 17:31:11,wahoo,Zwift - Zwift Racing League | WTRL - Men&#039;s/Mixed EMEA E1 DIVISION 1 (A),Gen 3 Stages Power L (BT),Wahoo KICKR &#039;17,385,416,-31
117252,2580,2021-02-18 17:39:24,wahoo,WTRL Team Time Trial Platinum League (Doppio),Gen 3 Stages Power L (BT),Wahoo KICKR &#039;17,349,374,-25
118253,2580,2021-02-20 14:01:15,wahoo,Zwift - VACA Saturday Smackdown (A),Gen 3 Stages Power L (BT),Wahoo KICKR &#039;17,358,365,-7
119731,2580,2021-02-23 17:30:14,wahoo,Zwift - Zwift Racing League | WTRL - Men&#039;s/Mixed EMEA E1 DIVISION 1 (A),Gen 3 Stages Power L (BT),Wahoo KICKR &#039;17,354,379,-25
120767,2580,2021-02-25 17:42:13,wahoo,Zwift - WTRL Team Time Trial Platinum League (Doppio),Gen 3 Stages Power L (BT),Wahoo KICKR &#039;17,353,374,-21
121835,2580,2021-02-26 21:31:53,wahoo,Zwift - Haute Route Watopia 2021 Stage 1 (A),Gen 3 Stages Power L (BT),Wahoo KICKR &#039;17,347,362,-15
121838,2580,2021-02-27 16:30:16,wahoo,Zwift - Haute Route Watopia 2021 Stage 2 (A),Gen 3 Stages Power L (BT),Wahoo KICKR &#039;17,350,357,-7
122149,2580,2021-02-28 16:31:16,wahoo,Zwift - Haute Route Watopia 2021 Stage 3 (A),Gen 3 Stages Power L (BT),Wahoo KICKR &#039;17,347,361,-14
124049,2580,2021-03-04 17:29:36,wahoo,Zwift - WTRL Team Time Trial Platinum League (Doppio),Gen 3 Stages Power L (BT),Wahoo KICKR &#039;17,370,394,-24
125428,2580,2021-03-07 14:31:05,wahoo,Zwift - Runaway Rock-iTT Race Series (A),Rotor 2InPower,Wahoo KICKR &#039;17,346,359,-13
128699,2580,2021-03-14 14:26:10,wahoo,Zwift - Runaway Rock-iTT Race Series (A),Gen 3 Stages Power L (BT),Wahoo KICKR &#039;17,341,354,-13
6429,2592,2019-12-16 18:50:59,wahoo,Zwift - BRT Ages Training Race (B),Assioma Duo,KICKR,345,345,0
6627,2592,2019-12-18 18:54:59,wahoo,Zwift - DIRT & IS: Baker&#039;s Dozen (A),Assioma Duo,KICKR,363,365,-2
6871,2592,2019-12-20 18:59:59,wahoo,Zwift - 12/20/2019,Assioma Duo,KICKR,361,362,-1
7054,2592,2019-12-22 18:14:59,wahoo,Zwift - 3R Watopia Hilly Reverse Race - 4 Laps,Assioma Duo,KICKR,351,354,-3
7132,2592,2019-12-23 18:09:59,wahoo,Zwift - Chris&#039; Christmas Chase! (A),Assioma Duo,KICKR,379,382,-3
7210,2592,2019-12-24 17:39:59,wahoo,Zwift - Team Italy Specialissima Race (A),Assioma Duo,KICKR,339,347,-8
7399,2592,2019-12-27 10:50:26,wahoo,Zwift - KISS at Base Training Ride (B),Assioma Duo,KICKR,309,303,6
7689,2592,2019-12-30 17:00:17,wahoo,Zwift - KALAS at Second Base  (B),Assioma Duo,KICKR,279,274,5
7744,2592,2019-12-31 16:05:12,wahoo,Zwift - Ultimate - Goodbye 2019 By 3R (A),Assioma Duo,KICKR,356,364,-8
9793,2592,2020-01-17 16:45:00,wahoo,Zwift - Crit City Race (A),Assioma Duo (Zwift),KICKR (Bolt),341,333,8
10454,2592,2020-01-22 18:00:00,wahoo,Zwift - SZR Winter Race Series (A),Assioma Duo (Zwift),KICKR (Bolt),340,346,-6
10617,2592,2020-01-23 18:10:09,wahoo,Zwift - Tour de Zwift: Stage 3 Race (A),Assioma Duo (Zwift),KICKR (Bolt),335,338,-3
11024,2592,2020-01-26 07:25:22,wahoo,Zwift - 3R 100 Steady Ride [~3.0/2.5w/kg avg] (B),Assioma Duo (Zwift),KICKR (Bolt),250,250,0
13328,2592,2020-02-10 20:10:02,wahoo,Zwift - GGCC Glasgow Green Cycle Club Race Series (A),Assioma Duo (Zwift),KICKR (Bolt),359,353,6
13478,2592,2020-02-11 19:00:03,wahoo,Zwift - British Triathlon Winter Series TT Race (E),Assioma Duo (Zwift),KICKR (Bolt),332,338,-6
13605,2592,2020-02-12 17:15:04,wahoo,Zwift - 3R Gotham Grind Flat Race - 3 Laps (27.8km/17.4mi 87m) (A),Assioma Duo (Zwift),KICKR (Bolt),351,354,-3
14181,2592,2020-02-15 10:30:01,wahoo,Zwift - 3R Volcano Climb Race - 1 Lap (22.4km/14mi 204m) (A),Assioma Duo (Zwift),KICKR (Bolt),370,370,0
14182,2592,2020-02-16 10:10:00,wahoo,Zwift - 3R Sand & Sequoias - 1 Lap (20km/12.5mi 173m) (A),Assioma Duo (Zwift),KICKR (Bolt),357,358,-1
14188,2592,2020-02-16 11:05:00,wahoo,Zwift - 3R Innsbruckring Sprint Race - 1 Lap (8.8km/5.5mi 77m) (A),Assioma Duo (Zwift),KICKR (Bolt),349,349,0
15109,2592,2020-02-21 18:45:39,wahoo,Zwift - GGCC GlasgowGreen CC TT  (A),Assioma Duo (Zwift),KICKR (Bolt),347,352,-5
15110,2592,2020-02-21 18:04:59,wahoo,Zwift - KIRCHMAIR February Series 5/8 (A),Assioma Duo (Zwift),KICKR (Bolt),375,375,0
15177,2592,2020-02-22 10:30:01,wahoo,Zwift - 3R Volcano Climb Race - 1 Lap (22.4km/14mi 204m) (A),Assioma Duo (Zwift),KICKR (Bolt),391,393,-2
15330,2592,2020-02-23 12:20:01,wahoo,Zwift - Ottawa TopSpeed Race (A),Assioma Duo (Zwift),KICKR (Bolt),349,344,5
15492,2592,2020-02-24 19:20:01,wahoo,Zwift - TFC & WTRL Mad Monday Race Series (Pilot) (A),Assioma Duo (Zwift),KICKR (Bolt),363,362,1
16159,2592,2020-02-29 16:50:01,wahoo,Zwift - 3R Innsbruckring Flat Race - 3 Laps (26.4km/16.4mi 231m) (A),Assioma Duo (Zwift),KICKR (Bolt),357,358,-1
17312,2592,2020-03-08 10:10:01,wahoo,Zwift - 3R Sand & Sequoias - 1 Lap (20km/12.5mi 173m) (A),Assioma Duo (Zwift),KICKR (Bolt),354,355,-1
17373,2592,2020-03-09 18:10:00,wahoo,Zwift - Stage 1 Race (A) - Tour of Watopia 2020,Assioma Duo (Zwift),KICKR (Bolt),347,346,1
18071,2592,2020-03-14 16:50:01,wahoo,Zwift - 3R Innsbruckring Flat Race - 3 Laps (26.4km/16.4mi 231m) (A),Assioma Duo (Zwift),KICKR (Bolt),351,352,-1
20008,2592,2020-03-27 19:00:06,wahoo,Zwift - The Friday Criterium Winter Race Series  (A),Power2Max (Zwift),KICKR,363,358,5
34197,2592,2020-05-12 18:30:06,wahoo,Zwift - British Cycling Race Series (A),Power2Max (Zwift),KICKR,368,361,7
59924,2592,2020-10-06 18:29:59,wahoo,Zwift - British Cycling Race Series (A),Assioma Duo (Zwift),KICKR,363,360,3
62718,2592,2020-10-17 16:04:59,wahoo,Zwift - 3R Classique Flat Race - 4 Laps (26.9km/16.7mi 76m) (A),Assioma Duo (Zwift),KICKR,351,350,1
63204,2592,2020-10-19 18:20:02,wahoo,Zwift - TFC Mad Monday Autumn Series (A),Assioma Duo (Zwift),KICKR,352,344,8
64568,2592,2020-10-24 08:45:03,wahoo,Zwift - Crit City Race (A),Assioma Duo (Zwift),KICKR,348,345,3
65148,2592,2020-10-26 19:19:59,wahoo,Zwift - TFC Mad Monday Autumn Series (A),Assioma Duo (Zwift),KICKR,349,350,-1
65542,2592,2020-10-27 19:51:00,wahoo,Zwift - Zwift Racing League | WTRL - EMEA W (MEN) -  Division 7 (A),Assioma Duo (Zwift),KICKR,363,360,3
66185,2592,2020-10-29 19:11:39,wahoo,Zwift - WTRL Team Time Trial - Zone 5 (D),Assioma Duo (Zwift),KICKR,355,359,-4
66489,2592,2020-10-30 18:59:59,wahoo,Zwift - TFC Autumn Race Series (A),Assioma Duo (Zwift),KICKR,379,376,3
68411,2592,2020-11-05 19:09:32,wahoo,Zwift - WTRL Team Time Trial - Zone 7 (D),Assioma Duo (Zwift),KICKR,351,355,-4
68722,2592,2020-11-07 10:45:02,wahoo,Zwift - Into the Red by RELENTLESS (A),Assioma Duo (Zwift),KICKR,371,372,-1
69044,2592,2020-11-08 12:20:04,wahoo,Zwift - Ottawa TopSpeed Race (A),Assioma Duo (Zwift),KICKR,373,379,-6
69907,2592,2020-11-10 19:51:01,wahoo,Zwift - Zwift Racing League | WTRL - EMEA W2 (MEN) -  Division 3 (A),Assioma Duo (Zwift),KICKR,397,395,2
70821,2592,2020-11-12 19:14:10,wahoo,Zwift - Frappe,Assioma Duo (Zwift),KICKR,352,354,-2
73114,2592,2020-11-19 19:06:02,wahoo,Zwift - Frappe,Assioma Duo (Zwift),KICKR,344,348,-4
73799,2592,2020-11-21 10:30:01,wahoo,Zwift - 3R Volcano Climb Race - 1 Lap (22.4km/14mi 204m) (A),Assioma Duo (Zwift),KICKR,373,377,-4
76287,2592,2020-11-26 19:28:04,wahoo,Zwift - WTRL NOPINZ WORLD TTT CHAMPIONSHIPS - Zone 9 (D),Assioma Duo (Zwift),KICKR,356,352,4
76599,2592,2020-11-27 18:45:04,wahoo,Zwift - GGCC GlasgowGreen CC TT  (A),Assioma Duo (Zwift),KICKR,361,367,-6
78255,2592,2020-12-01 19:58:37,wahoo,Zwift - Zwift Racing League | WTRL - Men&#039;s EMEA W2 DIVISION 3 (A),Assioma Duo (Zwift),KICKR,346,346,0
95834,2592,2021-01-12 19:53:01,wahoo,Zwift - Zwift Racing League | WTRL - Men&#039;s/Mixed EMEA W2 DIVISION 2 (A),Assioma Duo (Zwift),KICKR,376,367,9
108977,2592,2021-02-04 19:19:00,wahoo,Zwift - WTRL Team Time Trial - Zone 8 (C),Assioma Duo (Zwift),KICKR,362,360,2
30543,2670,2020-05-02 00:27:32,wahoo,Zwift - Virtual Redlands Bicycle Classic p/b Project Echelon Racing (A) - 5th! ,Stages,Kickr,444,422,22
98740,2670,2021-01-17 18:48:37,wahoo,"Zwift - BRT Iron Goat Racing League (A) - Day 29 of racing. Trial run up Innsbruck climb, cracked.,",Stages,Kickr to Zwift,432,438,-6
99980,2670,2021-01-20 00:28:52,wahoo,Zwift - Zwift Racing League | WTRL - Men&#039;s/Mixed AMERICAS E DIVISION 4 (A) - 31 days of racing - That TTT had hardiship drama and SMACK talk!,Stages,Kickr to Zwift,430,425,5
100552,2670,2021-01-20 23:59:59,wahoo,Zwift - EVR Definitely Not the WTNC (A) - Okay I didnt stop. Day 32 of racing.,Stages,Kickr to Zwift,366,371,-5
101177,2670,2021-01-22 00:29:23,wahoo,Zwift - WTRL Team Time Trial - Zone 10 (C) - Day 33 Of Racing!!!!,Stages,Kickr to Zwift,406,406,0
103151,2670,2021-01-26 00:00:49,wahoo,Zwift - The Bump Sprint Race (A) - Opener,Stages,Kickr to Zwift,429,429,0
103785,2670,2021-01-26 00:00:49,wahoo,Zwift - Zwift Racing League | WTRL - Men&#039;s/Mixed AMERICAS E DIVISION 4 (A) - 1st across the line!,Stages,Kickr to Zwift,429,456,-27
103786,2670,2021-01-27 00:27:09,wahoo,Zwift - Zwift Racing League | WTRL - Men&#039;s/Mixed AMERICAS E DIVISION 4 (A) - 1st across the line!,Kickr to Zwift,Kickr to Zwift,450,456,-6
103790,2670,2021-01-27 00:27:09,wahoo,Okay I finally did it right - Zwift - Zwift Racing League | WTRL - Men&#039;s/Mixed AMERICAS E DIVISION 4 (A) - 1st across the line!,Stages,Kickr to Zwift,450,456,-6
105816,2670,2021-01-30 17:39:41,wahoo,Zwift - 3R Three Sisters Hilly Race (47km/29.2mi 879m) (A) - Not dropped enough on Radio!,Stages,Kickr to Zwift,447,448,-1
106269,2670,2021-01-31 14:06:39,wahoo,Zwift - KISS 100 Race Series - Americas (A) - a long one!,Stages,Kickr to Zwift,449,444,5
107014,2670,2021-02-01 23:55:48,wahoo,Zwift - The Bump Sprint Race (A) - Opener - ZRL tomorrow!,Stages,Kickr to Zwift,367,363,4
107708,2670,2021-02-03 00:25:36,wahoo,Zwift - Zwift Racing League | WTRL - Men&#039;s/Mixed AMERICAS E DIVISION 4 (A) - Great teams race,Stages,Kickr to Zwift,457,456,1
109119,2670,2021-02-05 00:14:45,wahoo,Zwift - WTRL Team Time Trial - Zone 10 (C) - Really well executed TTT!,Stages,Kickr to Zwift,421,427,-6
116201,2670,2021-02-17 00:29:27,wahoo,Zwift - Zwift Racing League | WTRL - Men&#039;s/Mixed AMERICAS E DIVISION 4 (A) - Teamwork!,Stages,Kickr to Zwift,485,482,3
117495,2670,2021-02-19 00:14:24,wahoo,Zwift - WTRL Team Time Trial - Zone 13 (C) - Staying on it in the TTT,Stages,Kickr to Zwift,414,424,-10
119322,2670,2021-02-23 00:03:43,wahoo,Zwift - The Bump Sprint Race (A),Stages,Kickr to Zwift,371,363,8
119927,2670,2021-02-24 00:19:26,wahoo,Zwift - Zwift Racing League | WTRL - Men&#039;s/Mixed AMERICAS E DIVISION 4 (A) - More Great Team racing!,Stages,Kickr to Zwift,393,393,0
120979,2670,2021-02-25 23:48:13,wahoo,Zwift - Haute Route Watopia 2021 Stage 1 (A),Stages,Kickr to Zwift,453,440,13
121353,2670,2021-02-26 23:52:12,wahoo,"Zwift - Haute Route Watopia 2021 Stage 2 (A) - bridge, breakaway, solo move! it was like a race",Stages,Kickr to Zwift,429,437,-8
123255,2670,2021-03-03 00:11:03,wahoo,Zwift - Zwift Racing League | WTRL - Men&#039;s/Mixed AMERICAS E DIVISION 4 (A) -GREAT Team TTT!!!!,Stages,Kickr to Zwift,422,433,-11
64349,2905,2020-10-23 11:20:02,wahoo,Zwift - 3R LaGuardia Loop Reverse Flat Race - 8 Laps (24.5km/15.2mi 216m) (A),Quarq Dfour91,Wahoo Kickr,375,373,2
81726,2905,2020-12-10 19:00:00,wahoo,Zwift - BENELIGA 2020-2021 (E),Quarq Dfour91,Wahoo Kickr,376,380,-4
86000,2905,2020-12-22 10:05:09,wahoo,Bologna TT,Quarq Dfour91,Wahoo Kickr,399,395,4
86916,2905,2020-12-24 13:35:01,wahoo,Zwift - Crit City Race (A),Quarq Dfour91,Wahoo Kickr,366,363,3
87109,2905,2020-12-25 08:04:58,wahoo,Zwift - 3R Lagurdia Super Sprint Race - 1 Lap (3.7km/2.6mi 27m) (A),Quarq Dfour91,Wahoo Kickr,471,470,1
87723,2905,2020-12-27 09:29:53,wahoo,Zwift -  SloZl - Slovenian Zwift League - Weekly Race,Quarq Dfour91,Wahoo Kickr,334,335,-1
88914,2905,2020-12-30 09:05:25,wahoo,Zwift - 3R Watopia Flat Route Race - 3 Laps (30.3km/18.8mi 162m) (A),Quarq Dfour91,Wahoo Kickr,366,367,-1
90559,2905,2021-01-03 09:05:14,wahoo,Zwift - Newbury Velo Road Race (A),Quarq Dfour91,Wahoo Kickr,346,356,-10
90573,2905,2021-01-03 11:05:14,wahoo,3R Innsbruckring Sprint Race - 1 Lap (8.8km/5.5mi 77m),Quarq Dfour91,Wahoo Kickr,392,397,-5
90613,2905,2021-01-03 11:45:13,wahoo,Zwift - Crit City Race (A),Quarq Dfour91,Wahoo Kickr,367,373,-6
92402,2905,2021-01-06 19:00:35,wahoo,Zwift - TDZ Stage 1: Longer Ride,Quarq Dfour,Wahoo Kickr,291,286,5
92970,2905,2021-01-07 19:00:12,wahoo,BENELIGA 2020-2021,Quarq Dfour91,Wahoo Kickr,400,413,-13
93781,2905,2021-01-09 11:30:23,wahoo,Zwift - EMU Novice Race (A),Quarq Dfour91,Wahoo Kickr,410,409,1
94539,2905,2021-01-09 09:30:15,wahoo,Zwift - DBR SufferDay League III (A),Quarq Dfour91,Wahoo Kickr,391,389,2
97077,2905,2021-01-14 19:00:15,wahoo,BENELIGA 2020-2021,Quarq Dfour91,Wahoo Kickr,402,419,-17
101013,2905,2021-01-21 19:00:16,wahoo,Zwift - BENELIGA 2020-2021 (E),Quarq Dfour91,Wahoo Kickr,377,382,-5
101676,2905,2021-01-23 08:30:19,wahoo,Zwift - TEAM VEGAN Tofu Tornado XL (A),Quarq Dfour91,Wahoo Kickr,407,413,-6
103200,2905,2021-01-26 07:30:14,wahoo,Zwift - ZHQ FutureWorks Crit City Race - Anti-sandbagging (A),Quarq Dfour91,Wahoo Kickr,366,368,-2
104757,2905,2021-01-28 19:00:13,wahoo,Zwift - BENELIGA 2020-2021 (E),Quarq Dfour91,Wahoo Kickr,381,380,1
106057,2905,2021-01-31 10:10:15,wahoo,Zwift - 3R Sand & Sequoias - 1 Lap (20km/12.5mi 173m) (A),Quarq Dfour (S5),Wahoo Kickr,397,399,-2
106076,2905,2021-01-31 11:05:08,wahoo,Zwift - 3R Innsbruckring Sprint Race - 1 Lap (8.8km/5.5mi 77m) (A),Quarq Dfour (S5),Wahoo Kickr,387,375,12
108993,2905,2021-02-04 19:00:18,wahoo,Zwift - BENELIGA 2020-2021 (E),Quarq Dfour91,Wahoo Kickr,401,402,-1
113023,2905,2021-02-11 19:00:13,wahoo,BENELIGA 2020-2021,Quarq Dfour91,Wahoo Kickr,422,439,-17
113316,2905,2021-02-12 09:05:15,wahoo,Zwift - 3R Whole Lotta Lava Hilly Race - 2 Laps (28.9km/12.53mi 336m) (A),Quarq Dfour91,Wahoo Kickr,410,407,3
114159,2905,2021-02-13 15:15:09,wahoo,Zwift - OH MY CRIT!! - Saturday Smash Race (A),Quarq Dfour91,Wahoo Kickr,415,425,-10
117308,2905,2021-02-18 19:00:13,wahoo,BENELIGA 2020-2021,Quarq Dfour91,Wahoo Kickr,368,370,-2
50554,2983,2020-08-18 17:05:33,neo,Zwift - Yorkshire,Insyncd 20sec-3min-20sec vector,Neo,277,272,5
112991,2983,2021-02-11 18:12:32,neo,Zwift - Frappe,Garmin Vector,Neo,314,315,-1
116823,2983,2021-02-17 19:01:22,neo,Zwift Duathlon League | WTRL - Opt 3 Bike,Garmin Vector 2,Neo,298,298,0
118119,2983,2021-02-19 16:10:50,neo,Zwift - SZ AW Party by SZR (B),Garmin Vector 2,Neo,324,324,0
55090,3508,2020-09-14 18:21:24,wahoo,Zwift - TFC Mad Monday Autumn Series (1 of 9) (C),Stages,Kickr,312,339,-27
28062,3600,2020-04-25 20:04:59,wahoo,Zwift - 3R Watopia Hilly Race - 2 Laps (18.3km/11.4mi 200m) (B),Quarq D-Zero,Wahoo Kickr,360,368,-8
10778,3676,2020-01-23 19:14:52,wahoo,Zwift - Tour de Zwift // Pro-Am Invitational,Power2Max,Kickr Core,401,404,-3
11899,3676,2020-01-31 19:14:59,wahoo,Zwift - Tour de Zwift // Pro-Am Invitational (A),Power2Max,Kickr Core,413,410,3
119623,3676,2021-02-23 18:24:19,wahoo,Zwift - Zwift Racing League | WTRL - Men&#039;s/Mixed EMEA E2 DIVISION 1 (A),Favero Assioma Uno,Kickr Core,349,372,-23
124596,3676,2021-03-05 19:04:56,wahoo,Zwift - Zwift Racing League | WTRL Battle Royale Playoff - Men&#039;s Points Race (A),Power2Max,Kickr Core,377,375,2
125148,3676,2021-03-06 19:46:55,wahoo,Zwift - Zwift Racing League | WTRL Battle Royale Playoff - Men&#039;s TTT (A),Power2Max,Kickr Core,377,369,8
117528,4583,2021-02-08 21:58:07,wahoo,Fitness test,4IIII Precision,Wahoo Kickr Core,296,307,-11
120507,4583,2021-02-24 22:22:19,wahoo,Endurance might as well do it uphill,4IIII Precision,Wahoo Kickr Core,240,239,1
125911,4583,2021-03-08 22:19:00,wahoo,Wahoo Kickr Core / 4IIII Precision,4IIII Precision,Wahoo Kickr Core,306,313,-7
129391,4583,2021-03-15 21:05:55,wahoo,"NCC Winter series - Bell Lap 8 laps in Crit City... Felt tired, but managed to stay with the lead group.",4IIII Precision,Wahoo Kickr Core,321,316,5
14994,4635,2020-02-20 17:05:29,wahoo,Zwift - Watopia,Power2Max ,Wahoo Kickr power CPi,350,326,24
30359,4635,2020-05-01 18:55:48,wahoo,Reprise 25 - Recovery Legs after running of the morning,Power2Max (Zwift source),Wahoo Kickr Power,150,147,3
31058,4635,2020-05-03 05:30:01,wahoo,Zwift - XRS Races: a Longer and Hard race (A),Power2Max (Zwift source),Wahoo Kickr Power,323,302,21
31811,4635,2020-05-05 17:54:57,wahoo,Zwift - Team Italy & Frenchy Fuzion League (A) - 19th... grooupe de tete pour mon retour ! Content... ,Power2Max (Zwift source),Wahoo Kickr Power,326,309,17
32079,4635,2020-05-06 17:59:59,wahoo,Zwift - Zwift NL League - Woensdagavond Competitie (A),Power2Max (Zwift source),Wahoo Kickr Power,327,309,18
33404,4635,2020-05-10 07:20:12,wahoo,Zwift - Team Italy & Frenchy Fuzion Endurance Race (A),Power2Max (Zwift source),Wahoo Kickr Power,298,285,13
36749,4635,2020-05-19 17:54:58,wahoo,Zwift - Team Italy & Frenchy Fuzion League (A),Power2Max (Zwift source),Wahoo Kickr Power,324,314,10
38161,4635,2020-05-27 17:54:56,wahoo,Zwift - USA Cycling Race League by Indoor Specialist (A),Power2Max (Zwift source),Wahoo Kickr Power,352,339,13
38889,4635,2020-05-31 05:00:01,wahoo,Zwift - KISS at Race 100 - EU (A) - 4th,Power2Max (Zwift source),Wahoo Kickr Power,305,287,18
39381,4635,2020-06-03 17:54:46,wahoo,Zwift - USA Cycling Race League by Indoor Specialist (A),Power2Max (Zwift source),Wahoo Kickr Power,320,315,5
40768,4635,2020-06-09 17:55:00,wahoo,Zwift - Team Italy & Frenchy Fuzion League (A),Power2Max ,Wahoo Kickr Power,316,302,14
41451,4635,2020-06-10 17:55:02,wahoo,Zwift - USA Cycling Race League by Indoor Specialist (A),Power2Max (Zwift source),Wahoo Kickr Power,363,345,18
42011,4635,2020-06-16 18:40:08,wahoo,Zwift - 3R & Wahoo Ride Real Race Series - Round 5 of 7 (A),Power2Max (Zwift source),Wahoo Kickr Power,317,303,14
55587,4635,2020-09-14 17:59:57,wahoo,Zwift - Invitational League // Qualifying Race #1,Power2Max ,Wahoo Kickr Power,326,333,-7
69638,4635,2020-11-10 08:45:07,wahoo,Zwift - Zwift Racing League | WTRL - APAC (MEN) -  Division 1 (A) - 15th... a shit sprint again ! ,Power2Max ,Wahoo Kickr Power,364,358,6
73126,4635,2020-11-19 19:00:09,wahoo,Zwift -  Flanders The BZR Ronde  (A),Power2Max (Zwift source),Wahoo Kickr Power,304,305,-1
74245,4635,2020-11-22 14:15:01,wahoo,Zwift - KISS 100 Race Series - Americas (A),Power2Max (Zwift source),Wahoo Kickr Power,329,313,16
74926,4635,2020-11-24 08:44:59,wahoo,Zwift - Zwift Racing League | WTRL - Men&#039;s APAC DIVISION 1,Power2Max (Zwift source),Wahoo Kickr Power,346,345,1
76102,4635,2020-11-26 19:00:09,wahoo,Zwift -  Flanders The BZR Ronde  (A) - Day Off ,Power2Max ,Wahoo Kickr Power,336,342,-6
13227,4696,2020-02-09 13:17:14,wahoo,Zwift - Zwift Gran Fondo,Quarq 55120,Kickr Original,376,380,-4
14291,4696,2020-02-16 14:12:31,wahoo,Zwift - KISS at Race 100 - Americas (A),Quarq 55120,Kickr Original,383,382,1
56500,4696,2020-09-20 12:51:19,wahoo,Zwift - KISS at Race 100 - Americas (A),Power2Max Eco ,Kickr Original,363,363,0
64880,4696,2020-10-25 13:15:25,wahoo,Zwift - KISS at Race 100 - Americas (A),Quarq 55120,Kickr Original,358,361,-3
59718,4762,2020-10-05 05:00:00,wahoo,Zwift - 3R VOLT Interval Ride [~2.6-3.2 w/kg avg] (C),Stages,Kickr,280,287,-7
98567,4762,2021-01-04 06:00:11,wahoo,Zwift - 3R VOLT Interval Ride [~2.6-3.2 w/kg avg] (C),Garmin vector 3S,Kickr,263,269,-6
98570,4762,2021-01-06 06:10:34,wahoo,Zwift - 3R VOLT Interval Ride [~2.6-3.2 w/kg avg] (C),Garmin vector 3S,Kickr,263,278,-15
12356,5534,2020-02-04 14:09:31,neo,Zwift - Replacement Left Assioma vs Neo Test (Neo on Zwift. Assioma on Garmin)),Assioma Duo on Garmin,Neo on Zwift,238,236,2
12419,5534,2020-02-04 19:31:29,neo,Zwift - Tour de Zwift: Stage 6 Group Ride - Long Distance (Neo),Assioma Duo on Garmin,Neo on Zwift,296,299,-3
12629,5534,2020-02-05 20:41:27,neo,Zwift - Assioma and Neo Test (Neo on Zwift Ass on Garmin) Small ring 6th gear,Assioma Duo on Garmin,Neo on Zwift,219,222,-3
12885,5534,2020-02-07 12:39:06,neo,Zwift - Assioma and Neo Test (Neo on Zwift) No ERG mode or c trainer,Assioma Duo on Garmin,Neo on Zwift,223,220,3
12933,5534,2020-02-07 19:29:57,neo,Zwift - Tour de Zwift: Stage 7 - Long Distance  30th,Assioma Duo on Garmin,Neo on Zwift,328,341,-13
13542,5534,2020-02-12 13:34:43,neo,Zwift - Ramp Test (FTP 298W ) perhaps 2 days off makes a difference?,Assioma Duo on Garmin,Neo on Zwift,340,353,-13
13595,5534,2020-02-12 19:18:13,neo,Zwift - Tour de Zwift: Stage 5 Long Distance - again,Assioma Duo on Garmin,Neo on Zwift,345,350,-5
13793,5534,2020-02-13 19:34:39,neo,Zwift - Watopia. Alpe du Zwift,Assioma Duo on Garmin,Neo on Zwift,292,294,-2
52346,5534,2020-08-28 10:48:18,neo,Zwift - The Alpe. Checking out Everesting :),Assioma Duo on Garmin,Neo1 on Zwift,209,216,-7
81142,5537,2020-12-08 17:55:55,wahoo,Zwift - Zwift Racing League | WTRL - Men&#039;s EMEA E1 DIVISION 1 (A),CAAD12 Stages,wahoo kickr,332,324,8
82347,5537,2020-12-12 12:08:27,wahoo,Zwift - DIRT Dadurday Chase Race  (A),CAAD12 Stages,wahoo kickr,324,320,4
46600,6091,2020-07-16 06:35:32,neo,Zwift - TT Tune-Up - Sweet Spot 12min,Quarq,Neo,258,261,-3
53664,6091,2020-09-06 06:23:58,neo,Zwift - LEQP Provence Badge Hunter Series  (C),Quarq,Neo,331,332,-1
54053,6091,2020-09-08 18:38:35,neo,Zwift - 3R Sundown Race Series  (B),Quarq,Neo / Zwift,342,342,0
54530,6091,2020-09-10 18:52:51,neo,Zwift - Yorkshire,Quarq,Neo / Zwift,313,314,-1
55409,6091,2020-09-15 18:39:21,neo,3R Sundown Race Series ,Quarq,Neo / Zwift,344,349,-5
55410,6091,2020-09-15 18:39:21,neo,Zwift - 3R Sundown Race Series  (B),Quarq,Neo / Zwift,344,349,-5
56130,6091,2020-09-17 18:43:00,neo,WTRL Team Time Trial - Zone6,Quarq,Neo / Zwift,318,315,3
56132,6091,2020-09-18 10:59:59,neo,Zwift -  Stage 1 // Virtual Haute Route Ventoux  (C),Quarq,Neo / Zwift,312,311,1
56558,6091,2020-09-20 08:03:46,neo,Zwift -  Stage 3 // Virtual Haute Route Ventoux  (C),Quarq,Neo / Zwift,312,313,-1
56559,6091,2020-09-19 08:03:38,neo,Zwift -  Stage 2 // Virtual Haute Route Ventoux  (C),Quarq,Neo / Zwift,322,323,-1
56941,6091,2020-09-22 18:39:32,neo,Zwift - 3R Sundown Race Series  (B),Quarq,Neo / Zwift,336,334,2
57414,6091,2020-09-24 18:43:04,neo,Zwift - Frappe,Quarq,Neo / Zwift,316,316,0
57817,6091,2020-09-26 07:59:41,neo,Zwift - Herd Summer Racing League Series (B),Quarq,Neo / Zwift,342,344,-2
58390,6091,2020-09-29 18:36:42,neo,Zwift - 3R Sundown Race Series  (B),Quarq,Neo / Zwift,328,327,1
59577,6091,2020-10-04 06:19:15,neo,Zwift - LEQP Provence Badge Hunter Series (C),Quarq,Neo / Zwift,281,279,2
59885,6091,2020-10-06 18:40:18,neo,Zwift - 3R Sundown Race Series - iTT (B),Quarq,Neo / Zwift,326,328,-2
60447,6091,2020-10-08 18:41:53,neo,Zwift - WTRL Team Time Trial - Zone 6 (D),Quarq,Neo / Zwift,331,326,5
92069,6094,2021-01-06 08:29:43,wahoo,Zwift - ZHQ FutureWorks Circuit Race - Anti-sandbagging (B),power2max ngeco,KICKR v5,314,307,7
98107,6094,2021-01-16 13:00:41,wahoo,Zwift - TDZ Stage 3: Standard Ride,power2max ngeco,KICKR v5,304,292,12
101317,6094,2021-01-22 10:03:28,wahoo,Zwift - 3R Innsbruckring Flat Race - 4 Laps (35.2km/21.9mi 308m) (B),power2max ngeco,KICKR v5,322,321,1
115512,6094,2021-02-15 23:46:28,wahoo,Zwift - TDZ Stage 8: Group Ride,xcadey xpower-s,KICKR v5,325,344,-19
117634,6094,2021-02-19 09:31:53,wahoo,Zwift - TDZ Stage 7: Shorter Ride,xcadey xpower-s,KICKR v5,341,330,11
77231,6095,2020-11-29 09:24:07,wahoo,Zwift - Watopia dietro bot 4.2Wkg,Favero Assioma DUO,Wahoo Kickr Core,262,262,0
79423,6095,2020-12-04 15:30:18,wahoo,Zwift - BST Mountaingoat Race (A),Garmin Vector 2,Wahoo Kickr Core,240,232,8
101589,6138,2021-01-21 01:04:57,wahoo,Zwift - Cycling Canada Wednesday Night Race Series (A),Favero Assioma Duo,Wahoo KiCKR G1,349,365,-16
101593,6138,2021-01-19 22:51:55,wahoo,Zwift - Paris,Favero Assioma Duo,Wahoo KiCKR G1,213,216,-3
101595,6138,2021-01-20 23:48:55,wahoo,Zwift - Watopia,Favero Assioma Duo,Wahoo KiCKR G1,258,250,8
102576,6138,2021-01-24 17:17:01,wahoo,Zwift - Watopia,Favero Assioma Duo,Wahoo KiCKR G1,238,245,-7
102577,6138,2021-01-24 18:54:55,wahoo,Zwift - The Alpe Dash by Herd Racing League (A),Favero Assioma Duo,Wahoo KiCKR G1,380,368,12
104382,6138,2021-01-28 01:04:59,wahoo,Zwift - Cycling Canada Wednesday Night Race Series (A),Favero Assioma Duo,Wahoo KiCKR G1,389,393,-4
104383,6138,2021-01-27 23:51:18,wahoo,Zwift - Watopia,Favero Assioma Duo,Wahoo KiCKR G1,280,278,2
106484,6138,2021-01-31 18:59:58,wahoo,Zwift - BRT Iron Goat Racing League (A),Favero Assioma Duo,Wahoo KiCKR G1,357,357,0
106486,6138,2021-01-31 17:57:50,wahoo,Zwift - Richmond,Favero Assioma Duo,Wahoo KiCKR G1,241,251,-10
108536,6138,2021-02-04 01:04:58,wahoo,Zwift - Cycling Canada Wednesday Night Race Series (A),Favero Assioma Duo,Wahoo KiCKR G1,349,357,-8
108539,6138,2021-02-03 23:51:04,wahoo,Zwift - Watopia,Favero Assioma Duo,Wahoo KiCKR G1,240,247,-7
110436,6138,2021-02-06 20:30:31,wahoo,Zwift - Watopia,Favero Assioma Duo,Wahoo KiCKR G1,311,326,-15
110712,6138,2021-02-07 18:59:56,wahoo,Zwift - BRT Iron Goat Racing League (A),Favero Assioma Duo,Wahoo KiCKR G1,353,362,-9
110713,6138,2021-02-07 17:34:46,wahoo,Zwift - Watopia,Favero Assioma Duo,Wahoo KiCKR G1,259,268,-9
120487,6138,2020-04-15 00:38:32,wahoo,Zwift - Masters SA (B),Favero Assioma Duo,Wahoo KiCKR G1,353,368,-15
120488,6138,2021-02-24 13:59:39,wahoo,Zwift - KISS Race Series - Pacific AM (A),Favero Assioma Duo,Wahoo KiCKR G1,387,389,-2
123781,6138,2021-03-04 01:05:01,wahoo,Zwift - Cycling Canada Wednesday Night Race Series (A),Favero Assioma Duo,Wahoo KiCKR G1,367,370,-3
123785,6138,2021-02-27 21:49:10,wahoo,Zwift - VO2 Intervals,Favero Assioma Duo,Wahoo KiCKR G1,329,342,-13
124290,6138,2021-03-04 14:13:13,wahoo,Zwift - HIIT,Favero Assioma Duo,Wahoo KiCKR G1,338,327,11
125252,6138,2021-03-06 21:08:56,wahoo,Zwift - 03/06/2021,Favero Assioma Duo,Wahoo KiCKR G1,350,335,15
126783,6138,2021-03-11 01:04:28,wahoo,Zwift - Cycling Canada Wednesday Night Race Series (A),Favero Assioma Duo,Wahoo KiCKR G1,358,371,-13
5648,6306,2019-12-06 15:59:52,neo,Zwift - Team FZR Pre-Sauna Ride,p2mclassic,neo,181,176,5
6053,6306,2019-12-11 19:06:31,neo,Zwift - DBR HEINO CUP (E),p2mclassic,neo,270,258,12
7465,6306,2019-12-28 08:42:27,neo,Zwift - Special3/1x6,QuarqDfour,neo,234,230,4
7551,6306,2019-12-29 10:09:24,neo,Zwift - 3R Sand & Sequoias - 1 Lap (20km/12.5mi 173m) (A),QuarqDfour,neo,257,253,4
8018,6306,2020-01-04 09:29:42,neo,Zwift - DBR Saturday Race (B),QuarqDfour,neo,266,259,7
8475,6306,2020-01-08 19:06:52,neo,Zwift - DBR HEINO CUP (E),QuarqDfour,neo,256,251,5
8629,6306,2020-01-09 17:59:54,neo,Zwift - SCF SWE Cup Racing League (B),QuarqDfour,neo,274,268,6
61535,6309,2020-10-13 17:15:00,wahoo,Zwift - Zwift Racing League | WTRL,Power2max NG,Wahoo Kickr,429,410,19
64085,6309,2020-10-21 16:59:59,wahoo,Zwift - MIDWEEK Autumn Series by SZR (A),Quarq Dfour,Wahoo Kickr,408,403,5
64225,6309,2020-10-22 17:59:59,wahoo,Zwift -  Flanders The BZR Ronde  (A),Quarq Dfour,Wahoo Kickr,380,379,1
65657,6309,2020-10-27 18:15:59,wahoo,Zwift - Zwift Racing League | WTRL - EMEA E (MEN) -  Division 2 (A),Quarq Dfour,Wahoo Kickr,372,373,-1
66598,6309,2020-10-31 09:30:02,wahoo,Zwift - DBR Saturday Race (A),Quarq Dfour,Wahoo Kickr,396,390,6
67579,6309,2020-11-03 18:24:30,wahoo,Zwift - Zwift Racing League | WTRL - Men&#039;s EMEA E1 DIVISION 2 (A),Quarq Dfour,Wahoo Kickr,382,376,6
71384,6309,2020-11-14 13:00:22,wahoo,Zwift - 111 - Strongman racing series (A),4iiii R8000,Wahoo Kickr,402,398,4
73121,6309,2020-11-19 18:59:57,wahoo,Zwift -  Flanders The BZR Ronde  (A),4iiii R8000,Wahoo Kickr,367,377,-10
73863,6309,2020-11-21 15:15:09,wahoo,Zwift - OH MY CRIT - Saturday Smash Race (A),4iiii R8000,Wahoo Kickr,379,398,-19
75007,6309,2020-11-24 18:15:58,wahoo,Zwift - Zwift Racing League | WTRL - Men&#039;s EMEA E1 DIVISION 2,4iiii R8000,Wahoo Kickr,383,403,-20
75870,6309,2020-11-26 12:24:58,wahoo,Zwift - EMU Japan Race (A),4iiii R8000,Wahoo Kickr,355,363,-8
79284,6309,2020-12-04 10:05:01,wahoo,Zwift - 3R Innsbruckring Flat Race - 4 Laps (35.2km/21.9mi 308m) (A),Quarq Dfour,Wahoo Kickr,398,385,13
85687,6309,2020-12-21 10:30:00,wahoo,Zwift - European Lunch Ride (E),Quarq Dfour,Wahoo Kickr,343,331,12
86196,6309,2020-12-22 18:55:04,wahoo,Zwift - Team Italy & Frenchy Fuzion League (A),Quarq Dfour,Wahoo Kickr,419,415,4
86379,6309,2020-12-23 08:30:24,wahoo,Flanders Endurance Series,Quarq Dfour,Wahoo Kickr,355,361,-6
86945,6309,2020-12-24 14:04:58,wahoo,Zwift - 3R Classique Flat Race - 6 Laps (37.7km/23.4mi 114m) (A),Quarq Dfour,Wahoo Kickr,382,388,-6
89727,6309,2021-01-01 10:04:54,wahoo,Zwift - 3R Innsbruckring Flat Race - 4 Laps (35.2km/21.9mi 308m) (A),Quarq Dfour,Wahoo Kickr,402,400,2
91804,6309,2021-01-05 18:40:04,wahoo,Zwift - UK Armed Forces Cycling Community Race Night (A),Quarq Dfour,Wahoo Kickr,390,392,-2
92354,6309,2021-01-06 18:45:06,wahoo,Zwift - GCA Cup (A),Quarq Dfour,Wahoo Kickr,365,369,-4
95619,6309,2021-01-12 18:15:20,wahoo,Zwift - Zwift Racing League | WTRL - Men&#039;s/Mixed EMEA E1 DIVISION 1 (A),Quarq Dfour,Wahoo Kickr,390,389,1
96404,6309,2021-01-13 18:45:04,wahoo,Zwift - GCA Cup (A),Quarq Dfour,Wahoo Kickr,402,389,13
97826,6309,2021-01-16 09:59:57,wahoo,Zwift - Cycling Ireland Zwift League Rd 8 (A),Quarq Dfour,Wahoo Kickr,348,345,3
98387,6309,2021-01-17 09:14:59,wahoo,Zwift - Fantasy Nutrinovex Rice (A),Quarq Dfour,Wahoo Kickr,409,409,0
99666,6309,2021-01-19 18:18:03,wahoo,Zwift - Zwift Racing League | WTRL - Men&#039;s/Mixed EMEA E1 DIVISION 1 (A),Quarq Dfour,Wahoo Kickr,402,404,-2
103878,6309,2021-01-26 18:15:00,wahoo,Zwift - Zwift Racing League | WTRL - Men&#039;s/Mixed EMEA E1 DIVISION 1 (A),Quarq Dfour,Wahoo Kickr,413,409,4
107311,6309,2021-02-02 18:15:00,wahoo,Zwift - Zwift Racing League | WTRL - Men&#039;s/Mixed EMEA E1 DIVISION 1 (A),Quarq Dfour,Wahoo Kickr,423,407,16
108592,6309,2021-02-03 19:00:01,wahoo,Zwift - Open - Movistar Team Challenge Community Qualifier Race #1,Quarq Dfour,Wahoo Kickr,408,406,2
109427,6309,2021-02-05 18:00:03,wahoo,Zwift - KIRCHMAIR Race Series (A),Quarq Dfour,Wahoo Kickr,409,403,6
109429,6309,2021-02-05 18:30:00,wahoo,Zwift - KIRCHMAIR Race Series (A),Quarq Dfour,Wahoo Kickr,393,396,-3
111514,6309,2021-02-09 18:18:02,wahoo,Zwift - Zwift Racing League | WTRL - Men&#039;s/Mixed EMEA E1 DIVISION 1 (A),Quarq Dfour,Wahoo Kickr,415,412,3
112304,6309,2021-02-10 18:50:10,wahoo,Zwift - ATR Clubhouse Bash 4WAY (A),Quarq Dfour,Wahoo Kickr,427,421,6
115926,6309,2021-02-16 18:14:59,wahoo,Zwift - Zwift Racing League | WTRL - Men&#039;s/Mixed EMEA E1 DIVISION 1 (A),Quarq Dfour,Wahoo Kickr,402,392,10
122954,6309,2021-03-02 18:20:00,wahoo,Zwift - Zwift Racing League | WTRL - Men&#039;s/Mixed EMEA E1 DIVISION 1 (A),Quarq Dfour,Wahoo Kickr,397,406,-9
124573,6309,2021-03-05 18:30:00,wahoo,Zwift - KIRCHMAIR Race Series (A),Quarq Dfour,Wahoo Kickr,414,404,10
126216,6309,2021-03-09 19:03:14,wahoo,Zwift - London,Quarq Dfour,Wahoo Kickr,401,395,6
129283,6309,2021-03-16 19:03:00,wahoo,Zwift - 3R Omnium Event - Race 2 - iTT (E),Quarq Dfour,Wahoo Kickr,412,401,11
37157,6501,2020-05-23 14:39:39,wahoo,Zwift - Team Italy Specialissima Race  (A),Garmin Vector 2,Kickr,336,325,11
37981,6501,2020-05-26 17:18:34,wahoo,Zwift - NCF Grand Prix 2020 - Runde 4 - Aldersbestemt (C),Garmin Vector 2,Kickr,352,340,12
103429,6501,2021-01-26 17:25:32,wahoo,Zwift - WTRL Racing (A),Garmin Vector 2,Kickr,330,343,-13
122607,7199,2021-03-01 18:47:09,wahoo,kickr/zwift / stages/garmin,stages/garmin,kickr/zwift,307,306,1
8337,7220,2020-01-07 18:29:59,wahoo,Zwift - Flanders De Ronde Race (A) tactical errors! ,Stages GEN1 ,KICKR GEN1,393,400,-7
9481,7220,2020-01-15 14:10:09,wahoo,Zwift - Tour de Zwift: Stage 1 Race (A),Stages GEN1 ,KICKR GEN1,370,384,-14
11725,7220,2020-01-30 19:20:13,wahoo,Zwift - BRT Criterium Racing League (A) 1st ,Stages GEN1 ,KICKR GEN1,377,394,-17
15880,7220,2020-02-27 18:30:08,wahoo,Zwift - FUSION ECT BEUNSTOPPABLE Racing Series (A),Stages GEN1 ,KICKR GEN1,362,378,-16
21492,7220,2020-04-02 17:29:59,wahoo,Zwift - FUSION ECT BEUNSTOPPABLE Racing Series (A),Stages GEN1 ,KICKR GEN1,355,367,-12
55474,7220,2020-09-15 14:04:19,wahoo,Zwift - Zwift Time Trial Tuesday: Tempus Fugit (E),Quarq ,KICKR GEN1,382,402,-20
61561,7220,2020-10-13 17:15:00,wahoo,Zwift - Zwift Racing League | WTRL,Quarq ,KICKR GEN1,396,401,-5
62258,7220,2020-10-15 18:00:07,wahoo,Zwift -  Flanders The BZR Ronde  (A),Quarq ,KICKR GEN1,384,390,-6
63468,7220,2020-10-20 17:19:38,wahoo,Zwift - Zwift Racing League | WTRL - EMEA E (MEN) - TTT Grp 2 (C),Quarq ,KICKR GEN1,384,395,-11
65477,7220,2020-10-27 18:21:03,wahoo,Zwift - Zwift Racing League | WTRL - EMEA E (MEN) -  Division 7 (A),Quarq ,KICKR GEN1,410,409,1
73180,7220,2020-11-19 18:59:59,wahoo,Zwift -  Flanders The BZR Ronde  (A),Quarq ,KICKR GEN1,392,389,3
76180,7220,2020-11-26 18:29:59,wahoo,Zwift - FUSION ECT BEUNSTOPPABLE Racing Series (A),Quarq ,KICKR GEN1,380,381,-1
78660,7220,2020-12-01 18:28:47,wahoo,Zwift - Zwift Racing League | WTRL - Men&#039;s EMEA E2 DIVISION 3 (A),Quarq ,KICKR GEN1,391,391,0
96145,7220,2021-01-12 18:16:53,wahoo,Zwift - Zwift Racing League | WTRL - Men&#039;s/Mixed EMEA E1 DIVISION 3 (A),Quarq ,KICKR GEN1,404,393,11
100074,7220,2021-01-19 18:25:29,wahoo,Zwift - Zwift Racing League | WTRL - Men&#039;s/Mixed EMEA E1 DIVISION 3 (A),Quarq ,KICKR GEN1,372,376,-4
60592,7347,2020-10-09 08:34:59,wahoo,Zwift - TBR Burrito Race (B),Rotor INpower DM,Kickr V4,314,318,-4
62365,7347,2020-10-16 07:30:26,wahoo,Zwift - Flanders Endurance Series (E),Rotor 2IN power DM,Kickr V4,314,297,17
73376,7347,2020-11-19 19:01:21,wahoo,Zwift -  Flanders The BZR Ronde  (B),Rotor 2IN power DM,Kickr V5,317,306,11
75384,7347,2020-11-24 18:16:25,wahoo,Zwift - Zwift Racing League | WTRL - Men&#039;s EMEA E1 DIVISION 1,Rotor 2IN power DM,Kickr V5,324,315,9
76295,7347,2020-11-26 19:01:17,wahoo,Zwift -  Flanders The BZR Ronde  (B),Rotor 2IN power DM,Kickr V5,343,337,6
78394,7347,2020-12-01 18:26:29,wahoo,Zwift - Zwift Racing League | WTRL - Men&#039;s EMEA E1 DIVISION 1 (B),Rotor 2IN power DM,Kickr V5,315,313,2
79243,7347,2020-12-03 19:01:04,wahoo,Zwift -  Flanders The BZR Ronde  (B),Rotor 2IN power DM,Kickr V5,340,329,11
79428,7347,2020-12-04 08:29:53,wahoo,Zwift - Flanders Endurance Series (E),Rotor 2IN power DM,Kickr V5,302,294,8
81862,7347,2020-12-10 19:01:23,wahoo,Zwift -  Flanders The BZR Ronde  (B),Rotor 2IN power DM,Kickr V5,341,330,11
90045,7347,2021-01-01 12:05:15,wahoo,Zwift - 3R Greater London 8 Hilly Race - 1 Lap (23.8km/14.8mi 238m) (B),Rotor 2IN power DM,Kickr V5,355,340,15
93280,7347,2021-01-07 19:01:24,wahoo,Zwift -  Flanders The BZR Ronde  (B),Rotor 2IN power DM,Kickr V5,339,334,5
93285,7347,2021-01-08 08:30:19,wahoo,Zwift - Flanders Endurance Series (E),Rotor 2IN power DM,Kickr V5,295,292,3
94294,7347,2021-01-10 10:00:02,wahoo,Zwift - TDZ Stage 2: Longer Ride,Rotor 2IN power DM,Kickr V5,313,315,-2
96135,7347,2021-01-13 08:30:21,wahoo,Zwift - Flanders Endurance Series (E),Rotor 2IN power DM,Kickr V5,287,282,5
97211,7347,2021-01-14 19:01:04,wahoo,Zwift - The BZR Ronde Watopian League (B),Rotor 2IN power DM,Kickr V5,348,340,8
101104,7347,2021-01-21 19:01:07,wahoo,Zwift - The BZR Ronde Watopian League (B),Rotor 2IN power DM,Kickr V5,326,319,7
105024,7347,2021-01-29 08:00:09,wahoo,Zwift - TDZ Stage 6: Longer Ride : Intervals,Rotor 2IN power DM,Kickr V5,323,313,10
106201,7347,2021-01-31 08:30:15,wahoo,Zwift - Flanders Endurance Race League (B),Rotor 2IN power DM,Kickr V5,328,320,8
110614,7347,2021-02-07 08:29:58,wahoo,Zwift - Flanders Endurance Race League (B),Rotor 2IN power DM,Kickr V5,350,344,6
113145,7347,2021-02-11 19:01:23,wahoo,Zwift - FLANDERS The BZR Ronde Watopian League (B),Rotor 2IN power DM,Kickr V5,320,310,10
114986,7347,2021-02-14 08:30:01,wahoo,Zwift - Flanders Endurance Race League (B),Rotor 2IN power DM,Kickr V5,352,342,10
117597,7347,2021-02-18 19:01:03,wahoo,Zwift - FLANDERS The BZR Ronde Watopian League (B),Rotor 2IN power DM,Kickr V5,335,327,8
125982,7347,2021-03-08 08:30:20,wahoo,Zwift - Flanders Endurance Series (E),Rotor 2IN power DM,Kickr V5 / Wahoo ROAM,256,247,9
127133,7347,2021-03-11 19:00:58,wahoo,Zwift - Flanders The BZR Ronde Spring Classics League (B),Rotor 2IN power DM,Kickr V5 / Wahoo BOLT,358,347,11
128271,7347,2021-03-14 08:29:52,wahoo,Zwift - Flanders Endurance Race League Giro Di Grinta! (B),Rotor 2IN power DM,Kickr V5 / Wahoo BOLT,335,327,8
32582,7609,2020-05-07 21:59:23,wahoo,Zwift - Manuel Velez (Ciclo Pedal)&#039;s Meetup - Greatest London Loop,Favero Assioma Duo,Wahoo Kickr 16,312,318,-6
65513,7609,2020-10-27 19:39:26,wahoo,Zwift - Watopia,Quarq D Zero,Wahoo Kickr 16,240,238,2
129802,7609,2021-03-17 19:44:43,wahoo,Zwift - Innsbruck/ 30s Piques,Favero Assioma Duo,Wahoo Kickr 16,227,228,-1
118564,9010,2021-02-20 16:38:43,neo,Zwift - GCA Liga 2021 #4 (A),P2M NGeco,Tacx NEO,328,328,0
128658,9010,2021-03-15 09:34:21,neo,Zwift - KISS at Base Training Ride (B),P2M NGeco,Tacx Neo,330,322,8
8522,9044,2019-06-08 13:16:36,wahoo,Zwift - DIRT & IS: Baker&#039;s Dozen (A),Powertap C1 chainring,2018 Kickr,389,390,-1
9096,9044,2020-01-12 18:09:55,wahoo,Zwift - Tour de Zwift: Stage 1 Race (A),Powertap C1 chainring,2018 Kickr,374,376,-2
9842,9044,2020-01-17 00:09:53,wahoo,Zwift - Tour de Zwift: Stage 2 Race (A),Powertap C1 chainring,2018 Kickr,401,374,27
44318,9322,2020-06-30 23:39:59,wahoo,Zwift - USMES Turn It Up Tuesday Ride  (C),4iiii165,Kickr,321,323,-2
44622,9322,2020-07-02 22:09:58,wahoo,Zwift ,4iiii175,Kickr,304,299,5
84555,9322,2020-12-17 23:16:08,wahoo,kickr vs pioneer45245,pioneer45245,Kickr2016,228,224,4
21841,9913,2020-04-03 22:27:48,wahoo,Zwift - Watopia,Saris C1 Training Bike,Zwift - Wahoo Kickr,93,90,3
21843,9913,2020-04-03 21:00:01,wahoo,Zwift - Mat Stephens&#039;s Meetup - Sand And Sequoias,Saris C1 Training Bike,Zwift - Wahoo Kickr,209,204,5
21860,9913,2020-04-02 23:31:40,wahoo,Zwift - Austin Driveway Series Criterium (CAT P/1/2/3),Saris C1 Racing Bike,Zwift - Wahoo Kickr,276,281,-5
22076,9913,2020-04-04 17:48:15,wahoo,Zwift - Race prep,Saris C1 Training Bike,Zwift - Wahoo Kickr,265,265,0
22528,9913,2020-04-05 18:08:47,wahoo,Zwift - Yorkshire Grand Prix // Zwift Classic,Saris C1 Training Bike,Zwift - Wahoo Kickr,302,303,-1
22697,9913,2020-04-07 10:38:12,wahoo,Zwift - Bridging work,Saris C1 Training Bike,Zwift - Wahoo Kickr,285,283,2
23007,9913,2020-04-08 10:30:07,wahoo,Zwift - DIRT Watts Up Wednesday Ride (C),Saris C1 Training Bike,Zwift - Wahoo Kickr,219,222,-3
23064,9913,2020-04-08 17:27:51,wahoo,Zwift - USA Cycling Race League by Indoor Specialist  (A),Saris C1 Training Bike,Zwift - Wahoo Kickr,302,300,2
23395,9913,2020-04-09 12:27:55,wahoo,Zwift - Watopia - vEveresting,Saris C1 Training Bike,Zwift - Wahoo Kickr,259,253,6
24274,9913,2020-04-13 10:59:59,wahoo,Zwift - SRAM Women&#039;s Tour - Stage 1 with Tiffany Cromwell (E),Saris C1 Training Bike,Zwift - Wahoo Kickr,235,241,-6
24346,9913,2020-04-13 17:56:59,wahoo,Zwift - Trofeo Bologna // Zwift Classic (A),Saris C1 Training Bike,Zwift - Wahoo Kickr,294,298,-4
24994,9913,2020-04-15 17:54:53,wahoo,Zwift - USA Cycling Race League by Indoor Specialist  (A),Saris C1 Training Bike,Zwift - Wahoo Kickr,299,300,-1
26929,9913,2020-04-22 10:37:31,wahoo,Zwift - Watopia,Saris C1 Training Bike,Zwift - Wahoo Kickr,266,271,-5
27078,9913,2020-04-22 17:59:54,wahoo,Zwift - USA Cycling Race League by Indoor Specialist  (A),Saris C1 Training Bike,Zwift - Wahoo Kickr,294,296,-2
27491,9913,2020-04-23 23:29:58,wahoo,Zwift - Austin Driveway Series Criterium (CAT P/1/2/3),Saris C1 Training Bike,Zwift - Wahoo Kickr,315,310,5
30309,9913,2020-05-01 22:03:45,wahoo,Zwift - Sarah Moloney&#039;s Meetup - Tick Tock,Saris C1 Training Bike,Zwift - Wahoo Kickr,226,236,-10
32600,9913,2020-05-07 23:29:45,wahoo,Zwift - Austin Driveway Series Criterium (CAT P/1/2/3),Saris C1 Training Bike,Zwift - Wahoo Kickr,310,307,3
32842,9913,2020-05-09 00:38:13,wahoo,Zwift - Watopia,Saris C1 Training Bike,Zwift - Wahoo Kickr,248,249,-1
69997,10157,2020-11-11 00:44:46,wahoo,Zwift - Zwift Racing League | WTRL - AMERICAS E (MEN) -  Division 1 (A),Dual Sided 4iiii Precision ,Kickr 18,407,402,5
52295,10534,2020-08-27 23:46:16,wahoo,Zwift - WTRL Team Time Trial (B),Assioma Duo,Kickr Core,345,346,-1
129449,10534,2021-03-17 01:39:44,wahoo,Assioma Duo / Kickr Core,Assioma Duo,Kickr Core,370,369,1
68706,10558,2020-11-07 08:14:59,wahoo,Zwift - Matando o Corpo® PETA-Z (A),Power2Max S-Type,Wahoo Kickr V4,299,302,-3
69805,10558,2020-11-10 18:19:54,wahoo,Zwift - Zwift Racing League | WTRL - EMEA E2 (MEN) -  Division 2 (A),Power2Max S-Type,Wahoo Kickr V4,342,342,0
70750,10558,2020-11-12 18:59:49,wahoo,Zwift -  Flanders The BZR Ronde  (A),Power2Max S-Type,Wahoo Kickr V5,358,355,3
82240,10558,2020-12-12 10:30:21,wahoo,Zwift - 3R Volcano Climb Race - 1 Lap (22.4km/14mi 204m) (A),Power2Max S-Type,Wahoo Kickr V5,311,311,0
83342,10558,2020-12-15 06:21:49,wahoo,France - Ebbetts,Power2Max S-Type,Wahoo Kickr V5,300,303,-3
83821,10558,2020-12-16 07:31:26,wahoo,Zwift - France - Avalanche Spire -1,Power2Max S-Type,Wahoo Kickr V5,309,311,-2
84477,10558,2020-12-17 18:59:33,wahoo,Zwift -  Flanders The BZR Ronde  (A),Power2Max S-Type,Wahoo Kickr V5,310,311,-1
84755,10558,2020-12-18 16:59:39,wahoo,Zwift - Tour of New York Stage 1 - Open Longer,Power2Max S-Type,Wahoo Kickr V5,317,307,10
85065,10558,2020-12-19 12:59:28,wahoo,Zwift - Tour of New York Stage 2 - Open Longer,Power2Max S-Type,Wahoo Kickr V5,340,345,-5
85344,10558,2020-12-20 09:59:29,wahoo,Zwift - Tour of New York Stage 3 - Open Longer,Power2Max S-Type,Wahoo Kickr V5,304,304,0
86592,10558,2020-12-23 16:16:03,wahoo,Zwift - London,Power2Max S-Type,Wahoo Kickr V5,277,282,-5
87787,10558,2020-12-27 08:15:03,wahoo,Zwift - Granfondoteam Xmas Meetup - The PRL Full,Power2Max S-Type,Wahoo Kickr V5,306,302,4
89729,10558,2021-01-01 08:28:55,wahoo,Zwift - Flanders Endurance Serie,Power2Max S-Type,Wahoo Kickr V5,341,340,1
90592,10558,2021-01-03 08:59:36,wahoo,Zwift - Zwift Fondo Series 2020/21 (A),Power2Max S-Type,Wahoo Kickr V5 (Zwift),311,313,-2
91328,10558,2021-01-04 16:59:45,wahoo,Zwift - TDZ Stage 1: Longer Ride,Power2Max S-Type,Wahoo Kickr V5 (Zwift),316,316,0
91763,10558,2021-01-05 18:00:36,wahoo,Zwift - Zwift Time Trial Tuesday: Bologna (E),Power2Max S-Type,Wahoo Kickr V5 (Zwift),324,324,0
92619,10558,2021-01-07 10:59:31,wahoo,Zwift - KISS Race Series - Americas AM (A),Power2Max S-Type,Wahoo Kickr V5 (Zwift),314,310,4
93274,10558,2021-01-08 10:04:33,wahoo,Zwift - 3R Innsbruckring Flat Race - 4 Laps (35.2km/21.9mi 308m) (A),Power2Max S-Type,Wahoo Kickr V5 (Zwift),314,317,-3
93882,10558,2021-01-09 08:29:32,wahoo,Zwift - Flanders Endurance Serie,Power2Max S-Type,Wahoo Kickr V5 (Zwift),310,312,-2
94304,10558,2021-01-10 08:29:45,wahoo,Zwift - Flanders Endurance Series,Power2Max S-Type,Wahoo Kickr V5 (Zwift),309,310,-1
95638,10558,2021-01-12 18:23:39,wahoo,Zwift - Zwift Racing League | WTRL - Men&#039;s/Mixed EMEA E2 DIVISION 1 (A),Power2Max S-Type,Wahoo Kickr V5 (Zwift),315,312,3
96768,10558,2021-01-14 11:00:15,wahoo,Zwift - KISS Race Series - Americas AM (A),Power2Max S-Type,Wahoo Kickr V5 (Zwift),309,313,-4
97447,10558,2021-01-15 15:29:44,wahoo,Zwift - DBR Friday Race (A),Power2Max S-Type,Wahoo Kickr V5 (Zwift),304,307,-3
98436,10558,2021-01-17 08:29:51,wahoo,Zwift - Flanders Endurance Race League,Power2Max S-Type,Wahoo Kickr V5 (Zwift),307,311,-4
99675,10558,2021-01-19 18:18:58,wahoo,Zwift - Zwift Racing League | WTRL - Men&#039;s/Mixed EMEA E1 DIVISION 5 (A),Power2Max S-Type,Wahoo Kickr V5 (Zwift),309,312,-3
103509,10558,2021-01-26 18:23:26,wahoo,Zwift - Zwift Racing League | WTRL - Men&#039;s/Mixed EMEA E2 DIVISION 1 (A),Power2Max S-Type,Wahoo Kickr V5 (Zwift),323,329,-6
104072,10558,2021-01-27 15:59:40,wahoo,Zwift - TDZ Stage 5: Longer Ride,Power2Max S-Type,Wahoo Kickr V5 (Zwift),315,316,-1
107381,10558,2021-02-02 18:23:39,wahoo,Zwift - Zwift Racing League | WTRL - Men&#039;s/Mixed EMEA E2 DIVISION 1 (A),Power2Max S-Type,Wahoo Kickr V5 (Zwift),322,325,-3
108304,10558,2021-02-03 19:00:22,wahoo,Zwift - Open - Movistar Team Challenge Community Qualifier Race #1,Power2Max S-Type,Wahoo Kickr V5 (Zwift),323,326,-3
112718,10558,2021-02-11 10:59:29,wahoo,KISS Race Series - Americas AM,Power2Max S-Type,Wahoo Kickr V5 (Zwift),321,327,-6
113546,10558,2021-02-12 17:03:08,wahoo,Zwift - Zwift Fast Fridays: Bologna Time Trial (E),Power2Max S-Type,Wahoo Kickr V5 (Zwift),321,324,-3
115900,10558,2021-02-16 18:23:02,wahoo,Zwift - Zwift Racing League | WTRL - Men&#039;s/Mixed EMEA E2 DIVISION 1 (A),Power2Max S-Type,Wahoo Kickr V5 (Zwift),346,349,-3
117070,10558,2021-02-18 10:59:27,wahoo,Zwift - KISS Race Series - Americas AM (A),Power2Max S-Type,Wahoo Kickr V5 (Zwift),322,327,-5
119590,10558,2021-02-23 18:22:58,wahoo,Zwift - Zwift Racing League | WTRL - Men&#039;s/Mixed EMEA E2 DIVISION 1 (A),Power2Max S-Type (Allez Sprint),Wahoo Kickr V5 (Zwift),322,324,-2
122995,10558,2021-03-02 18:23:59,wahoo,Zwift - Zwift Racing League | WTRL - Men&#039;s/Mixed EMEA E2 DIVISION 1 (A),Power2Max S-Type (Allez Sprint),Wahoo Kickr V5 (Zwift),312,312,0
124597,10558,2021-03-05 19:04:04,wahoo,Zwift - Zwift Racing League | WTRL Battle Royale Playoff - Men&#039;s Points Race (A),Power2Max S-Type (Allez Sprint),Wahoo Kickr V5 (Zwift),336,343,-7
125183,10558,2021-03-06 19:44:58,wahoo,Zwift - Zwift Racing League | WTRL Battle Royale Playoff - Men&#039;s TTT (A),Power2Max S-Type (Allez Sprint),Wahoo Kickr V5 (Zwift),325,327,-2
129204,10558,2021-03-16 18:29:09,wahoo,Zwift - CeramicSpeed Race Series: Open Race (A),Power2Max S-Type (Allez Sprint),Wahoo Kickr V5 (Zwift),339,330,9
27517,10713,2020-04-24 06:26:56,wahoo,Zwift - Watopia,quarq,kickr,283,282,1
31437,10713,2020-05-04 05:19:31,wahoo,Zwift - Watopia,p2m,kickr,256,253,3
31440,10713,2020-05-03 05:12:30,wahoo,Zwift - Watopia,quarq,kickr,280,286,-6
50633,10713,2020-08-19 06:16:41,wahoo,kickr / old stages,old stages,kickr,188,200,-12
50825,10713,2020-08-20 08:33:06,wahoo,Zwift - London,old stages,kickr,192,201,-9
62951,10713,2020-10-19 04:18:17,wahoo,Zwift - Watopia,quarq,140kickr,213,215,-2
88039,10713,2020-12-27 19:18:28,wahoo,Zwift - Watopia,quarq,kickr,257,260,-3
88046,10713,2020-12-28 05:17:39,wahoo,quarq / kickr,quarq,kickr,109,114,-5
88863,10713,2020-12-30 05:37:57,wahoo,Zwift - Watopia,quarq,kickr,175,183,-8
93141,10713,2021-01-08 04:37:54,wahoo,Zwift - Zwift Fast Fridays: Tempus Fugit Time Trial (E),p2m,kickr,309,310,-1
94699,10713,2021-01-10 01:55:21,wahoo,Zwift - Watopia,p2m,kickr,289,282,7
8000,11265,2020-01-03 21:01:22,neo,"Zwift - Watopia .,,, vectors are fine :) ",Vector 3,Tacx Neo,225,222,3
8277,11265,2020-01-07 11:00:57,neo,Zwift - KISS at Race - Americas AM (B).. DOM win,Vector 3,Tacx Neo,358,358,0
8974,11265,2020-01-12 12:16:10,neo,Zwift - Ottawa TopSpeed Race (B),Vector 3,Tacx Neo,329,342,-13
9272,11265,2020-01-14 11:01:03,neo,Zwift - KISS at Race - Americas AM (B),Vector 3,Tacx Neo,325,327,-2
21574,11265,2020-04-02 23:30:59,neo,Zwift - Austin Driveway Series Criterium (CAT 3/4),Assoimas,Tacx Neo,383,368,15
21994,11265,2020-04-04 11:10:25,neo,Zwift - Herd Summer Racing League Race 1 (B),Assoimas,Tacx Neo,404,390,14
26406,11265,2020-04-20 11:21:16,neo,Zwift - Kick it into the Middle - 60 - Xert,Assoimas,Tacx Neo,311,294,17
26618,11265,2020-04-21 10:27:57,neo,Zwift - Watopia,Assoimas,Tacx Neo,260,242,18
26620,11265,2020-04-21 11:10:01,neo,Zwift - Japan Zwift Tuesday Race (A)  dnf,Assoimas,Tacx Neo,389,366,23
26919,11265,2020-04-22 11:35:31,neo,Zwift - Watopia (Tarmac),Assoimas,Tacx Neo,231,225,6
27471,11265,2020-04-23 23:20:40,neo,Zwift - Austin Driveway Series Criterium (CAT 3/4) - crushed by joe again,Assoimas - Tarmac,Tacx Neo - Tarmac,376,355,21
52339,11516,2020-08-28 11:30:25,wahoo,Zwift - Off The MAAP Stage 4 - Longer Ride,Garmin Vector 3S Pedals,Wahoo Kickr,433,417,16
52517,11516,2020-08-29 12:10:26,wahoo,Zwift - The BMTR Fundo (A),Garmin Vector 3S Pedals,Wahoo Kickr,364,365,-1
54147,11516,2020-09-09 16:10:15,wahoo,Zwift - 3R Tick Tock Flat Race - 2 Lap (36km/22.4mi 100m) (A),Garmin Vector 3S Pedals,Wahoo Kickr,451,467,-16
54152,11516,2020-09-05 12:09:56,wahoo,Zwift - The BMTR Fundo (A),Garmin Vector 3S Pedals,Wahoo Kickr,392,395,-3
54788,11516,2020-09-12 12:10:22,wahoo,Zwift - The BMTR Fundo (A),Garmin Vector 3S Pedals,Wahoo Kickr,425,421,4
55155,11516,2020-09-14 17:59:23,wahoo,Zwift - Invitational League // Qualifying Race #1,Garmin Vector 3S Pedals,Wahoo Kickr,441,450,-9
56015,11516,2020-09-17 18:28:44,wahoo,Zwift - Invitational League // Qualifying Race #2 (Men) ,Garmin Vector 3S Pedals,Wahoo Kickr,399,421,-22
56519,11516,2020-09-20 12:29:20,wahoo,Zwift - Invitational League // Qualifying Race #3 (Men) (A),Garmin Vector 3S Pedals,Wahoo Kickr,469,470,-1
59444,11516,2020-10-04 13:12:01,wahoo,Zwift - KISS at Race 100 - Americas (A),Garmin Vector 3S Pedals,Wahoo Kickr,461,466,-5
61346,11516,2020-10-12 17:40:52,wahoo,Zwift - Premier Division // Zwift Racing League (men) ,Garmin Vector 3S Pedals,Wahoo Kickr,480,490,-10
62715,11516,2020-10-17 11:10:09,wahoo,Zwift - ZA Road Race #1: 4 - 5 w/kg,Garmin Vector 3S Pedals,Wahoo Kickr,457,462,-5
63177,11516,2020-10-19 16:45:23,wahoo,Zwift - Premier Division // Zwift Racing League (men) ,Garmin Vector 3S Pedals,Wahoo Kickr,468,485,-17
63959,11516,2020-10-21 16:56:51,wahoo,Zwift - MIDWEEK Autumn Series by SZR (A),Garmin Vector 3S Pedals,Wahoo Kickr,442,466,-24
64700,11516,2020-10-24 11:59:31,wahoo,Zwift - The BMTR Fundo (A),Garmin Vector 3S Pedals,Wahoo Kickr,448,451,-3
65245,11516,2020-10-26 19:49:02,wahoo,Zwift - Premier Division // Zwift Racing League (men) (A),Garmin Vector 3S Pedals,Wahoo Kickr,450,465,-15
66673,11516,2020-10-31 11:07:52,wahoo,Zwift - ZA Road - Race #2 (A),Garmin Vector 3S Pedals,Wahoo Kickr,457,452,5
68606,11516,2020-11-06 19:00:57,wahoo,Zwift -  Tour De Spartacus  (E),Garmin Vector 3S Pedals,Wahoo Kickr,520,538,-18
68891,11516,2020-11-07 19:03:44,wahoo,Zwift -  Tour De Spartacus  (E),Garmin Vector 3S Pedals,Wahoo Kickr,411,414,-3
69149,11516,2020-11-08 19:02:53,wahoo,Zwift -  Tour De Spartacus  (E),Garmin Vector 3S Pedals,Wahoo Kickr,506,501,5
69493,11516,2020-11-09 19:35:34,wahoo,Zwift - Premier Division // Zwift Racing League (men) (A),Garmin Vector 3S Pedals,Wahoo Kickr,507,495,12
71374,11516,2020-11-14 10:01:32,wahoo,Zwift - 3R iTT Race - There will be no draft - Choose your own TT bike (A),Garmin Vector 3S Pedals,Wahoo Kickr,454,462,-8
71686,11516,2020-11-15 13:04:47,wahoo,Zwift - Rigo Urán: 2020 El Giro de Rigo - Official Route,Garmin Vector 3S Pedals,Wahoo Kickr,458,499,-41
72608,11516,2020-11-18 17:15:01,wahoo,Zwift - 50-59 years,Garmin Vector 3S Pedals,Wahoo Kickr,455,468,-13
73890,11516,2020-11-16 17:19:24,wahoo,Zwift - Premier Division // Zwift Racing League (men) (A),Garmin Vector 3S Pedals,Wahoo Kickr,461,479,-18
73901,11516,2020-11-21 13:09:59,wahoo,Zwift - BMTR Flat 100 (Miles) (A),Garmin Vector 3S Pedals,Wahoo Kickr,321,326,-5
77037,11516,2020-11-28 13:09:12,wahoo,BMTR 160 - Group managed Negative split 2nd half,Garmin Vector 3S Pedals,Wahoo Kickr,418,436,-18
77386,11516,2020-11-29 14:59:58,wahoo,Zwift - ZHR Masters Weekender (C),Garmin Vector 3S Pedals,Wahoo Kickr,461,497,-36
82486,11516,2020-12-12 13:45:59,wahoo,Zwift - MGCC hosts Ontario Cycling Association Virtual Challenge #1,Garmin Vector 3S Pedals,2018 Wahoo Kickr,409,396,13
82487,11516,2020-12-12 17:58:14,wahoo,Zwift - 3R Three Sisters Hilly Race (47km/29.2mi 879m) (A),Garmin Vector 3S Pedals,2018 Wahoo Kickr,472,462,10
82909,11516,2020-12-13 14:14:43,wahoo,Zwift - KISS 100 Race Series - Americas (A),Garmin Vector 3S Pedals,2018 Wahoo Kickr,465,454,11
87277,11516,2020-12-25 18:01:50,wahoo,Zwift - BRT Ages Racing League (D),2020 Garmin Vector 3S Pedals,2018 Wahoo Kickr,482,473,9
87520,11516,2020-12-26 13:09:35,wahoo,Zwift - BMTR Flat 100 (Miles) (A),2020 Garmin Vector 3S Pedals,2018 Wahoo Kickr,390,384,6
88027,11516,2020-12-28 00:32:37,wahoo,Toronto Hustle Holiday Classic Stage  Race: Stage One,2020 Garmin Vector 3S Pedals,2018 Wahoo Kickr,416,402,14
88821,11516,2020-12-30 00:29:47,wahoo,Zwift - Toronto Hustle Holiday Classic Stage Race: Stage Three (A),2020 Garmin Vector 3S Pedals,2018 Wahoo Kickr,443,431,12
89844,11516,2021-01-01 13:08:52,wahoo,Zwift - BMTR New Year&#039;s Day 100 - Riding For Alzheimer&#039;s (A),2020 Garmin Vector 3S Pedals,2018 Wahoo Kickr,363,351,12
94160,11516,2021-01-09 13:10:03,wahoo,Zwift - BMTR Flat 100 (Miles) (A),2020 Garmin Vector 3S Pedals,2018 Wahoo Kickr,356,344,12
94840,11516,2021-01-10 15:22:44,wahoo,A Pacey 60 kms and then some beloved climbing,2020 Garmin Vector 3S Pedals,2018 Wahoo Kickr,418,400,18
95190,11516,2021-01-11 18:41:04,wahoo,Zwift - Premier Division // Zwift Racing League (men) (A),2020 Garmin Vector 3S Pedals,2018 Wahoo Kickr,445,432,13
99280,11516,2021-01-18 18:56:52,wahoo,Zwift - Premier Division // Zwift Racing League (men) (A),2020 Garmin Vector 3S Pedals,2018 Wahoo Kickr,449,434,15
103079,11516,2021-01-25 18:53:49,wahoo,Zwift - Premier Division // Zwift Racing League (men) (A),2020 Garmin Vector 3S Pedals,2018 Wahoo Kickr,440,429,11
106261,11516,2021-01-31 13:09:32,wahoo,Zwift - The BMTR Fundo (A),2020 Garmin Vector 3S Pedals,2021 Wahoo Kickr v5,421,413,8
106987,11516,2021-02-01 19:27:43,wahoo,Zwift - Premier Division // Zwift Racing League (men) (A),2020 Garmin Vector 3S Pedals,2021 Wahoo Kickr v5,451,449,2
111234,11516,2021-02-08 18:11:47,wahoo,Zwift - Premier Division // Zwift Racing League (men) (A),2020 Garmin Vector 3S Pedals,2021 Wahoo Kickr v5,478,484,-6
114162,11516,2021-02-13 12:56:07,wahoo,Zwift - BMTR Flat 100 (Miles) (A),2020 Garmin Vector 3S Pedals,2021 Wahoo Kickr v5,347,351,-4
114783,11516,2021-02-14 13:01:59,wahoo,Zwift - The BMTR Fundo (B),2020 Garmin Vector 3S Pedals,2021 Wahoo Kickr v5,454,461,-7
115462,11516,2021-02-15 19:57:41,wahoo,Zwift - Premier Division // Zwift Racing League (men) (A),2020 Garmin Vector 3S Pedals,2021 Wahoo Kickr v5,469,477,-8
119234,11516,2021-02-22 18:15:49,wahoo,Zwift - Premier Division // Zwift Racing League (men) (A),2020 Garmin Vector 3S Pedals,2021 Wahoo Kickr v5,389,395,-6
122671,11516,2021-03-01 20:16:20,wahoo,Zwift - Premier Division // Zwift Racing League (men) (A),2020 Garmin Vector 3S Pedals,2021 Wahoo Kickr v5,462,473,-11
118328,11775,2021-02-20 16:07:55,wahoo,ASSIOMA-UNO / 3R Endurance Series pb OTE Sports- Stage 1 (C)kICKR,ASSIOMA-UNO,3R Endurance Series pb OTE Sports- Stage 1 (C)kICKR,305,304,1
121724,11775,2021-02-27 16:08:22,wahoo,3RENDURANCW2-ASSIOMA,3RENDURANCW2-ASSIOMA,3RENDURANCE2ZWIFT-KICKR,302,308,-6
122493,11775,2021-03-01 19:21:56,wahoo,tfcwinter-zwift-kickr / ~tfcwinter-zwift-assioma,~tfcwinter-zwift-assioma,tfcwinter-zwift-kickr,304,324,-20
125853,11775,2021-03-08 19:21:54,wahoo,TFC-GARMIN-ASSIOMA / TFC-ZWIFT-KICKR,TFC-GARMIN-ASSIOMA,TFC-ZWIFT-KICKR,312,327,-15
126233,11775,2021-03-09 19:01:52,wahoo,3ROMNIUM-ASSIOMA,3ROMNIUM-ASSIOMA,3ROMNIUM-ZWIFT-KICKR,316,340,-24
127119,11775,2021-03-11 19:19:52,wahoo,BRT-CRIT-ZWIFT-KICKR / BRT-CRIT-ASSIOMA,BRT-CRIT-ASSIOMA,BRT-CRIT-ZWIFT-KICKR,301,310,-9
127601,11775,2021-03-12 19:01:55,wahoo,tfc-zwift-kickr - / tfc-assiomauno,tfc-assiomauno,tfc-zwift-kickr -,309,317,-8
129324,11775,2021-03-16 20:01:57,wahoo,aussiecrit1-zwift-kickr / aussiecri1-assioma,aussiecri1-assioma,aussiecrit1-zwift-kickr,324,342,-18
16474,11849,2020-03-02 17:32:10,wahoo,Zwift -  Kiss Racing Team / FastFitnessTips iTT series,Power2Max NG - Zwift,Kickr 18,317,314,3
17083,11849,2020-03-06 17:04:55,wahoo,Zwift - 3R Classique Flat Race - 5 Laps (B),Power2Max NG - Zwift,Kickr 18,315,310,5
17484,11849,2020-03-10 17:10:51,wahoo,Zwift - Stage 1 Race (B) - Tour of Watopia 2020,Power2Max NG - Zwift,Kickr 18,314,310,4
25106,11849,2020-04-16 09:45:01,wahoo,Zwift - Koa Sports League Race (B),Power2Max NG (Primary),Kickr 18 (Secondary),346,340,6
25771,11849,2020-04-18 08:29:57,wahoo,DBR Sufferday League (B) - 41ST IN SANDBAGGER-CENTRAL,Power2Max NG (Primary),Kickr 18 (Secondary),336,321,15
27223,11849,2020-04-23 09:44:56,wahoo,Koa Sports League Race (B),Power2Max NG (Primary),Kickr 18 (Secondary),349,343,6
29482,11849,2020-04-30 09:44:57,wahoo,Zwift - Koa Sports League Race (B),Power2Max NG (Primary),Kickr 18 (Secondary),357,348,9
31204,11849,2020-05-04 09:59:52,wahoo,Zwift -  RCC Zwift Mens Championships - APAC Region (E),Power2Max NG (Primary),Kickr 18 (Secondary),338,334,4
40974,11849,2020-06-11 09:59:51,wahoo,Zwift - Koa Sports League Race (B),Power2Max NG (Primary),Kickr 18 (Secondary),335,311,24
60310,11849,2020-10-08 15:15:45,wahoo,Zwift - OH MY CRIT! - The Double Race 1/2 (B),Power2Max NG (Primary),Kickr 18 (Secondary),308,307,1
60932,11849,2020-10-11 06:29:48,wahoo,Zwift - LEQP Provence Badge Hunter Series (C),Power2Max NG (Primary),Kickr 18 (Secondary),307,302,5
78101,11849,2020-12-01 18:28:08,wahoo,Zwift - Zwift Racing League | WTRL - Men&#039;s EMEA E2 DIVISION 3 (B),Power2Max NG (Primary),Kickr 18 (Secondary),303,303,0
73430,11957,2020-11-20 10:56:20,wahoo,Zwift - KISS at Base Training Ride (B),Stages,Wahoo Kickr,239,229,10
110944,12495,2021-02-08 17:02:53,wahoo,Zwift - Watopia,Quarq Dzero,Kickr v5,219,213,6
110945,12495,2021-02-08 17:25:36,wahoo,Zwift - ZADA Three Sisters Test,Quarq Dzero,Kickr v5,355,336,19
111357,12495,2021-02-09 10:38:54,wahoo,Zwift - Watopia,Quarq Dzero,Kickr v5,288,277,11
112167,12495,2021-02-10 13:59:51,wahoo,Zwift - Kiss Race,Quarq Dzero,Kickr v5,357,346,11
113572,12495,2021-02-12 18:44:32,wahoo,Zwift - Team Italy Rosa League (A),Quarq Dzero,Kickr v5,359,343,16
115402,12495,2021-02-15 20:01:46,wahoo,Zwift - Premier Division // Zwift Racing League (men) (A),Quarq Dzero,Kickr v5,376,361,15
115732,12495,2021-02-16 14:11:25,wahoo,Zwift - New Workout,Quarq Dzero,Kickr v5,275,263,12
117624,12495,2021-02-18 16:00:12,wahoo,Zwift - 02/18/2021,Quarq Dzero,Kickr v5,237,228,9
117661,12495,2021-02-19 11:04:45,wahoo,Zwift - KISS at Base Training Ride (C),Quarq Dzero,Kickr v5,254,247,7
117860,12495,2021-02-19 18:44:40,wahoo,Zwift - Team Italy Rosa League (A),Quarq Dzero,Kickr v5,344,338,6
118112,12495,2021-02-20 09:04:51,wahoo,Zwift - 3R Endurance Series p/b OTE Sports- Stage 1 (E),Quarq Dzero,Kickr v5,308,301,7
119145,12495,2021-02-22 19:09:46,wahoo,Premier Division // Zwift Racing League (men) (A),Quarq Dzero,Kickr v5,336,331,5
119510,12495,2021-02-23 14:26:50,wahoo,Zwift - Watopia,Quarq Dzero,Kickr v5,256,253,3
121273,12495,2021-02-26 18:44:50,wahoo,Team Italy Rosa League,Quarq Dzero,Kickr v5,336,327,9
122455,12495,2021-03-01 16:53:46,wahoo,Zwift - Watopia,Quarq Dzero,Kickr v5,236,232,4
123439,12495,2021-03-03 09:05:13,wahoo,Zwift - 3R Watopia Flat Route Race - 3 Laps (30.3km/18.8mi 162m) (A),Quarq Dzero,Kickr v5,369,359,10
124645,12495,2021-03-05 18:44:40,wahoo,Zwift - Team Italy Rosa League (A),Quarq Dzero,Kickr v5,322,323,-1
126002,12495,2021-03-09 09:15:06,wahoo,Zwift - 3R Whole Lotta Lava Hilly Race - 2 Laps (28.9km/12.53mi 336m) (A),Quarq Dzero,Kickr 20 v5,359,356,3
127594,12495,2021-03-12 18:44:53,wahoo,Zwift - Team Italy Rosa League,Quarq Dzero,Kickr 20 v5,346,340,6
128458,12495,2021-03-14 14:14:47,wahoo,Zwift - Race  Warm Up,Quarq Dzero,Kickr 20 v5,320,313,7
128985,12495,2021-03-16 09:59:51,wahoo,Zwift - KISS Race Series - Americas AM,Quarq Dzero,Kickr 20 v5,346,340,6
34683,12505,2020-05-13 14:04:58,wahoo,Zwift - Z PRO TRI Race Series: Women&#039;s Race 5  (A),Favero Assioma Duo ,Wahoo Kickr,296,283,13
35019,12505,2020-05-15 11:09:57,wahoo,Zwift - Tour for All 2020: Stage 3 Longer Race A/B,Favero Assioma Duo ,Wahoo Kickr,285,283,2
36475,12505,2020-05-20 17:59:56,wahoo,Zwift - USA Cycling Race League by Indoor Specialist (A),Favero Assioma Duo ,Wahoo Kickr to Zwift,291,288,3
36893,12505,2020-05-20 14:04:55,wahoo,Zwift - Z PRO TRI Race Series: Women&#039;s B Race 6 (A),Favero Assioma Duo ,Wahoo Kickr to Zwift,297,288,9
39425,12505,2020-06-03 17:59:58,wahoo,Zwift - USA Cycling Race League by Indoor Specialist (A),Favero Assioma Duo ,Wahoo Kickr to Zwift,283,281,2
39860,12505,2020-06-04 20:59:59,wahoo,Zwift - Pedla Social Group Ride (A),Favero Assioma Duo ,Wahoo Kickr to Zwift,228,226,2
40254,12505,2020-06-07 18:44:58,wahoo,Zwift - XRS Races: Crit Feminine (E),Favero Assioma Duo ,Wahoo Kickr to Zwift,273,272,1
42248,12505,2020-06-17 18:00:00,wahoo,Zwift - USA Cycling Race League by Indoor Specialist (A),Favero Assioma Duo ,Wahoo Kickr to Zwift,272,269,3
47686,12505,2020-07-25 17:59:57,wahoo,Zwift - Tour De Boudicca (A),Favero Assioma Duo ,Wahoo Kickr to Zwift,291,285,6
47789,12505,2020-07-26 16:35:09,wahoo,Zwift - Tour De Boudicca (A),Favero Assioma Duo ,Wahoo Kickr to Zwift,296,290,6
49974,12505,2020-08-14 09:45:01,wahoo,Zwift - Off the MAAP Invitational Race // Stage 1 (Women) (A),Favero Assioma Duo ,Wahoo Kickr to Zwift,263,264,-1
50451,12505,2020-08-17 08:44:57,wahoo,Zwift - Off the MAAP Invitational Race // Stage 2 (Women) ,Favero Assioma Duo ,Wahoo Kickr to Zwift,275,272,3
55224,12505,2020-09-14 18:29:59,wahoo,Zwift - Invitational League // Qualifying Race #1 (Women),Favero Assioma Duo ,Wahoo Kickr to Zwift,285,283,2
55377,12505,2020-09-15 17:29:59,wahoo,Zwift - WTRL Women&#039;s EMPOWERMENT Series - Stage 2 (A),Favero Assioma Duo ,Wahoo Kickr to Zwift,283,282,1
55993,12505,2020-09-17 17:59:57,wahoo,Zwift - Invitational League // Qualifying Race #2 (Women) (A),Favero Assioma Duo ,Wahoo Kickr to Zwift,277,277,0
56566,12505,2020-09-20 13:30:03,wahoo,Zwift - Invitational League // Qualifying Race #3 (Women) (A),Favero Assioma Duo ,Wahoo Kickr,281,282,-1
60668,12505,2020-10-09 18:22:20,wahoo,Zwift - Amanda Wendorff (SISU- IRLAG)&#039;s Meetup - Three Sisters,Favero Assioma Duo ,Wahoo Kickr to Zwift,285,289,-4
61240,12505,2020-10-12 17:18:50,wahoo,Zwift - Premier Division // Zwift Racing League (women) (A),Favero Assioma Duo ,Wahoo Kickr to Zwift,287,290,-3
69401,12505,2020-11-09 19:04:58,wahoo,Zwift - Premier Division // Zwift Racing League (women) (A),Favero Assioma Duo ,Wahoo Kickr to Zwift,302,304,-2
74653,12505,2020-11-23 18:54:36,wahoo,Zwift - Premier Division // Zwift Racing League (women) (A),Favero Assioma Duo ,Wahoo Kickr to Zwift,291,290,1
76226,12505,2020-11-26 18:36:54,wahoo,Zwift - WTRL NOPINZ WORLD TTT CHAMPIONSHIPS - Zone 9 (E),Favero Assioma Duo ,Wahoo Kickr to Zwift,288,287,1
77811,12505,2020-11-30 19:35:33,wahoo,Zwift - Premier Division // Zwift Racing League (women) (A),Favero Assioma Duo ,Wahoo Kickr to Zwift,266,267,-1
81269,12505,2020-12-09 17:22:01,wahoo,Zwift - MIDWEEK Winter Series Women by SZR (A),Favero Assioma Duo ,Wahoo Kickr to Zwift,301,301,0
82532,12505,2020-12-12 19:15:29,wahoo,Zwift - Fearless Women&#039;s Team Championships - 2020 (A),Favero Assioma Duo ,Wahoo Kickr to Zwift,302,290,12
115289,12505,2021-02-15 18:24:25,wahoo,Zwift - Premier Division // Zwift Racing League (women) (A),Favero Assioma Duo ,Wahoo Kickr to Zwift,267,262,5
119248,12505,2021-02-22 19:20:01,wahoo,Zwift - Premier Division // Zwift Racing League (women) (A),Favero Assioma Duo ,Wahoo Kickr to Zwift,274,271,3
125248,12505,2021-03-06 17:11:48,wahoo,Zwift - The Iceni Women&#039;s Series  (A),Favero Assioma Duo ,Wahoo Kickr to Zwift,270,266,4
128153,12505,2021-03-13 17:21:55,wahoo,Zwift - The Iceni Women&#039;s Series (A),Favero Assioma Duo ,Wahoo Kickr to Zwift,282,282,0
129442,12505,2021-03-16 18:09:56,wahoo,Zwift - Women Only // CeramicSpeed Race Series: Open Race,Favero Assioma Duo ,Wahoo Kickr to Zwift,265,264,1
78853,12608,2020-12-03 11:00:00,neo,Zwift - KISS Race Series - Americas AM (A),Powermeter Stages Cycling,Tacx Neo,418,413,5
79688,12608,2020-12-05 10:00:00,neo,Cycling Ireland Zwift League Rd 4,Powermeter Stages Cycling,Tacx Neo,431,429,2
79731,12608,2020-12-05 13:07:01,neo,Zwift - Frenchy Fuzion Watopia Tour – Etape 6,Powermeter Stages Cycling,Tacx Neo,422,426,-4
80715,12608,2020-12-08 11:00:00,neo,KISS Race Series - Americas AM,Powermeter Stages Cycling,Tacx Neo,469,468,1
81842,12608,2020-12-10 11:00:00,neo,KISS Race Series - Americas AM,Powermeter Stages Cycling,Tacx Neo,426,417,9
83013,12608,2020-12-13 13:05:00,neo,Zwift - 3R Watopia Flat Route Race - 4 Laps (40.5km/25.1mi 216m) (A),Powermeter Stages Cycling,Tacx Neo,409,402,7
83426,12608,2020-12-15 11:00:02,neo,KISS Race Series - Americas AM,Powermeter Stages Cycling,Tacx Neo,465,468,-3
84230,12608,2020-12-17 11:00:02,neo,KISS Race Series - Americas AM,Powermeter Stages Cycling,Tacx Neo,464,453,11
84771,12608,2020-12-18 17:00:01,neo,Zwift - Tour of New York Stage 1 - Open Longer,Powermeter Stages Cycling,Tacx Neo,412,406,6
91081,12608,2021-01-02 15:14:59,neo,Zwift - OH MY CRIT - Saturday Smash Race (A),Powermeter Stages Cycling,Tacx Neo,427,420,7
92031,12608,2021-01-05 11:00:01,neo,Zwift - KISS Race Series - Americas AM (A),Powermeter Stages Cycling,Tacx Neo,468,460,8
92169,12608,2021-01-06 10:45:01,neo,Zwift - The Morning Grind by STPC (A),Powermeter Stages Cycling,Tacx Neo,487,475,12
92317,12608,2021-01-06 18:00:00,neo,Zwift - MIDWEEK Winter Series by SZR (A),Powermeter Stages Cycling,Tacx Neo,416,405,11
93340,12608,2021-01-08 13:50:01,neo,Zwift - KISS Race Series - Pacific AM (A),Powermeter Stages Cycling,Tacx Neo,496,486,10
95465,12608,2021-01-12 10:59:51,neo,Zwift - KISS Race Series - Americas AM (A),Powermeter Stages Cycling,Tacx Neo,444,428,16
95466,12608,2021-01-12 12:04:56,neo,Zwift - 3R Gotham Grind Flat Race - 2 Laps (18.5km/11.6mi 58m) (A),Powermeter Stages Cycling,Tacx Neo,444,433,11
96211,12608,2021-01-13 10:45:00,neo,Zwift - The Morning Grind by STPC (A),Powermeter Stages Cycling,Tacx Neo,398,388,10
96349,12608,2021-01-13 18:00:00,neo,Zwift - MIDWEEK Winter Series by SZR (A),6102233745_ACTIVITY,Tacx Neo,457,436,21
96868,12608,2021-01-14 16:15:01,neo,Zwift - OH MY CRIT! - The Double Race 1/2 (A),Powermeter Stages Cycling,Tacx Neo,423,413,10
98248,12608,2021-01-16 18:02:56,neo,Zwift - Championnat des departements Frenchy Fuzion (E),Powermeter Stages Cycling,Tacx Neo,453,438,15
99576,12608,2021-01-19 11:00:06,neo,Zwift - KISS Race Series - Americas AM (A),Powermeter Stages Cycling,Tacx Neo,501,495,6
102073,12608,2021-01-23 18:02:57,neo,Zwift - Championnat des Regions Frenchy Fuzion (E),Powermeter Stages Cycling,Tacx Neo,486,467,19
103278,12608,2021-01-26 10:59:56,neo,Zwift - KISS Race Series - Americas AM (A),Powermeter Stages Cycling,Tacx Neo,450,437,13
104513,12608,2021-01-28 09:58:40,neo,Zwift - Japan ZWIFT Hill Climb Race (A),Powermeter Stages Cycling,Tacx Neo,467,444,23
105382,12608,2021-01-30 06:58:36,neo,Zwift - 3R Weekend Race Club - Race 1 (A),Powermeter Stages Cycling,Tacx Neo,434,422,12
107183,12608,2021-02-02 10:01:37,neo,Zwift - KISS Race Series - Americas AM (A),Powermeter Stages Cycling,Tacx Neo,480,466,14
108221,12608,2021-02-03 17:59:52,neo,Zwift - LES ROUTES DE ZWIFT Frenchy Fuzion - Etape 1 (C),Powermeter Stages Cycling,Tacx Neo,434,418,16
108850,12608,2021-02-04 17:47:27,neo,Zwift - LES ROUTES DE ZWIFT Frenchy Fuzion - Etape 2 (E),Powermeter Stages Cycling,Tacx Neo,493,474,19
109446,12608,2021-02-05 17:24:08,neo,Zwift - LES ROUTES DE ZWIFT Frenchy Fuzion - Etape 3 (E),Powermeter Stages Cycling,Tacx Neo,438,430,8
109679,12608,2021-02-06 08:38:20,neo,Zwift - LES ROUTES DE ZWIFT Frenchy Fuzion - Etape 4 (A),Powermeter Stages Cycling,Tacx Neo,486,480,6
110009,12608,2021-02-06 16:27:44,neo,Zwift - LES ROUTES DE ZWIFT Frenchy Fuzion - Etape 5 (E),Powermeter Stages Cycling,Tacx Neo,447,448,-1
111377,12608,2021-02-09 10:03:37,neo,Zwift - KISS Race Series - Americas AM (A),Powermeter Stages Cycling,Tacx Neo,430,426,4
111485,12608,2021-02-09 16:51:45,neo,Zwift - 3R Volcano KOM After Party Race - 2 laps + climb (40.2km/25mi 286m) (A),Powermeter Stages Cycling,Tacx Neo,439,430,9
112586,12608,2021-02-10 17:21:04,neo,Zwift - MIDWEEK Winter Series by SZR (A),Powermeter Stages Cycling,Tacx Neo,416,410,6
112723,12608,2021-02-11 10:10:46,neo,Zwift - KISS Race Series - Americas AM (A),Powermeter Stages Cycling,Tacx Neo,420,418,2
127027,12608,2021-03-11 16:36:55,neo,Zwift - OH MY CRIT!! - The Double Race 2/2 (A),Powermeter Stages Cycling,Tacx Neo,423,413,10
127028,12608,2021-03-11 07:58:45,neo,Zwift - ZESP ,Powermeter Stages Cycling,Tacx Neo,455,444,11
127889,12608,2021-03-13 07:44:54,neo,Zwift - TEAM VEGAN Tofu Tornado XL (A),Powermeter Stages Cycling,Tacx Neo,440,442,-2
29355,12901,2020-04-30 06:56:39,wahoo,Zwift - Richmond,Assioma Duo,Wahoo KickR16,170,169,1
29456,12901,2020-04-30 09:39:57,wahoo,Zwift - Koa Sports League Race (B),Assioma Duo,Wahoo KickR16,372,398,-26
34588,12901,2020-05-14 09:44:53,wahoo,Zwift - Koa Sports League Race (B),Assioma Duo,Wahoo KickR16,348,371,-23
53139,12901,2020-09-02 08:05:57,wahoo,Zwift - Aussie Crit Crushers Race 1 of 2 (B),Assioma Duo,Wahoo KickR16,353,360,-7
53141,12901,2020-09-02 08:33:07,wahoo,Zwift - Aussie Crit Crushers Race 2 of 2 (B),Assioma Duo,Wahoo KickR16,333,342,-9
47601,13263,2020-07-24 22:22:16,wahoo,Zwift - Herd Summer Racing League Race 7 (A),2020-07-25-07-52-16,KICKR CORE,319,323,-4
47803,13263,2020-07-26 23:55:51,wahoo,3R LaGuardia Loop Reverse Flat Race - 8 Laps (24.5km/15.2mi 216m) (A),2020-07-27-09-25-51,KICKR CORE,311,332,-21
47804,13263,2020-07-26 03:50:30,wahoo,Zwift - 3R Innsbruckring Flat Race - 2 Laps (17.6km/10.9m 154m) (A),2020-07-26-13-20-30,KICKR CORE,350,369,-19
48564,13263,2020-08-01 23:51:32,wahoo,Zwift - Herd Summer Racing League Race 8 (A),2020-08-02-09-21-32,KICKR CORE,323,340,-17
49048,13263,2020-08-06 09:13:21,wahoo,Zwift - ZHR Up & Down Race (A),2020-08-06-18-43-21,KICKR CORE,315,322,-7
50076,13263,2020-08-14 20:57:15,wahoo,Zwift - 3R LaGuardia Loop Flat Race - 8 Laps (22.9km/14.2mi 216m) (B),2020-08-15-06-27-15,KICKR CORE,353,346,7
50302,13263,2020-08-16 02:51:29,wahoo,Zwift - 3R Watopia Flat Route Race - 3 Laps (30.3km/18.8mi 162m) (B),2020-08-16-12-21-29,KICKR CORE,356,352,4
50303,13263,2020-08-16 23:49:20,wahoo,Zwift - 3R LaGuardia Loop Reverse Flat Race - 8 Laps (24.5km/15.2mi 216m) (B),2020-08-17-09-19-20,KICKR CORE,344,345,-1
53096,13266,2020-09-02 15:49:09,wahoo,Zwift - EVO CC 90 Min Ride Cat C [~2.8-3.2w/kg avg] (C),Assioma ,Kickr,214,213,1
53282,13266,2020-09-03 18:27:07,wahoo,Zwift - Frappe,Assioma ,Kickr,241,248,-7
54134,13266,2020-09-09 15:34:22,wahoo,Zwift - EVO CC Sprint Race Series  (B),Assioma Uno ,Kickr,262,265,-3
55129,13266,2020-09-14 18:29:02,wahoo,Zwift - Invitational League // Qualifying Race #1 (Women),Assioma ,Kickr,273,279,-6
55808,13266,2020-09-17 17:57:58,wahoo,Zwift - Invitational League // Qualifying Race #2 (Women) (A),Assioma ,Kickr,263,272,-9
56474,13266,2020-09-20 13:30:13,wahoo,Invitational League // Qualifying Race #3 (Women),Assioma ,Kickr,251,269,-18
57007,13266,2020-09-23 15:48:32,wahoo,Zwift - INC Steady State 45min - Group Training Ride 2.5 - 3.0w/kg Average (C),Assioma ,Kickr,175,173,2
57261,13266,2020-09-24 16:52:13,wahoo,Zwift - Frappe,Assioma ,Kickr,267,274,-7
61652,13266,2020-10-13 17:53:37,wahoo,Zwift - Zwift Racing League | WTRL,Assioma ,Kickr,289,290,-1
70740,13266,2020-11-12 18:40:03,wahoo,Kickr / Assioma ,Assioma ,Kickr,238,248,-10
75106,13266,2020-11-24 19:14:02,wahoo,Zwift Racing League | WTRL - Womens EMEA W1 DIVISION 1,Assioma Uno ,Kickr,266,277,-11
76042,13266,2020-11-26 18:44:23,wahoo,Zwift - WTRL NOPINZ WORLD TTT CHAMPIONSHIPS - Zone 7 (E),Assioma Uno ,Kickr,264,274,-10
94602,13266,2021-01-10 18:59:55,wahoo, Tour De Boudicca,Assioma Uno ,Kickr,287,291,-4
99738,13266,2021-01-19 19:20:25,wahoo,Zwift - Race warm-up,Assioma Uno ,Kickr,259,263,-4
103723,13266,2021-01-26 19:10:23,wahoo,Zwift - Zwift Racing League | WTRL - Women&#039;s EMEA W1 DIVISION 1 (A),Assioma Uno ,Kickr,268,269,-1
105452,13266,2021-01-30 08:31:52,wahoo,Zwift - London Lockdown eRace Series: Race 1 (D),Assioma Uno ,Kickr,256,258,-2
111758,13266,2021-02-09 19:21:13,wahoo,Zwift - Zwift Racing League | WTRL - Women&#039;s EMEA W1 DIVISION 1 (A),Assioma Uno ,Kickr,268,266,2
116630,13266,2021-02-17 17:53:33,wahoo,Zwift - INC Relentless Intervals (B),Assioma Uno ,Kickr,231,228,3
32767,13398,2020-05-08 17:02:37,wahoo,Zwift - Zwift Fast Fridays: Bologna Time Trial (E),Power2Max,Kickr Core,426,417,9
34952,13398,2020-05-14 17:26:55,wahoo,Zwift - WTRL Team Time Trial Premier League (C),Power2Max,Kickr Core,409,400,9
35090,13398,2020-05-15 18:21:22,wahoo,Zwift - GGCC GlasgowGreen CC TT  (A),Power2Max,Kickr Core,440,419,21
35248,13398,2020-05-16 08:59:54,wahoo,Zwift - Cycling Ireland Zwift League Rd 8 (A),Power2Max,Kickr Core,427,419,8
36796,13398,2020-05-21 17:25:09,wahoo,Zwift - WTRL Team Time Trial Premier League (C),Power2Max,Kickr Core,408,402,6
36883,13398,2020-05-22 17:03:44,wahoo,Zwift - Zwift Fast Fridays: Bologna Time Trial (E),Power2Max,Kickr Core,454,438,16
37011,13398,2020-05-23 08:59:56,wahoo,Zwift - Cycling Ireland Zwift League Rd 9 (A),Power2Max,Kickr Core,432,416,16
38569,13398,2020-05-29 18:14:59,wahoo,Zwift - GGCC GlasgowGreen CC TT  (A),Power2Max,Kickr Core,435,414,21
38658,13398,2020-05-30 08:59:55,wahoo,Zwift - Cycling Ireland Zwift League Rd 10 (A),Power2Max,Kickr Core,447,432,15
39821,13398,2020-06-05 17:05:04,wahoo,Zwift - 3R & Triathlon Ireland TT League - Round 6 (A),Power2Max,Kickr Core,406,387,19
39932,13398,2020-06-06 09:00:19,wahoo,Zwift - Cycling Ireland Zwift League Rd 11 (A),Power2Max,Kickr Core,405,393,12
118392,14021,2021-02-20 16:33:22,wahoo,Zwift - 3R Innsbruckring Flat Race - 3 Laps (26.4km/16.4mi 231m) (A),Quarq D-Four,Wahoo Kickr,314,304,10
120056,14021,2021-02-23 19:35:24,wahoo,Zwift - Zwift Racing League | WTRL - Men&#039;s/Mixed EMEA W2 DIVISION 1 (A),Quarq D-Four,Wahoo Kickr v5,352,345,7
123369,14021,2021-03-02 19:31:56,wahoo,Zwift - Zwift Racing League | WTRL - Men&#039;s/Mixed EMEA W2 DIVISION 1 (A),Quarq D-Four,Wahoo Kickr v5,360,356,4
62999,14073,2020-10-11 21:24:24,wahoo,Zwift - Watopia,Assioma,Kickr,179,183,-4
63288,14073,2020-10-20 04:35:45,wahoo,Zwift - Richmond,Assioma,Kickr,262,280,-18
63376,14073,2020-10-20 15:14:49,wahoo,Zwift - Innsbruck,Assioma,Kickr,265,262,3
111945,14913,2021-02-10 02:45:13,wahoo,Zwift - Zwift Racing League | WTRL - Men&#039;s/Mixed AMERICAS W DIVISION 3 (B),Quark ,Wahoo Kickr,345,328,17
13407,15197,2020-02-11 18:08:06,wahoo,Zwift - SZR iTT Winter Racing League (D),Team Zwatt  Zimanox,Wahoo Kickr 2018,283,287,-4
47101,15197,2020-07-21 03:58:57,wahoo,Zwift - Vikings Valhalla Fatburn Ride (D),Favero Assioma,Wahoo Kickr 2018,240,232,8
47335,15197,2020-07-22 17:02:10,wahoo,Zwift - MIDWEEK Summer Series by SZR (D),Favero Assioma,Wahoo Kickr 2018,309,300,9
47451,15197,2020-07-23 17:21:20,wahoo,Zwift - Mocha (B),Favero Assioma,Wahoo Kickr 2018,300,290,10
47926,15197,2020-07-28 03:57:10,wahoo,Zwift - Vikings Valhalla Fatburn Ride (D),Favero Assioma,Wahoo Kickr 2018,245,234,11
48636,15197,2020-08-03 05:05:34,wahoo,"Zwift - Over under FTP 2x13 z1@145w & z6@340w, legs dead after two out of three blocks",Favero Assioma,Wahoo Kickr 2018,295,280,15
49087,15197,2020-08-06 17:22:16,wahoo,Zwift -  WTRL TTT Mocha - Premiere League,Favero Assioma,Wahoo Kickr 2018,294,279,15
52243,15197,2020-08-27 17:16:12,wahoo,Zwift - WTRL TTT Mocha - Los Ketchup,Favero Assioma,Wahoo Kickr 2018,303,284,19
52658,15197,2020-08-30 04:54:05,wahoo,Zwift - Off The MAAP Stage 1 Race (D),Favero Assioma,Wahoo Kickr 2018,291,281,10
52661,15197,2020-08-30 15:11:51,wahoo,Zwift - Off The MAAP Stage 2 Race (D),Favero Assioma,Wahoo Kickr 2018,294,285,9
53112,15197,2020-09-02 17:01:09,wahoo,Zwift - MIDWEEK Summer Series by SZR (D),Favero Assioma,Wahoo Kickr 2018,307,290,17
53432,15197,2020-09-04 15:00:52,wahoo,Zwift - ZHQ Beta Crit City Race (C),Favero Assioma,Wahoo Kickr 2018,342,322,20
53499,15197,2020-09-05 03:55:00,wahoo,Zwift - SZR Wakeup Endurance Ride (D),Favero Assioma,Wahoo Kickr 2018,213,201,12
54422,15197,2020-09-10 17:24:27,wahoo,Zwift - WTRL TTT Mocha - Platinum League - Los Ketchup,Favero Assioma,Wahoo Kickr 2018,297,282,15
60389,15197,2020-10-08 17:16:27,wahoo,WTRL Team Time Trial PLATINUM LEAGUE,Favero Assioma,Wahoo Kickr 2018,309,310,-1
61526,15197,2020-10-13 17:13:06,wahoo,Zwift Racing League | WTRL - EMEA E (MEN) - Pool 1,Favero Assioma,Wahoo Kickr 2018,306,312,-6
63451,15197,2020-10-20 17:27:27,wahoo,Zwift - Zwift Racing League | WTRL - EMEA E (MEN) - TTT Grp 6 (C),Favero Assioma,Wahoo Kickr 2018,301,307,-6
64192,15197,2020-10-22 17:23:11,wahoo,Zwift - WTRL TTT -  Platinum League - Los Ketchup,Favero Assioma,Wahoo Kickr 2018,284,287,-3
65439,15197,2020-10-27 18:17:07,wahoo,Zwift Racing League | WTRL - Mens EMEA E1 DIVISION 1,Favero Assioma,Wahoo Kickr 2018,293,291,2
66172,15197,2020-10-29 18:23:29,wahoo,Zwift - WTRL Team Time Trial Platinum League (B),Favero Assioma,Wahoo Kickr 2018,273,276,-3
67584,15197,2020-11-03 18:26:57,wahoo,Zwift - Zwift Racing League | WTRL - Men&#039;s EMEA E1 DIVISION 1 (D),Favero Assioma,Wahoo Kickr 2018,290,297,-7
68271,15197,2020-11-05 18:54:37,wahoo,Zwift - WTRL TTT - Platinum League - Mocha,Favero Assioma,Wahoo Kickr 2018,298,297,1
69075,15197,2020-11-08 16:31:59,wahoo,Zwift - Crit City Race (D),Favero Assioma,Wahoo Kickr 2018,286,294,-8
71702,15197,2020-11-15 16:13:25,wahoo,Zwift Academy Road: Workout 7 | VO2 Development,Favero Assioma,Wahoo Kickr 2018,287,282,5
72232,15197,2020-11-17 18:24:17,wahoo,Zwift - Zwift Racing League | WTRL - Men&#039;s EMEA E1 DIVISION 1 (D),Favero Assioma,Wahoo Kickr 2018,308,295,13
74326,15197,2020-11-22 16:31:17,wahoo,Zwift - Crit City Race (C),Favero Assioma,Wahoo Kickr 2018,318,303,15
6103,15543,2019-12-12 15:40:44,wahoo,Zwift - Tour of London // Stage 2 (Short Distance),Garmin Vector 2 (Dual) - Garmin Edge 510,Kickr 2018 - Zwift,306,301,5
6169,15543,2019-12-13 10:15:11,wahoo,Zwift - Richmond Hilly route feeling the burn 100% gradient,Garmin Vector 2 (Dual) - Garmin Edge 510,Kickr 2018 - Zwift,288,287,1
7204,15543,2019-12-24 12:41:29,wahoo,Zwift - Building Up to It (ERG smoothing off),Garmin Vector 2 (Dual) - Garmin Edge 510,Kickr 2018 - Zwift (using Vector 2 powermatch),247,246,1
8833,15543,2020-01-11 10:00:03,wahoo,Zwift - UKZwifters 2 Hour Sportive (B) nice pace after a crazy start,Assioma Duo - Edge 510,Kickr 2018 Zwift,282,274,8
10149,15543,2020-01-20 16:43:16,wahoo,Zwift - Tour de Zwift: Stage 3 Group Ride - Short Distance Sand & Sequoias,Garmin Vector 2 (Dual) - Garmin Edge 510,Kickr 2018 - Zwift BLUETOOTH,302,295,7
10410,15543,2020-01-22 13:01:31,wahoo,Zwift - Watopia testing garmin 530,Garmin Vector 2 (Dual) - Garmin Edge 530,Kickr 2018 Zwift,190,192,-2
10524,15543,2020-01-22 16:58:09,wahoo,Zwift - Watopia Uber Pretzel,Garmin Vector 2 (Dual) - Garmin Edge 530,Kickr 2018 - Zwift,251,248,3
10627,15543,2020-01-23 18:22:51,wahoo,Zwift - WTRL &#039;Ray Mondo&#039; Team Time Trial  (A),Assioma Duo - Edge 530,Kickr 2018 - Zwift,294,284,10
10749,15543,2020-01-24 11:26:16,wahoo,Zwift - Pebble Pounder - Active Recovery,Assioma Duo - Edge 530,Kickr 2018 - Zwift,162,160,2
35453,15543,2020-05-16 08:16:50,wahoo,Fulgaz Cap de Formentor climbing workout,Vector2 + Wahoo Tickr,KICKR2018 + Rhythym24 arm HRM,203,200,3
72349,15543,2020-11-17 19:54:02,wahoo,Zwift - Zwift Racing League | WTRL - Men&#039;s EMEA W1 DIVISION 2 (B) + cooldown,Assioma Duo - Edge 530,Kickr 2018 - Zwift BLUETOOTH,297,293,4
75631,15543,2020-11-25 11:27:26,wahoo,Zwift - France Learning to Survive - 120 Xert,Assioma Duo - Edge 530,Kickr 2018 Zwift,246,245,1
61784,15833,2020-10-12 16:30:00,wahoo,Zwift - Holly Lawrence Coffee Ride (E),Assioma,Kickr 2016,226,217,9
61786,15833,2020-09-29 18:29:52,wahoo,Zwift - R obbo1234biking (STW)&#039;s Meetup - Royal Pump Room 8,Assioma,Kickr 2016,310,309,1
70184,15833,2020-11-11 14:19:57,wahoo,Zwift - Ascenders Team Midweek Ride (D),Assioma,Kickr 2016,218,206,12
70959,15833,2020-11-12 18:29:50,wahoo,Zwift - WKG Winter League 2020 / 2021  (B),Assioma,Kickr 2016,337,312,25
72170,15833,2020-11-16 19:00:26,wahoo,Zwift - WKG Winter League 2020 / 2021  (B),Assioma,Kickr 2016,329,300,29
28140,16428,2020-04-26 06:44:00,wahoo,Zwift - 3R Figure 8 Hilly Race - 1 Lap (29.2km/18.1m 234m) (A),Quarq ,Wahoo Kickr,380,362,18
28653,16428,2020-04-28 06:11:01,wahoo,Zwift - Crit City Slam Race // Zwift Classic (A),Quarq DZero,Wahoo Kickr,364,335,29
29026,16428,2020-04-29 09:00:01,wahoo,Zwift - AHDR p/b Giant (B),Quarq Dzero,Wahoo Kickr,380,364,16
30363,16428,2020-05-02 06:51:06,wahoo,Zwift - Watopia,Quarq Dzero,Wahoo Kickr,237,217,20
30768,16428,2020-05-03 01:08:27,wahoo,Zwift - Watopia | Ceramic Speed unlock and Megapretzel Route Achievement,Quarq Dzero,Wahoo Kickr,286,280,6
32875,16428,2020-05-09 05:03:51,wahoo,Zwift - 3R Watopia Hilly Reverse Race - 3 Laps (27.5km/17.1mi 300m) (A),Quarq Elsa,Wahoo Kickr,389,371,18
33811,16428,2020-05-12 08:33:23,wahoo,Zwift - SRAM Send it Series - Race 1 - Men&#039;s (E),Quarq Dzero,Wahoo Kickr,373,375,-2
34569,16428,2020-05-14 08:37:36,wahoo,Zwift - Cycling Australia&#039;s The Chop by AHDR (A),Quarq Dzero,Wahoo Kickr,369,366,3
35165,16428,2020-05-15 23:11:27,wahoo,Zwift - NRS Invitational - Week 2 (B),Quarq Dzero,Wahoo Kickr,404,376,28
35970,16428,2020-05-19 08:21:15,wahoo,Zwift - SRAM Send it Series - Race 2 - Men&#039;s (E),Quarq Dzero,Wahoo Kickr,405,388,17
36306,16428,2020-05-20 06:45:42,wahoo,Zwift - Aussie Crit Crushers Race 2 of 2 (A),Quarq Dzero,Wahoo Kickr,349,330,19
36311,16428,2020-05-20 06:45:42,wahoo,Zwift - 3R Volcano Circuit Flat Race - 4 Laps (18.9km/11.7mi 80m) (A),Quarq Dzero,Wahoo Kickr,406,390,16
36552,16428,2020-05-21 07:59:54,wahoo,Zwift - Cycling Australia&#039;s The Chop by AHDR (A),Quarq Dzero,Wahoo Kickr,356,334,22
36554,16428,2020-05-21 07:59:54,wahoo,Zwift - Team 3R&#039;s Choice: Stage 5 Longer Race A/B,Quarq Dzero,Wahoo Kickr,387,363,24
39028,16428,2020-06-02 08:01:14,wahoo,Zwift - SRAM Send it Series - Race 4 - Men&#039;s (E)    #DualRecord,Quarq Dzero,Wahoo Kickr,395,377,18
41313,16428,2020-06-12 23:07:51,wahoo,Zwift - NRS Invitational - Week 4 (B),Quarq Dzero,Wahoo Kickr,374,351,23
41896,16428,2020-06-16 09:01:55,wahoo,Zwift - SRAM Send it Series - Race 6 - Men&#039;s (E),Quarq Dzero,Wahoo Kickr,383,355,28
43747,16428,2020-06-26 22:39:09,wahoo,Zwift - NRS Invitational - Week 5: Men Only,Quarq Elsa,Wahoo Kickr,400,386,14
45848,16428,2020-07-11 00:08:55,wahoo,Zwift - NRS Invitational - Week 6 (B),Quarq Dzero,Wahoo Kickr,380,363,17
116907,16589,2021-02-17 21:50:01,wahoo,Day 9 - Zwift - Long Island Cranx Race (A),P2M Type S,Wahoo Kickr V5,377,361,16
28957,16672,2020-04-29 08:04:30,neo,Zwift - Aussie Crit Crushers Race 1 of 2 (A),Stages PM,Tacx Neo,346,354,-8
40700,16672,2020-06-10 05:03:29,neo,Zwift - 3R Gotham Grind Flat Race - 1 Lap (9.25km/5.8mi 29m) (A),Stages PM,Tacx Neo,333,316,17
52572,16672,2020-08-30 03:12:00,neo,Zwift - 3R Watopia Flat Route Race - 3 Laps (30.3km/18.8mi 162m) (A),Stages PM,Tacx Neo,320,310,10
82960,16672,2020-12-13 20:41:13,neo,Zwift - ZA Tri: TT Race - 20k,Stages PM,Tacx Neo,332,329,3
86268,16672,2020-12-22 20:39:00,neo,Zwift - ZA Tri: TT Race - 20k,Stages PM,Tacx Neo,316,308,8
11211,16708,2020-01-27 10:50:27,neo,Zwift - KISS at Base Training Ride (B),Assioma Duo,Tacx Neo,346,339,7
14525,16708,2020-02-18 18:05:59,neo,Zwift - SZR iTT Winter Racing League (A),Assioma Duo,Tacx Neo,362,360,2
15314,16708,2020-02-23 14:15:05,neo,KISS at Race 100 - Americas,Assioma Duo,Tacx Neo,311,307,4
19968,16708,2020-03-27 16:36:43,neo, KALAS Indoor EFCT race series #iTT,Assioma Duo,Tacx Neo,348,343,5
30140,16708,2020-05-01 14:57:17,neo,Regular Assioma vs Neo calibration check,Assioma Duo,Tacx Neo,335,327,8
42360,16708,2020-06-18 09:29:46,neo,Zwift - ZHR Up & Down Race (A),Assioma Duo,Tacx Neo,333,330,3
42409,16708,2020-06-18 15:14:57,neo,Zwift - OH CRIT!! - Lockdown Series - Round 3 Race 1 (A),Assioma Duo,Tacx Neo,341,339,2
52902,16708,2020-09-01 17:07:25,neo,Zwift - SZR iTT Autumn Racing league (A),Assioma Duo,Tacx Neo,342,340,2
55350,16708,2020-09-15 17:09:57,neo,Zwift - SZR iTT Autumn Racing league (A),Assioma Duo,Tacx Neo,361,357,4
58725,16708,2020-10-01 10:56:29,neo,Zwift - Team ODZ Thursday Morning Throwdown (E),Assioma Duo,Tacx Neo,358,353,5
59614,16708,2020-10-05 16:36:05,neo,Zwift - ZHR Zwift Handicap Race Europe (A),Assioma Duo,Tacx Neo,345,338,7
59616,16708,2020-10-05 17:34:17,neo,Zwift - Kiss Racing Team / FastFitnessTips iTT series (E),Assioma Duo,Tacx Neo,340,333,7
60011,16708,2020-10-07 09:57:24,neo,Zwift - Maximus Shootout Time Trial (E),Assioma Duo,Tacx Neo,356,352,4
60264,16708,2020-10-08 11:14:26,neo,British Cycling Time Trial Series,Assioma Duo,Tacx Neo,352,349,3
60331,16708,2020-10-08 17:29:29,neo,Zwift - British Cycling Time Trial Series (A),Assioma Duo,Tacx Neo,347,346,1
61169,16708,2020-10-12 16:34:10,neo,Zwift - ZHR Zwift Handicap Race Europe (A),Assioma Duo,Tacx Neo,345,342,3
62477,16708,2020-10-16 17:01:47,neo,Zwift - Team WEZ Friday Race (A),Assioma Duo,Tacx Neo,338,325,13
63047,16708,2020-10-19 17:28:13,neo,Zwift - Kiss Racing Team / FastFitnessTips iTT series (E),Assioma Duo,Tacx Neo,368,359,9
69243,16708,2020-11-09 10:26:14,neo,DIRTy Dozen Sprint League,Assioma Duo,Tacx Neo,337,331,6
69324,16708,2020-11-09 17:13:54,neo,Zwift - Kiss Racing Team / FastFitnessTips iTT series (E),Assioma Duo,Tacx Neo,346,341,5
72945,16708,2020-11-19 12:15:17,neo,Zwift - Team ODZ Thursday Morning Throwdown (E),Assioma Duo,Tacx Neo,356,342,14
73803,16708,2020-11-21 11:04:55,neo,Team EN Hang-On Ride,Assioma Duo,Tacx Neo,388,372,16
74461,16708,2020-11-23 10:30:15,neo,Zwift - DIRTy Dozen Sprint League (A),Assioma Duo,Tacx Neo,308,301,7
74556,16708,2020-11-23 17:24:54,neo,Zwift - Kiss Racing Team / FastFitnessTips iTT series (E) / Sweet Spot,Assioma Duo,Tacx Neo,318,313,5
74917,16708,2020-11-24 12:33:27,neo,Team ODZ Tuesday Covfefe Espresso Humblebrag Series Finale,Assioma Duo,Tacx Neo,393,382,11
75142,16708,2020-11-24 19:46:18,neo,Zwift - Zwift Racing League | WTRL - Men&#039;s EMEA W1 DIVISION 3 (A),Assioma Duo,Tacx Neo,341,328,13
75399,16708,2020-11-25 10:45:07,neo,Zwift - USA Cycling Race League by Indoor Specialist (A),Assioma Duo,Tacx Neo,320,311,9
75871,16708,2020-11-26 12:15:22,neo,Zwift - Team ODZ Thursday Morning Throwdown (E),Assioma Duo,Tacx Neo,264,251,13
81008,16708,2020-12-09 14:32:36,wahoo,Zwift - 3R Sand & Sequoias - Kickr V5 Test,Assioma Duo,Kickr V5,319,308,11
81608,16708,2020-12-10 18:29:41,neo,Zwift - FUSION DECEMBER CUP (A),Assioma Duo (2nd Pair),Tacx Neo,351,345,6
91764,16708,2021-01-05 18:00:23,neo,Zwift - KIRCHMAIR TT Race (A),Assioma Duo,Tacx Neo,353,343,10
95433,16708,2021-01-12 11:04:30,neo,Zwift - MGCC Ride & Race (B),Assioma Duo,Tacx Neo,303,298,5
110900,16708,2021-02-08 10:49:51,neo,Zwift - KISS at Base Training Ride (B),Assioma Duo,Tacx Neo,333,324,9
118429,17055,2021-02-20 18:09:00,wahoo,Zwift - BRT&#039;s Thunder & Lightning (B),Rotor Inpower,Wahoo Kickr V3,362,356,6
127166,17055,2021-03-11 19:00:59,wahoo,Zwift - Flanders The BZR Ronde Spring Classics League (B),Rotor Inpower,Wahoo Kickr V3,386,372,14
8544,17943,2020-01-09 07:00:43,wahoo,Zwift - 3R Innsbruckring Flat Race - 5 Laps (44km/27.3mi 385m) (A),Power2Max,Kickr Core,393,403,-10
13086,17943,2020-02-09 07:25:06,wahoo,Zwift - Tour de Zwift: Stage 1 Long Distance,Quarq DZero,Kickr Core,411,421,-10
13470,17943,2020-02-11 19:47:12,wahoo,Zwift - Japan ZWIFT Morning Race -Innsbruck KOM After Party(37km) (A),Quarq DZero,Kickr Core,413,424,-11
34233,17943,2020-05-13 08:41:49,wahoo,Kickr Core / Quarq DZero,Quarq DZero,Kickr Core,285,287,-2
35977,17943,2020-05-19 08:28:31,wahoo,Zwift - SRAM Send it Series - Race 2 - Men&#039;s (E),Quarq DZero,Kickr Core,420,426,-6
36295,17943,2020-05-20 05:29:32,wahoo,Zwift - 3R Volcano Circuit Flat Race - 4 Laps (18.9km/11.7mi 80m) (A),Quarq DZero,Kickr Core,436,441,-5
36987,17943,2020-05-23 05:20:52,wahoo,Zwift - 3R Road To Ruins Hilly Race - 1 Lap (29..2km/18.1mi 275m) (A),Quarq DZero,Kickr Core,450,452,-2
37266,17943,2020-05-24 01:56:46,wahoo,Zwift - Team 3R&#039;s Choice: Stage 5 Longer Race A/B,Quarq DZero,Kickr Core,424,426,-2
37737,17943,2020-05-26 08:30:18,wahoo,Zwift - SRAM Send it Series - Race 3 - Men&#039;s (E),Quarq DZero,Kickr Core,424,427,-3
38243,17943,2020-05-28 08:49:39,wahoo,Zwift - ZHR Up & Down Race (A),Quarq DZero,Kickr Core,422,425,-3
39034,17943,2020-06-02 08:25:41,wahoo,Zwift - SRAM Send it Series - Race 4 - Men&#039;s (E),SRM,Kickr Core,440,445,-5
40467,17943,2020-06-09 08:21:13,wahoo,Zwift - SRAM Send it Series - Race 5 - Men&#039;s (E),SRM,Kickr Core,445,448,-3
40957,17943,2020-06-11 07:47:55,wahoo,Zwift - Cycling Australia&#039;s The Chop by AHDR (A),SRM,Kickr Core,408,413,-5
41899,17943,2020-06-16 08:27:25,wahoo,Zwift - SRAM Send it Series - Race 6 - Men&#039;s (E),SRM,Kickr Core,424,432,-8
42358,17943,2020-06-18 08:50:25,wahoo,Zwift - Cycling Australia&#039;s The Chop by AHDR (A),SRM,Kickr Core,392,396,-4
42928,17943,2020-06-21 04:48:17,wahoo,KISS at Race 100. I. Am. Toast.,Quarq DZero,Kickr Core,417,417,0
43183,17943,2020-06-23 08:22:44,wahoo,Zwift - SRAM Send it Series - Race 7 - Men&#039;s (E),Quarq DZero,Kickr Core,432,435,-3
44160,17943,2020-06-30 08:13:06,wahoo,Zwift - SRAM Send it Series - Race 8 - Men&#039;s (E),SRM,Kickr Core,430,434,-4
44518,17943,2020-07-02 08:25:55,wahoo,Zwift - ZHR Up & Down Race (A),SRM,Kickr Core,439,445,-6
44926,17943,2020-07-05 03:18:46,wahoo,Zwift - L&#039;Etape du Tour Stage 1 - Open,SRM,Kickr Core,433,438,-5
45553,17943,2020-07-09 08:30:16,wahoo,Zwift - The Lamb Chop p/b Black Sheep (A),SRM,Kickr Core,409,411,-2
46107,17943,2020-07-13 02:23:01,wahoo,Zwift - Virtual Tour de France - Open - Stage 4 Discovery Ride,SRM,Kickr Core,456,462,-6
46561,17943,2020-07-16 08:12:02,wahoo,Zwift - The Lamb Chop p/b Black Sheep (A),Quarq DZero,Kickr Core,458,458,0
47026,17943,2020-07-20 02:39:02,wahoo,Virtual Tour de France - Open - Stage 5 Discovery Ride,SRM,Kickr Core,397,404,-7
47405,17943,2020-07-23 07:46:09,wahoo,Zwift - The Lamb Chop p/b Black Sheep (A),SRM,Kickr Core,412,417,-5
47942,17943,2020-07-28 07:17:24,wahoo,Zwift - KISS at Race - Down Under (A),SRM,Kickr Core,452,454,-2
48262,17943,2020-07-30 08:19:02,wahoo,Zwift - The Lamb Chop p/b Black Sheep (A),SRM,Kickr Core,409,411,-2
48874,17943,2020-08-05 07:19:09,wahoo,Zwift - Aussie Crit Crushers Race 1 of 2 (A),Quarq DZero,Kickr2,399,382,17
50209,17943,2020-08-16 03:36:11,wahoo,Zwift - Off The MAAP Stage 1 - Longer Ride,SRM,Kickr Core,420,427,-7
50867,17943,2020-08-20 08:08:54,wahoo,Zwift - Cycling Australia&#039;s The Chop by AHDR (A),SRM,Kickr Core,420,424,-4
51181,17943,2020-08-22 05:28:18,wahoo,Zwift - Off The MAAP Stage 3 Race (A),SRM,Kickr Core,426,432,-6
52106,17943,2020-08-27 05:48:29,wahoo,Zwift - Off The MAAP Stage 4 - Shorter Ride,Quarq DZero,Kickr Core,380,381,-1
53330,17943,2020-09-03 08:53:16,wahoo,Zwift - Cycling Australia&#039;s The Chop by AHDR (A),Quarq DZero,Kickr Core,393,395,-2
53500,17943,2020-09-05 04:31:04,wahoo,Zwift - XRS Races - The Saturday Classic (A),Quarq DZero,Kickr Core,427,426,1
54307,17943,2020-09-10 08:33:20,wahoo,Zwift - Cycling Australia&#039;s The Chop by AHDR (A),SRM,Kickr Core,404,407,-3
54801,17943,2020-08-18 07:14:02,wahoo,Zwift - Off The MAAP Stage 2 - Longer Ride,Quarq DZero,Kickr Core,383,391,-8
56023,17943,2020-09-17 17:56:55,wahoo,Zwift - Invitational League // Qualifying Race #2 (Men) ,Quarq DZero,Kickr Core,398,403,-5
56444,17943,2020-09-20 12:09:54,wahoo,Zwift - Invitational League // Qualifying Race #3 (Men) (A),Quarq DZero,Kickr Core,413,421,-8
85977,17943,2020-12-22 05:29:06,wahoo,Zwift - Zwift Time Trial Tuesday: Tempus Fugit (E),Infocrank,Kickr5,376,386,-10
86330,17943,2020-12-23 01:24:59,wahoo,"ZADA Three Sisters test, Team Aero",Infocrank,Kickr5,412,415,-3
87082,17943,2020-12-24 21:34:59,wahoo,Zwift - Crit City Race (A),Infocrank,Kickr5,402,409,-7
91982,17943,2021-01-05 23:51:42,wahoo,Zwift - TDZ Stage 1: Standard Ride,Infocrank,Kickr5,250,257,-7
92505,17943,2021-01-07 00:25:46,wahoo,Zwift - TDZ Stage 1: Longer Ride,Infocrank,Kickr5,286,276,10
95089,17943,2021-01-11 18:43:36,wahoo,Zwift - Premier Division // Zwift Racing League (men) (A),Infocrank,Kickr5,395,392,3
97358,17943,2021-01-11 18:43:36,wahoo,Zwift - TDZ Stage 2: Shorter Ride,Infocrank,Kickr5,322,320,2
97692,17943,2021-01-15 23:35:03,wahoo,"TdZ, stage 3",Infocrank,Kickr5,392,396,-4
99313,17943,2021-01-18 19:24:58,wahoo,Zwift - Premier Division // Zwift Racing League (men) (A),Infocrank,Kickr5,411,415,-4
99317,17943,2021-01-18 19:24:58,wahoo,Zwift - 3R London Loop Hilly Race - 2 Laps (29km/18mi 440m) (A),Infocrank,Kickr5,434,433,1
100611,17943,2021-01-21 04:39:44,wahoo,Zwift - TDZ Stage 4: Longer Ride,Infocrank,Kickr5,381,380,1
102999,17943,2021-01-25 18:33:12,wahoo,Zwift - Premier Division // Zwift Racing League (men) (A),Infocrank,Kickr5,400,402,-2
103008,17943,2021-01-25 18:33:12,wahoo,Zwift - TDZ Stage 5: Shorter Ride,Infocrank,Kickr5,363,367,-4
111269,17943,2021-02-09 01:51:46,wahoo,Zwift - TDZ Stage 8: Group Ride,Infocrank,Kickr5,334,339,-5
112568,17943,2021-02-11 01:52:07,wahoo,Zwift - TDZ Stage 8: Group Ride,Quarq DZero,Kickr5,380,369,11
113786,17943,2021-02-12 23:41:52,wahoo,"Mega Pretzel, jungle segment needs to die",Infocrank,Kickr5,333,338,-5
115001,17943,2021-02-15 07:21:51,wahoo,Zwift - TDZ Stage 8: Group Ride,Infocrank,Kickr5,303,312,-9
115364,17943,2021-02-15 19:25:07,wahoo,Zwift - Premier Division // Zwift Racing League (men) (A),Infocrank,Kickr5,465,422,43
116327,17943,2021-02-17 06:07:43,wahoo,Zwift - TDZ Stage 2: Longer Ride,Infocrank,Kickr5,392,400,-8
119146,17943,2021-02-22 18:27:55,wahoo,Zwift - Premier Division // Zwift Racing League (men) (A),Infocrank,Kickr5,360,375,-15
122648,17943,2021-03-01 19:28:21,wahoo,Zwift - Premier Division // Zwift Racing League (men) (A),Infocrank,Kickr5,386,391,-5
101575,18521,2021-01-22 23:30:58,wahoo,Zwift - ZHQ FutureWorks Circuit Race - Anti-sandbagging (B),Power2Max,Kickr,292,281,11
67246,19462,2020-11-02 18:01:52,wahoo,Zwift - SZR Evening Joyride (C),Vector 3,Wahoo Kickr V5,318,299,19
68312,19462,2020-11-05 19:50:36,wahoo,Zwift - WTRL Team Time Trial - Zone 8 (D),Vector 3,Wahoo Kickr V5,327,323,4
70345,19462,2020-11-11 20:14:05,wahoo,Garmin ride - phone/zwift comparison,Wahoo Kickr V5,Wahoo Kickr V5,207,197,10
70349,19462,2020-11-11 20:14:05,wahoo,Garmin ride - phone/zwift comparison,Snap,Wahoo Kickr V5,197,197,0
71536,19462,2020-11-15 08:13:27,wahoo,Wahoo Kickr V5 / Vector 3,Vector 3,Wahoo Kickr V5,323,322,1
97203,19462,2021-01-14 19:39:45,wahoo,Zwift - WTRL Team Time Trial - Zone 9 (D),Vector 3,Wahoo Kickr V5,332,340,-8
112227,19462,2021-02-10 17:59:48,wahoo,Zwift - Alistair Wood (Team Sheffield)&#039;s Meetup - Greater London Flat,Garmin Vector 3,Wahoo Kickr V5,337,340,-3
113068,19462,2021-02-11 19:50:21,wahoo,Zwift - WTRL Team Time Trial - Zone 11 (C),Garmin Vector 3,Wahoo Kickr V5,320,329,-9
123473,19462,2021-03-03 15:04:27,wahoo,Just a test after recalibrating my Vector,Garmin Vector 3,Wahoo Kickr V5,157,157,0
124158,19462,2021-03-04 19:52:05,wahoo,Zwift - WTRL Team Time Trial - Zone 12 (C),Garmin Vector 3,Wahoo Kickr V5,335,339,-4
40018,19498,2020-06-06 16:00:08,wahoo,Zwift - GCA Klassiker #1,Stages,KICKR 18,399,385,14
42846,19498,2020-06-20 16:00:11,wahoo,Zwift - GCA Klassiker #3 (A),Stages,KICKR 18,412,388,24
62229,19498,2020-10-15 17:29:56,wahoo,Zwift - FUSION ECT BEUNSTOPPABLE Racing Series (A),Stages,KICKR 18,417,418,-1
72650,19498,2020-11-18 18:45:00,wahoo,Zwift - GCA Cup (A),Stages,KICKR 18,384,365,19
76986,19498,2020-11-28 09:00:18,wahoo,Zwift - ZTS Season II - Race 1 (A),Stages,KICKR 18,404,389,15
80193,19498,2020-12-06 14:14:54,wahoo,Zwift - KISS 100 Race Series - Americas (A),Stages,KICKR 18,366,350,16
81329,19498,2020-12-09 18:44:55,wahoo,Zwift - GCA Cup (A),Stages,KICKR 18,379,362,17
82191,19498,2020-12-12 08:59:55,wahoo,Zwift - ZTS Season II - Race 2 (A),Stages,KICKR 18,382,375,7
84177,19498,2020-12-16 18:44:54,wahoo,Zwift - GCA Cup (A),Stages,KICKR 18,385,361,24
84400,19498,2020-12-17 18:29:54,wahoo,Zwift - FUSION DECEMBER CUP (A),Stages,KICKR 18,367,345,22
86598,19498,2020-12-23 18:44:54,wahoo,Zwift - GCA Cup (A),Stages,KICKR 18,408,394,14
90062,19498,2021-01-02 08:59:54,wahoo,Zwift - ZTS Season II - Race 3 (A),Stages,KICKR 18,362,340,22
92369,19498,2021-01-06 18:44:59,wahoo,Zwift - GCA Cup (A),Stages,KICKR 18,357,336,21
96406,19498,2021-01-13 18:44:57,wahoo,Zwift - GCA Cup (A),Stages,KICKR 18,395,380,15
97753,19498,2021-01-16 08:59:52,wahoo,Zwift - ZTS Season II - Race 4 (A),Stages,KICKR 18,380,366,14
127759,19498,2021-03-13 09:00:25,wahoo,Zwift - ZTS Season II - Race 8 - das grosse Finale! (A),Stages,KICKR 18,401,387,14
28945,19673,2020-04-25 09:54:20,wahoo,Zwift - PartyAnimal 80 palapala Mega Pretzel 110K (B),Garmin Vector 3S,Wahoo Kickr,298,294,4
28947,19673,2020-04-14 18:28:20,wahoo,Zwift - 3R Spring Loaded Race Series - Round 3of6 (A),Garmin Vector 3S,Wahoo Kickr,307,326,-19
31962,19673,2020-05-03 07:23:42,wahoo,Zwift - Gaul! ZwiftUp for War Child stage 2 (E),Garmin Vector 3S,Wahoo Kickr,283,294,-11
32096,19673,2020-05-06 17:24:24,wahoo,Zwift - Zwift NL League - Woensdagavond Competitie (A),Garmin Vector 3S,Wahoo Kickr,332,361,-29
34443,19673,2020-05-13 17:22:45,wahoo,Zwift - Zwift NL League - Woensdagavond Competitie (A),Garmin Vector 3S,Wahoo Kickr,340,354,-14
36428,19673,2020-05-20 17:11:02,wahoo,Zwift - Zwift NL League - Woensdagavond Competitie (A),Garmin Vector 3S,Wahoo Kickr,343,342,1
38370,19673,2020-05-27 17:13:14,wahoo,Zwift - Zwift NL League - Woensdagavond Competitie (A),Garmin Vector 3S,Wahoo Kickr,333,339,-6
39422,19673,2020-06-03 17:23:08,wahoo,Zwift - Zwift NL League - Woensdagavond Competitie (A),Garmin Vector 3S,Wahoo Kickr,322,334,-12
42091,19673,2020-06-14 17:05:12,wahoo,Zwift - 3R Greater London 8 Hilly Race - 1 Lap (23.8km/14.8mi 238m) (A),Garmin Vector 3S,Wahoo Kickr,348,354,-6
42243,19673,2020-06-17 17:05:25,wahoo,Zwift - Zwift NL League - The Watopia Series  (A),Garmin Vector 3S,Wahoo Kickr,344,347,-3
43421,19673,2020-06-24 17:17:49,wahoo,Zwift - Zwift NL League - The Watopia Series  (A),Garmin Vector 3S,Wahoo Kickr,345,342,3
44442,19673,2020-07-01 17:12:06,wahoo,Zwift - Zwift NL League - The Watopia Series  (A),Garmin Vector 3S,Wahoo Kickr,321,323,-2
57937,19673,2020-09-27 13:11:09,wahoo,Zwift - KISS at Race 100 - Americas (A),Garmin Vector 3S,Wahoo Kickr,313,334,-21
58278,19673,2020-09-29 16:58:23,wahoo,Zwift - ZESP Hamster (A),Garmin Vector 3S,Wahoo Kickr,321,334,-13
58846,19673,2020-10-01 16:46:37,wahoo,Zwift - FUSION ECT BEUNSTOPPABLE Racing Series (A),Garmin Vector 3S,Wahoo Kickr,301,324,-23
59411,19673,2020-10-04 08:55:55,wahoo,Zwift - Newbury Velo Road Race (A),Garmin Vector 3S,Wahoo Kickr,304,322,-18
62267,19673,2020-10-15 17:14:45,wahoo,Zwift - FUSION ECT BEUNSTOPPABLE Racing Series (A),Garmin Vector 3S,Wahoo Kickr,334,351,-17
62807,19673,2020-10-18 07:33:56,wahoo,Zwift - 100km ZESP Fondo (A),Garmin Vector 3S,Wahoo Kickr,312,325,-13
63414,19673,2020-10-20 16:13:04,wahoo,Zwift - Team Sportslab UK Road Race League (A),Garmin Vector 3S,Wahoo Kickr,330,343,-13
64907,19673,2020-10-25 08:23:48,wahoo,Zwift - 100km ZESP Fondo (A),Garmin Vector 3S,Wahoo Kickr,318,333,-15
64910,19673,2020-10-24 10:46:15,wahoo,Zwift - ZA Road - Race #2 (A),Garmin Vector 3S,Wahoo Kickr,307,314,-7
116797,19673,2021-02-17 18:42:44,wahoo,Zwift - Zwift NL Race Day (A),Powertap P1,Wahoo Kickr,325,326,-1
120412,19673,2021-02-24 18:52:43,wahoo,Zwift - Zwift NL Race Day (A),Powertap P1,Wahoo Kickr,332,333,-1
125467,19673,2021-03-07 08:16:28,wahoo,Zwift - Flanders Endurance Race League (A),Powertap P1,Wahoo Kickr,322,316,6
127607,19673,2021-03-12 18:06:41,wahoo,Zwift - 50-59 BRT Ages Racing League (C),Powertap P1,Wahoo Kickr,336,335,1
128296,19673,2021-03-14 08:50:03,wahoo,Zwift - Newbury Velo Road Race (A),Powertap P1,Wahoo Kickr,303,304,-1
35451,20267,2020-05-14 20:35:28,wahoo,Zwift - Tour for All 2020: Stage 3 Longer Ride with Ella Harris,Vector,Kickr,295,269,26
40874,20267,2020-06-10 20:26:52,wahoo,Kickr Vector Ramp 2,Vector,Kickr,340,328,12
43242,20267,2020-06-23 06:13:07,wahoo,Ansel Adams + Kickr Powermatch,Vector,Kickr,265,263,2
44730,20267,2020-07-03 21:05:01,wahoo,Zwift - Zwift Fast Fridays: Tempus Fugit Time Trial (4.6),Vector,Kickr,314,309,5
50238,20267,2020-08-16 13:59:54,wahoo,Zwift - ZHR Masters Weekender (A),Vector,Kickr,323,324,-1
66124,20267,2020-10-29 17:12:26,wahoo,Zwift - ZHR Hare & Hounds Race (A),Vector,Kickr,291,292,-1
127933,20267,2021-03-10 21:49:14,wahoo,Long Island Crank Race 8 3 21,Vector 3S,Kickr,271,270,1
14570,20421,2020-02-18 19:10:56,neo,Zwift - Feltet.dk Race Series,PowerTap P1,Tacx Neo Bike,334,351,-17
43077,20421,2020-06-22 10:00:16,neo,Zwift - New Workout,PowerTap P1,Tacx Neo Bike,363,363,0
43078,20421,2020-06-22 09:59:53,neo,EVR Asia Race,PowerTap P1,Tacx Neo Bike,358,363,-5
53248,20421,2020-09-03 17:29:57,neo,Zwift - FUSION ECT BEUNSTOPPABLE Racing Series (A),PowerTap P1,Tacx Neo Bike,354,367,-13
53518,20421,2020-09-05 08:29:57,neo,Zwift - DBR SufferDay League II (A),PowerTap P1,Tacx Neo Bike,370,388,-18
55678,20421,2020-09-16 17:44:38,neo,Zwift - DCU powered by Feltet.dk (A),PowerTap P1,Tacx Neo Bike,308,325,-17
56422,20421,2020-09-20 12:59:27,neo,Zwift - Invitational League // Qualifying Race #3 (Men) (A),PowerTap P1,Tacx Neo Bike,362,380,-18
58465,20421,2020-09-24 16:29:48,neo,Zwift - OTAKAM Race Series (A),PowerTap P1,Tacx Neo Bike,366,380,-14
58466,20421,2020-09-24 17:30:15,neo,Zwift - FUSION ECT BEUNSTOPPABLE Racing Series (A),PowerTap P1,Tacx Neo Bike,349,368,-19
58598,20421,2020-09-30 17:44:18,neo,Zwift - DCU powered by Feltet.dk (A),PowerTap P1,Tacx Neo Bike,381,405,-24
61610,20421,2020-10-13 18:19:00,neo,Zwift - Zwift Racing League | WTRL (A),PowerTap P1,Tacx Neo Bike,361,373,-12
63690,20421,2020-10-20 18:13:41,neo,Zwift - Zwift Racing League | WTRL - EMEA (MEN) - TTT Grp 2 (C),PowerTap P1,Tacx Neo Bike,368,378,-10
82042,20421,2020-11-05 18:27:45,neo,Zwift - FUSION ECT BEUNSTOPPABLE Racing Series (A),PowerTap P1,Tacx Neo Bike,340,347,-7
82044,20421,2020-11-12 18:48:05,neo,Zwift - Espresso,PowerTap P1,Tacx Neo Bike,320,339,-19
82046,20421,2020-12-08 19:37:03,neo,Zwift - Zwift Racing League | WTRL - Men&#039;s EMEA W1 DIVISION 1 (A),PowerTap P1,Tacx Neo Bike,339,355,-16
83599,20421,2020-12-15 18:15:48,neo,Zwift - Zwift Racing League | WTRL - Men&#039;s EMEA E1 DIVISION 1 (A),PowerTap P1,Tacx Neo Bike,340,356,-16
87218,20421,2020-12-25 13:58:23,neo,Zwift - 3R Innsbruckring Flat Race - 2 Laps (17.6km/10.9m 154m) (A),PowerTap P1,Tacx Neo Bike,319,332,-13
87221,20421,2020-12-25 15:02:54,neo,Zwift - 3R Sand and Sequoias Race (A),PowerTap P1,Tacx Neo Bike,341,353,-12
90271,20421,2021-01-01 18:00:30,neo,Zwift - Cocorico Race League - Bikes France,PowerTap P1,Tacx Neo Bike,342,355,-13
93357,20421,2021-01-07 13:59:14,neo,Zwift - TDZ Stage 1: Longer Ride,PowerTap P1,Tacx Neo Bike,324,343,-19
93360,20421,2021-01-08 09:58:34,neo,Zwift - 3R Innsbruckring Flat Race - 4 Laps (35.2km/21.9mi 308m) (A),PowerTap P1,Tacx Neo Bike,320,341,-21
97368,20421,2021-01-14 18:20:16,neo,Zwift - FUSION WINTER CUP (A),PowerTap P1,Tacx Neo Bike,398,409,-11
98864,20421,2021-01-17 18:01:29,neo,Zwift - 3R Watopia Hilly Reverse Race - 4 Laps (36.7km/22.8mi 400m) (A),PowerTap P1,Tacx Neo Bike,397,414,-17
99825,20421,2021-01-19 19:26:08,neo,Zwift - Zwift Racing League | WTRL - Men&#039;s/Mixed EMEA W2 DIVISION 1 (A),PowerTap P1,Tacx Neo Bike,352,364,-12
100396,20421,2021-01-20 18:17:38,neo,Zwift - Danmarks Cykle Union & Partners 2/6 (A),PowerTap P1,Tacx Neo Bike,393,404,-11
104304,20421,2021-01-27 18:20:40,neo,Zwift - Danmarks Cykle Union & Partners 3/6 (A),PowerTap P1,Tacx Neo Bike,399,407,-8
108611,20421,2021-02-03 18:11:00,neo,Zwift - Danmarks Cykle Union & Partners 4/6 (A),PowerTap P1,Tacx Neo Bike,356,371,-15
112470,20421,2021-02-10 18:01:30,neo,Zwift - Danmarks Cykle Union & Partners 5/6 (A),PowerTap P1,Tacx Neo Bike,407,421,-14
117052,20421,2021-02-17 18:41:37,neo,DCU 6,PowerTap P1,Tacx Neo Bike,324,340,-16
53905,20665,2020-09-08 09:59:51,neo,Zwift - KISS at Race - Americas AM (B),Garmin SRM,NEO,331,310,21
105218,20679,2021-01-29 17:59:38,neo,Zwift - TDZ Stage 6: Longer Ride,Garmin Vector 3 pedals,Tacx Neo - Smart Turbo Trainer,319,327,-8
107630,20679,2021-02-02 19:10:02,neo,Zwift - JETT Warm up Ride for JZMR (2.5~3.0w/kg) (C),Garmin Vector 3 pedals,Tacx Neo - Smart Turbo Trainer,300,302,-2
109278,20679,2021-02-05 11:03:00,neo,Zwift - TDZ Stage 7: Shorter Ride,Garmin Vector 3 pedals,Tacx Neo - Smart Turbo Trainer,290,286,4
30235,20932,2020-05-01 18:34:36,wahoo,Seg u23 classic 2.0,Dura ace,Kickr,378,385,-7
31141,20932,2020-05-03 13:15:14,wahoo,Zwift - KISS at Race 100 - Americas (A),Dura ace,Kickr,364,367,-3
32081,20932,2020-05-06 17:59:52,wahoo,Zwift - Zwift NL League - Woensdagavond Competitie (A),Dura ace,Kickr,386,390,-4
36564,20932,2020-05-20 17:59:46,wahoo,Zwift - Zwift NL League - Woensdagavond Competitie (A),Dura ace,Kickr,391,387,4
36981,20932,2020-05-21 18:15:35,wahoo,Zwift - Tour for All Invitational Race // Men (A) WIN!!!,Dura ace,Kickr,375,377,-2
38240,20932,2020-05-27 17:59:52,wahoo,Zwift - Zwift NL League - Woensdagavond Competitie (A),Dura ace,Kickr,402,406,-4
40951,20932,2020-06-10 17:59:45,wahoo,Zwift - Zwift NL League - Woensdagavond Competitie (A),Dura ace,Kickr,388,388,0
67275,20932,2020-11-02 18:21:12,wahoo,Zwift - Premier Division // Zwift Racing League (men) (A),Dura ace,Kickr,360,363,-3
69426,20932,2020-11-09 19:59:24,wahoo,Zwift - Premier Division // Zwift Racing League (men) (A),Dura ace,Kickr,377,382,-5
104736,20932,2021-01-28 18:59:15,wahoo,Zwift - BENELIGA 2020-2021 (E),Dura ace,Kickr,364,346,18
109065,20932,2021-02-04 18:59:49,wahoo,Zere teen,Dura ace,Kickr,355,354,1
117354,20932,2021-02-18 19:00:14,wahoo,Zwift - BENELIGA 2020-2021 (E),Dura ace,Kickr,372,373,-1
98585,21308,2021-01-17 10:00:51,wahoo,Zwift - TDZ Stage 3: Standard Ride,pedal,kickr,270,286,-16
116363,21308,2021-02-16 16:59:56,wahoo,Zwift - Power Climbs MR,6282440392_ACTIVITY,kickr,260,273,-13
9541,21486,2020-01-15 18:30:57,neo,Zwifties Meetup - Matzes 4 mal 4,Garmin V3,Tacx Neo,298,299,-1
10633,21486,2020-01-23 18:35:01,neo,Zwift - Aktivitus Power & Endurance 3-VO2max,Power2max NG ANT+,Tacx Neo,326,323,3
61776,21486,2020-10-14 06:56:16,neo,Zwift - Mitochondria #4,Power2max NG ANT+,Tacx Neo,245,242,3
62959,21486,2020-10-18 17:13:35,neo,Zwift - 20min Tempo w/15sec surge - in aero,Power2max NG ANT+,Tacx Neo,269,269,0
64434,21486,2020-10-23 16:54:31,neo,Zwift Academy Road: Workout 3 | VO2 Capacity,Power2max NG ANT+,Tacx Neo,328,317,11
96825,21486,2021-01-14 08:59:36,neo,Power2max NG ANT+ / Tacx Neo BT,Power2max NG ANT+,Tacx Neo BT,256,250,6
68050,21764,2020-11-04 11:35:07,wahoo,Zwift - CADENCE DRILL,assioma,Kickr,220,203,17
68054,21764,2020-11-05 09:13:14,wahoo,Zwift - CADENCE DRILL,assioma,Kickr,198,203,-5
106733,21764,2021-02-01 17:06:26,wahoo,Zwift - Yorkshire RECON RECOVERY,assioma,Kickr,286,294,-8
113029,21764,2021-02-11 19:01:59,wahoo,Zwift - FLANDERS The BZR Ronde Watopian League (C),assioma,Kickr,326,358,-32
117331,21764,2021-02-18 19:01:58,wahoo,Zwift - FLANDERS The BZR Ronde Watopian League (C),Assioma duo,Kickr (Gen1),314,340,-26
119565,21764,2021-02-23 18:17:00,wahoo,Zwift - Zwift Racing League | WTRL - Men&#039;s/Mixed EMEA E1 DIVISION 1 (C),Assioma duo,Kickr (Gen1),330,333,-3
120844,21764,2021-02-25 19:01:59,wahoo,Zwift - FLANDERS The BZR Ronde Watopian League (C),Assioma duo,Kickr (Gen1),325,351,-26
123111,21764,2021-03-02 18:20:39,wahoo,Zwift - Zwift Racing League | WTRL - Men&#039;s/Mixed EMEA E1 DIVISION 1 (C),Assioma duo,Kickr (Gen1),325,333,-8
129164,21764,2021-03-16 18:32:01,wahoo,Zwift - CeramicSpeed Race Series: Open Race (C),Assioma duo,Kickr (Gen1),324,327,-3
106575,21902,2021-01-31 09:14:34,neo,Tacx Neo / Morning_Ride,Morning_Ride,Tacx Neo,285,288,-3
125608,23076,2021-03-07 21:13:13,wahoo,Zwift - London,Stages L,Wahoo Kickr Old,229,241,-12
128821,23076,2021-03-15 18:06:39,wahoo,Zwift -  DBR Monday Race (B),Stages L,Wahoo Kickr Old,377,399,-22
129415,23076,2021-03-11 21:35:43,wahoo,Zwift - Crit City Race (A),Stages L,Wahoo Kickr Old,372,391,-19
70704,23675,2020-11-12 18:34:28,wahoo,Zwift - Espresso,Quarq,Kickr20,334,336,-2
72059,23675,2020-11-16 19:20:24,wahoo,Zwift - TFC Mad Monday Autumn Series (A),Quarq,Kickr20,353,335,18
72274,23675,2020-11-16 19:22:48,wahoo,Zwift - Zwift Racing League | WTRL - Men&#039;s EMEA E1 DIVISION 1 (A),Quarq DZero AXS,Kickr20,330,314,16
96946,23675,2021-01-14 18:22:57,wahoo,Zwift - Vienna,Quarq DZero AXS,Kickr20,348,334,14
39518,23705,2020-06-04 11:19:35,wahoo,TT,Rotor 2inpower,Kickr,348,342,6
51993,23705,2020-08-21 17:04:48,wahoo,Zwift - Team WEZ Friday Race (A),Power2max Type S,Kickr,351,346,5
58531,23705,2020-09-30 16:59:49,wahoo,Zwift - MIDWEEK Autumn Series by SZR (A),Power2max Type S,Kickr,333,332,1
59413,23705,2020-10-04 09:05:14,wahoo,Zwift - Newbury Velo Road Race (A),Power2max Type S,Kickr Zwift,348,341,7
72199,23705,2020-11-17 17:18:59,wahoo,Zwift - WKG - CRITTY CRITTY BANG BANG (A),Specialized Power Crank,Kickr Zwift,327,327,0
75166,23705,2020-11-24 19:44:25,wahoo,Zwift - Zwift Racing League | WTRL - Men&#039;s EMEA W1 DIVISION 1,Specialized Power Crank,Kickr Zwift,356,355,1
78986,23705,2020-12-03 18:29:09,wahoo,Zwift - Frenchy Fuzion Watopia Tour - Etape 4 (E),Specialized Power Crank,Kickr Zwift,326,329,-3
80894,23705,2020-12-08 19:42:59,wahoo,Zwift - Zwift Racing League | WTRL - Men&#039;s EMEA W1 DIVISION 1 (A),Specialized Power Crank,Kickr Zwift,336,330,6
81115,23705,2020-12-09 17:58:57,wahoo,Zwift - MIDWEEK Winter Series by SZR (A),Specialized Power Crank,Kickr Zwift,370,367,3
92960,23705,2021-01-07 18:29:47,wahoo,Zwift - FUSION WINTER CUP (A),Specialized Power Crank,Kickr Zwift,339,333,6
95800,23705,2021-01-12 19:44:55,wahoo,Zwift - Zwift Racing League | WTRL - Men&#039;s/Mixed EMEA W1 DIVISION 1 (A),Specialized Power Crank,Kickr Zwift,325,319,6
103631,23705,2021-01-26 19:45:22,wahoo,Zwift - Zwift Racing League | WTRL - Men&#039;s/Mixed EMEA W1 DIVISION 1 (A),Specialized Power Crank,Kickr Zwift,345,353,-8
118280,23705,2021-02-20 15:14:09,wahoo,Zwift - OH MY CRIT!! - Saturday Smash Race (A),Specialized Power Crank,Kickr Zwift,360,369,-9
124592,23705,2021-03-05 19:04:29,wahoo,Zwift - Zwift Racing League | WTRL Battle Royale Playoff - Men&#039;s Points Race (A),Specialized Power Crank,Kickr Zwift,350,357,-7
125177,23705,2021-03-06 19:45:57,wahoo,Zwift - Zwift Racing League | WTRL Battle Royale Playoff - Men&#039;s TTT (A),Specialized Power Crank,Kickr Zwift,356,362,-6
64238,25528,2020-10-22 17:17:51,neo,Zwift - Espresso,Quarq DFour,Tacx Neo 20,373,352,21
98241,25722,2021-01-16 17:14:35,neo,Zwift - 3R Three Sisters Hilly Race (47km/29.2mi 879m) (A),Assioma Duo,Neo Bike,362,361,1
119540,26233,2021-02-23 15:09:34,wahoo,Zwift - FTP DOUBLE PEAKS 3 x 15 (1:35),stages lr,kick,306,312,-6
121556,26233,2021-02-27 10:29:45,wahoo,Zwift - Cycling Weekly Winter Lockdown RR Series (B),stages lr,kickr,314,328,-14
123515,26233,2021-03-03 15:50:41,wahoo,Zwift - Watopia,DAstages lr,kickr spindown down??????,263,280,-17
123941,26233,2021-03-04 10:37:20,wahoo,Zwift - Watopia,DA LR,kickr,233,255,-22
58066,26251,2020-09-28 17:16:13,wahoo,Zwift - DBR Ride´N´Roll League (B),Asssioma Duo Pedals,Wahoo Kickr Core,317,317,0
58070,26251,2020-09-28 17:11:27,wahoo,Zwift - DBR Ride´N´Roll League (B),Asssioma Duo Pedals,Wahoo Kickr Core,307,317,-10
59280,26251,2020-10-03 15:59:55,wahoo,Zwift - 3R Classique Flat Race - 4 Laps (26.9km/16.7mi 76m) (B),Asssioma Duo Pedals,Wahoo Kickr Core,332,343,-11
81450,26258,2020-12-08 19:15:03,wahoo,Zwift - Zwift Racing League | WTRL - Men&#039;s EMEA W1 DIVISION 1 (A),4iiii Dual sided ,Wahoo Kickr &#039;18,344,340,4
83808,26258,2020-12-15 19:29:25,wahoo,Zwift - Zwift Racing League | WTRL - Men&#039;s EMEA W1 DIVISION 1 (A),4iiii Dual sided ,Wahoo Kickr &#039;18,338,325,13
96088,26258,2021-01-12 19:43:00,wahoo,Zwift - Zwift Racing League | WTRL - Men&#039;s/Mixed EMEA W1 DIVISION 1 (A),4iiii Dual sided ,Wahoo Kickr &#039;18,355,346,9
99894,26258,2021-01-19 19:45:04,wahoo,Zwift - Zwift Racing League | WTRL - Men&#039;s/Mixed EMEA W1 DIVISION 1 (A),4iiii Dual sided ,Wahoo Kickr &#039;18,355,343,12
103893,26258,2021-01-26 19:41:37,wahoo,Zwift Racing League | WTRL - Mens/Mixed EMEA W1 DIVISION 1,4iiii Dual sided ,Wahoo Kickr &#039;18,361,353,8
113998,26258,2021-02-13 08:50:07,wahoo,Zwift - Team WEz Race (E),4iiii Dual sided ,Wahoo Kickr &#039;18,341,337,4
116124,26258,2021-02-16 19:38:03,wahoo,Zwift - Zwift Racing League | WTRL - Men&#039;s/Mixed EMEA W1 DIVISION 1 (A),4iiii Dual sided ,Wahoo Kickr &#039;18,343,346,-3
123151,26258,2021-03-02 19:45:01,wahoo,Zwift - Zwift Racing League | WTRL - Men&#039;s/Mixed EMEA W1 DIVISION 1 (A),4iiii Dual sided ,Wahoo Kickr &#039;18,324,330,-6
124608,26258,2021-03-05 18:30:10,wahoo,Zwift - Zwift Racing League | WTRL Battle Royale Playoff - Men&#039;s Points Race (A),4iiii Dual sided ,Wahoo Kickr &#039;18,346,342,4
125198,26258,2021-03-06 19:16:59,wahoo,Zwift - Zwift Racing League | WTRL Battle Royale Playoff - Men&#039;s TTT (A),4iiii Dual sided ,Wahoo Kickr &#039;18,357,354,3
8480,26829,2020-01-08 19:00:12,wahoo,Zwift - FIETS Magazine Race Series (A),Favero Assioma DUO 4.04,Wahoo KICKR CORE v1.0.12,460,455,5
11901,26829,2020-01-31 19:15:21,wahoo,Zwift - Tour de Zwift // Pro-Am Invitational (A),Favero Assioma DUO 4.04,Wahoo KICKR CORE v1.0.12 (Zwift Power Source),454,451,3
13179,26829,2020-02-09 14:00:10,wahoo,Zwift - Zwift Gran Fondo,Favero Assioma DUO 4.04,Wahoo KICKR CORE v1.0.12 (Zwift Power Source),409,413,-4
13753,26829,2020-02-13 19:00:19,wahoo,Zwift - KALAS Cup - Round 3 (A),Favero Assioma DUO 4.04,Wahoo KICKR CORE v1.0.12 (Zwift Power Source),416,406,10
15913,26829,2020-02-27 19:00:18,wahoo,Zwift - KALAS Cup - Round 5 (A),Favero Assioma DUO 4.04,KICKR &#039;18 v3.4.70,414,410,4
16937,26829,2020-03-05 19:00:14,wahoo,Zwift - KALAS Cup - Round 6 (A),Favero Assioma DUO 4.04,Wahoo KICKR CORE v1.0.12 (Zwift Power Source),382,379,3
17851,26829,2020-03-12 19:15:18,wahoo,Zwift - Tour of Watopia Pro-Am Men&#039;s Race #1 (A),Favero Assioma DUO 4.04,Wahoo KICKR CORE v1.0.12 (Zwift Power Source),421,415,6
18921,26829,2020-03-20 19:15:20,wahoo,Zwift - Tour of Watopia Pro-Am Men&#039;s Race #2 (A),Favero Assioma DUO 4.04,Wahoo KICKR CORE v1.0.12 (Zwift Power Source),435,436,-1
21887,26829,2020-04-03 09:00:16,wahoo,Zwift -  Haute Route Watopia Stage 1 (E),Favero Assioma DUO 4.25,Wahoo KICKR CORE v1.0.12 (Zwift Power Source),425,421,4
22172,26829,2020-04-05 09:00:18,wahoo,Zwift - Ronde van Zwift (A),Favero Assioma DUO 4.25,Wahoo KICKR CORE v1.0.12 (Zwift Power Source),404,406,-2
28991,26829,2020-04-29 09:45:14,wahoo,USA Cycling Race League by Indoor Specialist,Favero Assioma DUO 4.25,KICKR &#039;18 v3.4.70 to Zwift,401,401,0
30659,26829,2020-05-02 16:00:18,wahoo,Zwift - YANA Pro/AM Invitiational (A),Favero Assioma DUO 4.25,KICKR &#039;18 v3.4.70 to Zwift,467,450,17
32052,26829,2020-05-06 17:00:14,wahoo,Zwift - Swedish Zwift Racing Cup by SZR (A),Favero Assioma DUO 4.25,KICKR &#039;18 v3.4.70 to Zwift,435,430,5
38415,26829,2020-05-28 18:17:13,wahoo,Zwift - Tour for All Invitational Race // Men (A),Favero Assioma DUO 4.25,KICKR &#039;18 v3.4.70,466,457,9
56400,26880,2020-09-20 12:59:55,wahoo,Zwift - Invitational League // Qualifying Race #3 (Men) (A),Rotor 2INPower,Wahoo Kickr (Primary to Zwift),375,356,19
127373,27976,2021-03-06 09:45:53,wahoo,Zwift - Cycling Ireland eRacing Spring League Rd 2 (A),power2max  NGeco,kickr core,322,316,6
127389,27976,2021-02-27 09:40:44,wahoo,Zwift - Cycling Ireland Spring Zwift League Rd 1 (A),2021-02-27-09-40-44,kickr core,315,319,-4
127392,27976,2021-02-27 09:40:44,wahoo,Zwift - Cycling Ireland Spring Zwift League Rd 1 (A),power2max  NGeco,kickr core,315,319,-4
127807,27976,2021-03-13 10:00:00,wahoo,Zwift - Cycling Ireland eRacing Spring League Rd 3 (A),power2max  NGeco,kickr core,328,336,-8
15554,28279,2020-02-25 15:53:50,neo,Zwift - 3R SuperCRITical Race Series - Round 2of4 (B),Quarq Riken,Neo,262,269,-7
16060,28279,2020-02-29 04:56:37,neo,Zwift - 3R Watopia Hilly Reverse Race - 3 Laps (27.5km/17.1mi 300m) (B),Quarq Riken,Neo OG,286,282,4
69778,28279,2020-11-10 18:16:49,neo,Zwift - Zwift Racing League | WTRL - EMEA E1 (MEN) -  Division 2 (B),Quarq Riken,Neo OG,299,306,-7
79361,28279,2020-12-04 14:05:17,neo,Zwift - 3R Innsbruckring Flat Race - 2 Laps (17.6km/10.9m 154m) (B),Quarq Riken,Neo OG,278,264,14
96653,28364,2021-01-14 00:37:02,wahoo,Zwift - TDZ Stage 2: Longer Ride,Specialized Power Cranks,Wahoo Kickr Core,327,323,4
99234,28364,2021-01-18 19:35:57,wahoo,Zwift - Premier Division // Zwift Racing League (men) (A),Specialized Power Cranks,Wahoo Kickr Core,364,352,12
100832,28364,2021-01-21 00:31:21,wahoo,Zwift - Cycling Canada Wednesday Night Race Series (A),Specialized Power Cranks,Wahoo Kickr Core,353,349,4
102965,28364,2021-01-25 18:39:24,wahoo,Zwift - Premier Division // Zwift Racing League (men) (A),Specialized Power Cranks,Wahoo Kickr Core,361,357,4
104928,28364,2021-01-29 00:26:02,wahoo,Zwift - WTRL Team Time Trial - Zone 10 (C),Specialized Power Cranks,Wahoo Kickr Core,351,351,0
106965,28364,2021-02-01 19:44:12,wahoo,Zwift - Premier Division // Zwift Racing League (men) (A),Specialized Power Cranks,Wahoo Kickr Core,370,356,14
111068,28364,2021-02-08 18:28:32,wahoo,Zwift - Premier Division // Zwift Racing League (men) (A),Specialized Power Cranks,Wahoo Kickr Core,377,373,4
112431,28364,2021-02-10 18:18:31,wahoo,Zwift - Movistar Team Challenge // Round 1 (A),Specialized Power Cranks,Wahoo Kickr Core,371,349,22
113620,28364,2021-02-12 18:29:34,wahoo,Zwift - Movistar Team Challenge // Round 1 (men),Specialized Power Cranks,Wahoo Kickr Core,389,383,6
115440,28364,2021-02-15 19:30:31,wahoo,Zwift - Premier Division // Zwift Racing League (men) (A),Specialized Power Cranks,Wahoo Kickr Core,378,372,6
116780,28364,2021-02-17 18:34:38,wahoo,Zwift - Movistar Team Challenge // Round 2 (men) - Race 3/4,Specialized Power Cranks,Wahoo Kickr Core,340,344,-4
117922,28364,2021-02-19 18:25:46,wahoo,Zwift - Movistar Team Challenge // Round 2 (men),Specialized Power Cranks,Wahoo Kickr Core,393,389,4
119220,28364,2021-02-22 18:48:09,wahoo,Zwift - Premier Division // Zwift Racing League (men) (A),Specialized Power Cranks,Wahoo Kickr Core,364,361,3
122619,28364,2021-03-01 19:47:14,wahoo,Zwift - Premier Division // Zwift Racing League (men) (A),Specialized Power Cranks,Wahoo Kickr Core,363,357,6
4911,28466,2019-11-26 17:59:57,wahoo,Zwift - ZRG-Race-Series-5/10 (A),Favero Assioma Duo,2018 Kickr,336,328,8
5376,28466,2019-12-03 18:00:01,wahoo,Zwift - ZRG-Race-Series-6/10 (A),Favero Assioma Duo,2018 Kickr,311,306,5
5882,28466,2019-12-09 18:59:58,wahoo,Zwift - Tour of London // Stage 1 (Race Group-Men),Favero Assioma Duo,2018 Kickr,323,315,8
8047,28466,2020-01-04 13:44:54,wahoo,Zwift - WTRL Winter Racing League,Favero Assioma Duo,2018 Kickr,291,294,-3
8306,28466,2020-01-07 17:59:58,wahoo,Zwift - ZRG Crit City Race (A),Favero Assioma Duo,2018 Kickr @Zwift,318,302,16
8860,28466,2020-01-11 13:44:55,wahoo,Zwift - WTRL Winter Racing League (A),Favero Assioma Duo,2018 Kickr @Zwift,341,339,2
9169,28466,2020-01-13 18:39:56,wahoo,Zwift - Tour de Zwift: Stage 1 Race (A),Favero Assioma Duo,2018 Kickr @Zwift,334,329,5
9342,28466,2020-01-14 17:59:52,wahoo,Zwift - ZRG Winter Race Series 1/10 - Crit City (A),Favero Assioma Duo,2018 Kickr @Zwift,309,305,4
10246,28466,2020-01-21 14:09:56,wahoo,Zwift - Tour de Zwift: Stage 3 Race (A),Favero Assioma Duo,2018 Kickr @Zwift,327,327,0
10888,28466,2020-01-25 13:42:57,wahoo,Zwift - WTRL Winter Racing League (A),Favero Assioma Duo,2018 Kickr @Zwift,325,326,-1
11202,28466,2020-01-27 18:39:48,wahoo,Zwift - Tour de Zwift: Stage 4 Race (A),Favero Assioma Duo,2018 Kickr @Zwift,338,332,6
11563,28466,2020-01-29 18:39:51,wahoo,Zwift - Tour de Zwift: Stage 5 Race (A),Favero Assioma Duo,2018 Kickr @Zwift,330,326,4
12019,28466,2020-02-01 08:01:48,wahoo,Zwift - WTRL Winter Racing League (A),Favero Assioma Duo,2018 Kickr @Zwift,313,315,-2
13140,28466,2020-02-09 08:59:34,wahoo,Zwift -  BDR Winter Gran Fondo #1 (E),Favero Assioma Duo,2018 Kickr @Zwift,300,299,1
14036,28466,2020-02-15 10:04:47,wahoo,Zwift - Tour de Zwift: Stage 2 Race (A),Favero Assioma Duo,2018 Kickr @Zwift,300,298,2
15835,28466,2020-02-26 18:44:21,wahoo,"Zwift - GCA-TALENT-RACE, CRIT, 20 Km (E)",Favero Assioma Duo,2018 Kickr @Zwift,322,314,8
65462,28466,2020-10-27 18:15:59,wahoo,Zwift - Zwift Racing League | WTRL - EMEA E (MEN) -  Division 1 (B),Favero Assioma Duo,2018 Kickr @Zwift,298,295,3
66487,28466,2020-10-30 18:01:58,wahoo,ZRG-CC Falling Leaves Tour,Favero Assioma Duo,2018 Kickr @Zwift,316,317,-1
68565,28466,2020-11-06 18:01:59,wahoo,Zwift - ZRG-CC Falling Leaves Tour (B),Favero Assioma Duo,2018 Kickr @Zwift,283,287,-4
70143,28466,2020-11-10 18:15:58,wahoo,Zwift - Zwift Racing League | WTRL - EMEA E1 (MEN) -  Division 1 (B),Favero Assioma Duo,2018 Kickr @Zwift,348,333,15
71145,28466,2020-11-13 18:01:59,wahoo,Zwift - ZRG-CC Falling Leaves Tour (B),Favero Assioma Duo,2018 Kickr @Zwift,312,299,13
75023,28466,2020-11-24 18:15:58,wahoo,Zwift - Zwift Racing League | WTRL - Men&#039;s EMEA E1 DIVISION 1,Favero Assioma Duo,2018 Kickr @Zwift,321,317,4
75776,28466,2020-11-25 18:45:59,wahoo,Zwift - GCA Cup (B),Favero Assioma Duo,2018 Kickr @Zwift,302,300,2
77141,28466,2020-11-27 18:02:00,wahoo,Zwift - ZRG-CC Falling Leaves Tour (B),Favero Assioma Duo,2018 Kickr @Zwift,295,298,-3
79483,28466,2020-12-04 18:02:00,wahoo,Zwift - ZRG-CC Falling Leaves Tour (B),Favero Assioma Duo,2018 Kickr @Zwift,322,314,8
80802,28466,2020-12-08 18:16:00,wahoo,Zwift - Zwift Racing League | WTRL - Men&#039;s EMEA E1 DIVISION 1 (B),Favero Assioma Duo,2018 Kickr @Zwift,309,299,10
97427,28466,2021-01-14 18:29:52,wahoo,Zwift - FUSION WINTER CUP (A),Favero Assioma Duo,2018 Kickr @Zwift,332,329,3
105003,28466,2021-01-28 18:29:54,wahoo,Zwift - FUSION WINTER CUP (A),Favero Assioma Duo,2018 Kickr @Zwift,330,330,0
107132,28466,2021-02-01 19:09:46,wahoo,Zwift - RuhrRiders Pott-Race,Favero Assioma Duo,2018 Kickr @Zwift,313,313,0
109002,28466,2021-02-04 18:29:54,wahoo,Zwift - FUSION WINTER CUP (A),Favero Assioma Duo,2018 Kickr @Zwift,320,315,5
110012,28466,2021-02-06 16:59:51,wahoo,Zwift - GCA Liga 2021 #2 (A),Favero Assioma Duo,2018 Kickr @Zwift,325,321,4
111039,28466,2021-02-08 19:09:43,wahoo,Zwift - RuhrRiders Pott-Race (A),Favero Assioma Duo,2018 Kickr @Zwift,330,327,3
115253,28466,2021-02-15 19:09:14,wahoo,Zwift - RuhrRiders Pott-Race (A),Favero Assioma Duo,2018 Kickr @Zwift,300,305,-5
119083,28466,2021-02-22 19:09:57,wahoo,Zwift - RuhrRiders Pott-Race (A),Favero Assioma Duo,2018 Kickr @Zwift,319,308,11
122440,28466,2021-03-01 19:09:57,wahoo,Zwift - RuhrRiders Pott-Race (A),Favero Assioma Duo,2018 Kickr @Zwift,326,328,-2
12095,30728,2020-02-02 09:15:00,neo,02-2020,Pedale,Neo,307,304,3
12568,30728,2020-02-04 18:02:00,neo,ZRG Race,Pedale,Neo,313,304,9
12957,30728,2020-02-07 18:08:42,neo,Neo / Pedale,Pedale,Neo,213,224,-11
13119,30728,2020-02-09 12:01:14,neo,Neo / Pedale,Pedale,Neo,278,284,-6
122134,30728,2021-02-28 11:10:19,wahoo,Dura-ace PM vs. Kickr 5,Dura-ace PM (2018),Kickr,233,234,-1
82134,30739,2020-12-12 01:39:11,wahoo,Zwift - HeeeWarmup,SworksPower,Kickr5,321,318,3
24403,31823,2020-04-13 23:40:44,wahoo,Zwift - SMART - Stuck in the Middle - 60 - Xert,Powertap P1,Wahoo Kickr Core,272,283,-11
24639,31823,2020-04-14 18:25:33,wahoo,Zwift - Oreo Cookie Blues - Xert,Powertap P1,Wahoo Kickr Core,296,306,-10
61999,33006,2020-10-14 23:58:00,wahoo,Zwift - Assioma 175mm   offset 4.2%,2020-10-14 Assioma 4.2%,2020-10-14 Kickr,227,236,-9
8328,34678,2020-01-07 18:48:45,neo,Zwift - Team Italy Gladiators Race (B),Power2max NGeco,Tacx Neo,294,289,5
9352,34678,2020-01-14 18:53:04,neo,Zwift - Team Italy Gladiators Race (B),Power2max NGeco,Tacx Neo,296,289,7
10322,34678,2020-01-21 18:57:36,neo,Zwift - Tour de Zwift: Stage 3 Group Ride - Long Distance,Power2max NGeco,Tacx Neo,297,289,8
11083,34678,2020-01-26 19:06:47,neo,Zwift - Tour de Zwift: Stage 4 Race (A),Power2max NGeco,Tacx Neo,325,319,6
11371,34678,2020-01-28 18:59:16,neo,Zwift - ZwiftTeamPL League – Classic Series (B),Power2max NGeco,Tacx Neo,298,295,3
11751,34678,2020-01-28 19:55:40,neo,Zwift - KALAS Cup - Round 1 (B),Power2max NGeco,Tacx Neo,302,294,8
12047,34678,2020-01-30 20:25:46,neo,Zwift - Tour de Zwift: Stage 6 Race (A),Power2max NGeco,Tacx Neo,298,293,5
13436,34678,2020-02-11 19:05:05,neo,&quot;No Pain No Gain&quot; Transparency Racing Series,Power2max NGeco,Tacx Neo,281,275,6
14562,34678,2020-02-18 19:14:15,neo,Zwift - Feltet.dk Race Series,Power2max NGeco,Tacx Neo,324,316,8
14982,34678,2020-02-20 19:32:06,neo,Zwift - WTRL Team Time Trial (C),Power2max NGeco,Tacx Neo,296,289,7
15602,34678,2020-02-25 19:00:17,neo,Zwift - Feltet.dk Race Series (A),Power2max NGeco,Tacx Neo,307,301,6
16651,34678,2020-03-03 19:11:29,neo,Zwift - Feltet.dk Race Series (A),Power2max NGeco,Tacx Neo,313,307,6
17540,34678,2020-03-10 19:13:08,neo,Zwift - Feltet.dk Race Series (A),Power2max NGeco,Tacx Neo,291,284,7
18498,34678,2020-03-17 19:12:08,neo,Zwift - Feltet.dk Race Series (A),Power2max NGeco,Tacx Neo,314,307,7
29765,34678,2020-04-30 18:56:53,neo,Zwift - KISS at Race - EU PM (A),Power2max NGeco,Tacx Neo,288,274,14
62581,34678,2020-10-17 10:28:15,neo,Zwift - 3R Volcano Climb Race - 1 Lap (22.4km/14mi 204m) (A),Power2max NGeco,Tacx Neo,316,308,8
63942,34678,2020-10-21 17:39:57,neo,Zwift - DBR HEINO CUP III (A),Power2max NGeco,Tacx Neo,297,289,8
65950,34678,2020-10-28 18:56:03,neo,Zwift - Zwift NL Race Day (A),Power2max NGeco,Tacx Neo,303,295,8
66786,34678,2020-10-31 19:55:34,neo,Zwift - Cycling Australia&#039;s PretzHELL by AHDR (B),Power2max NGeco,Tacx Neo,346,336,10
68591,34678,2020-11-06 18:32:57,neo,Zwift - TFC Autumn Race Series (A),Power2max NGeco,Tacx Neo,336,328,8
70383,34678,2020-11-11 18:40:42,neo,Zwift - DCU – Feltet.dk November series (A),Power2max NGeco,Tacx Neo,318,313,5
70563,34678,2020-11-10 19:35:13,neo,Zwift - Zwift Racing League | WTRL - EMEA W1 (MEN) -  Division 1 (A),Power2max NGeco,Tacx Neo,354,345,9
71085,34678,2020-11-13 13:22:00,neo,Zwift - DIRT Friday Pacific Sprintapalooza  (C),Power2max NGeco,Tacx Neo,220,214,6
75204,34678,2020-11-24 19:07:01,neo,Zwift - Zwift Racing League | WTRL - Men&#039;s EMEA W1 DIVISION 1,Power2max NGeco,"Tacx Neo, Garmin 530",322,312,10
79489,34678,2020-12-04 18:39:50,neo,Zwift - TFC Autumn Race Series (A),Power2max NGeco,"Tacx Neo, Garmin 530",330,322,8
80924,34678,2020-12-08 19:01:05,neo,Zwift - Zwift Racing League | WTRL - Men&#039;s EMEA W1 DIVISION 1 (A),Power2max NGeco,"Tacx Neo, Garmin 530",320,315,5
81203,34678,2020-12-09 12:25:48,neo,Zwift - 3R LaGuardia Loop Flat Race - 10 Laps (28.3km/17.6mi 270m) (A),Power2max NGeco,"Tacx Neo, Garmin 530",296,285,11
81210,34678,2020-11-16 19:06:19,neo,Zwift - TFC Mad Monday Autumn Series (A),Power2max NGeco,"Tacx Neo, Garmin 530",306,299,7
83571,34678,2020-12-15 18:28:01,neo,Zwift - Team Italy & Frenchy Fuzion League (A),Power2max NGeco,"Tacx Neo, Garmin 530",325,316,9
85106,34678,2020-12-19 15:14:20,neo,Zwift - OH MY CRIT - Saturday Smash Race (A),Power2max NGeco,"Tacx Neo, Garmin 530",338,332,6
89936,34678,2020-12-26 19:41:33,neo,Zwift - 3R Flat Race (A),Power2max NGeco,"Tacx Neo, Garmin 530",295,284,11
91844,34678,2021-01-05 18:44:28,neo,Zwift - Team Italy & Frenchy Fuzion League (A),Power2max NGeco,"Tacx Neo, Garmin 530",322,310,12
93173,34678,2021-01-07 18:09:43,neo,Zwift - FUSION WINTER CUP (A),Power2max NGeco,"Tacx Neo, Garmin 530",309,301,8
96421,34678,2021-01-13 18:19:17,neo,Zwift - Danmarks Cykle Union & Partners 1/6 (A),Power2max NGeco,"Tacx Neo, Garmin 530",313,306,7
96796,34678,2021-01-14 12:22:10,neo,Zwift - EMU Japan Race (A),Power2max NGeco,"Tacx Neo, Garmin 530",291,285,6
97558,34678,2021-01-15 18:53:23,neo,Zwift - 3R Watopia Hilly Race - 3 Laps (27km/16.8mi 300m) (A),Power2max NGeco,"Tacx Neo, Garmin 530",299,294,5
99049,34678,2021-01-18 18:35:03,neo,Zwift -  SCF SWE Cup Men (A),Power2max NGeco,"Tacx Neo, Garmin 530",297,286,11
100315,34678,2021-01-20 18:15:19,wahoo,Zwift - Danmarks Cykle Union & Partners 2/6 (A),Power2max NGeco,Kickr Core 2021,323,332,-9
101509,34678,2021-01-22 18:26:15,wahoo,Zwift - TFC Xmas Smash Fest (E),"Power2max NGeco, Garmin 530",Kickr Core 2021,309,321,-12
101880,34678,2021-01-23 13:56:14,wahoo,Zwift - MGCC hosts Ontario Cycling Association Virtual Challenge #2 (A),"Power2max NGeco, Garmin 530",Kickr Core 2021,290,300,-10
109849,34678,2021-02-06 12:43:33,wahoo,Zwift - 111 - Strongman racing series (A),"Power2max NGeco, Garmin 530, ANT+","Kickr Core 2021, Bluetooth",315,319,-4
110509,34678,2021-02-07 13:32:59,wahoo,Zwift - La Bicicletta Toronto & Toronto Hustle Donut Race (A),"Power2max NGeco, Garmin 530, ANT+","Kickr Core 2021, Bluetooth",331,338,-7
113013,34678,2021-02-11 18:15:30,wahoo,Zwift - FUSION WINTER CUP (A),"Assioma Duo 2021, Garmin 130, ANT+","Kickr Core 2021, Bluetooth",303,307,-4
116012,34678,2021-02-16 19:45:50,wahoo,Zwift - Zwift Racing League | WTRL - Men&#039;s/Mixed EMEA W2 DIVISION 1 (A),"Assioma Duo 2021, Garmin 530, ANT+","Kickr Core 2021, Bluetooth",338,340,-2
118249,34678,2021-02-20 12:59:24,wahoo,Zwift - 111 - Strongman racing series (A),"Assioma Duo 2021, Garmin 530, ANT+","Kickr Core 2021, ANT+ FE-C",298,298,0
118783,34678,2021-02-21 14:13:22,wahoo,Zwift - KISS 100 Race Series - Americas (A),"Assioma Duo 2021, Garmin 530, ANT+","Kickr Core 2021, ANT+ FE-C",300,298,2
120322,34678,2021-02-24 18:05:25,wahoo,Zwift - Scandinavian Cup 2021 - Round 1 - Men (A),"Assioma Duo 2021, Garmin 530, ANT+","Kickr Core 2021, Bluetooth",324,318,6
123596,34678,2021-03-03 18:41:36,wahoo,Zwift - Scandinavian Cup 2021 - Round 2 - Men (A),"Assioma Duo 2021, Garmin 530, ANT+","Kickr Core 2021, Bluetooth",341,337,4
126589,34678,2021-03-10 18:38:36,wahoo,Zwift - Scandinavian Cup 2021 - Round 3 - Men (A),"Assioma Duo 2021, Garmin 530, ANT+","Kickr Core 2021, Bluetooth",341,335,6
127129,34678,2021-03-11 18:01:11,wahoo,Zwift - FUSION SPRING CUP (A),"Assioma Duo 2021, Garmin 530, ANT+","Kickr Core 2021, ANT+ FE-C",312,306,6
25405,35222,2020-04-17 01:11:28,wahoo,Zwift - USA Cycling - Sweatfest (B) - Dropped on the last lap,PowerTap P1 Cannondale,Kickr Core,343,345,-2
29908,35222,2020-05-01 01:15:46,wahoo,Zwift - USA Cycling - Sweatfest (A) - 14th Zwiftpower,PowerTap P1 Cannondale,Kickr Core,352,370,-18
32844,35222,2020-05-08 23:44:09,wahoo,Zwift - TGIF Group Ride (D),PowerTap P1 Cannondale,Kickr Core,231,246,-15
32845,35222,2020-05-08 01:13:39,wahoo,Zwift - USA Cycling - Sweatfest (B),PowerTap P1 Cannondale,Kickr Core,364,377,-13
32846,35222,2020-05-06 01:09:45,wahoo,Zwift - USA Cycling - Sweatfest (A) - Dropped on the first climb. :(  Where&#039;s my boost?,PowerTap P1 Cannondale,Kickr Core,339,351,-12
34361,35222,2020-05-13 01:12:03,wahoo,Zwift - USA Cycling - Sweatfest (B) - 15th,PowerTap P1 Cannondale,Kickr Core,399,400,-1
35148,35222,2020-05-14 23:22:22,wahoo,Zwift - Austin Driveway Series Criterium (B) - 8th,PowerTap P1 Cannondale,Kickr Core,364,379,-15
36259,35222,2020-05-20 01:23:20,wahoo,Zwift - USA Cycling - Sweatfest (B) - 7th but leadout teammate to 1st,PowerTap P1 Cannondale,Kickr Core,365,396,-31
39212,35222,2020-05-29 01:14:29,wahoo,Zwift - USA Cycling - Sweatfest (B),PowerTap P1 Emonda,Kickr Core,377,390,-13
39213,35222,2020-05-29 23:49:16,wahoo,Zwift - TGIF Group Ride (D),PowerTap P1 Emonda,Kickr Core,325,335,-10
39214,35222,2020-06-02 22:41:04,wahoo,Zwift - Watopia - TrainerRoad ramp test,PowerTap P1 Cannondale,Kickr Core,400,426,-26
39466,35222,2020-06-04 03:05:55,wahoo,Zwift - London -Trainerroad,PowerTap P1 Cannondale,Kickr Core,320,338,-18
39697,35222,2020-06-05 01:12:09,wahoo,Zwift - Ballard Food Bank Crit p/b SweatFest (B) - 8th in zwiftpower,PowerTap P1 Cannondale,Kickr Core,364,384,-20
40644,35222,2020-06-09 22:26:13,wahoo,Zwift - Espresso Double Shot Ride p/b SweatFest (A) - Trainer Road - Donner,PowerTap P1 Cannondale,Kickr Core,318,341,-23
40654,35222,2020-06-10 01:13:32,wahoo,Zwift - Espresso Double Shot Ride p/b SweatFest (A),PowerTap P1 Cannondale,Kickr Core,377,392,-15
41310,35222,2020-06-11 23:07:24,wahoo,Zwift - Frappe,PowerTap P1 Cannondale,Kickr Core,370,376,-6
41316,35222,2020-06-11 23:07:24,wahoo,Zwift - TGIF Group Ride (D),PowerTap P1 Cannondale,Kickr Core,216,217,-1
5893,35498,2019-12-10 10:19:59,wahoo,Zwift - Eat The Pain Race (A),Zwift,Wahoo Kickr 2017 with Element Bolt,302,304,-2
7195,35498,2019-12-24 10:19:57,wahoo,Zwift - Eat The Pain Race (A),Quarq DFour,Wahoo Kickr 2017 with Element Bolt,325,321,4
10235,35498,2020-01-21 10:19:59,wahoo,Zwift - Eat The Pain Race (A),Quarq DFour - Zwift,Wahoo Kickr 2017 - Element Bolt,351,341,10
94976,35498,2021-01-11 18:43:31,wahoo,Zwift - Premier Division // Zwift Racing League (men) (A),Favero Assioma DUO to Garmin Edge1000,Wahoo Kickr 2017 to Zwift,310,310,0
99167,35498,2021-01-18 19:29:39,wahoo,Zwift - Premier Division // Zwift Racing League (men) (A),Favero Assioma DUO to Garmin Edge1000,Wahoo Kickr 2017 to Zwift,328,325,3
74865,36654,2020-11-24 08:41:34,neo,Zwift - Zwift Racing League | WTRL - Men&#039;s APAC DIVISION 1,Pioneer Dual Sided (Shimano Crank),Tacx Neo,366,369,-3
75300,36654,2020-11-25 02:59:18,neo,Zwift - Zwift Racing League | WTRL - Men&#039;s AMERICAS W DIVISION 1,Pioneer Dual Sided (Shimano Crank) (Garmin 520),Tacx Neo (zWIFT),364,364,0
75789,36654,2020-11-26 08:09:04,neo,Zwift - WTRL NOPINZ WORLD TTT CHAMPIONSHIPS - Zone 1 (A),Pioneer Dual Sided (Shimano Crank) (Garmin 520),Tacx Neo (ZWIFT),332,329,3
76334,36654,2020-11-27 00:39:30,neo,Zwift - WTRL NOPINZ WORLD TTT CHAMPIONSHIPS - Zone 11 (C),Pioneer Dual Sided (Shimano Crank) (Garmin 520),Tacx Neo (zWIFT),344,343,1
77901,36654,2020-11-29 04:59:32,neo,Zwift - 3R Volcano Flat Race - 3 Laps (36.6km/22.7mi 138m) (B),Pioneer Dual Sided (Shimano Crank) (Garmin 520),Tacx Neo (zWIFT),341,342,-1
78326,36654,2020-12-02 02:54:47,neo,Zwift - Zwift Racing League | WTRL - Men&#039;s AMERICAS W DIVISION 1 (B),Pioneer Dual Sided (Shimano Crank) (Garmin 520),Tacx Neo (zWIFT),340,336,4
80649,36654,2020-12-08 08:40:17,neo,Zwift - Zwift Racing League | WTRL - Men&#039;s APAC DIVISION 1 (B),Pioneer Dual Sided (Shimano Crank) (Garmin 520),Tacx Neo (zWIFT),383,386,-3
80653,36654,2020-12-04 02:30:57,neo,Zwift - WTRL Team Time Trial - Zone 11 (B),Pioneer Dual Sided (Shimano Crank) (Garmin 520),Tacx Neo (zWIFT),341,339,2
95386,36654,2021-01-12 08:42:53,neo,Zwift - Zwift Racing League | WTRL - Men&#039;s/Mixed APAC DIVISION 1 (B),Pioneer Dual Sided (Shimano Crank) (Garmin 520),Tacx Neo (zWIFT),342,334,8
96039,36654,2021-01-13 02:54:36,neo,Zwift - Zwift Racing League | WTRL - Men&#039;s/Mixed AMERICAS W DIVISION 1 (B),Pioneer Dual Sided (Shimano Crank) (Garmin 520),Tacx Neo (zWIFT),375,372,3
98322,36654,2021-01-17 01:02:38,neo,Zwift - Herd Beginner Racing Series,Pioneer Dual Sided (Shimano Crank) (Garmin 520),Tacx Neo (zWIFT),366,376,-10
100019,36654,2021-01-20 02:48:22,neo,Zwift - Zwift Racing League | WTRL - Men&#039;s/Mixed AMERICAS W DIVISION 1 (B),Pioneer Dual Sided (Shimano Crank) (Garmin 520),Tacx Neo (zWIFT),363,368,-5
12702,36913,2020-02-06 11:09:50,wahoo,Zwift - Tour de Zwift: Stage 7 Race (A),powertap c1,Kickr 18,367,351,16
8199,36916,2020-01-06 10:17:08,wahoo,Zwift - 3R Volcano Flat Reverse Race - 3 Laps (36.6km/22.7mi 138m) (A),Stages,Kickr,330,349,-19
8956,36916,2020-01-12 10:55:59,wahoo,Zwift - Tour de Zwift: Stage 1 Long Distance,Stages L,Kickr15 via Zwift,334,347,-13
9522,36916,2020-01-15 19:11:04,wahoo,Zwift - Tour de Zwift // Pro-Am Invitational (A),Stages L,Kickr15 via Zwift,352,369,-17
9981,36916,2020-01-19 10:45:26,wahoo,Zwift - The Season - Richmond Cup (A),Stages L,Kickr15 via Zwift,366,369,-3
10569,36916,2020-01-23 11:10:16,wahoo,Zwift - Tour de Zwift: Stage 3 Race (A),Stages L,Kickr15 via Zwift,336,346,-10
10743,36916,2020-01-24 10:23:00,wahoo,Zwift - DIRT Friday Morning Sprintapalooza (C),Stages L,Kickr15 via Zwift,258,252,6
11618,36916,2020-01-30 10:43:49,wahoo,Zwift - Z2 w/ a little VO2,Stages L,Kickr15 via Zwift,261,275,-14
11881,36916,2020-01-31 19:11:09,wahoo,Zwift - Tour de Zwift // Pro-Am Invitational (A),Stages L,Kickr15 via Zwift,366,376,-10
12097,36916,2020-02-02 10:47:55,wahoo,Zwift - The Season - 4 Days of Watopia #2 ITT,Stages L,Kickr15 via Zwift,309,316,-7
12452,36916,2020-02-04 19:12:53,wahoo,Zwift - Tour de Zwift // Pro-Am Invitational (A),Stages L,Kickr15 via Zwift,361,366,-5
12528,36916,2020-02-05 11:09:03,wahoo,Zwift - Tour de Zwift: Stage 7 Race (A),Stages L,Kickr15 via Zwift,370,365,5
12700,36916,2020-02-06 10:22:22,wahoo,Zwift - WTRL Team Time Trial (D),Stages L,Kickr15 via Zwift,320,339,-19
13098,36916,2020-02-09 10:43:09,wahoo,Zwift - The Season - 4 Days of Watopia #3 (A),Stages L,Kickr15 via Zwift,362,370,-8
13238,36916,2020-02-10 09:57:39,wahoo,Zwift - MET-5 Race (A),Stages L,Kickr15 via Zwift,357,363,-6
13524,36916,2020-02-12 10:43:06,wahoo,Zwift - DIRT & IS: Baker&#039;s Dozen (A),Stages L,Kickr15 via Zwift,377,389,-12
13649,36916,2020-02-13 10:24:19,wahoo,WTRL Team Time Trial - Zone1,Stages L,Kickr15 via Zwift,340,355,-15
13874,36916,2020-02-14 10:26:44,wahoo,ZHR Morning Tea Race,Stages L,Kickr15 via Zwift,340,352,-12
14186,36916,2020-02-16 10:43:10,wahoo,Zwift - The Season - 4 Days of Watopia #4 (A),Stages L,Kickr15 via Zwift,348,359,-11
14466,36916,2020-02-18 10:35:03,wahoo,Zwift - MGCC Ride & Race (B),Stages L,Kickr15 via Zwift,342,360,-18
14824,36916,2020-02-20 10:42:44,wahoo,Zwift - Crit City Race (A),Stages L,Kickr15 via Zwift,340,355,-15
15033,36916,2020-02-21 10:23:25,wahoo,DIRT Friday Morning Sprintapalooza,Stages L,Kickr15 via Zwift,253,259,-6
15277,36916,2020-02-23 11:43:05,wahoo,Crit City Race,Stages L,Kickr15 via Zwift,330,342,-12
15682,36916,2020-02-26 10:43:13,wahoo,Zwift - DIRT & IS: Baker&#039;s Dozen (A),Stages L,Kickr15 via Zwift,377,391,-14
15985,36916,2020-02-28 10:22:19,wahoo,Zwift - DIRT Friday Morning Sprintapalooza (C),Stages L,Kickr15 via Zwift,247,238,9
16227,36916,2020-03-01 10:43:24,wahoo,The Season - 3 Days of NY #2,Stages L,Kickr15 via Zwift,339,351,-12
17238,36916,2020-03-08 09:08:37,wahoo,ZHR Audax 100km (Ride),Stages L,Kickr15 via Zwift,308,322,-14
18022,36916,2020-03-14 10:08:19,wahoo,Stage 2 Race - Tour of Watopia 2020,Stages L,Kickr15 via Zwift,364,374,-10
18364,36916,2020-03-17 09:57:05,wahoo,Zwift - KISS at Race - Americas AM (A),Stages L,Kickr15 via Zwift,352,364,-12
18649,36916,2020-03-19 09:19:39,wahoo,WTRL Team Time Trial - Zone1,Stages L,Kickr15 via Zwift,354,368,-14
19242,36916,2020-03-23 10:16:00,wahoo,Zwift - 3R Volcano Flat Race - 3 Laps (36.6km/22.7mi 138m) (A),Stages L,Kickr15 via Zwift,345,358,-13
19464,36916,2020-03-25 09:42:59,wahoo,Zwift - USA Cycling Race League by Indoor Specialist  (A),Stages L,Kickr15 via Zwift,346,352,-6
19705,36916,2020-03-26 09:20:17,wahoo,Zwift - WTRL Team Time Trial (C),Stages L,Kickr15 via Zwift,332,341,-9
20204,36916,2020-03-28 19:07:11,wahoo,Stage 5 Race - Tour of Watopia 2020,Stages L,Kickr15 via Zwift,335,346,-11
21319,36916,2020-04-02 09:19:59,wahoo,Zwift - WTRL Team Time Trial (C),Stages L,Kickr15 via Zwift,353,363,-10
21668,36916,2020-04-03 10:04:10,wahoo,Zwift - 3R Innsbruckring Flat Race - 4 Laps (35.2km/21.9mi 308m) (A),Stages L,Kickr15 via Zwift,333,352,-19
22182,36916,2020-04-05 09:41:06,wahoo,DIRTy Opposite Race,Stages L,Kickr15 via Zwift,340,370,-30
22507,36916,2020-04-06 10:27:53,wahoo,Zwift - Yorkshire Grand Prix Race (A),Stages L,Kickr15 via Zwift,365,367,-2
22510,36916,2020-04-06 11:18:35,wahoo,Crit City Race,Stages L,Kickr15 via Zwift,338,349,-11
22966,36916,2020-04-08 09:41:49,wahoo,Zwift - USA Cycling Race League by Indoor Specialist  (A),Stages L,Kickr15 via Zwift,370,385,-15
23208,36916,2020-04-09 09:20:50,wahoo,Zwift - WTRL Team Time Trial (D),Stages L,Kickr15 via Zwift,330,346,-16
23960,36916,2020-04-12 10:08:47,wahoo,Zwift - 3R Sand & Sequoias - 1 Lap (20km/12.5mi 173m) (A),Stages L,Kickr15 via Zwift,351,360,-9
25115,36916,2020-04-16 10:37:16,wahoo,Zwift - DIRT Doozy Race (A),Stages L,Kickr15 via Zwift,344,347,-3
26608,36916,2020-04-21 10:26:42,wahoo,Zwift - Richmond Challenge Race // Zwift Classic (B),Stages L,Kickr15 via Zwift,353,357,-4
27208,36916,2020-04-23 09:36:05,wahoo,Zwift - Koa Sports League Race (A),Stages L,Kickr15 via Zwift,343,361,-18
27224,36916,2020-04-23 10:38:25,wahoo,Zwift - DIRT Doozy Race (A),Stages L,Kickr15 via Zwift,329,336,-7
27842,36916,2020-04-25 09:33:01,wahoo,Zwift - Watopia - AdZ,Stages L,Kickr15 via Zwift,324,330,-6
28428,36916,2020-04-27 15:12:32,wahoo,Zwift - 3R Volcano Circuit Sprint Flat Race - 1 Lap (6.6km/4.1mi 20m) (A),Stages L,Kickr15 via Zwift,356,369,-13
28661,36916,2020-04-28 09:35:55,wahoo,Zwift - MGCC Ride & Race (B),Stages L,Kickr15 via Zwift,360,372,-12
28983,36916,2020-04-29 09:30:34,wahoo,Zwift - USA Cycling Coffee with Hot Espresso Presented by Team ODZ (C),Stages L,Kickr15 via Zwift,350,359,-9
29475,36916,2020-04-30 10:27:22,wahoo,Zwift - European Lunch Ride  (E),Stages L,Kickr15 via Zwift,333,336,-3
30450,36916,2020-05-02 09:37:43,wahoo,Zwift - Ryan Fulmer [RELENTLESS]&#039;s Meetup - Tour of Fire and Ice,Stages L,Kickr15 via Zwift,364,366,-2
30880,36916,2020-05-03 09:28:00,wahoo,Zwift - Joseph Anthony [RELENTLESS]&#039;s Meetup - Big Foot Hills,Stages L,Kickr15 via Zwift,243,247,-4
33548,36916,2020-05-11 09:43:56,wahoo,Zwift - VO2 3*5*1 - 2 MIN REST,Stages L,Kickr15 via Zwift,266,271,-5
33839,36916,2020-05-12 09:57:27,wahoo,Zwift - KISS at Race - Americas AM (A),Stages L,Kickr15 via Zwift,358,359,-1
34579,36916,2020-05-14 09:44:00,wahoo,Zwift - Koa Sports League Race (A),Stages L,Kickr15 via Zwift,367,372,-5
34598,36916,2020-05-14 10:38:55,wahoo,Zwift - DIRT Doozy Race (A),Stages L,Kickr15 via Zwift,335,345,-10
35777,36916,2020-05-18 09:57:58,wahoo,Zwift - EVR Asia Race (A),Stages L,Kickr15 via Zwift,313,324,-11
36582,36916,2020-05-21 09:42:29,wahoo,Zwift - Koa Sports League Race (A),Stages L,Kickr15 via Zwift,350,364,-14
36584,36916,2020-05-21 10:37:28,wahoo,Zwift - DIRT Doozy Race (A),Stages L,Kickr15 via Zwift,345,356,-11
37556,36916,2020-05-25 09:37:41,wahoo,Zwift - THRESHOLD PYRAMID,Stages L,Kickr15 via Zwift,336,346,-10
37748,36916,2020-05-26 09:58:15,wahoo,Zwift - KISS at Race - Americas AM (A),Stages L,Kickr15 via Zwift,332,340,-8
38237,36916,2020-05-28 09:44:26,wahoo,Zwift - Koa Sports League Race (A),Stages L,Kickr15 via Zwift,371,370,1
38253,36916,2020-05-28 10:37:32,wahoo,Zwift - DIRT Doozy Race (A),Stages L,Kickr15 via Zwift,357,364,-7
38673,36916,2020-05-30 10:04:02,wahoo,Zwift - Team EN Hang-On Ride (C),Stages L,Kickr15 via Zwift,353,362,-9
38810,36916,2020-05-31 10:55:52,wahoo,Zwift - D az Carter [BRT]&#039;s Meetup - Volcano Circuit,Stages L,Kickr15 via Zwift,374,382,-8
38914,36916,2020-06-01 09:43:43,wahoo,Zwift - VO2 30/15 for 75,Stages L,Kickr15 via Zwift,323,331,-8
39257,36916,2020-06-03 09:42:27,wahoo,Zwift - USA Cycling Race League by Indoor Specialist (A),Stages L,Kickr15 via Zwift,330,346,-16
39504,36916,2020-06-04 10:36:49,wahoo,Zwift - DIRT Doozy Race (A),Stages L,Kickr15 via Zwift,312,324,-12
39661,36916,2020-06-04 20:22:23,wahoo,A little more volume with a 4’ VO2 worked ,Stages L,Kickr15 via Zwift,345,356,-11
40249,36916,2020-06-07 18:36:49,wahoo,SMART - Shut Up and Ride - Xert,Stages L,Kickr,298,298,0
40488,36916,2020-06-09 09:57:34,wahoo,Zwift - KISS at Race - Americas AM (A),Stages L,Kickr15 via Zwift,341,345,-4
40708,36916,2020-06-10 09:31:49,wahoo,Zwift - USA Cycling Coffee with Hot Espresso Presented by Team ODZ (C),Stages L,Kickr15 via Zwift,352,351,1
40971,36916,2020-06-11 09:59:01,wahoo,Zwift - Koa Sports League Race (A),Stages L,Kickr15 via Zwift,337,356,-19
40975,36916,2020-06-11 10:36:58,wahoo,Zwift - DIRT Doozy Race (A),Stages L,Kickr15 via Zwift,341,352,-11
41521,36916,2020-06-13 20:00:17,wahoo,Zwift - 3R Watopia Hilly Race - 2 Laps (18.3km/11.4mi 200m) (A),Stages L,Kickr15 via Zwift,353,372,-19
41775,36916,2020-06-15 09:58:28,wahoo,Zwift - EVR Asia Race (A),Stages L,Kickr15 via Zwift,333,339,-6
42133,36916,2020-06-17 09:35:54,wahoo,Zwift - ZHR Hare & Hounds Race (A),Stages L,Kickr15 via Zwift,340,354,-14
42365,36916,2020-06-18 10:42:58,wahoo,Zwift - Crit City Race (A),Stages L,Kickr15 via Zwift,344,354,-10
42561,36916,2020-06-19 09:21:26,wahoo,Zwift - DIRT Friday Morning Sprintapalooza (C),Stages L,Kickr15 via Zwift,233,230,3
43023,36916,2020-06-21 20:06:51,wahoo,Zwift - 3R Greater London Flat Race - 3 Laps (40.2km/25mi 135m) (A),Stages L,Kickr15 via Zwift,353,368,-15
43072,36916,2020-06-22 09:57:26,wahoo,Zwift - EVR Asia Race (A),Stages L,Kickr15 via Zwift,317,334,-17
43511,36916,2020-06-25 09:59:22,wahoo,Koa Sports League Race,Stages L,Kickr15 via Zwift,362,359,3
43517,36916,2020-06-25 10:37:07,wahoo,Zwift - DIRT Doozy Race (A),Stages L,Kickr15 via Zwift,333,344,-11
43676,36916,2020-06-26 09:58:17,wahoo,Zwift - EVR Asia Race (A),Stages L,Kickr15 via Zwift,335,350,-15
43913,36916,2020-06-28 09:44:38,wahoo,Zwift - Stages of DIRT (A),Stages L,Kickr15 via Zwift,349,355,-6
43922,36916,2020-06-28 10:35:34,wahoo,Zwift - Z2 w/ a little VO2,Stages L,Kickr15 via Zwift,267,273,-6
44029,36916,2020-06-29 10:17:14,wahoo,Zwift - 3R Volcano Flat Race - 3 Laps (36.6km/22.7mi 138m) (A),Stages L,Kickr15 via Zwift,337,345,-8
44177,36916,2020-06-30 09:34:34,wahoo,Zwift - MGCC Ride & Race (B),Stages L,Kickr15 via Zwift,354,356,-2
44526,36916,2020-07-02 09:59:20,wahoo,Koa Sports League Race,Stages L,Kickr15 via Zwift,361,372,-11
44527,36916,2020-07-02 10:36:56,wahoo,Zwift - DIRT Doozy Race (A),Stages L,Kickr15 via Zwift,351,350,1
44663,36916,2020-07-03 09:24:51,wahoo,Zwift - DIRT Friday Morning Sprintapalooza (C),Stages L,Kickr15 via Zwift,290,293,-3
45083,36916,2020-07-06 09:57:06,wahoo,Zwift - EVR Asia Race (A),Stages L,Kickr15 via Zwift,325,339,-14
45214,36916,2020-07-07 09:33:12,wahoo,Zwift - MGCC Ride & Race (B),Stages L,Kickr15 via Zwift,372,380,-8
45564,36916,2020-07-09 09:12:06,wahoo,Zwift - The Lamb Chop p/b Black Sheep (A),Stages L,Kickr on Wahoo app,342,356,-14
45566,36916,2020-07-09 09:57:00,wahoo,Zwift - Koa Sports League Race (A),Stages L,Kickr on Wahoo app,333,346,-13
45567,36916,2020-07-09 10:37:19,wahoo,Zwift - DIRT Doozy Race (A),Stages L,Kickr on Wahoo app,344,356,-12
46135,36916,2020-07-11 20:39:54,wahoo,SMART - Stuck in the Middle - 60 - Xert,Stages L,Kickr,289,286,3
46242,36916,2020-07-14 09:02:45,wahoo,Zwift - 3R Turbocharged Team Race Series - Round 1 (A),Stages L,Kickr15 via Zwift,335,351,-16
46572,36916,2020-07-16 09:15:17,wahoo,Zwift - The Lamb Chop p/b Black Sheep (A),Stages L,Kickr15 via Zwift,365,386,-21
46573,36916,2020-07-16 09:57:48,wahoo,Zwift - Koa Sports League Race (A),Stages L,Kickr15 via Zwift,356,363,-7
46574,36916,2020-07-16 10:37:15,wahoo,Zwift - DIRT Doozy Race (A),Stages L,Kickr15 via Zwift,350,361,-11
46935,36916,2020-07-19 10:00:41,wahoo,Zwift - L&#039;Etape du Tour Stage 3 - Open,Stages L,Kickr15 via Zwift,336,348,-12
47143,36916,2020-07-21 10:00:40,wahoo,Zwift - Virtual Tour de France - A - Stage 6 Discovery Ride,Stages L,Kickr on Wahoo app,308,320,-12
47154,36916,2020-07-21 09:01:53,wahoo,Kickr15 via Zwift / Stages L,Stages L,Kickr15 via Zwift,321,340,-19
47283,36916,2020-07-22 10:11:00,wahoo,Zwift - KISS at Base Training Ride (C),Stages L,Kickr15 via Zwift,232,229,3
47418,36916,2020-07-23 09:58:47,wahoo,Zwift - Koa Sports League Race (A),Stages L,Kickr15 via Zwift,345,354,-9
47419,36916,2020-07-23 10:42:40,wahoo,Zwift - Crit City Race (A),Stages L,Kickr15 via Zwift,358,365,-7
47521,36916,2020-07-24 09:32:21,wahoo,Zwift - TBR Burrito Race (A),Stages L,Kickr15 via Zwift,343,348,-5
47760,36916,2020-07-26 15:37:21,wahoo,Zwift - The Alpe Dash by Herd Racing League (A),Stages L,Kickr15 via Zwift,358,357,1
47847,36916,2020-07-27 09:51:21,wahoo,Zwift - KISS at Base Training Ride (C),Stages L,Kickr15 via Zwift,208,220,-12
47951,36916,2020-07-28 09:04:15,wahoo,Zwift - 3R Turbocharged Team Race Series - Round 3 (A),Stages L,Kickr15 via Zwift,352,369,-17
48109,36916,2020-07-29 09:44:30,wahoo,Zwift - USA Cycling Race League by Indoor Specialist (A),Stages L,Kickr15 via Zwift,333,353,-20
48275,36916,2020-07-30 09:59:36,wahoo,Zwift - Koa Sports League Race (A),Stages L,Kickr15 via Zwift,363,365,-2
48276,36916,2020-07-30 10:36:58,wahoo,Zwift - DIRT Doozy Race (A),Stages L,Kickr15 via Zwift,347,362,-15
48563,36916,2020-08-02 09:42:25,wahoo,Zwift - Stages of DIRT (A),Stages L,Kickr15 via Zwift,354,349,5
48656,36916,2020-08-03 09:51:04,wahoo,Zwift - KISS at Base Training Ride (C),Stages L,Kickr15 via Zwift,246,246,0
48749,36916,2020-08-04 09:04:08,wahoo,Zwift - 3R Turbocharged Team Race Series - Round 4 (A),Stages L,Kickr15 via Zwift,326,337,-11
48751,36916,2020-08-04 09:57:56,wahoo,Zwift - KISS at Race - Americas AM (A),Stages L,Kickr15 via Zwift,308,317,-9
49035,36916,2020-08-06 09:59:14,wahoo,Zwift - Koa Sports League Race (A),Stages L,Kickr15 via Zwift,348,352,-4
49037,36916,2020-08-06 10:38:23,wahoo,Zwift - DIRT Doozy Race (A),Stages L,Kickr15 via Zwift,313,324,-11
49428,36916,2020-08-10 09:56:46,wahoo,Zwift - KISS at Base Training Ride (B),Stages L,Kickr15 via Zwift,295,296,-1
49531,36916,2020-08-11 09:04:22,wahoo,Zwift - 3R Turbocharged Team Race Series - Round 5 (A),Stages L,Kickr15 via Zwift,367,385,-18
49805,36916,2020-08-13 09:28:11,wahoo,Zwift - Espresso,Stages L,Kickr15 via Zwift,345,352,-7
50287,36916,2020-08-16 20:58:40,wahoo,Off The MAAP Stage 1 Race,Stages L,Kickr15 via Zwift,363,364,-1
50507,36916,2020-08-18 09:58:18,wahoo,Zwift - Off The MAAP Stage 2 Race (A),Stages L,Kickr15 via Zwift,349,354,-5
50670,36916,2020-08-19 09:49:15,wahoo,Zwift - KISS at Base Training Ride (C),Stages L,Kickr15 via Zwift,220,227,-7
50852,36916,2020-08-20 09:29:13,wahoo,Zwift - Espresso,Stages L,Kickr15 via Zwift,370,377,-7
50891,36916,2020-08-20 10:17:08,wahoo,Zwift - 3R Whole Lotta Lava Hilly Race - 1 Lap (16.9km/10.5mi 183m) (A),Stages L,Kickr15 via Zwift,359,372,-13
51072,36916,2020-08-21 09:33:41,wahoo,Zwift - TBR Burrito Race (A),Stages L,Kickr15 via Zwift,333,345,-12
51337,36916,2020-08-23 09:58:29,wahoo,Off The MAAP Stage 3 Race,Stages L,Kickr15 via Zwift,349,363,-14
51340,36916,2020-08-23 11:04:21,wahoo,Zwift - 3R Innsbruckring Sprint Race - 1 Lap (8.8km/5.5mi 77m) (A),Stages L,Kickr15 via Zwift,346,348,-2
51620,36916,2020-08-25 09:04:14,wahoo,Zwift - 3R Turbocharged Team Race Series - Bonus Round (A),Stages L,Kickr15 via Zwift,341,356,-15
51635,36916,2020-08-25 09:59:12,wahoo,Zwift - Off The MAAP Stage 4 Race (A),Stages L,Kickr15 via Zwift,343,351,-8
52123,36916,2020-08-27 09:59:27,wahoo,Koa Sports League Race,Stages L,Kickr15 via Zwift,350,363,-13
53175,36916,2020-09-03 09:59:22,wahoo,Zwift - KISS at Race - Americas AM (A),Stages L,Kickr15 via Zwift,337,344,-7
53391,36916,2020-09-04 09:37:53,wahoo,Zwift - DIRT Friday Morning Sprintapalooza (C),Stages L,Kickr15 via Zwift,227,225,2
54569,36916,2020-09-11 09:22:32,wahoo,Zwift - DIRT Friday Morning Sprintapalooza (C),Stages L,Kickr15 via Zwift,236,233,3
54570,36916,2020-09-11 10:24:32,wahoo,Zwift - Kinetic Cruisers (C),Stages L,Kickr15 via Zwift,231,232,-1
55310,36916,2020-09-15 09:34:37,wahoo,Zwift - MGCC Ride & Race (B),Stages L,Kickr15 via Zwift,360,347,13
55511,36916,2020-09-16 09:54:07,wahoo,Zwift - KISS at Base Training Ride (C),Stages L,Kickr15 via Zwift,242,243,-1
55723,36916,2020-09-17 09:58:10,wahoo,Zwift - KISS at Race - Americas AM (A),Stages L,Kickr15 via Zwift,365,363,2
58433,36916,2020-09-30 09:40:23,wahoo,Zwift - USA Cycling Race League by Indoor Specialist (A),Xpower-s,Kickr15 via Zwift,359,355,4
59218,36916,2020-10-03 10:41:41,wahoo,Zwift - Into the Red by RELENTLESS (A),Xpower-s,Kickr15 via Zwift,407,386,21
59752,36916,2020-10-06 09:46:17,wahoo,Zwift - KISS at Race - Americas AM (A),Xpower-s,Kickr15 via Zwift,367,358,9
60017,36916,2020-10-07 09:29:53,wahoo,Zwift - Buckwild Buckland [RELENTLESS]&#039;s Meetup - Sand And Sequoias,Xpower-s,Kickr15 via Zwift,301,297,4
60756,36916,2020-10-10 10:44:24,wahoo,Zwift - Into the Red by RELENTLESS (A),Xpower-s,Kickr15 via Zwift,370,362,8
61453,36916,2020-10-13 09:32:37,wahoo,Zwift - MGCC Ride & Race (B),Xpower-s,Kickr15 via Zwift,392,370,22
61781,36916,2020-10-14 10:03:18,wahoo,Zwift - KISS at Base Training Ride (C),Xpower-s,Kickr15 via Zwift,215,213,2
62094,36916,2020-10-15 09:39:18,wahoo,Zwift - Jakob  Wilson [RELENTLESS]&#039;s Meetup - Greater London 8,Xpower-s,Kickr,346,336,10
62389,36916,2020-10-16 09:54:35,wahoo,Zwift - KISS at Base Training Ride (C),Xpower-s,Kickr15 via Zwift,264,252,12
62588,36916,2020-10-17 10:42:26,wahoo,Zwift - Into the Red by RELENTLESS (A),Xpower-s,Kickr15 via Zwift,367,352,15
63744,36916,2020-10-21 09:31:14,wahoo,Zwift - Watopia,Xpower-s,Kickr,349,331,18
64078,36916,2020-10-22 09:59:04,wahoo,Zwift - KISS at Race - Americas AM (A),Xpower-s,Kickr15 via Zwift,396,382,14
64337,36916,2020-10-23 10:29:49,wahoo,Kinetic Cruisers,Kickr to Garmin,XPOWER-S w/ Kickr controled,246,255,-9
64595,36916,2020-10-24 10:44:04,wahoo,Zwift - Into the Red by RELENTLESS (A),Xpower-s,Kickr15 via Zwift,370,357,13
65000,36916,2020-10-26 09:30:17,wahoo,Zwift - DIRTy Dozen Sprint League (A),Xpower-s,Kickr15 via Zwift,397,381,16
65988,36916,2020-10-29 09:57:56,wahoo,Zwift - KISS at Race - Americas AM (A),Xpower-s,Kickr15 via Zwift,374,375,-1
66005,36916,2020-10-29 10:54:38,wahoo,Zwift - DIRT Doozy Race (A),Xpower-s,Kickr15 via Zwift,349,341,8
66367,36916,2020-10-30 10:28:30,wahoo,Zwift - Kinetic Cruisers (C),Xpower-s,Kickr15 via Zwift,246,237,9
66614,36916,2020-10-31 10:43:51,wahoo,Zwift - Into the Red by RELENTLESS (A),Xpower-s,Kickr15 via Zwift,393,392,1
67149,36916,2020-11-02 10:43:07,wahoo,Zwift - Balazs Galambos [RELENTLESS]&#039;s Meetup - Figure 8 Reverse,Xpower-s,Kickr15 via Zwift,384,366,18
67485,36916,2020-11-03 09:02:35,wahoo,Zwift - Zwift Racing League | WTRL - Men&#039;s APAC DIVISION 1 (A),Xpower-s,Kickr15 via Zwift,387,385,2
67506,36916,2020-11-03 10:46:42,wahoo,Zwift - SZR Lunch Race (A),Xpower-s,Kickr15 via Zwift,352,339,13
68066,36916,2020-11-05 10:27:12,wahoo,Zwift - 30/15,Xpower-s,Kickr15 via Zwift,333,331,2
68729,36916,2020-11-07 10:44:16,wahoo,Zwift - Into the Red by RELENTLESS (A),Xpower-s,Kickr15 via Zwift,358,339,19
68995,36916,2020-11-08 11:06:18,wahoo,Calibration checks - XPOWER-S to Zwift,Xpower-s,Kickr on Wahoo app,230,220,10
69129,36916,2020-11-08 19:56:35,wahoo,More calibration checks,Xpower-s,Kickr on Wahoo app,227,217,10
70117,36916,2020-11-11 10:38:58,wahoo,Zwift - USA Cycling Race League by Indoor Specialist (A),Xpower-s,Kickr15 via Zwift,372,360,12
70541,36916,2020-11-12 10:59:38,wahoo,Zwift - KISS at Race - Americas AM (A),Xpower-s,Kickr15 via Zwift,391,376,15
71036,36916,2020-11-13 10:29:35,wahoo,Zwift - Adam Otstot (RELENTLESS)&#039;s Meetup - Greatest London Flat,Xpower-s,Kickr15 via Zwift,308,297,11
71317,36916,2020-11-14 10:43:23,wahoo,Zwift - Into the Red by RELENTLESS (A),Xpower-s,Kickr15 via Zwift,389,376,13
72088,36916,2020-11-17 10:45:07,wahoo,Zwift - SZR Lunch Race (A),Xpower-s,Kickr15 via Zwift,377,367,10
72530,36916,2020-11-18 10:29:58,wahoo,Zwift - Buckwild Buckland [RELENTLESS]&#039;s Meetup - Hilly Route,Xpower-s,Kickr15 via Zwift,302,299,3
72907,36916,2020-11-19 10:29:16,wahoo,Zwift - Frappe ,Xpower-s,Kickr15 via Zwift,380,378,2
73790,36916,2020-11-21 10:44:13,wahoo,Zwift - Into the Red by RELENTLESS (A),Xpower-s,Kickr15 via Zwift,392,384,8
74469,36916,2020-11-23 10:19:37,wahoo,Zwift - 3R Volcano Flat Race - 3 Laps (36.6km/22.7mi 138m) (A),Xpower-s,Kickr15 via Zwift,371,359,12
74897,36916,2020-11-24 10:59:41,wahoo,Zwift - KISS Race Series - Americas AM (A),Xpower-s,Kickr15 via Zwift,363,361,2
75815,36916,2020-11-26 10:27:29,wahoo,Zwift - WTRL NOPINZ WORLD TTT CHAMPIONSHIPS - Zone 2 (C),Xpower-s,Kickr15 via Zwift,369,366,3
77025,36916,2020-11-28 16:49:13,wahoo,Zwift - 3R Innsbruckring Flat Race - 3 Laps (26.4km/16.4mi 231m) (A),Xpower-s,Kickr15 via Zwift,377,373,4
77930,36916,2020-12-01 11:09:12,wahoo,Zwift - Japan Zwift Tuesday Race (A),Xpower-s,Kickr15 via Zwift,361,360,1
78819,36916,2020-12-03 10:27:39,wahoo,Zwift - WTRL Team Time Trial - Zone 2 (C),Xpower-s,Kickr15 via Zwift,368,364,4
79690,36916,2020-12-05 10:44:42,wahoo,Zwift - Into the Red by RELENTLESS (A),Xpower-s,Kickr15 via Zwift,374,380,-6
80643,36916,2020-12-08 08:43:45,wahoo,Zwift Racing League | WTRL - Mens APAC DIVISION 1,Xpower-s,Kickr15 via Zwift,390,381,9
81423,36916,2020-12-10 10:25:19,wahoo,Zwift - Espresso,Xpower-s,Kickr15 via Zwift,372,369,3
82285,36916,2020-12-12 11:14:32,wahoo,Zwift - 3R Tick Tock Flat Race - 2 Lap (36km/22.4mi 100m) (A),Xpower-s,Kickr15 via Zwift,377,373,4
82957,36916,2020-12-13 21:24:00,wahoo,Zwift - Watopia,Xpower-s,Kickr15 via Zwift,387,381,6
83361,36916,2020-12-15 08:53:56,wahoo,Zwift - Zwift Racing League | WTRL - Men&#039;s APAC DIVISION 1 (A),Xpower-s,Kickr15 via Zwift,368,356,12
83878,36916,2020-12-16 10:50:55,wahoo,Zwift - KISS at Base Training Ride (C),Xpower-s,Kickr15 via Zwift,260,257,3
84214,36916,2020-12-17 11:52:32,wahoo,Zwift - DIRT Doozy Race (A),Xpower-s,Kickr15 via Zwift,386,387,-1
85249,36916,2020-12-19 20:02:33,wahoo,Zwift - AdZ... still with the damn gloves.  New 20-min of 357W.,Xpower-s,Kickr15 via Zwift,383,363,20
86015,36916,2020-12-22 10:46:26,wahoo,Zwift - SZR Lunch Race (A),Xpower-s,Kickr,376,361,15
86887,36916,2020-12-24 11:54:06,wahoo,Zwift - DIRT Doozy Race (A),Xpower-s,Kickr15 via Zwift,384,376,8
87768,36916,2020-12-27 11:43:25,wahoo,Zwift - Crit City Race (A),Xpower-s,Kickr15 via Zwift,385,381,4
93024,37116,2021-01-07 19:19:02,wahoo,Zwift - WTRL Team Time Trial - Zone 7 (D),Vector 3,Kickr,296,289,7
101310,37116,2021-01-21 18:48:51,wahoo,Zwift - WTRL Team Time Trial - Zone 6 (D),Vector 3 2nd,Kickr Zwift,269,271,-2
105458,37116,2021-01-30 09:00:10,wahoo,Zwift - Newbury Velo Weekend TT,Vector 3 2nd,Kickr Zwift,295,297,-2
50093,37710,2020-08-05 15:29:53,neo,Zwift - TEAM VEGAN Mixed Salad (B),4iiii Dura Ace 9100  L/R  Factory Data Accuracy 1%,Tacx Neo 1 Factory Data Accuracy 1%,215,218,-3
50094,37710,2020-08-06 17:37:54,neo,Zwift - Frappe,4iiii Dura Ace 9100  L/R  Factory Data Accuracy 1%,Tacx Neo 1 Factory Data Accuracy 1%,274,269,5
50095,37710,2020-08-13 17:40:21,neo,Zwift - Frappe,4iiii Dura Ace 9100  L/R  Factory Data Accuracy 1%,Tacx Neo 1 Factory Data Accuracy 1%,250,246,4
50147,37710,2020-08-15 14:59:16,neo,Zwift - ZHQ Steering Race // FutureWorks (B),4iiii Dura Ace 9100  L/R  Factory Data Accuracy 1%,Tacx Neo 1 Factory Data Accuracy 1%,278,277,1
50543,37710,2020-08-18 15:29:15,neo,Zwift - TEAM VEGAN Tofu Tornado (B),4iiii Dura Ace 9100  L/R  Factory Data Accuracy 1%,Tacx Neo 1 Factory Data Accuracy 1%,259,261,-2
51192,37710,2020-08-22 08:00:16,neo,Zwift - Off The MAAP Stage 3 Race (B),4iiii Dura Ace 9100  L/R  Factory Data Accuracy 1%,Tacx Neo 1 Factory Data Accuracy 1%,282,283,-1
51654,37710,2020-08-25 13:00:15,neo,Zwift - Off The MAAP Stage 4 Race (B),4iiii Dura Ace 9100  L/R  Factory Data Accuracy 1%,Tacx Neo 1 Factory Data Accuracy 1%,273,276,-3
52191,37710,2020-08-27 17:40:16,neo,Zwift - WTRL Team Time Trial (D),4iiii Dura Ace 9100  L/R  Factory Data Accuracy 1%,Tacx Neo 1 Factory Data Accuracy 1%,262,255,7
52739,37710,2020-08-31 12:39:12,neo,Zwift - 3R Volcano Climb Race - 1 Lap (22.4km/14mi 204m) (B),4iiii Dura Ace 9100  L/R  Factory Data Accuracy 1%,Tacx Neo 1 Factory Data Accuracy 1%,301,296,5
52884,37710,2020-09-01 13:14:12,neo,Zwift - 3R Figure 8 Hilly Reverse Race - 1 Lap (29.2km/18.1mi 234m ) (B),4iiii Dura Ace 9100  L/R  Factory Data Accuracy 1%,Tacx Neo 1 Factory Data Accuracy 1%,283,277,6
53507,37710,2020-09-05 07:29:11,neo,Zwift - TEAM VEGAN Tofu Tornado XL (B),4iiii Dura Ace 9100  L/R  Factory Data Accuracy 1%,Tacx Neo 1 Factory Data Accuracy 1%,299,294,5
53922,37710,2020-09-08 13:15:15,neo,Zwift - 3R Figure 8 Hilly Reverse Race - 1 Lap (29.2km/18.1mi 234m ) (B),4iiii Dura Ace 9100  L/R  Factory Data Accuracy 1%,Tacx Neo 1 Factory Data Accuracy 1%,301,303,-2
54408,37710,2020-09-10 17:37:41,neo,Zwift - Frappe,4iiii Dura Ace 9100  L/R  Factory Data Accuracy 1%,Tacx Neo 1 Factory Data Accuracy 1%,246,246,0
54715,37710,2020-09-12 13:19:10,neo,Zwift - 3R Innsbruckring Flat Race - 5 Laps (44km/27.3mi 385m) (A),4iiii Dura Ace 9100  L/R  Factory Data Accuracy 1%,Tacx Neo 1 Factory Data Accuracy 1%,279,281,-2
55329,37710,2020-09-15 13:15:15,neo,Zwift - 3R Figure 8 Hilly Reverse Race - 1 Lap (29.2km/18.1mi 234m ) (A),4iiii Dura Ace 9100  L/R  Factory Data Accuracy 1%,Tacx Neo 1 Factory Data Accuracy 1%,277,279,-2
56803,37710,2020-09-22 13:14:09,neo,Zwift - 3R Figure 8 Hilly Reverse Race - 1 Lap (29.2km/18.1mi 234m ) (A),4iiii Dura Ace 9100  L/R  Factory Data Accuracy 1%,Tacx Neo 1 Factory Data Accuracy 1%,273,279,-6
57825,37710,2020-09-27 07:09:07,neo,Zwift - 3R Figure 8 Hilly Race - 1 Lap (29.2km/18.1m 234m) (A),4iiii Dura Ace 9100  L/R  Factory Data Accuracy 1%,Tacx Neo 1 Factory Data Accuracy 1%,293,293,0
58238,37710,2020-09-29 13:14:05,neo,Zwift - 3R Figure 8 Hilly Reverse Race  (A),4iiii Dura Ace 9100  L/R  Factory Data Accuracy 1%,Tacx Neo 1 Factory Data Accuracy 1%,295,294,1
59175,37710,2020-10-03 07:29:17,neo,Zwift - TEAM VEGAN Tofu Tornado XL (A),4iiii Dura Ace 9100  L/R  Factory Data Accuracy 1%,Tacx Neo 1 Factory Data Accuracy 1%,295,296,-1
59782,37710,2020-10-06 13:14:04,neo,Zwift - 3R Figure 8 Hilly Reverse Race - 1 Lap (29.2km/18.1mi 234m ) (A),4iiii Dura Ace 9100  L/R  Factory Data Accuracy 1%,Tacx Neo 1 Factory Data Accuracy 1%,291,289,2
60834,37710,2020-10-10 15:29:35,neo,Zwift - TEAM VEGAN Tofu Tornado (A),4iiii Dura Ace 9100  L/R  Factory Data Accuracy 1%,Tacx Neo 1 Factory Data Accuracy 1%,285,279,6
61487,37710,2020-10-13 15:29:04,neo,Zwift - TEAM VEGAN Tofu Tornado (A),4iiii Dura Ace 9100  L/R  Factory Data Accuracy 1%,Tacx Neo 1 Factory Data Accuracy 1%,295,287,8
64546,37710,2020-10-24 07:39:26,neo,Zwift - Duathlon Race Series (A),4iiii Dura Ace 9100  L/R  Factory Data Accuracy 1%,Tacx Neo 1 Factory Data Accuracy 1%,241,234,7
64660,37710,2020-10-24 14:59:03,neo,Zwift - ZHQ Steering Race // FutureWorks (A),4iiii Dura Ace 9100  L/R  Factory Data Accuracy 1%,Tacx Neo 1 Factory Data Accuracy 1%,265,260,5
68149,37710,2020-11-05 14:09:06,neo,Zwift - ZA Road Race #1: 4 - 5 w/kg,4iiii Dura Ace 9100  L/R  Factory Data Accuracy 1%,Tacx Neo 1 Factory Data Accuracy 1%,271,266,5
79637,37710,2020-12-05 08:25:13,neo,Zwift - TEAM VEGAN Tofu Tornado XL (A),4iiii Dura Ace 9100  L/R  Accuracy 1%,Tacx Neo 1  Accuracy 1%,252,258,-6
82221,37710,2020-12-12 09:35:25,neo,Zwift - ZA Tri: TT Race - 20k,4iiii Dura Ace 9100  L/R ,Tacx Neo 1  ,249,242,7
83448,37710,2020-12-15 13:13:59,neo,Zwift - 3R Figure 8 Hilly Reverse Race - 1 Lap (29.2km/18.1mi 234m ) (B),4iiii Dura Ace 9100  L/R ,Tacx Neo 1  ,292,285,7
88628,37710,2020-12-29 16:29:58,neo,Zwift - TEAM VEGAN Tofu Tornado (B),4iiii Dura Ace 9100  L/R ,Tacx Neo 1  ,249,257,-8
90164,37710,2021-01-02 08:31:13,neo,Zwift - TEAM VEGAN Tofu Tornado XL (B),4iiii Dura Ace 9100  L/R ,Tacx Neo 1  ,280,276,4
91695,37710,2021-01-05 13:13:58,neo,Zwift - 3R Figure 8 Hilly Reverse Race - 1 Lap (29.2km/18.1mi 234m ) (B),4iiii Dura Ace 9100  L/R ,Tacx Neo 1  ,283,275,8
95499,37710,2021-01-12 13:14:05,neo,Zwift - 3R Figure 8 Hilly Reverse Race - 1 Lap (29.2km/18.1mi 234m ) (B),4iiii Dura Ace 9100  L/R ,Tacx Neo 1  ,288,286,2
98386,37710,2021-01-17 09:29:57,neo,Zwift -  SloZl - Slovenian Zwift League  Race  (B),4iiii Dura Ace 9100  L/R ,Tacx Neo 1  ,277,273,4
99622,37710,2021-01-19 16:29:56,neo,Zwift - TEAM VEGAN Tofu Tornado (B),4iiii Dura Ace 9100  L/R ,Tacx Neo 1  ,267,263,4
109236,37710,2021-02-05 09:03:56,neo,Zwift - 3R Whole Lotta Lava Hilly Race - 2 Laps (28.9km/12.53mi 336m) (B),4iiii Dura Ace 9100  L/R ,Tacx Neo 1  ,297,294,3
111435,37710,2021-02-09 14:30:04,neo,Zwift - DBR Tuesday Race (B),4iiii Dura Ace 9100  L/R ,Tacx Neo 1  ,281,286,-5
113854,37710,2021-02-13 08:30:02,neo,Zwift - TEAM VEGAN Tofu Tornado XL (B),4iiii Dura Ace 9100  L/R ,Tacx Neo 1  ,289,286,3
121107,37710,2021-02-26 09:01:14,neo,Zwift - Haute Route Watopia 2021 Stage 1 (B),4iiii Dura Ace 9100  L/R ,Tacx Neo 1  ,280,275,5
121471,37710,2021-02-27 08:01:29,neo,Zwift - Haute Route Watopia 2021 Stage 2 (B),4iiii Dura Ace 9100  L/R ,Tacx Neo 1  ,277,276,1
126143,37710,2021-03-09 16:31:03,neo,Zwift - TEAM VEGAN Tofu Tornado (B),4iiii Dura Ace 9100  L/R ,Tacx Neo 1  ,283,284,-1
128341,37710,2021-03-14 12:19:51,neo,Zwift - Ottawa TopSpeed Race (B),4iiii Dura Ace 9100  L/R ,Tacx Neo 1  ,288,283,5
129077,37710,2021-03-16 16:30:22,neo,Zwift - TEAM VEGAN Tofu Tornado (B),4iiii Dura Ace 9100  L/R ,Tacx Neo 1  ,295,288,7
73512,37725,2020-11-20 13:35:01,wahoo,Crit City 20/11/2020 14:35,P1s Pedal & FR735 HR,Turbo Kickr Core,326,337,-11
73667,37725,2020-11-20 14:14:58,wahoo,Turbo Kickr Core / P1s Pedal & FR735 HR,P1s Pedal & FR735 HR,Turbo Kickr Core,233,242,-9
73828,37725,2020-11-21 12:10:01,wahoo,Turbo Kickr Core / P1s Pedal,P1s Pedal,Turbo Kickr Core,349,358,-9
84265,37725,2020-12-17 14:05:03,wahoo,Turbo Kickr Core / P1s Pedal & FR735 HR,P1s Pedal & FR735 HR,Turbo Kickr Core,343,357,-14
170,38150,2019-08-14 18:03:59,wahoo,Zwift - Trofeo Bologna // Zwift Classic ,Favero Assioma DUO,Wahoo KICKR 2018,405,400,5
1335,38150,2019-09-05 18:03:05,wahoo,Zwift - Watopia Cup // Zwift Classic ,Favero Assioma DUO,Wahoo KICKR 2018,421,400,21
11870,38150,2020-01-31 19:14:58,wahoo,Zwift - Tour de Zwift // Pro-Am Invitational (A),Favero Assioma DUO,Wahoo KICKR 2018,400,387,13
50567,38150,2020-08-18 18:40:17,wahoo,Zwift - 3R Turbocharged Team Race Series - Round 6 (A),Favero Assioma DUO,Wahoo KICKR 2018,385,386,-1
50920,38150,2020-08-20 15:15:02,wahoo,Zwift - OH MY CRIT! - The Double Race 1/2 (A),Favero Assioma DUO,Wahoo KICKR 2018,374,380,-6
51865,38150,2020-08-25 18:40:02,wahoo,Zwift - 3R Turbocharged Team Race Series - Bonus Round (A),Favero Assioma DUO,Wahoo KICKR 2018,370,371,-1
52765,38150,2020-08-31 18:19:57,wahoo,Zwift - TFC Mad Monday Summer Series (9 of 10) (A),Favero Assioma DUO,Wahoo KICKR 2018,381,383,-2
52927,38150,2020-09-01 18:40:34,wahoo,Zwift - 3R Sundown Race Series - Round1 iTT,Favero Assioma DUO,Wahoo KICKR v5,395,398,-3
53231,38150,2020-09-03 17:21:10,wahoo,Zwift - Espresso,Favero Assioma DUO,Wahoo KICKR v5,372,380,-8
53425,38150,2020-09-04 14:05:01,wahoo,Zwift - 3R Innsbruckring Flat Race - 2 Laps (17.6km/10.9m 154m) (A),Favero Assioma DUO,Wahoo KICKR v5,384,386,-2
53977,38150,2020-09-08 18:43:59,wahoo,Zwift - 3R Sundown Race Series  (E),Favero Assioma DUO,Wahoo KICKR v5,391,397,-6
55380,38150,2020-09-15 18:44:00,wahoo,Zwift - 3R Sundown Race Series  (E),Favero Assioma DUO,Wahoo KICKR v5,387,393,-6
55829,38150,2020-09-17 18:29:58,wahoo,Zwift - Invitational League // Qualifying Race #2 (Men) ,Favero Assioma DUO,Wahoo KICKR v5,380,381,-1
56852,38150,2020-09-22 18:44:06,wahoo,Zwift - 3R Sundown Race Series  (E),Favero Assioma DUO,Wahoo KICKR v5,405,413,-8
56949,38150,2020-09-23 08:25:06,wahoo,Giant Crit Crushers Race 2,Favero Assioma DUO,Wahoo KICKR v5,401,405,-4
57844,38150,2020-09-27 08:05:11,wahoo,Zwift - Erik Haugen [R3R]&#039;s Meetup,Favero Assioma DUO,Wahoo KICKR v5,396,404,-8
58309,38150,2020-09-29 18:44:02,wahoo,Zwift - 3R Sundown Race Series  (E),Favero Assioma DUO,Wahoo KICKR v5,383,394,-11
59882,38150,2020-10-06 18:43:57,wahoo,Zwift - 3R Sundown Race Series - iTT (E),Favero Assioma DUO,Wahoo KICKR v5,387,396,-9
61349,38150,2020-10-12 18:49:59,wahoo,Zwift - Premier Division // Zwift Racing League (men) ,Favero Assioma DUO,Wahoo KICKR v5,406,414,-8
61853,38150,2020-10-14 16:00:03,wahoo,Zwift - ZHQ Beta Crit City Race (A),Favero Assioma DUO,Wahoo KICKR v5,398,400,-2
63205,38150,2020-10-19 18:07:59,wahoo,Zwift - Premier Division // Zwift Racing League (men) ,Favero Assioma DUO,Wahoo KICKR v5,392,394,-2
64195,38150,2020-10-22 17:25:13,wahoo,Zwift - Espresso,Favero Assioma DUO,Wahoo KICKR v5,383,394,-11
65186,38150,2020-10-26 19:59:56,wahoo,Zwift - Premier Division // Zwift Racing League (men) (A),Favero Assioma DUO,Wahoo KICKR v5,413,420,-7
67381,38150,2020-11-02 19:07:53,wahoo,Zwift - Premier Division // Zwift Racing League (men) (A),Favero Assioma DUO,Wahoo KICKR v5,395,395,0
68416,38150,2020-11-06 07:00:14,wahoo,Race 1 // Men // Z Pro Tri // Community,Favero Assioma DUO,Wahoo KICKR v5,379,381,-2
68417,38150,2020-11-06 07:29:58,wahoo,Race 2 // Men // Z Pro Tri // Community,Favero Assioma DUO,Wahoo KICKR v5,367,365,2
68419,38150,2020-11-06 07:59:54,wahoo,Race 3 // Men // Z Pro Tri // Community,Favero Assioma DUO,Wahoo KICKR v5,361,366,-5
68692,38150,2020-11-07 08:04:58,wahoo,Zwift - 3R Weekend Race Club - Race 1 (A),Favero Assioma DUO,Wahoo KICKR v5,376,380,-4
69410,38150,2020-11-09 19:59:57,wahoo,Zwift - Premier Division // Zwift Racing League (men) (A),Favero Assioma DUO,Wahoo KICKR v5,453,457,-4
70650,38150,2020-11-12 17:04:57,wahoo,Zwift - OH MY CRIT! - The Double Race 2/2 (A),Favero Assioma DUO,Wahoo KICKR v5,362,369,-7
71240,38150,2020-11-14 08:05:05,wahoo,Zwift - 3R Weekend Race Club - Race 1 (A),Favero Assioma DUO,Wahoo KICKR v5,380,384,-4
74108,38150,2020-11-22 11:04:59,wahoo,Zwift - 3R Innsbruckring Sprint Race - 1 Lap (8.8km/5.5mi 77m) (A),Favero Assioma DUO,Wahoo KICKR v5,387,393,-6
76022,38150,2020-11-26 18:34:50,wahoo,Zwift - WTRL NOPINZ WORLD TTT CHAMPIONSHIPS - Zone 6 (C),Favero Assioma DUO,Wahoo KICKR v5,397,398,-1
84647,38150,2020-12-18 11:00:17,wahoo,Zwift - Tour of New York Stage 1 - Open Longer,Favero Assioma DUO,Wahoo KICKR v5,378,379,-1
88300,38150,2020-12-28 19:19:48,wahoo,Team TFC Mad Monday Winter Series,Favero Assioma DUO,Wahoo KICKR v5,371,371,0
92854,38150,2021-01-07 18:35:26,wahoo,Zwift - WTRL Team Time Trial - Zone 6 (C),Favero Assioma DUO,Wahoo KICKR v5,390,401,-11
98962,38150,2021-01-18 15:15:48,wahoo,3R Volcano Circuit Sprint Flat Race - 1 Lap (6.6km/4.1mi 20m),Favero Assioma DUO,Wahoo KICKR v5,384,381,3
100227,38150,2021-01-20 16:09:47,wahoo,Zwift - 3R Tick Tock Flat Race - 2 Lap (36km/22.4mi 100m) (A),Favero Assioma DUO,Wahoo KICKR v5,367,369,-2
100808,38150,2021-01-21 16:14:47,wahoo,Zwift - OH MY CRIT! - The Double Race 1/2 (A),Favero Assioma DUO,Wahoo KICKR v5,387,397,-10
100833,38150,2021-01-21 17:04:58,wahoo,Zwift - OH MY CRIT! - The Double Race 2/2 (A),Favero Assioma DUO,Wahoo KICKR v5,342,334,8
101690,38150,2021-01-23 10:30:03,wahoo,Zwift - 3R Volcano Climb Race - 1 Lap (22.4km/14mi 204m) (A),Favero Assioma DUO,Wahoo KICKR v5,416,421,-5
102887,38150,2021-01-25 19:04:40,wahoo,Premier Division // Zwift Racing League (men),Favero Assioma DUO,Wahoo KICKR v5,402,403,-1
106913,38150,2021-02-01 20:07:09,wahoo,Zwift - Premier Division // Zwift Racing League (men) (A),Favero Assioma DUO,Wahoo KICKR v5,412,406,6
110997,38150,2021-02-08 19:16:39,wahoo,Zwift - Premier Division // Zwift Racing League (men) (A),Favero Assioma DUO,Wahoo KICKR v5,405,412,-7
115385,38150,2021-02-15 20:01:41,wahoo,Zwift - Premier Division // Zwift Racing League (men) (A),Favero Assioma DUO,Wahoo KICKR v5,421,425,-4
115744,38150,2021-02-16 16:05:25,wahoo,Zwift - 3R Volcano Circuit Flat Race - 8 Laps (35.2km/21.9mi 160m) (A),Favero Assioma DUO,Wahoo KICKR v5,361,361,0
118257,38150,2021-02-20 15:30:15,wahoo,Zwift - Team Draft Crit City Race (A),Favero Assioma DUO,Wahoo KICKR v5,366,379,-13
49901,39406,2020-08-12 22:00:42,neo,Zwift - Women Only - 7 Days of Tarmac SL7: Stage 2 with Ashlee Jones,Quarq CinQo Saturn,Tacx Neo,179,171,8
49904,39406,2020-08-13 22:00:54,neo,Zwift - Shorter Ride - 7 Days of Tarmac SL7: Stage 2 with Sam Hsieh,Quarq CinQo Saturn,Tacx Neo,173,163,10
50186,39406,2020-08-15 22:02:22,neo,Zwift - Off The MAAP Stage 1 Race (C),Quarq CinQo Saturn,Tacx Neo,178,174,4
50993,39406,2020-08-20 21:01:47,neo,Zwift - Off The MAAP Stage 2 Race (C),Quarq CinQo Saturn,Tacx Neo,169,156,13
51297,39406,2020-08-22 22:00:15,neo,Zwift - Off The MAAP Stage 3 Race (C),Quarq CinQo Saturn,Tacx Neo,156,148,8
51901,39406,2020-08-25 21:00:29,neo,Zwift - Off The MAAP Stage 4 Race (C),Quarq CinQo Saturn,Tacx Neo,175,165,10
63772,39406,2020-10-20 18:28:26,neo,Zwift - Zwift Racing League | WTRL - EMEA (WOMEN) - TTT Grp 2 (B),Quarq CinQo Saturn,Tacx Neo,158,148,10
65817,39406,2020-10-27 19:16:14,neo,Zwift - Zwift Racing League | WTRL - EMEA (WOMEN) -  Division 1 (C),Quarq CinQo Saturn,Tacx Neo,173,160,13
74971,39406,2020-11-17 19:21:05,neo,Zwift - Zwift Racing League | WTRL - Women&#039;s EMEA W1 DIVISION 1 (C),Quarq CinQo Saturn,Tacx Neo,166,158,8
77610,39406,2020-11-26 23:59:00,neo,Zwift - Focus: Colours of PARI - Shorter Ride,Quarq CinQo Saturn,Tacx Neo,171,159,12
80964,39406,2020-12-08 19:17:19,neo,Zwift - Zwift Racing League | WTRL - Women&#039;s EMEA W1 DIVISION 1 (C),Quarq CinQo Saturn,Tacx Neo,186,178,8
82827,39406,2020-12-12 19:29:43,neo,Zwift - Fearless Women&#039;s Team Championships - 2020 (C),Quarq CinQo Saturn,Tacx Neo,174,158,16
28293,39632,2020-04-26 13:44:15,wahoo,Zwift - La Bicicletta Toronto & Toronto Hustle Donut Race (A),QUARQ DFour91,Wahoo KICKR V4,381,376,5
28300,39632,2020-04-25 08:27:14,wahoo,Zwift - Newbury Velo Weekend TT (E),QUARQ DFour91,Wahoo KICKR V4,408,405,3
28479,39632,2020-04-27 16:58:02,wahoo,Zwift - SCF MTB Challenge 2 (A),QUARQ DFour91,Wahoo KICKR V4,394,386,8
29172,39632,2020-04-29 16:08:01,wahoo,Zwift - ZHR Hare & Hounds Race (A),QUARQ DFour91,Wahoo KICKR V4,378,373,5
29761,39632,2020-04-30 15:00:19,wahoo,Zwift - Braquasse cup - 2/4 (A),QUARQ DFour91,Wahoo KICKR V4,427,422,5
30652,39632,2020-05-02 13:58:40,wahoo,Zwift - XRS Races: Saturday Climbing Series (A) 7e,QUARQ DFour91,Wahoo KICKR V4,404,403,1
34031,39632,2020-05-12 17:54:57,wahoo,Zwift - Team Italy & Frenchy Fuzion League (A),QUARQ DFour91,Wahoo KICKR V4,414,408,6
96221,39632,2021-01-13 10:29:29,wahoo,USA Cycling Coffee with Hot Espresso Presented by Team ODZ,Quarq Sram Red DZERO,Wahoo KICKR V4,255,249,6
96453,39632,2021-01-13 15:59:25,wahoo,Sydkysten Race,Quarq Sram Red DZERO,Wahoo KICKR V4,350,339,11
107157,39632,2021-02-02 10:59:49,wahoo,CRYO-GEN ZTGR (Zwift Tuesday Group Ride),QUARQ DFour91,Wahoo KICKR V4,288,280,8
108113,39632,2021-02-03 16:10:12,wahoo,3R Tick Tock Flat Race - 2 Lap (36km/22.4mi 100m),QUARQ DFour91,Wahoo KICKR V4,369,357,12
108745,39632,2021-02-04 10:59:46,wahoo,Zwift - KISS Race Series - Americas AM (A),QUARQ DFour91,Wahoo KICKR V4,356,352,4
109365,39632,2021-02-05 16:04:51,wahoo,Zwift - 3R Volcano Flat Race - 3 Laps (36.6km/22.7mi 138m) (A),QUARQ DFour91,Wahoo KICKR V4,439,426,13
110312,39632,2021-02-07 10:14:04,wahoo,Test ramp Lucas ,Power 2 max,Wahoo KICKR V4,371,369,2
110556,39632,2021-02-07 15:25:11,wahoo,Zwift - 3R Watopia 65km Race - 6 laps (40mi 324m) (A),QUARQ DFour91,Wahoo KICKR V4,372,361,11
111351,39632,2021-02-09 09:34:20,wahoo,Zwift - Innsbruck -- Slope -1.5% Quarq,QUARQ DFour91,Wahoo KICKR V4,273,276,-3
112081,39632,2021-02-10 10:44:25,wahoo,Zwift - The Morning Grind by STPC (A),QUARQ DFour91,Wahoo KICKR V4,423,421,2
76684,39754,2020-11-28 02:47:05,wahoo,Zwift - Watopia,Stages RH Gen 3,Kickr V5,300,322,-22
80344,39754,2020-12-07 00:00:16,wahoo,Zwift - Nations Challenge // Canada (E),Stages RH Gen 3,Kickr V5,290,303,-13
96658,39754,2021-01-14 02:30:22,wahoo,Zwift - Bicicletta Vancouver Group Ride (C),Stages LH Gen 3,Kickr V5,246,258,-12
97264,39754,2021-01-15 03:03:38,wahoo,Zwift - TDZ Stage 3: Shorter Ride,Stages LH Gen 3,Kickr V5,150,164,-14
98333,39754,2021-01-17 02:02:16,wahoo,Zwift - The P Race (B),Stages LH Gen 3,Kickr V5,293,313,-20
99410,39754,2021-01-19 02:40:11,wahoo,Zwift - R.G.V.,Stages LH Gen 3,Kickr V5,176,182,-6
100590,39754,2021-01-21 02:30:11,wahoo,Zwift - Bicicletta Vancouver Group Ride (C),Quarq Dzero Dub,Kickr V5,250,248,2
102128,39754,2021-01-24 02:13:47,wahoo,Zwift - Innsbruck,Quarq Dzero Dub,Kickr V5,295,294,1
102647,39754,2021-01-25 02:50:37,wahoo,Zwift - Innsbruck,Quarq Dzero Dub,Kickr V5,149,145,4
103836,39754,2021-01-27 03:00:49,wahoo,Zwift - Zwift Racing League | WTRL - Men&#039;s/Mixed AMERICAS W DIVISION 1 (B),Quarq Dzero Dub,Kickr V5,337,335,2
104936,39754,2021-01-27 03:00:49,wahoo,Zwift - Alpe Workout 2,Quarq Dzero Dub,Kickr V5,337,309,28
105986,39754,2021-01-31 02:09:48,wahoo,Zwift - Alpe Workout 3,Quarq Dzero Dub,Kickr V5,327,329,-2
107036,39754,2021-02-02 02:20:08,wahoo,Zwift - A. Dylewski (MusetteAlligator)&#039;s Meetup - 2019 UCI Worlds Harrogate Circuit,Quarq Dzero Dub,Kickr V5,196,193,3
107776,39754,2021-02-03 03:01:00,wahoo,Zwift - Zwift Racing League | WTRL - Men&#039;s/Mixed AMERICAS W DIVISION 1 (B),Quarq Dzero Dub,Kickr V5,348,348,0
109150,39754,2021-02-05 02:10:04,wahoo,Zwift - Alpe Workout,Quarq Dzero Dub,Kickr V5,302,304,-2
109580,39754,2021-02-06 03:54:00,wahoo,Zwift - London,Stages RH Gen 3,Kickr V5,303,319,-16
111270,39754,2021-02-09 02:30:01,wahoo,Zwift - A. Dylewski (MusetteAlligator)&#039;s Meetup - Mighty Metropolitan,Stages RH Gen 3,Kickr V5,264,265,-1
111925,39754,2021-02-10 03:07:16,wahoo,Zwift - Zwift Racing League | WTRL - Men&#039;s/Mixed AMERICAS W DIVISION 1 (B),Stages RH Gen 3,Kickr V5,338,338,0
112574,39754,2021-02-11 02:30:05,wahoo,Zwift - Bicicletta Vancouver Group Ride (C),Stages RH Gen 3,Kickr V5,267,269,-2
114455,39754,2021-02-14 00:59:49,wahoo,Zwift - Herd Beginner Racing Series (E),Stages RH Gen 3,Kickr V5,338,349,-11
124738,39754,2021-03-05 19:04:42,wahoo,Zwift - Zwift Racing League | WTRL Division Championships - Men&#039;s Points Race (A),Stages RH Gen 3,Kickr V5,322,336,-14
128315,40174,2021-03-14 09:00:36,wahoo,Zwift - Amersham RCC Winter Events (D),Stages,Kickr Core,267,292,-25
129503,40174,2021-03-16 19:29:01,wahoo,Zwift - British Cycling Race Series (A),Stages,Kickr Core,274,299,-25
19811,40913,2020-03-26 17:05:00,neo,Garmin Vector 2 to Edge 1030 / Tacx Neo to Fenix 3,Garmin Vector 2 to Edge 1030,Tacx Neo to Fenix 3,380,357,23
28790,40913,2020-04-28 16:26:09,neo,Zwift - ZHR Masters (B),Garmin Vector 2 to Zwift,Tacx Neo to Fenix 3,363,356,7
32121,40913,2020-05-06 16:52:30,neo,Zwift - Swedish Zwift Racing Cup by SZR (A),Garmin Vector 2 to Zwift,Tacx Neo to Fenix 3,375,360,15
47337,40913,2020-07-22 14:58:54,neo,Zwift - Virtual Tour de France - Open - Stage 5 Discovery Ride,Garmin Vector 2 to Edge 1030,Tacx Neo to Fenix 3,380,372,8
77387,40913,2020-11-29 14:57:42,neo,bePRO to EDGE 1030 / Tacx Neo to EDGE 820,bePRO to EDGE 1030,Tacx Neo to EDGE 820,352,340,12
88221,40913,2020-12-27 08:29:08,neo,Garmin Vector 2 to Edge 1030 / Tacx Neo to Edge 530,Garmin Vector 2 to Edge 1030,Tacx Neo to Edge 530,327,320,7
95859,40913,2021-01-12 17:41:40,neo,bePRO to EDGE 1030 / Tacx Neo to Edge 530,bePRO to EDGE 1030,Tacx Neo to Edge 530,367,350,17
101007,40913,2021-01-21 12:59:56,neo,Assioma to Edge 1030 / Tacx Neo to EDGE 820,Assioma to Edge 1030,Tacx Neo to EDGE 820,356,344,12
103709,40913,2021-01-26 17:36:26,neo,bePRO to EDGE 1030 / Tacx Neo to Fenix 3,bePRO to EDGE 1030,Tacx Neo to Fenix 3,373,364,9
35192,41408,2020-05-16 05:23:02,wahoo,Zwift - XRS Races - The Saturday Classic (A),Power2Max NG,Wahoo Kickr,386,389,-3
35540,41408,2020-05-17 07:54:26,wahoo,Zwift - 3R & Cannondale Super Six Series - Race 3 (A),Power2Max NG,Wahoo Kickr,377,353,24
37298,41408,2020-05-24 07:56:37,wahoo,Zwift - 3R & Cannondale Super Six Series - Race 4 (A),Power2Max NG,Wahoo Kickr,389,393,-4
38247,41408,2020-05-28 09:14:48,wahoo,Zwift - Cycling Australia&#039;s The Chop by AHDR (A),Power2Max NG,Wahoo Kickr,389,398,-9
38609,41408,2020-05-29 22:04:55,wahoo,Zwift - NRS Invitational - Week 3 (B),Power2Max NG,Wahoo Kickr,399,406,-7
38790,41408,2020-05-31 08:01:25,wahoo,Zwift - 3R & Cannondale Super Six Series - Race 5 (A),Power2Max NG,Wahoo Kickr,342,371,-29
41588,41408,2020-06-14 07:58:24,wahoo,Zwift - 3R & Cannondale Super Six Series - Make Up Series Race (A),Power2Max NG,Wahoo Kickr,367,373,-6
42370,41408,2020-06-18 08:14:58,wahoo,Zwift - Cycling Australia&#039;s The Chop by AHDR (A),Power2Max NG,Wahoo Kickr,363,388,-25
43350,41408,2020-06-24 09:07:27,wahoo,Zwift - USA Cycling Race League by Indoor Specialist (A),Power2Max NG,Wahoo Kickr,430,444,-14
43746,41408,2020-06-26 22:55:28,wahoo,Zwift - NRS Invitational - Week 5: Men Only,Power2Max NG,Wahoo Kickr,425,427,-2
45552,41408,2020-07-09 09:12:15,wahoo,Zwift - The Lamb Chop p/b Black Sheep (A),Power2Max NG,Wahoo Kickr,385,395,-10
47408,41408,2020-07-23 09:12:51,wahoo,Zwift - The Lamb Chop p/b Black Sheep (A),Power2Max NG,Wahoo Kickr,368,385,-17
48122,41408,2020-07-29 08:59:47,wahoo,Zwift - USA Cycling Race League by Indoor Specialist (A),Power2Max NG,Wahoo Kickr,337,352,-15
48270,41408,2020-07-30 09:01:47,wahoo,Zwift - The Lamb Chop p/b Black Sheep (A),Power2Max NG,Wahoo Kickr,389,393,-4
49016,41408,2020-08-06 08:57:57,wahoo,Zwift - The Lamb Chop p/b Black Sheep (A),Power2Max NG,Wahoo Kickr,376,392,-16
49958,41408,2020-08-14 08:35:06,wahoo,Zwift - Off the MAAP Invitational Race // Stage 1 (Men) (A),Power2Max NG,Wahoo Kickr,400,385,15
50373,41408,2020-08-17 09:15:10,wahoo,Zwift - Off the MAAP Invitational Race // Stage 2 (Men) (A),Power2Max NG,Wahoo Kickr,403,396,7
50851,41408,2020-08-20 08:23:03,wahoo,Zwift - Off the MAAP Invitational Race // Stage 3 (men) ,Power2Max NG,Wahoo Kickr,379,372,7
51487,41408,2020-08-24 09:05:23,wahoo,Zwift - Off the MAAP Invitational Race // Stage 4 (men) ,Power2Max NG,Wahoo Kickr,386,390,-4
55037,41408,2020-09-14 17:34:45,wahoo,Zwift - Invitational League // Qualifying Race #1,Power2Max NG,Wahoo Kickr,385,373,12
55924,41408,2020-09-17 18:04:02,wahoo,Zwift - Invitational League // Qualifying Race #2 (Men) ,Power2Max NG,Wahoo Kickr,356,361,-5
91020,41408,2021-01-03 22:22:14,wahoo,Zwift Verification - Three Sisters Test,InfoCrank,Wahoo Kickr,387,364,23
94995,41408,2021-01-11 18:58:16,wahoo,Zwift - Premier Division // Zwift Racing League (men) (A),InfoCrank,Wahoo Kickr,331,326,5
102943,41408,2021-01-25 18:41:58,wahoo,Zwift - Premier Division // Zwift Racing League (men) (A),InfoCrank,Wahoo Kickr,357,353,4
82649,41562,2020-12-13 08:59:57,wahoo,Zwift - BRT Breakfast Club (B),Garmin Pedals,Wahoo kickr,266,265,1
82651,41562,2020-12-08 18:19:59,wahoo,Zwift - Zwift Racing League | WTRL - Men&#039;s EMEA E2 DIVISION 1 (B),Garmin Pedals,Wahoo kickr,358,369,-11
83234,41562,2020-12-14 17:09:23,wahoo,Taper 4 x 90secs,Garmin Pedals,Wahoo kickr,272,257,15
86912,41562,2020-12-23 18:45:50,wahoo,Zwift - BC South Christmas LIZR Series - the iTT (OPEN),Garmin Pedals,Wahoo kickr,319,329,-10
86913,41562,2020-12-21 18:45:09,wahoo,Zwift - BC South Christmas LIZR Series - the crit (OPEN),Garmin Pedals,Wahoo kickr,342,349,-7
93910,41562,2021-01-09 09:00:01,wahoo,Zwift - David Stoyle (Bath CC)&#039;s Meetup - Big Foot Hills,Garmin Pedals,Wahoo kickr,336,331,5
93914,41562,2021-01-07 18:27:19,wahoo,Zwift - Tanfield - Session,Garmin Pedals,Wahoo kickr,326,323,3
93917,41562,2021-01-05 10:00:01,wahoo,Zwift - Charlie Shields&#039;s Meetup - Petit Boucle,Garmin Pedals,Wahoo kickr,312,312,0
94966,41562,2021-01-11 18:38:52,wahoo,Zwift - Recovery spin on rollers or turbo,Garmin Pedals 2,Wahoo kickr,224,224,0
11184,41990,2020-01-27 18:16:49,neo,Zwift - DBR Caresport Crit Cup  (C),Quarg dZero,Neo,241,230,11
11549,41990,2020-01-29 19:07:55,neo,Zwift - DBR Wednesday Race (C),Quarg dZero,Neo,247,235,12
11738,41990,2020-01-30 19:01:47,neo,KALAS Cup - Round 1,Quarg dZero,Neo,236,232,4
12606,41990,2020-02-05 19:08:16,neo,DBR Wednesday Race,Quarg dZero,Neo,251,246,5
12812,41990,2020-02-06 19:02:21,neo,Zwift - KALAS Cup - Round 2 (C),Quarg dZero,Neo,227,216,11
15783,41990,2020-02-26 19:07:48,neo,DBR Winter Cup,Quarg dZero,Neo,243,240,3
16483,41990,2020-03-02 18:16:50,neo,DBR Winter Cup,Quarg dZero,Neo,244,242,2
18461,41990,2020-03-17 19:16:52,neo,Feltet.dk Race Series,Quarg dZero,Neo,241,249,-8
77122,41990,2020-11-28 19:10:56,wahoo,Zwift - TBR Pancake Chase Race! (B),Quarg dZero,Kickr V5,237,230,7
104799,41990,2021-01-28 18:30:51,wahoo,Zwift - FUSION WINTER CUP (B),Quarg dZero,Kickr V5,237,228,9
862,42327,2019-08-27 16:41:30,neo,Zwift - FUSION ECT Racing League (A),Garmin Vector 3,Tacx NEO,372,375,-3
1216,42327,2019-09-03 18:09:09,neo,Zwift - FUSION ECT Racing League (A),Garmin Vector 3,Tacx NEO,341,336,5
1717,42327,2019-09-12 17:48:37,neo,Zwift - FUSION ECT BEUNSTOPPABLE Racing Series (A),Garmin Vector 3,Tacx NEO,338,328,10
5916,42327,2019-12-10 17:59:04,neo,Zwift - Danmarks Cykle Union Racing League (A),Garmin Vector 3,Tacx NEO,377,376,1
6748,42327,2019-12-19 18:09:12,neo,Zwift - FUSION ECT BEUNSTOPPABLE Racing Series (A),Garmin Vector 3,Tacx NEO,333,313,20
14558,42327,2020-02-18 18:48:06,neo,Zwift - Feltet.dk Race Series,Garmin Vector 3,Tacx NEO,359,356,3
15600,42327,2020-02-25 18:49:16,neo,Feltet.dk Race Series,Garmin Vector 3,Tacx NEO,358,343,15
15966,42327,2020-02-27 19:24:29,neo,Zwift - WTRL Team Time Trial (C),Garmin Vector 3,Tacx NEO,353,343,10
16098,42327,2020-02-29 07:14:44,neo,Zwift - 3R Tempus Fugit Flat Race - 1 Lap (19.8km/12.3mi 20m) (A),Garmin Vector 3,Tacx NEO,341,331,10
16229,42327,2020-03-01 06:44:59,neo,Zwift - No Pain No Gain Endurance Racing Series (A),Garmin Vector 3,Tacx NEO,305,293,12
17502,42327,2020-03-10 18:16:57,neo,Zwift - WKG - CRITTY CRITTY BANG BANG (A),Garmin Vector 3,Tacx NEO,334,323,11
21514,42327,2020-04-02 18:32:22,neo,Zwift - WTRL Team Time Trial (C),Garmin Vector 3,Tacx NEO,370,359,11
33238,42327,2020-05-10 09:53:26,neo,Zwift - 3R Sand & Sequoias - 1 Lap (20km/12.5mi 173m) (A),Garmin Vector 3,Tacx NEO,359,352,7
34054,42327,2020-05-12 17:35:40,neo,Zwift - UNO X CUP powered by DCU & Feltet.dk (A),Garmin Vector 3,Tacx NEO,367,343,24
35094,42327,2020-05-15 16:56:35,neo,Zwift - 3R Classique Flat Race - 5 Laps (A),Garmin Vector 3,Tacx NEO,322,320,2
54166,42327,2020-09-09 17:40:58,neo,Zwift - 6Points Mallorca GGCC Race (A),Garmin Vector 3,Tacx NEO,360,354,6
54420,42327,2020-09-10 17:27:26,neo,FUSION ECT BEUNSTOPPABLE Racing Series,Garmin Vector 3,Tacx NEO,341,333,8
57281,42327,2020-09-24 17:29:20,neo,Zwift - FUSION ECT BEUNSTOPPABLE Racing Series (A),Garmin Vector 3,Tacx NEO,356,348,8
58561,42327,2020-09-30 17:43:59,neo,Zwift - DCU powered by Feltet.dk (A),Garmin Vector 3,Tacx NEO,371,367,4
59845,42327,2020-10-06 17:51:28,neo,Zwift - Team Italy & Frenchy Fuzion League (B),Garmin Vector 3,Tacx NEO,361,352,9
60926,42327,2020-10-11 08:02:36,neo,Zwift - 3R & Cannondale Super Six Series - Make Up Series Race (A),Garmin Vector 3,Tacx NEO,324,306,18
61095,42327,2020-10-12 07:02:24,neo,Zwift - 3R Watopia Flat Route Race - 3 Laps (30.3km/18.8mi 162m) (A),Garmin Vector 3,Tacx NEO,336,333,3
62400,42327,2020-10-16 11:11:47,neo,Zwift - 3R LaGuardia Loop Reverse Flat Race - 8 Laps (24.5km/15.2mi 216m) (A),Garmin Vector 3,Tacx NEO,349,356,-7
63448,42327,2020-10-20 17:52:08,neo,Zwift - Team Italy & Frenchy Fuzion League (A),Garmin Vector 3,Tacx NEO,340,346,-6
64196,42327,2020-10-22 17:53:57,neo,Zwift - Team Italy Superveloce Race (A),Garmin Vector 3,Tacx NEO,343,337,6
64783,42327,2020-10-25 07:33:48,neo,Zwift - ZHR Masters Weekender (A),Garmin Vector 3,Tacx NEO,323,316,7
65486,42327,2020-10-27 18:53:45,neo,Zwift - Team Italy & Frenchy Fuzion League (A),Garmin Vector 3,Tacx NEO,351,342,9
66202,42327,2020-10-29 18:24:54,neo,Zwift - FUSION ECT BEUNSTOPPABLE Racing Series (B),Garmin Vector 3,Tacx NEO,376,373,3
66451,42327,2020-10-30 15:10:23,neo,Zwift - 3R Sand and Sequoias Race (B),Garmin Vector 3,Tacx NEO,345,343,2
67920,42327,2020-11-04 18:55:38,neo,Zwift - DCU – Feltet.dk November series,Garmin Vector 3,Tacx NEO,372,373,-1
68216,42327,2020-11-05 18:24:09,neo,Zwift - ZHR Up & Down Race (A),Garmin Vector 3,Tacx NEO,366,360,6
68970,42327,2020-11-08 08:10:06,neo,Zwift - Team Italy & Frenchy Fuzion Endurance Race (A),Garmin Vector 3,Tacx NEO,329,320,9
70272,42327,2020-11-11 18:29:20,neo,Zwift - 3R Race - France Petit Boucle - 45KM (A),Garmin Vector 3,Tacx NEO,369,374,-5
70772,42327,2020-11-12 19:01:36,neo,Zwift - Espresso,Garmin Vector 3,Tacx NEO,342,341,1
71567,42327,2020-11-15 08:17:43,neo,Zwift - Team Italy & Frenchy Fuzion Endurance Race (A),Garmin Vector 3,Tacx NEO,343,356,-13
72207,42327,2020-11-17 17:26:38,neo,Zwift - ZHR Masters Europe (A),Garmin Vector 3,Tacx NEO,349,346,3
74209,42327,2020-11-22 13:41:47,neo,Zwift - La Bicicletta Toronto & Toronto Hustle Donut Race (A),Garmin Vector 3,Tacx NEO,371,379,-8
74211,42327,2020-11-22 14:29:46,neo,Zwift - Herd Beginner Racing Series (E),Garmin Vector 3,Tacx NEO,337,329,8
74618,42327,2020-11-23 18:33:32,neo,Zwift - XRS Races: Monday&#039;s blues (A),Garmin Vector 3,Tacx NEO,319,314,5
75044,42327,2020-11-24 18:32:57,neo,Zwift - Team Sportslab UK Road Race League (A),Garmin Vector 3,Tacx NEO,351,341,10
76503,42327,2020-11-27 14:58:39,neo,Zwift - Focus: Colours of PARI - Shorter Ride,Garmin Vector 3,Tacx NEO,341,338,3
76934,42327,2020-11-28 13:14:31,neo,Zwift - Team ODZ RACE (A),Garmin Vector 3,Tacx NEO,325,321,4
77398,42327,2020-11-29 08:01:34,neo,Zwift - 3R Volcano Circuit - 6 Laps (A),Garmin Vector 3,Tacx NEO,358,348,10
78082,42327,2020-12-01 18:30:34,neo,Zwift - Team Sportslab UK Road Race League (A),Garmin Vector 3,Tacx NEO,336,335,1
79010,42327,2020-12-03 18:59:01,neo,Zwift - Team KST ,Garmin Vector 3,Tacx NEO,333,327,6
79417,42327,2020-12-04 15:13:57,neo,Zwift - 3R Sand and Sequoias Race (A),Garmin Vector 3,Tacx NEO,359,357,2
79602,42327,2020-12-05 08:04:21,neo,Zwift - 3R Weekend Race Club - Race 1 (A),Garmin Vector 3,Tacx NEO,328,325,3
80528,42327,2020-12-07 18:58:07,neo,Zwift - EVR Europe Race (A),Garmin Vector 3,Tacx NEO,349,342,7
80847,42327,2020-12-08 18:39:15,neo,Zwift - 3R iTT Race (A),Garmin Vector 3,Tacx NEO,347,349,-2
81543,42327,2020-12-10 14:38:56,neo,Zwift - Team Italy Specialissima Race (A),Garmin Vector 3,Tacx NEO,324,338,-14
81982,42327,2020-12-11 16:43:53,neo,Zwift - Crit City Race (A),Garmin Vector 3,Tacx NEO,351,348,3
82366,42327,2020-12-12 12:58:22,neo,Zwift - 111 - Strongman racing series (B),Garmin Vector 3,Tacx NEO,356,356,0
83565,42327,2020-12-15 18:34:28,neo,Zwift - Team Sportslab UK Road Race League (A),Garmin Vector 3,Tacx NEO,324,319,5
84436,42327,2020-12-17 18:28:54,neo,Zwift - FUSION DECEMBER CUP (A),Garmin Vector 3,Tacx NEO,349,347,2
85813,42327,2020-12-21 18:12:28,neo,Zwift -  DBR Monday Race (A),Garmin Vector 3,Tacx NEO,356,355,1
86198,42327,2020-12-22 18:29:06,neo,Zwift - 6DQTE - Race 3 (A),Garmin Vector 3,Tacx NEO,402,398,4
87215,42327,2020-12-25 15:14:19,neo,Zwift - 3R Sand and Sequoias Race (A),Garmin Vector 3,Tacx NEO,354,351,3
88910,42327,2020-12-30 09:03:33,neo,Zwift - 3R Watopia Flat Route Race - 3 Laps (30.3km/18.8mi 162m) (A),Garmin Vector 3,Tacx NEO,367,361,6
90117,42327,2021-01-02 09:25:33,neo,Zwift - DBR SufferDay League III (A),Garmin Vector 3,Tacx NEO,385,379,6
90678,42327,2021-01-03 13:04:14,neo,Zwift - 3R Watopia Flat Route Race - 4 Laps (40.5km/25.1mi 216m) (A),Garmin Vector 3,Tacx NEO,339,333,6
91855,42327,2021-01-05 18:52:25,neo,Zwift - Team Italy & Frenchy Fuzion League (A),Garmin Vector 3,Tacx NEO,371,364,7
92334,42327,2021-01-06 17:59:14,neo,Zwift - MIDWEEK Winter Series by SZR (A),Garmin Vector 3,Tacx NEO,348,343,5
93681,42327,2021-01-09 09:04:24,neo,Zwift - 3R Weekend Race Club - Race 2 (A),Garmin Vector 3,Tacx NEO,307,300,7
93683,42327,2021-01-09 08:04:17,neo,Zwift - 3R Weekend Race Club - Race 1 (A),Garmin Vector 3,Tacx NEO,314,309,5
94280,42327,2021-01-10 09:04:04,neo,Zwift - Newbury Velo Road Race (A),Garmin Vector 3,Tacx NEO,338,352,-14
95690,42327,2021-01-12 18:27:22,neo,Zwift - Zwift Racing League | WTRL - Men&#039;s/Mixed EMEA E2 DIVISION 6 (A),Garmin Vector 3,Tacx NEO,349,343,6
96384,42327,2021-01-13 17:58:42,neo,Zwift - Frenchy Fuzion Criterium League (A),Garmin Vector 3,Tacx NEO,330,330,0
96939,42327,2021-01-14 17:59:12,neo,Zwift - Renegade Race (A),Garmin Vector 3,Tacx NEO,343,338,5
97972,42327,2021-01-16 13:13:30,neo,Zwift - Team ODZ RACE (A),Garmin Vector 3,Tacx NEO,320,314,6
98596,42327,2021-01-17 14:13:29,neo,Zwift - KISS 100 Race Series - Americas (A),Garmin Vector 3,Tacx NEO,356,352,4
99692,42327,2021-01-19 18:35:02,neo,Zwift - Zwift Racing League | WTRL - Men&#039;s/Mixed EMEA E2 DIVISION 6 (A),Garmin Vector 3,Tacx NEO,353,352,1
100338,42327,2021-01-20 18:43:57,neo,Zwift - Danmarks Cykle Union & Partners 2/6 (A),Garmin Vector 3,Tacx NEO,378,377,1
100867,42327,2021-01-21 17:28:59,neo,Zwift - ZHQ FutureWorks Circuit Race - Anti-sandbagging (A),Garmin Vector 3,Tacx NEO,367,363,4
101732,42327,2021-01-23 09:28:33,neo,Zwift - DBR SufferDay League III (A),Garmin Vector 3,Tacx NEO,339,338,1
102318,42327,2021-01-24 11:54:38,neo,Zwift - 01/24/2021,Garmin Vector 3,Tacx NEO,328,324,4
102354,42327,2021-01-24 11:54:38,neo,Zwift - Peel Cycling - Sunday Chase (A),Garmin Vector 3,Tacx NEO,328,324,4
102365,42327,2021-01-24 13:04:34,neo,Zwift - 3R Watopia Flat Route Race - 4 Laps (40.5km/25.1mi 216m) (A),Garmin Vector 3,Tacx NEO,346,337,9
103512,42327,2021-01-26 18:28:27,neo,Zwift - Zwift Racing League | WTRL - Men&#039;s/Mixed EMEA E2 DIVISION 6 (A),Garmin Vector 3,Tacx NEO,377,369,8
104752,42327,2021-01-28 18:29:23,neo,Zwift - FUSION WINTER CUP (A),Garmin Vector 3,Tacx NEO,367,363,4
105467,42327,2021-01-30 09:29:33,neo,Zwift - DBR SufferDay League III (A),Garmin Vector 3,Tacx NEO,359,361,-2
106055,42327,2021-01-31 08:19:24,neo,Zwift - Team Italy & Frenchy Fuzion Endurance Race (A),Garmin Vector 3,Tacx NEO,346,355,-9
107410,42327,2021-02-02 18:28:29,neo,Zwift - Zwift Racing League | WTRL - Men&#039;s/Mixed EMEA E2 DIVISION 6 (A),Garmin Vector 3,Tacx NEO,363,365,-2
108960,42327,2021-02-04 18:29:47,neo,Zwift - FUSION WINTER CUP (A),Garmin Vector 3,Tacx NEO,374,370,4
109368,42327,2021-02-05 15:29:42,neo,Zwift - DBR Friday Race (A),Garmin Vector 3,Tacx NEO,342,337,5
109832,42327,2021-02-06 12:44:34,neo,Zwift - WTRL Racing (A),Garmin Vector 3,Tacx NEO,357,350,7
110315,42327,2021-02-07 08:29:34,neo,Zwift - Flanders Endurance Race League (A),Garmin Vector 3,Tacx NEO,375,372,3
111579,42327,2021-02-09 18:36:32,neo,Zwift - Zwift Racing League | WTRL - Men&#039;s/Mixed EMEA E2 DIVISION 6 (A),Garmin Vector 3,Tacx NEO,387,385,2
112272,42327,2021-02-10 18:44:42,neo,Zwift - GCA Cup (A),Garmin Vector 3,Tacx NEO,365,361,4
113034,42327,2021-02-11 18:29:33,neo,FUSION WINTER CUP,Garmin Vector 3,Tacx NEO,345,340,5
114228,42327,2021-02-13 09:29:31,neo,Zwift - DBR SufferDay League III (A),Garmin Vector 3,Tacx NEO,334,326,8
114861,42327,2021-02-14 18:39:48,neo,Zwift - XRS Races Crit (A),Garmin Vector 3,Tacx NEO,347,338,9
115920,42327,2021-02-16 18:28:22,neo,Zwift - Zwift Racing League | WTRL - Men&#039;s/Mixed EMEA E2 DIVISION 6 (A),Garmin Vector 3,Tacx NEO,402,390,12
116618,42327,2021-02-17 17:59:35,neo,Zwift - MIDWEEK Winter Series by SZR (A),Garmin Vector 3,Tacx NEO,343,343,0
118085,42327,2021-02-20 09:05:46,neo,Zwift - 3R Endurance Series p/b OTE Sports- Stage 1 (A),Garmin Vector 3,Tacx NEO,332,331,1
119678,42327,2021-02-23 18:34:31,neo,Zwift - Team Sportslab UK Road Race League (A),Garmin Vector 3,Tacx NEO,323,323,0
120360,42327,2021-02-24 18:44:45,neo,Zwift - Scandinavian Cup 2021 - Round 1 - Men (A),Garmin Vector 3,Tacx NEO,335,357,-22
122983,42327,2021-03-02 18:34:31,neo,Zwift - Zwift Racing League | WTRL - Men&#039;s/Mixed EMEA E2 DIVISION 6 (A),Garmin Vector 3,Tacx NEO,378,374,4
124098,42327,2021-03-04 18:29:28,neo,FUSION SPRING CUP,Garmin Vector 3,Tacx NEO,326,313,13
126213,42327,2021-03-09 18:58:51,neo,Zwift - 3R Omnium Event - Race 1 - Scatch Race (A),Garmin Vector 3,Tacx NEO,359,359,0
126637,42327,2021-03-10 18:43:52,neo,Zwift - Scandinavian Cup 2021 - Round 3 - Men (A),Garmin Vector 3,Tacx NEO,349,349,0
127105,42327,2021-03-11 18:58:57,neo,Zwift - Team KST ,Garmin Vector 3,Tacx NEO,337,338,-1
129172,42327,2021-03-16 18:28:28,neo,Zwift - CeramicSpeed Race Series: Open Race (A),Garmin Vector 3,Tacx NEO,358,371,-13
31172,42820,2020-04-30 10:56:24,neo,Zwift - 3R Classique Flat Race - 4 Laps (26.9km/16.7mi 76m) (A),Power2max,Tacx Neo,366,361,5
31176,42820,2020-04-28 11:13:04,neo,Zwift - Crit City Slam Race // Zwift Classic (A),Power2max,Tacx Neo,356,344,12
31177,42820,2020-04-25 07:30:08,neo,Zwift - EVR Asia Weekend (A),Power2max,Tacx Neo,373,372,1
31180,42820,2020-04-22 10:31:21,neo,Zwift - Peak-PTY Midweek TT Climb Challenge,Power2max,Tacx Neo,382,385,-3
31181,42820,2020-04-17 09:14:56,neo,Zwift - TBR Burrito Race (A),Power2max,Tacx Neo,352,354,-2
31183,42820,2020-03-29 15:20:32,neo,Zwift - 3R Watopia 65km Race - 6 laps (40mi 324m) (B),Powertap p1 pedalen,Tacx Neo Maarten,377,363,14
32137,42820,2020-05-06 17:34:03,neo,Zwift - Zwift NL League - Woensdagavond Competitie (A),Power2max,Tacx Neo,394,383,11
34434,42820,2020-05-13 17:22:56,neo,Zwift - Zwift NL League - Woensdagavond Competitie (A),Power2max,Tacx Neo,365,381,-16
72869,42820,2020-11-19 08:52:07,neo,Zwift - Garmin Never Stop Cycling // Stage 4 MTB - Open Category,4i,Tacx Neo,342,355,-13
85767,42820,2020-12-21 13:16:47,neo,Zwift - ZHQ FutureWorks Circuit Race - Anti-sandbagging (A),4i,Tacx Neo,355,339,16
99444,42820,2021-01-12 08:36:22,neo,Neo / Zwift-4i,Zwift-4i,Neo,319,336,-17
111472,42820,2021-02-09 14:04:36,neo,Zwift - DBR Tuesday Race (A),4i,Tacx Neo,379,374,5
129586,42854,2021-03-16 18:26:12,neo,Zwift - CeramicSpeed Race Series: Open Race (A),Stages,tacx neo,427,394,33
90194,43157,2021-01-02 09:21:53,wahoo,Zwift - DBR SufferDay League III (A),Zwift/Rotor 2inPower,Kickr&#039;17/Ant (uncalibrated),423,410,13
95767,43157,2021-01-12 18:12:14,wahoo,Zwift - race,Rotor/Ant,"Kickr/Ant (uncalibrated, with drops)",372,360,12
99892,43157,2021-01-19 18:10:13,wahoo,Zwift - TTT,Rotor 2inPower/ANT,Kickr&#039;17/ANT (uncalibrated + drops),372,344,28
50945,43160,2020-08-20 17:24:44,wahoo,Zwift -  Frappe,Garmin Vector,Wahoo Kickr 2016,353,337,16
52208,43160,2020-08-27 17:37:38,wahoo,Zwift - WTRL Team Time Trial (C),Garmin Vector,Wahoo Kickr 2016,371,367,4
53949,43160,2020-09-08 15:04:45,wahoo,Zwift - 3R Sundown Race Series  (A),Garmin Vector,Wahoo Kickr 2016,357,357,0
54464,43160,2020-09-10 17:35:32,wahoo,Zwift - Espresso,Garmin Vector,Wahoo Kickr 2016,366,363,3
57642,43160,2020-09-26 07:57:35,wahoo,ZADA 3 Sisters,Garmin Vector,Wahoo Kickr 2016,378,375,3
59170,43160,2020-10-03 07:04:55,wahoo,Zwift - 3R Flat Race (A),Garmin Vector,Wahoo Kickr 2016,363,365,-2
66341,43160,2020-10-29 19:49:29,wahoo,Zwift - WTRL Team Time Trial - Zone 6 (B),Garmin Vector,Wahoo Kickr 2016,344,342,2
68588,43160,2020-11-06 19:05:16,wahoo,Zwift -  Tour De Spartacus  (A),Garmin Vector,Wahoo Kickr 2016,375,359,16
68872,43160,2020-11-07 19:04:46,wahoo,Zwift - 3R Innsbruckring Sprint Race - 1 Lap (8.8km/5.5mi 77m) (A),Garmin Vector,Wahoo Kickr 2016,365,357,8
69470,43160,2020-11-09 19:59:03,wahoo,Zwift - Premier Division // Zwift Racing League (men) (A),Garmin Vector,Wahoo Kickr 2016,379,379,0
76239,43160,2020-11-26 19:01:32,wahoo,Zwift - WTRL NOPINZ WORLD TTT CHAMPIONSHIPS - Zone 7 (D),Garmin Vector,Wahoo Kickr 2016,350,342,8
77682,43160,2020-11-30 19:09:31,wahoo,Zwift - Premier Division // Zwift Racing League (men) (A),Garmin Vector,Wahoo Kickr 2016,364,361,3
98430,43160,2021-01-17 07:59:56,wahoo,Zwift - TDZ Stage 3: Longer Ride,Garmin Vector,Wahoo Kickr Core,334,339,-5
100648,43160,2021-01-21 06:59:28,wahoo,Zwift - TDZ Stage 4: Longer Ride,Power2Max,Wahoo Kickr Core,323,327,-4
102000,43160,2021-01-23 16:29:09,wahoo,Zwift - TEAM VEGAN Tofu Tornado (A),Power2Max,Wahoo Kickr Core,390,394,-4
102309,43160,2021-01-24 08:29:56,wahoo,Zwift - Steven Brierley [nopinzR3R]&#039;s Meetup - Quatch Quest,Power2Max,Wahoo Kickr Core,336,333,3
104100,43160,2021-01-27 17:30:12,wahoo,Zwift - ZHQ FutureWorks Circuit Race - Anti-sandbagging (A),Power2Max,Wahoo Kickr Core,341,352,-11
114691,43160,2021-02-14 09:17:18,wahoo,Zwift - TDZ Stage 6: Standard Ride,Garmin Vector,Wahoo Kickr Core,320,326,-6
117657,43160,2021-02-19 10:28:21,wahoo,Zwift - ZADA Three Sisters,Garmin Vector,Wahoo Kickr Core,375,381,-6
118102,43160,2021-02-20 08:54:51,wahoo,Zwift - 3R Endurance Series p/b OTE Sports- Stage 1 (E),Garmin Vector,Wahoo Kickr Core,339,350,-11
119114,43160,2021-02-22 19:08:48,wahoo,Zwift - Premier Division // Zwift Racing League (men) (A),Garmin Vector,Wahoo Kickr Core,349,361,-12
70597,43225,2020-11-12 08:31:09,wahoo,Zwift - ZHQ FutureWorks Circuit Race - Anti-sandbagging (B),P1,Kickr,307,307,0
117398,43962,2021-02-18 18:29:44,neo,Zwift - FUSION WINTER CUP (A),Garmin Vector 3s,Tacx Neo,283,274,9
122225,43962,2021-02-28 17:59:59,neo,Zwift - Haute Route Watopia 2021 Stage 3 (A),Garmin Vector 3s,Tacx Neo,292,287,5
56478,44022,2020-09-20 10:59:55,wahoo,Zwift - USA Cycling Xtra Long Ride by DIRT (C),5565375263[1],Kickr,237,249,-12
59098,44022,2020-10-01 18:22:50,wahoo,Zwift - Frappe,Vector,Kickr,309,309,0
77115,44022,2020-11-28 16:49:44,wahoo,Zwift - Focus: Colours of PARI - Longer Ride,5886512451_ACTIVITY[1],Kickr,295,283,12
87559,44022,2020-12-26 11:56:57,wahoo,Zwift - DIRT Dadurday Chase Race  (A),Garmin Vector,Kickr,333,327,6
116015,44022,2021-02-16 18:56:52,wahoo,Zwift - Power Climbs MR,Garmin Vector,Kickr,313,311,2
118041,44022,2021-02-19 18:23:41,wahoo,Zwift - Flanders Cycling Happening (C),Garmin Vector,Kickr,291,295,-4
119774,44022,2021-02-23 17:47:54,wahoo,Zwift - Zwift Racing League | WTRL - Men&#039;s/Mixed EMEA E1 DIVISION 3 (A),Garmin Vector,Kickr,352,334,18
121014,44022,2021-02-25 17:46:01,wahoo,Zwift - Frappe,Garmin Vector,Kickr,333,336,-3
121413,44022,2021-02-26 16:48:51,wahoo,Zwift - Haute Route Watopia 2021 Stage 1 (A),Garmin Vector,Kickr,341,342,-1
127181,44022,2021-03-11 17:51:54,wahoo,Zwift - Frappe,Kickr,Kickr,344,337,7
127183,44022,2021-03-11 17:51:54,wahoo,Zwift - Frappe,Garmin Vector,Kickr,344,337,7
25126,44125,2020-04-16 09:45:13,neo,Zwift - Koa Sports League Race (A),ZWIFT Team Zwatt Zimanox,Elemnt Bolt Tacx Neo 1 (2018),365,370,-5
25212,44125,2020-04-16 15:14:59,neo,Zwift - OH CRIT!! - The Double Race - Race 1/2 (A),ZWIFT Team Zwatt Zimanox,Elemnt Bolt Tacx Neo 1 (2018),370,370,0
25214,44125,2020-04-16 16:05:23,neo,Zwift - OH CRIT!! - The Double Race - Race 2/2 (A),Elemnt Bolt Team Zwatt Zimanox ,ZWIFT Tacx Neo 1 (2018),329,337,-8
26488,44125,2020-04-20 17:15:08,neo,Zwift - DBR Wahoo League (A),Elemnt Bolt Team Zwatt Zimanox ,ZWIFT Tacx Neo 1 (2018),381,398,-17
26704,44125,2020-04-21 17:54:58,neo,Zwift - Team Italy & Frenchy Fuzion League (A),Elemnt Bolt Team Zwatt Zimanox ,ZWIFT Tacx Neo 1 (2018),386,374,12
29447,44125,2020-04-30 09:44:59,neo,Zwift - Koa Sports League Race (A),Elemnt Bolt Team Zwatt Zimanox ,ZWIFT Tacx Neo 1 (2018),375,372,3
30535,44125,2020-05-02 12:34:27,neo,Zwift - Team ODZ RACE (A),Elemnt Bolt Team Zwatt Zimanox ,ZWIFT Tacx Neo 1 (2018),369,360,9
30811,44125,2020-05-03 07:19:50,neo,Zwift - Team Italy & Frenchy Fuzion Endurance Race (A),Elemnt Bolt Team Zwatt Zimanox ,ZWIFT Tacx Neo 1 (2018),373,366,7
32310,44125,2020-05-07 09:45:14,neo,Zwift - Koa Sports League Race (A),Elemnt Bolt Team Zwatt Zimanox ,ZWIFT Tacx Neo 1 (2018),349,369,-20
33685,44125,2020-05-11 17:14:39,neo,Zwift - DBR Wahoo League (A),Elemnt Bolt Team Zwatt Zimanox ,ZWIFT Tacx Neo 1 (2018),354,356,-2
75400,44125,2020-11-25 10:45:14,neo,Zwift - USA Cycling Race League by Indoor Specialist (A),ZWIFT Team Zwatt Zimanox,Elemnt Bolt Tacx Neo 1 (2018),350,347,3
75923,44125,2020-11-26 16:15:19,neo,Zwift - OH MY CRIT! - The Double Race 1/2 (A),Elemnt Bolt Team Zwatt Zimanox ,ZWIFT Tacx Neo 1 (2018),356,354,2
76984,44125,2020-11-28 15:15:22,neo,Zwift - OH MY CRIT - Saturday Smash Race (A),Elemnt Bolt Team Zwatt Zimanox ,ZWIFT Tacx Neo 1 (2018),333,338,-5
77341,44125,2020-11-29 14:59:55,neo,Zwift - Focus: Colours of PARI - Longer Ride,Elemnt Bolt Team Zwatt Zimanox ,ZWIFT Tacx Neo 1 (2018),346,345,1
77523,44125,2020-11-30 09:14:55,neo,Zwift - 3R Watopia Flat Route Race - 4 Laps (41km/25.5mi 216m) (A),Elemnt Bolt Team Zwatt Zimanox ,ZWIFT Tacx Neo 1 (2018),347,354,-7
78422,44125,2020-12-02 10:44:53,neo,Zwift - USA Cycling Race League by Indoor Specialist (A),Elemnt Bolt Team Zwatt Zimanox ,ZWIFT Tacx Neo 1 (2018),349,355,-6
78843,44125,2020-12-03 10:59:47,neo,Zwift - KISS Race Series - Americas AM (A),Elemnt Bolt Team Zwatt Zimanox ,ZWIFT Tacx Neo 1 (2018),327,344,-17
79263,44125,2020-12-04 09:04:42,neo,Zwift - 3R Whole Lotta Lava Hilly Race - 2 Laps (28.9km/12.53mi 336m) (A),Elemnt Bolt Team Zwatt Zimanox ,ZWIFT Tacx Neo 1 (2018),358,376,-18
79711,44125,2020-12-05 09:59:55,neo,Nations Challenge // France,Elemnt Bolt Team Zwatt Zimanox ,ZWIFT Tacx Neo 1 (2018),321,334,-13
80425,44125,2020-12-07 14:14:55,neo,Zwift - 3R Classique Reverse Flat Race - 5 Laps (32km/20.1mi 76m) (A),Elemnt Bolt Team Zwatt Zimanox ,ZWIFT Tacx Neo 1 (2018),341,341,0
80842,44125,2020-12-08 18:54:54,neo,Team Italy & Frenchy Fuzion League,Elemnt Bolt Team Zwatt Zimanox ,ZWIFT Tacx Neo 1 (2018),399,405,-6
81534,44125,2020-12-10 16:15:14,neo,Zwift - OH MY CRIT! - The Double Race 1/2 (A),ZWIFT Team Zwatt Zimanox,ZWIFT Tacx Neo 1 (2018),362,365,-3
81553,44125,2020-12-10 17:05:07,neo,Zwift - OH MY CRIT! - The Double Race 2/2 (A),Elemnt Bolt Team Zwatt Zimanox ,ZWIFT Tacx Neo 1 (2018),350,350,0
86485,44125,2020-12-23 14:00:23,neo,Zwift - KISS Race Series - Pacific AM (A),Elemnt Bolt Team Zwatt Zimanox ,ZWIFT Tacx Neo 1 (2018),379,383,-4
95441,44125,2021-01-12 10:59:46,neo,Zwift - KISS Race Series - Americas AM (A),Elemnt Bolt Team Zwatt Zimanox ,ZWIFT Tacx Neo 1 (2018),360,370,-10
96172,44125,2021-01-13 10:44:58,neo,Zwift - The Morning Grind by STPC (A),2021-01-13-104458-ELEMNT BOLT EE6B-120-0,ZWIFT Tacx Neo 1 (2018),345,348,-3
104216,44125,2021-01-27 17:59:54,neo,Zwift - MIDWEEK Winter Series by SZR (A),Elemnt Bolt Team Zwatt Zimanox ,ZWIFT Tacx Neo 1 (2018),352,352,0
107408,44125,2021-02-02 18:28:04,neo,Zwift - Zwift Racing League | WTRL - Men&#039;s/Mixed EMEA E2 DIVISION 5 (A),Elemnt Bolt Team Zwatt Zimanox ,ZWIFT Tacx Neo 1 (2018),371,376,-5
108280,44125,2021-02-03 17:59:51,neo,Zwift - LES ROUTES DE ZWIFT Frenchy Fuzion - Etape 1 (C),Elemnt Bolt Team Zwatt Zimanox ,ZWIFT Tacx Neo 1 (2018),363,368,-5
108898,44125,2021-02-04 18:00:00,neo,Zwift - LES ROUTES DE ZWIFT Frenchy Fuzion - Etape 2 (E),Elemnt Bolt Team Zwatt Zimanox ,ZWIFT Tacx Neo 1 (2018),377,383,-6
109425,44125,2021-02-05 17:59:55,neo,Zwift - LES ROUTES DE ZWIFT Frenchy Fuzion - Etape 3 (E),Elemnt Bolt Team Zwatt Zimanox ,ZWIFT Tacx Neo 1 (2018),375,381,-6
109694,44125,2021-02-06 10:05:58,neo,Zwift - LES ROUTES DE ZWIFT Frenchy Fuzion - Etape 4 (A),Elemnt Bolt Team Zwatt Zimanox ,ZWIFT Tacx Neo 1 (2018),387,375,12
110798,44125,2021-02-06 17:02:57,neo,Zwift - LES ROUTES DE ZWIFT Frenchy Fuzion - Etape 5 (E),Elemnt Bolt Team Zwatt Zimanox ,ZWIFT Tacx Neo 1 (2018),349,344,5
113339,44125,2021-02-12 08:35:05,neo,Zwift - TBR Burrito Race (A),Elemnt Bolt / Left Arm Zimanox PM,ZWIFT Tacx Neo 1 (2018),358,360,-2
115847,44125,2021-02-16 18:19:57,neo,Zwift - Zwift Racing League | WTRL - Men&#039;s/Mixed EMEA E1 DIVISION 6 (A),Elemnt Bolt / Left Arm Zimanox PM,ZWIFT Tacx Neo 1 (2018),371,380,-9
119576,44125,2021-02-23 18:28:04,neo,Zwift - Zwift Racing League | WTRL - Men&#039;s/Mixed EMEA E2 DIVISION 5 (A),Elemnt Bolt / Left Arm Zimanox PM,ZWIFT Tacx Neo 1 (2018),352,358,-6
120263,44125,2020-04-21 17:54:58,neo,Zwift - MIDWEEK Winter Series by SZR (A),Elemnt Bolt / Left Arm Zimanox PM,ZWIFT Tacx Neo 1 (2018),386,380,6
120538,44125,2021-02-24 17:59:59,neo,Zwift - MIDWEEK Winter Series by SZR (A),Elemnt Bolt / Left Arm Zimanox PM,ZWIFT Tacx Neo 1 (2018),366,380,-14
123055,44125,2021-03-02 18:32:17,neo,Zwift - Zwift Racing League | WTRL - Men&#039;s/Mixed EMEA E1 DIVISION 6 (A),Elemnt Bolt Team Zwatt Zimanox ,ZWIFT Tacx Neo 1 (2018),394,391,3
103223,44318,2021-01-26 08:45:22,neo,Zwift - Zwift Racing League | WTRL - Men&#039;s/Mixed APAC DIVISION 1 (A),Quarq,Tacx Neo,439,430,9
104925,44318,2021-01-29 00:41:18,neo,Zwift - WTRL Team Time Trial - Zone 10 (C),Quarq,Tacx Neo,340,338,2
36461,44582,2020-05-20 17:56:37,wahoo,Zwift - Zwift NL League - Woensdagavond Competitie (A),Favero Assioma DUO,Wahoo Kickr &#039;14,341,344,-3
40848,44582,2020-06-10 17:56:05,wahoo,Zwift - Zwift NL League - Woensdagavond Competitie (A),Favero Assioma DUO,Wahoo Kickr &#039;14,356,338,18
81602,44582,2020-12-10 19:00:42,wahoo,Zwift - Espresso,Favero Assioma DUO,Wahoo Kickr &#039;14,293,302,-9
60276,44626,2020-10-08 12:49:19,wahoo,Zwift - France,Assioma Duo Pedals,Kickr V5,161,158,3
62370,44626,2020-10-16 08:32:38,wahoo,Zwift - TBR Burrito Race (A),Vector s`s,Kickr V5,326,326,0
62883,44626,2020-10-18 15:38:03,wahoo,Zwift - The Alpe Dash by Herd Racing League (A),Allisons Vectors`2,Kickr V5,339,355,-16
63039,44626,2020-10-19 16:52:57,wahoo,Zwift - Watopia,Allisons Vectors`2,Kickr V5,202,200,2
63405,44626,2020-10-20 17:24:01,wahoo,Zwift - Zwift Racing League | WTRL - EMEA E (MEN) - TTT Grp 2 (C),Vector s`s,Kickr V5,345,343,2
64137,44626,2020-10-22 14:06:01,wahoo,Zwift - ZA Road - Race #2 (A),Vector s`s,Kickr V5,359,363,-4
64393,44626,2020-10-23 14:14:02,wahoo,Zwift - BST Mountaingoat Race (A),Vector s`s,Kickr V5,360,364,-4
65356,44626,2020-10-27 08:43:16,wahoo,Zwift - Zwift Racing League | WTRL - APAC (MEN) -  Division 1 (A),Vector s`s,Kickr V5,360,371,-11
65702,44626,2020-10-28 09:23:04,wahoo,Zwift - Watopia,Vector s`s,Kickr V5,289,299,-10
67003,44626,2020-11-01 14:15:29,wahoo,Zwift - 3R Alpe Du Zwift KOM Race (20km 1444m) (A),Assioma Duo Pedals,Kickr V5,377,378,-1
72175,44626,2020-11-17 08:25:48,wahoo,Zwift - Zwift Racing League | WTRL - Men&#039;s APAC DIVISION 1 (A),Vector s`s,Kickr V5,290,297,-7
75381,44626,2020-11-25 08:51:34,wahoo,Zwift - Z2,Vector s`s,Kickr V5,243,246,-3
75382,44626,2020-11-24 08:30:01,wahoo,Zwift - Zwift Racing League | WTRL - Men&#039;s APAC DIVISION 1,Vector s`s,Kickr V5,262,257,5
76629,44626,2020-11-27 06:55:53,wahoo,Zwift - Focus: Colours of PARI - Shorter Ride,quarq,Kickr V5,328,329,-1
77127,44626,2020-11-28 13:27:02,wahoo,Zwift - 111 - Strongman racing series (A),quarq,Kickr V5,337,344,-7
83135,44626,2020-12-14 16:59:53,wahoo,Zwift - REVO Climbers (E),Vector s`s,Kickr V5,388,396,-8
84750,44626,2020-12-18 16:21:50,wahoo,Zwift - Innsbruck,Vector s`s,Kickr V5,293,292,1
90402,44626,2021-01-02 16:24:19,wahoo,Zwift - Serpentine 8,Vector s`s,Kickr V5,252,254,-2
92101,44626,2021-01-06 09:59:39,wahoo,Zwift - TDZ Stage 1: Longer Ride,Vector s`s,Kickr V5,352,360,-8
104145,44626,2021-01-27 16:47:27,wahoo,Zwift - TDZ Stage 5: Longer Ride,Assioma Duo Pedals,Kickr V5,247,249,-2
111762,44626,2021-02-09 18:59:40,wahoo,Zwift - TDZ Stage 8: Group Ride,quarq,Kickr V5,340,347,-7
114207,44626,2021-02-13 16:12:03,wahoo,Zwift - TDZ Stage 3: Longer Ride,Vector s`s,Kickr V5,352,361,-9
114858,44626,2021-02-14 07:55:36,wahoo,Zwift - Watopia,Allisons Vectors`2,Kickr V5,269,274,-5
118563,44626,2021-02-20 13:41:53,wahoo,Zwift -  Zwift Insider Badge Hunters - The Uber Pretzel Edition (E),Vector s`s,Kickr V5,332,336,-4
120746,44626,2021-02-23 16:30:46,wahoo,Zwift - FRC/FTP - DESCENDING VO2,quarq,Kickr V5,335,353,-18
121754,44626,2021-02-27 08:48:30,wahoo,Zwift - Haute Route Watopia 2021 Stage 2 (A),Vector s`s,Kickr V5,349,361,-12
121820,44626,2021-02-27 18:59:01,wahoo,Zwift - Grin And Bear It,2021-02-27-18-59-01,Kickr V5,241,244,-3
122797,44626,2021-03-02 08:23:25,wahoo,Kickr V5 / Vector s`s,Vector s`s,Kickr V5,318,321,-3
123392,44626,2021-03-03 08:30:33,wahoo,Zwift - TEMPO - NP,Vector s`s,Kickr V5,310,309,1
123862,44626,2021-03-04 08:24:37,wahoo,Zwift - Ascenders Team Aussie Triathlon Group Ride (C),2021-03-04-08-24-37,Kickr V5,339,337,2
125506,44626,2021-03-06 15:25:33,wahoo,Zwift - Norseman Winter Training Series Hill Climbs (E),Vector s`s,Kickr V5,348,355,-7
128216,44626,2021-03-13 13:55:38,wahoo,Zwift - Zwift Insider Badge Hunters - The PRL Full Edition,Vector s`s,Kickr V5,362,367,-5
10991,44795,2020-01-26 10:00:00,wahoo,Zwift - Tour de Zwift: Stage 4 Group Ride - Long Distance,Favero Assioma,Wahoo Kickr,284,298,-14
112605,44795,2021-02-10 18:29:56,wahoo,Zwift - UKAFC Race Night (A),Favero Assioma,Wahoo Kickr,364,363,1
120440,44795,2021-02-24 18:29:56,wahoo,Zwift - UKAFC Race Night (A)-15th,Favero Assioma Duo,Wahoo Kickr,393,376,17
128973,44867,2021-03-16 08:45:56,neo,Zwift - WTRL Racing (B),Stage powermeter,Tacx Neo,308,324,-16
11998,44933,2020-02-01 13:44:48,wahoo,Zwift - WTRL Winter Racing League (A),Quarq DZero Crank,Wahoo Kickr18,374,377,-3
52827,44933,2020-09-01 06:25:03,wahoo,Zwift - 3R Watopia Flat Route Race - 3 Laps (30.3km/18.8mi 162m) (A),Quarq DZero Crank,Wahoo Kickr18,343,343,0
53005,44933,2020-09-02 06:15:17,wahoo,Zwift - Tri NZ Night Race (A),Quarq DZero Crank,Wahoo Kickr18,399,400,-1
78846,45652,2020-12-03 11:25:46,neo,Zwift - Watopia,Favero Assioma Duo,Tacx Neo,223,222,1
83431,45652,2020-12-15 11:57:44,neo,Zwift - Watopia,Favero Assioma Duo,Tacx Neo,227,224,3
94389,45652,2021-01-10 13:01:06,neo,Tacx Neo,Favero Assioma Duo,Tacx Neo,271,270,1
74683,46286,2020-11-23 20:08:13,wahoo,Zwift - GGCC Glasgow Green Cycle Club Race Series (A),p2m,Wahoo Kickr,318,330,-12
74921,46286,2020-11-24 12:15:02,wahoo,Zwift - ODZ Covfefe Ride,p2m,Wahoo Kickr,406,410,-4
75128,46286,2020-11-24 19:45:20,wahoo,Zwift - Zwift Racing League | WTRL - Men&#039;s EMEA W1 DIVISION 1,p2m,Wahoo Kickr,391,397,-6
77305,46286,2020-11-29 15:00:00,wahoo,Zwift - Focus: Colours of PARI - Empty Tank,p2m,Wahoo Kickr,310,317,-7
78535,46286,2020-12-02 16:10:02,wahoo,Zwift - 3R Tick Tock Flat Race - 2 Laps (A),p2m,Wahoo Kickr,348,357,-9
78899,46286,2020-12-03 15:41:00,wahoo,Zwift - ZA Tri: TT Race - 20k,p2m,Wahoo Kickr,347,353,-6
80988,46286,2020-12-09 00:45:00,wahoo,Zwift - Zwift Racing League | WTRL - Men&#039;s AMERICAS E DIVISION 1 (A),p2m,Wahoo Kickr,362,369,-7
80999,46286,2020-12-09 14:00:00,wahoo,Zwift - KISS Race Series - Pacific AM (A),p2m,Wahoo Kickr,387,406,-19
81933,46286,2020-12-11 13:50:02,wahoo,Zwift - KISS Race Series - Pacific AM (A),p2m,Wahoo Kickr,356,364,-8
82879,46286,2020-12-13 14:15:14,wahoo,KISS 100 - PRL Full Edition,p2m,Wahoo Kickr,379,384,-5
83752,46286,2020-12-16 00:47:26,wahoo,Zwift - Zwift Racing League | WTRL - Men&#039;s AMERICAS E DIVISION 1 (A),p2m,Wahoo Kickr,353,355,-2
89597,46286,2020-12-31 18:09:03,wahoo,🍾🎉 NYE Alpe du Zwift TTT - New PR!,p2m,Wahoo Kickr,361,371,-10
91306,46286,2021-01-04 17:00:26,wahoo,Zwift - TDZ Stage 1: Gong Show,p2m,Wahoo Kickr,362,362,0
91649,46286,2021-01-05 12:15:31,wahoo,Zwift - Team ODZ Tuesday Coffee and Espresso Ride ,p2m,Wahoo Kickr (Zwift),386,377,9
96263,46286,2021-01-13 14:00:01,wahoo,Zwift - KISS Race Series - Pacific AM (A),p2m,Wahoo Kickr (Zwift),361,360,1
96933,46286,2021-01-14 18:17:00,wahoo,Zwift - WTRL Team Time Trial,p2m,Wahoo Kickr (Zwift),388,362,26
99962,46286,2021-01-19 23:00:03,wahoo,Zwift - TDZ Stage 4: Surfin� the pack,p2m,Wahoo Kickr (Zwift),368,368,0
100206,46286,2021-01-20 14:00:01,wahoo,Zwift - KISS Race Series - Pacific AM (A),p2m,Wahoo Kickr (Zwift),370,361,9
100743,46286,2021-01-21 12:15:24,wahoo,Zwift - Team ODZ Thursday Morning Throwdown (E),p2m,Wahoo Kickr (Zwift),357,359,-2
103632,46286,2021-01-26 19:52:01,wahoo,Zwift - Zwift Racing League | WTRL - Men&#039;s/Mixed EMEA W2 DIVISION 1 (A),p2m,Wahoo Kickr (Zwift),380,380,0
104335,46286,2021-01-27 23:00:03,wahoo,Zwift - TDZ Stage 5: Bleh,p2m,Wahoo Kickr (Zwift),387,382,5
109889,46286,2021-02-06 12:33:02,wahoo,Zwift - Zwift Ultima Fondo - FUBAR,p2m,Wahoo Kickr (Zwift),373,383,-10
111242,46286,2021-02-08 22:00:01,wahoo,Zwift - TDZ Stage 8: Until Next Year TDZ..!,p2m,Wahoo Kickr (Zwift),397,399,-2
111872,46286,2021-02-10 00:57:30,wahoo,Zwift - Zwift Racing League | WTRL TTT,p2m,Wahoo Kickr (Zwift),364,377,-13
112762,46286,2021-02-11 12:15:00,wahoo,Zwift - Team ODZ Thursday Morning Throwdown ,p2m,Wahoo Kickr (Zwift),365,373,-8
116005,46286,2021-02-16 19:52:01,wahoo,Zwift - Zwift Racing League | EMEA W2 DIVISION 1 (A),p2m,Wahoo Kickr (Zwift),405,423,-18
116915,46286,2021-02-17 23:02:02,wahoo,Zwift - Zwift Duathlon League - Bike,p2m,Wahoo Kickr (Zwift),369,381,-12
120203,46286,2021-02-24 14:00:15,wahoo,Zwift - KISS Race Series - Pacific AM (A),p2m,Wahoo Kickr (Zwift),403,396,7
120658,46286,2021-02-25 12:15:01,wahoo,Zwift - Team ODZ TMT - Surfing,p2m,Wahoo Kickr (Zwift),323,319,4
125737,46286,2021-03-08 14:30:01,wahoo,Zwift - Aero Army Wyn TT Series (A),p2m,Wahoo Kickr (Zwift),410,420,-10
125770,46286,2021-03-08 17:30:00,wahoo,Zwift - Absa Cape Epic Stage 1 pb Oakley - Open (A),p2m,Wahoo Kickr (Zwift),365,371,-6
125802,46286,2021-03-08 18:15:01,wahoo,Zwift -  DBR Monday Race - One Hill too far,p2m,Wahoo Kickr (Zwift),386,379,7
128043,46286,2021-03-13 14:00:02,wahoo,Zwift - Zwift Insider Badge Hunters - The PRL Full Edition,p2m,Wahoo Kickr (Zwift),368,374,-6
16571,46509,2020-03-03 12:24:58,wahoo,Zwift - E Eizo [EMU/NICO]&#039;s Meetup - Mountain 8,Quarq S-Works Spider 110mm,wahoo kickr 2018,362,366,-4
10662,46603,2020-01-23 19:14:54,wahoo,Zwift - Tour de Zwift // Pro-Am Invitational,Garmin vector,Zwift Kickr,424,423,1
11890,46603,2020-01-31 19:14:53,wahoo,Zwift - Tour de Zwift // Pro-Am Invitational (A),Garmin vector,Kickr Zwift,441,444,-3
11977,46603,2019-09-26 18:35:14,wahoo,Zwift - Yorkshire Gran Prix // Zwift Classic (A),Garmin vector,Kickr Zwift,405,408,-3
17053,46603,2020-03-05 18:56:32,wahoo,Zwift - KALAS Cup - Round 6 (A),Garmin vector,Kickr Zwift,387,405,-18
17839,46603,2020-03-12 19:06:08,wahoo,Zwift - Tour of Watopia Pro-Am Men&#039;s Race #1 (A),Garmin vector,Kickr Zwift,424,430,-6
18724,46603,2020-03-19 19:00:14,wahoo,Zwift - KALAS Cup - Round 8 (A),Garmin vector,Kickr Zwift,408,408,0
18910,46603,2020-03-20 19:05:16,wahoo,Zwift - Tour of Watopia Pro-Am Men&#039;s Race #2 (A),Garmin vector,Kickr Zwift,438,447,-9
19437,46603,2020-03-24 19:12:58,wahoo,Tour of Watopia Pro-Am Mens Race #3,Garmin vector,Kickr Zwift,393,402,-9
19812,46603,2020-03-26 19:00:16,wahoo,Zwift - KALAS Cup - Round 9 (A),Garmin vector,Kickr Zwift,407,405,2
20879,46603,2020-03-31 17:57:55,wahoo,Zwift - NCF Spring Cup (A),Garmin vector,Kickr Zwift,411,409,2
22064,46603,2020-04-04 15:59:56,wahoo,Zwift -  Haute Route Watopia Stage 2 (E),Garmin vector,Kickr Zwift,371,371,0
24328,46603,2020-04-13 18:14:58,wahoo,Zwift - TFC Mad Monday World Series (1 of 6) (A),Garmin vector,Kickr Zwift,411,410,1
24935,46603,2020-04-15 17:54:12,wahoo,Zwift - USA Cycling Race League by Indoor Specialist  (A),Garmin vector,Kickr Zwift,412,414,-2
28120,46603,2020-04-25 17:52:02,wahoo,Zwift - Crit City Slam // Zwift Classic (A),Garmin vector,Kickr Zwift,428,425,3
75579,46603,2020-11-25 18:29:58,wahoo,Zwift - NCF Vinter Cup 2020 - Runde 10 - Herrer (A),Garmin vector,Kickr Zwift,406,392,14
84359,46603,2020-12-17 16:11:58,wahoo,Zwift - OH MY CRIT! - The Double Race 1/2 (A),Garmin vector,Kickr Zwift,415,409,6
95616,46603,2021-01-12 18:08:26,wahoo,Zwift - Zwift Racing League | WTRL - Men&#039;s/Mixed EMEA E1 DIVISION 1 (A),Garmin vector,Kickr Zwift,407,415,-8
97032,46603,2021-01-14 17:56:15,wahoo,Zwift - Doddie Aid Hare and Hounds Race (A),Garmin vector,Kickr Zwift,402,401,1
112963,46603,2021-02-11 17:47:37,wahoo,Zwift - WTRL Team Time Trial - Zone 3 (A),Garmin vector,Kickr Zwift,391,396,-5
116720,46603,2021-02-17 18:20:01,wahoo,Zwift - NCF Vintercup 2021 - Runde 6 - Herrer (A),Garmin vector,Kickr Zwift,376,378,-2
120350,46603,2021-02-24 18:45:25,wahoo,Zwift - Scandinavian Cup 2021 - Round 1 - Men (A),Garmin vector,Kickr Zwift,374,378,-4
37909,47077,2020-05-26 18:17:00,neo,Zwift - UNO X CUP powered by DCU & Feltet.dk (C),4993866052,Tacx Neo,299,308,-9
63790,47083,2020-10-21 13:35:59,neo,Zwift - Crit City Race (B),Power Tap P1,Tacx Neo,355,368,-13
96501,47083,2021-01-13 18:46:00,neo,Zwift - Danmarks Cykle Union & Partners 1/6 (B),Power Tap P1,Tacx Neo,333,352,-19
100636,47083,2021-01-20 18:46:05,neo,Zwift - Danmarks Cykle Union & Partners 2/6 (B),Power Tap P1,Tacx Neo,339,357,-18
108372,47083,2021-02-03 18:46:02,neo,Zwift - Danmarks Cykle Union & Partners 4/6 (B),Power Tap P1,Tacx Neo,354,369,-15
115940,47083,2021-02-16 18:23:05,neo,Zwift - Zwift Racing League | WTRL - Men&#039;s/Mixed EMEA E1 DIVISION 9 (B),Power Tap P1,Tacx Neo,351,368,-17
78545,47154,2020-12-01 18:21:47,wahoo,Zwift - Zwift Racing League | WTRL - Men&#039;s EMEA E1 DIVISION 3 (A),2020-12-01-18-09-34,Kicker,383,383,0
90379,47154,2021-01-02 09:00:00,wahoo,Zwift - KRT/KISS 80 km Endurance Ride (B),arm,Kicker,296,299,-3
36931,47261,2020-05-21 18:20:09,wahoo,Zwift - WTRL Team Time Trial (D),Stages Right Crank Arm,Wahoo Kicker,304,303,1
76617,48061,2020-11-26 19:29:56,wahoo,Zwift - CWRB Friyay Workout,a vectors,kickr v5,171,170,1
76625,48061,2020-11-25 18:22:49,wahoo,Zwift - Watopia,a vectors,kickr v5,165,170,-5
77205,48061,2020-11-29 09:01:01,wahoo,Zwift - BRT Breakfast Club (C),a vectors OR,kickr v5,153,146,7
77739,48061,2020-11-30 18:29:56,wahoo,Zwift - GBCT eSports Recon Ride (D),a vectors,kickr v5,139,141,-2
78361,48061,2020-12-01 19:23:14,wahoo,Zwift - Zwift Racing League | WTRL - Women&#039;s EMEA W1 DIVISION 2 (C), vectors,kickr v5,216,215,1
98196,48061,2021-01-16 13:30:01,wahoo,ff race tt,a vectors,kickr v5,227,227,0
119757,48061,2021-02-23 19:17:45,wahoo,Zwift - Zwift Racing League | WTRL - Women&#039;s EMEA W1 DIVISION 2 (C),a vectors,kickr v5,238,223,15
32967,48210,2020-05-09 11:09:37,wahoo,Zwift - Tour for All 2020: Stage 2 Longer Race A/B,P1,Kickr,344,318,26
36914,48210,2020-05-22 10:27:47,wahoo,Zwift - Kinetic Cruisers (C),P1,Kickr,221,213,8
119877,48314,2021-02-23 19:52:03,wahoo,Zwift - Zwift Racing League | WTRL W2 D1(A) Win again boiz,Specialized Power Crank,Wahoo Kickr Core,389,394,-5
29610,48456,2020-04-30 13:53:00,wahoo,Zwift - Watopia,Assioma Duo,Kickr Gen 1 ,353,362,-9
52326,48456,2020-08-28 09:04:58,wahoo,Zwift - 3R Whole Lotta Lava Hilly Race - 2 Laps (28.9km/12.53mi 336m) (A) 2nd ,Assioma Duo,Kickr Gen 1 ,353,359,-6
55077,48456,2020-09-14 17:59:59,wahoo,Zwift - Invitational League // Qualifying Race #1,Assioma Duo,Kickr Gen 1 ,373,364,9
55992,48456,2020-09-17 18:45:01,wahoo,Zwift - XRS - ZTR Thursday Night Race (A) Win :),Assioma Duo,Kickr Gen 1 ,379,386,-7
108823,48611,2021-01-30 08:32:29,neo,Zwift - London Lockdown eRace Series: Race 1 (C),Powertap P1,Neo,300,279,21
6499,49249,2019-12-17 18:14:45,wahoo,"Zwift - Danmarks Cykle Union Racing League (A),  no legs day",Favero BePro - Zwift,Wahoo KICKR 18v4 - Garmin 810,378,352,26
8014,49249,2020-01-04 08:14:32,wahoo,Zwift - EVR Asia Weekend (A),Favero BePro - Zwift,Wahoo KICKR 18v4 - Garmin 810,364,348,16
8327,49249,2020-01-07 18:54:08,wahoo,Zwift - Team Italy Gladiators Race (A),Favero BePro - Zwift,Wahoo KICKR 18v4 - Garmin 810,390,368,22
8581,49249,2020-01-09 14:59:28,wahoo,Zwift - ZA Tri 2020 TT Race - Open A,Favero BePro - Zwift,Wahoo KICKR 18v4 - Garmin 810,354,336,18
9131,49249,2020-01-13 15:33:26,wahoo,Wahoo KICKR Core - Garmin 810 / Favero BePro - Zwift,Favero BePro - Zwift,Wahoo KICKR Core - Garmin 810,355,345,10
9483,49249,2020-01-15 14:09:35,wahoo,"Zwift - KISS at Race - Pacific AM (A) #�4, no legs day",Favero BePro - Zwift,Wahoo KICKR Core - Garmin 810,364,335,29
9869,49249,2020-01-18 06:28:42,wahoo,Zwift - XRS Races - The Saturday Classic (A),Favero BePro - Zwift,Wahoo KICKR Core - Wahoo ELEMNT BOLT,354,348,6
10340,49249,2020-01-21 19:40:03,wahoo,Zwift - 3R Ultimate Racing League - Round 3 (A),Favero BePro - Zwift,Wahoo KICKR Core - Wahoo ELEMNT BOLT,396,375,21
10766,49249,2020-01-24 15:13:34,wahoo,Zwift - 3R Sand and Sequoias Race (A),Favero BePro - Zwift,Wahoo KICKR Core - Wahoo ELEMNT BOLT,364,351,13
11019,49249,2020-01-26 13:03:23,wahoo,"Zwift - 3R Watopia Flat Route Race - 4 Laps (40.5km/25.1mi 216m) (A) #3, medium intensity+ intervals ",Favero BePro - Zwift,Wahoo KICKR Core - Wahoo ELEMNT BOLT,344,326,18
12510,49249,2020-02-04 19:08:22,wahoo,Zwift - &quot;No Pain No Gain&quot; Transparency Racing Series,Favero BePro - Zwift,Wahoo KICKR Core - Wahoo ELEMNT BOLT,356,335,21
14500,49249,2020-02-18 16:04:05,wahoo,Zwift - 3R SuperCRITical Race Series - Round 1of4 (A),Favero BePro - Zwift,Wahoo KICKR Core - Wahoo ELEMNT BOLT,363,344,19
15146,49249,2020-02-22 09:29:06,wahoo,Zwift - DBR Saturday Race (A) #6,Favero BePro - Zwift,Wahoo KICKR Core - Wahoo ELEMNT BOLT,356,335,21
15429,49249,2020-02-24 15:05:22,wahoo,"Zwift - Watopia solo, hill sprints / SST",Favero BePro - Zwift,Wahoo KICKR Core - Wahoo ELEMNT BOLT,357,345,12
15728,49249,2020-02-26 16:09:31,wahoo,"Zwift - 3R Tick Tock Flat Race - 2 Lap (36km/22.4mi 100m) (A), no legs",Favero BePro - Zwift,Wahoo KICKR Core - Wahoo ELEMNT BOLT,329,321,8
16622,49249,2020-03-03 19:13:52,wahoo,Zwift - Feltet.dk Race Series (A),Favero BePro - Zwift,Wahoo KICKR Core - Wahoo ELEMNT BOLT,365,352,13
16887,49249,2020-03-05 10:59:50,wahoo,Zwift - KISS at Race - Americas AM (A),Favero BePro - Zwift,Wahoo KICKR Core - Wahoo ELEMNT BOLT,322,313,9
16888,49249,2020-03-05 11:51:40,wahoo,Zwift - TTR Mini Chase Thursday (A) #1,Favero BePro - Zwift,Wahoo KICKR Core - Wahoo ELEMNT BOLT,326,329,-3
17654,49249,2020-03-11 13:33:50,wahoo,Zwift - Crit City Race (A) ,Favero BePro - Zwift,Wahoo KICKR Core - Wahoo ELEMNT BOLT,332,317,15
18044,49249,2020-03-14 13:18:15,wahoo,Zwift - 3R Innsbruckring Flat Race - 5 Laps (44km/27.3mi 385m) (A) #2,Favero BePro - Zwift,Wahoo KICKR Core - Wahoo ELEMNT BOLT,346,335,11
18444,49249,2020-03-17 19:13:59,wahoo,Zwift - Feltet.dk Race Series (A),Favero BePro - Zwift,Wahoo KICKR Core - Wahoo ELEMNT BOLT,371,363,8
19433,49249,2020-03-24 19:13:48,wahoo,Zwift - Feltet.dk Race Series (A) no juice,Favero BePro - Zwift,Wahoo KICKR Core - Wahoo ELEMNT BOLT,343,343,0
31712,49249,2020-05-05 18:13:52,wahoo,Zwift - UNO X CUP powered by DCU & Feltet.dk (A),Favero BePro - Zwift,Wahoo KICKR Core - Wahoo ELEMNT BOLT,353,348,5
69039,49249,2020-11-08 08:00:02,wahoo,Zwift - FIETS Weekend Warriors 2 - Long #4,Favero BePro - Zwift,Wahoo KICKR Core - Wahoo ELEMNT BOLT,310,290,20
6624,49443,2019-12-18 16:25:14,neo,Zwift - 2set 5 X 3/1,V3,NEO,260,262,-2
7610,49443,2019-12-29 06:48:32,neo,Zwift 29/12,V3,NEO,276,281,-5
7611,49443,2019-12-19 18:10:47,neo,Zwift - A,V3,NEO,272,274,-2
6587,49668,2019-12-17 18:04:28,neo,Zwift - ZwiftTeamPL League – Climbers Series (A),Stages,NEO,366,367,-1
11967,49668,2020-01-30 11:27:25,neo,NEO / Stages,Stages,NEO,263,265,-2
11972,49668,2020-02-01 06:10:56,neo,NEO / Stages,Stages,NEO,260,264,-4
12800,49668,2020-02-04 19:13:54,neo,Zwift - Tour de Zwift // Pro-Am Invitational (A),Stages,NEO,398,407,-9
17629,49668,2020-03-10 18:59:57,neo,Zwift - ZwiftTeamPL League – Classic Series (A),Stages,NEO,399,406,-7
23340,49668,2020-04-09 18:09:51,neo,Zwift - London International // Zwift Classic (A),Stages,NEO,429,444,-15
28020,49668,2020-04-25 18:09:59,neo,Zwift - Crit City Slam // Zwift Classic (A),Stages,NEO,405,427,-22
55095,49668,2020-09-14 18:00:04,neo,Zwift - Invitational League // Qualifying Race #1,Stages,NEO,391,396,-5
55876,49668,2020-09-17 18:29:59,neo,Zwift - Invitational League // Qualifying Race #2 (Men) ,Stages,NEO,385,391,-6
58266,49668,2020-09-29 15:10:00,neo,ZADA Three Sister Michal Kaminski,Stages,NEO,408,426,-18
61780,49668,2020-10-13 18:44:58,neo,Zwift - Zwift Racing League | WTRL,Stages,NEO,404,413,-9
63513,49668,2020-10-20 18:49:53,neo,Zwift - Zwift Racing League | WTRL - EMEA (MEN) - TTT Grp 2 (A),Stages,NEO,390,398,-8
64375,49668,2020-10-23 10:09:53,neo,Zwift - ZA Road - Race #2 (A),Stages,NEO,403,418,-15
66722,49668,2020-10-31 16:00:16,neo,ZA Road 2020 - Segment Ride #2,Stages,NEO,429,446,-17
67679,49668,2020-11-03 20:04:58,neo,Zwift - Zwift Racing League | WTRL - Men&#039;s EMEA W1 DIVISION 1 (A),Stages,NEO,403,405,-2
65035,49722,2020-10-26 12:00:02,neo,Zwift - ZA Road Group Ride: 2.2 - 2.7 w/kg with Gianni Vermeersch,Pedal Garmin Vector 2,Tacx Neo,198,208,-10
109984,49870,2021-02-06 12:29:49,wahoo,Zwift - Zwift Fondo Series: Gran Fondo,Quarq,Kickr,367,365,2
119300,49870,2021-02-22 19:27:44,wahoo,Zwift - Watopia,Quarq,Kickr,241,245,-4
108017,49910,2021-02-02 21:39:44,wahoo,Zwift - Zwift Racing League | WTRL - Men&#039;s/Mixed AMERICAS E DIVISION 2 (B),4iiii crank,Wahoo Kickr 5,342,349,-7
113556,49910,2021-02-09 23:54:30,wahoo,Zwift - Zwift Racing League | WTRL - Men&#039;s/Mixed AMERICAS E DIVISION 2 (B),4iiii crank,Wahoo Kickr 5,356,347,9
68290,50010,2020-11-05 19:12:39,wahoo,Zwift - WTRL Team Time Trial - Zone 7 (B),Assioma,Kickr,297,286,11
72523,50010,2020-11-17 20:00:16,wahoo,Zwift - Zwift Racing League | WTRL - Men&#039;s EMEA W2 DIVISION 2 (B),Assioma,Kickr,313,315,-2
75423,50010,2020-11-24 19:51:21,wahoo,Zwift - Zwift Racing League | WTRL - Men&#039;s EMEA W2 DIVISION 2,Assioma,Kickr,341,340,1
76422,50010,2020-11-26 19:15:16,wahoo,Zwift - WTRL NOPINZ WORLD TTT CHAMPIONSHIPS - Zone 8 (B),Assioma,Kickr,332,332,0
84287,50010,2020-12-15 19:59:34,wahoo,Zwift - Zwift Racing League | WTRL - Men&#039;s EMEA W2 DIVISION 2 (B),Assioma,Kickr,327,316,11
95891,50010,2021-01-12 19:54:23,wahoo,Zwift - Zwift Racing League | WTRL - Men&#039;s/Mixed EMEA W2 DIVISION 4 (A),Assioma,Kickr,336,320,16
34756,50281,2020-05-14 17:05:32,neo,Zwift - WTRL Team Time Trial (A),Quarq dFour,Tacx Neo,299,300,-1
47983,50281,2020-07-28 11:29:57,neo,Zwift - 3R Volcano Circuit Flat Race - 8 Laps (35.2km/21.9mi 160m) (C),Quarq dFour,Tacx Neo,316,305,11
52526,50281,2020-08-29 16:46:57,neo,Zwift - Crit City Race (C),Quarq dFour,Tacx Neo,308,303,5
68629,50281,2020-11-06 19:04:29,neo,Zwift - WarmUP! Beta1,Quarq dFour,Tacx Neo,332,340,-8
68900,50281,2020-11-07 19:01:11,neo,Zwift -  Tour De Spartacus  (B),Quarq dFour,Tacx Neo,301,299,2
69131,50281,2020-11-08 19:01:00,neo,Zwift -  Tour De Spartacus  (B) Stage 3,Quarq dFour,Tacx Neo,347,337,10
89129,50281,2020-12-30 18:01:01,neo,Zwift - ,Quarq dFour,Tacx Neo,342,328,14
111638,50281,2021-02-09 18:29:59,neo,Zwift - Zwift Racing League | WTRL - Men&#039;s/Mixed EMEA E2 DIVISION 3 (B),Quarq dFour,Tacx Neo,344,341,3
70524,50521,2020-11-08 07:29:53,wahoo,Zwift - 3R 100 Steady Ride [~3.0/2.5w/kg avg] (B),Power2max,Wahoo kickr 2018,269,275,-6
122274,50521,2021-02-28 15:02:00,wahoo,Power2max / Wahoo kickr 2018,Power2max,Wahoo kickr 2018,199,195,4
122275,50521,2021-02-28 15:02:00,wahoo,Wahoo kickr 2018 / Power2max,Power2max,Wahoo kickr 2018,195,199,-4
7129,50641,2019-12-23 15:29:58,wahoo,Zwift - 5 x 20,DFour,Kicker,324,318,6
23079,52333,2020-04-04 09:02:46,neo,Zwift - 3R Sand & Sequioas Race - 2 Laps (B),Stages,Taxc Neo,324,323,1
23260,52333,2020-04-09 14:45:44,neo,Zwift - VICC & RLM Wien Recovery Group Workout,Stages via Zwift,Taxc Neo via Garmin,265,275,-10
23940,52333,2020-04-12 07:03:46,neo,Zwift - Vikings Valhalla 100 series (D),Stages via Garmin,Taxc Neo via Zwift,183,189,-6
24210,52333,2020-04-13 11:17:43,neo,Zwift - Crit City Race (B),Stages L Gen2 via Garmin 530,Taxc Neo via Zwift,307,314,-7
25770,52333,2020-04-18 08:13:20,neo,Zwift - EVR Asia Weekend (A),Stages L Gen2 via Garmin 530,Taxc Neo via Zwift,319,347,-28
27806,52333,2020-04-25 08:01:38,neo,Zwift - 3R Crit City - Downtown Dolphin - 16laps (A),Stages LR Gen3 via Garmin 530,Taxc Neo via Zwift,326,350,-24
30393,52333,2020-05-02 07:59:32,neo,Zwift - e-liga FINALE - eCycling Austria (C),Favero Assioma Duo via Garmin 530,Taxc Neo via Zwift,326,335,-9
31633,52333,2020-05-05 16:09:35,neo,Zwift - Tour for All 2020: Stage 1 Longer Race A/B,Favero Assioma Duo via Garmin 530,Taxc Neo via Zwift,320,326,-6
33948,52333,2020-05-12 16:59:46,neo,Zwift - Boost Mode Test 4a (A),Favero Assioma Duo via Zwift,Taxc Neo via Garmin 530,338,336,2
36059,52333,2020-05-19 15:59:51,neo,Zwift - Tour for All 2020: Stage 4 Longer Ride,Favero Assioma Duo via Zwift,Taxc Neo via Garmin 530,313,315,-2
36980,52333,2020-05-23 05:09:48,neo,Zwift - Team 3R&#039;s Choice: Stage 5 Longer Race A/B - lost group w/ pwr.cnn.drp,Favero Assioma Duo via Zwift,Taxc Neo via Garmin 530,334,335,-1
38800,52333,2020-05-31 07:35:14,neo,Zwift - ZHR Masters Weekender (B),Favero Assioma Duo via Garmin 530,Taxc Neo via Zwift,340,346,-6
40699,52333,2020-06-10 08:29:17,neo,Zwift - Aussie Crit Crushers Race 2 of 2 (A) + cooldown,Favero Assioma Duo via Garmin 530,Taxc Neo via Zwift,349,354,-5
42697,52333,2020-06-20 05:00:19,neo,Zwift - Zwift Fast Fridays: Bologna Time Trial (E),Favero Assioma Duo via Garmin 530,Taxc Neo via Zwift,366,374,-8
62580,52333,2020-10-17 09:04:47,neo,Zwift - 3R Hilly Race (C),Stages via Garmin,Taxc Neo via Zwift,346,345,1
67582,52333,2020-11-03 18:27:55,neo,Zwift - Zwift Racing League | WTRL - Men&#039;s EMEA E2 DIVISION 3 (A),Favero Assioma Duo via Garmin 530,Taxc Neo via Zwift,334,337,-3
68818,52333,2020-11-07 16:04:53,neo,Zwift - e-liga | eCycling league Austria Race 0 (A),Favero Assioma Duo via Garmin 530,Taxc Neo via Zwift,313,316,-3
71265,52333,2020-11-14 09:04:17,neo,Zwift - e-liga | eCycling league Austria Race 1 (A),Favero Assioma Duo via Garmin 530,Taxc Neo via Zwift,352,358,-6
73665,52333,2020-11-20 17:59:44,neo,Zwift - KIRCHMAIR Race Series (A),Favero Assioma Duo via Garmin 530,Taxc Neo via Zwift,332,337,-5
73666,52333,2020-11-20 18:29:48,neo,Zwift - KIRCHMAIR Race Series (A),Favero Assioma Duo via Garmin 530,Taxc Neo via Zwift,315,317,-2
76762,52333,2020-11-28 09:04:23,neo,Zwift - e-liga | eCycling league Austria Race 2 (A),Favero Assioma Duo via Garmin 530,Taxc Neo via Zwift,333,344,-11
79670,52333,2020-12-05 09:59:37,neo,Zwift - Nations Challenge // Austria (E),Favero Assioma Duo via Garmin 530,Taxc Neo via Zwift,301,305,-4
83546,52333,2020-12-15 18:23:19,neo,Zwift - Zwift Racing League | WTRL - Men&#039;s EMEA E2 DIVISION 3 (A),Favero Assioma Duo via Garmin 530,Taxc Neo via Zwift,319,320,-1
85060,52333,2020-12-19 09:04:42,neo,Zwift - e-liga | eCycling league Austria Race 3 (A),Favero Assioma Duo via Garmin 530,Taxc Neo via Garmin,325,327,-2
93734,52333,2021-01-09 09:29:05,neo,Zwift - DBR SufferDay League III (A),Favero Assioma Duo via Garmin 530,Taxc Neo via Zwift,369,376,-7
98086,52333,2021-01-16 09:04:04,neo,Zwift - e-liga | eCycling league Austria Race 4 (A),Favero Assioma Duo via Garmin 530,Taxc Neo via Zwift,343,351,-8
101738,52333,2021-01-23 09:04:26,neo,Zwift - e-liga | eCycling league Austria Race 5 (A),Favero Assioma Duo via Garmin 530,Taxc Neo via Garmin,354,360,-6
107391,52333,2021-02-02 18:25:05,neo,Zwift - Zwift Racing League | WTRL - Men&#039;s/Mixed EMEA E2 DIVISION 2 (A),Favero Assioma Duo via Garmin 530,Taxc Neo via Zwift,333,342,-9
109674,52333,2021-02-06 09:04:56,neo,Zwift - e-liga | eCycling league Austria Race 6 (A),Favero Assioma Duo via Garmin 530,Taxc Neo via Zwift,321,326,-5
111564,52333,2021-02-09 18:27:42,neo,Zwift - Zwift Racing League | WTRL - Men&#039;s/Mixed EMEA E2 DIVISION 2 (A),Favero Assioma Duo via Garmin 530,Taxc Neo via Zwift,340,347,-7
113820,52333,2021-02-13 08:59:39,neo,Zwift - Herd Beginner Racing Series (E) chaindrop race,Favero Assioma Duo via Garmin 530,Taxc Neo via Zwift,320,327,-7
118092,52333,2021-02-20 09:04:29,neo,Zwift - e-liga | eCycling league Austria Race 7 (A),Favero Assioma Duo via Garmin 530,Taxc Neo via Zwift,362,369,-7
119628,52333,2021-02-23 18:24:22,neo,Zwift - Zwift Racing League | WTRL - Men&#039;s/Mixed EMEA E2 DIVISION 2 (A),Favero Assioma Duo via Garmin 530,Taxc Neo via Garmin,339,341,-2
124944,52333,2021-03-06 09:04:27,neo,Zwift - e-liga | eCycling league Austria Race 8 (A),Favero Assioma Duo via Garmin 530,Taxc Neo via Zwift,375,379,-4
50713,52589,2020-08-19 13:35:44,wahoo,Zwift - France,power binnen,wahoo kickr core,328,345,-17
52495,52589,2020-08-29 11:21:38,wahoo,Zwift - VO2 Max training,power binnen,wahoo kickr core,410,394,16
53541,52589,2020-09-05 12:52:08,wahoo,Zwift - France,power binnen,wahoo kickr core,342,336,6
57637,52589,2020-09-26 08:29:46,wahoo,Zwift - Three Sisters Reverse,power binnen,wahoo kickr core,402,390,12
57927,52589,2020-09-27 14:59:51,wahoo,Zwift - La Reine ,power binnen,wahoo kickr core,367,340,27
61584,52589,2020-10-13 18:44:33,wahoo,Zwift - Zwift Racing League | WTRL,power binnen,wahoo kickr core,388,382,6
64878,52589,2020-10-25 14:15:53,wahoo,Zwift - France,power binnen,wahoo kickr core,343,329,14
65506,52589,2020-10-27 19:47:59,wahoo,Zwift - Zwift Racing League | WTRL - EMEA W (MEN) -  Division 4 (A),power binnen,wahoo kickr core,400,387,13
67672,52589,2020-11-03 19:57:04,wahoo,Zwift - Zwift Racing League | WTRL - Men&#039;s EMEA W1 DIVISION 4 (A),power binnen,wahoo kickr core,353,350,3
69858,52589,2020-11-10 19:47:22,wahoo,Zwift - Zwift Racing League | WTRL - EMEA W1 (MEN) -  Division 4 (A),power binnen,wahoo kickr core,423,407,16
82650,52589,2020-12-13 09:00:51,wahoo,Zwift - Zwift Fondo Series 2020/21 (B),power binnen,wahoo kickr core,363,350,13
90570,52589,2021-01-03 09:00:35,wahoo,Zwift - Zwift Fondo Series 2020/21 (B),power binnen,wahoo kickr core,365,355,10
95783,52589,2021-01-12 19:45:10,wahoo,Zwift - Zwift Racing League | WTRL - Men&#039;s/Mixed EMEA W1 DIVISION 2 (A),power binnen,wahoo kickr core,411,381,30
103638,52589,2021-01-26 19:43:44,wahoo,Zwift - Zwift Racing League | WTRL - Men&#039;s/Mixed EMEA W1 DIVISION 2 (A),power binnen,wahoo kickr core,396,377,19
105517,52589,2021-01-30 11:34:24,wahoo,KNWU Fondo Combi-duur-bloktraining #fietsmetfondo,power binnen,wahoo kickr core,366,358,8
106589,52589,2021-02-01 10:15:00,wahoo,KNWU Fondo Tempo-duurtraining #fietsmetfondo,power binnen,wahoo kickr core,294,283,11
107483,52589,2021-02-02 19:43:28,wahoo,Zwift - Zwift Racing League | WTRL - Men&#039;s/Mixed EMEA W1 DIVISION 2 (A),power binnen,wahoo kickr core,380,390,-10
109755,52589,2021-02-06 10:29:28,wahoo,Zwift - Zwift Fondo Series: Medio Fondo,power binnen,wahoo kickr core,383,377,6
115995,52589,2021-02-16 19:45:54,wahoo,Zwift - Zwift Racing League | WTRL - Men&#039;s/Mixed EMEA W1 DIVISION 2 (A),power binnen,wahoo kickr core,398,405,-7
121169,52589,2021-02-26 13:57:48,wahoo,Zwift - Haute Route Watopia 2021 Stage 1 (B),power binnen,wahoo kickr core,370,376,-6
121628,52589,2021-02-27 13:57:42,wahoo,Zwift - Haute Route Watopia 2021 Stage 2 (B),power binnen,wahoo kickr core,350,357,-7
122023,52589,2021-02-28 09:57:31,wahoo,Zwift - Haute Route Watopia 2021 Stage 3 (B),power binnen,wahoo kickr core,362,348,14
107019,53224,2021-02-02 00:00:02,neo,TDZ Stage 6: Group Ride,Pioneer SGY-PM910V,Tacx Neo,253,250,3
108543,53224,2021-02-02 00:00:02,neo,Zwift - TDZ Stage 6: Longer Ride,Pioneer SGY-PM910V,Tacx Neo,253,250,3
618,53292,2019-08-21 18:05:53,wahoo,Zwift - DBR Wednesday Race (B),Quarq Dzero91,Kickr&#039;15,272,280,-8
1572,53322,2019-09-10 18:10:16,wahoo,FUSION ECT Racing League,Power2max NG (Principia D2S),Wahoo KICKR &#039;18,338,324,14
4992,53322,2019-11-27 16:10:12,wahoo,Zwift - 3R Tick Tock Flat Race - 2 Lap (36km/22.4mi 100m) (A),Power2max NG (Principia D2S),Wahoo KICKR 18 (3),312,315,-3
5638,53322,2019-12-06 13:30:12,wahoo,Zwift - Danmarks Cykle Union #40omdagen (A) - No.14,Power2max NG (Principia D2S),Wahoo KICKR 18 (3),309,306,3
6001,53322,2019-12-11 16:30:13,wahoo,Sydkysten Cycling - Carl Ras Race,Power2max NG (Principia D2S),Wahoo KICKR 18 (3),347,346,1
6608,53322,2019-12-18 16:10:12,wahoo,Zwift - 3R Tick Tock Flat Race - 2 Lap (36km/22.4mi 100m) (A),Power2max NG (Principia D2S),Wahoo KICKR 18 (3),299,300,-1
7226,53322,2019-12-25 10:03:20,wahoo,Zwift - Maximus Shootout Time Trial (E) #FuckingHard :-(,Power2max NG (Principia D2S),Wahoo KICKR 18 (3),340,338,2
7456,53322,2019-12-28 09:00:14,wahoo,Zwift - Danmarks Cykle Union Punchers Special (A),Power2max NG (Principia D2S),Wahoo KICKR 18 (3),315,314,1
7660,53322,2019-12-30 17:30:13,wahoo,Zwift - Danmarks Cykle Union New Year&#039;s Special  (A),Power2max NG (Principia D2S),Wahoo KICKR 18 (3),326,326,0
7713,53322,2019-12-31 10:05:14,wahoo,Zwift - Ultimate - Goodbye 2019 By 3R (A),Power2max NG (Principia D2S),Wahoo KICKR 18 (3),323,319,4
7980,53322,2020-01-03 16:45:12,wahoo,Crit City Race,Power2max NG (Principia D2S),Wahoo KICKR 18 (3),323,316,7
8171,53322,2020-01-05 17:10:26,wahoo,Zwift - Zwift Bambino Fondo,Power2max NG (Principia D2S),Wahoo KICKR 18 (3),337,326,11
8229,53322,2020-01-06 19:01:16,wahoo,Zwift - FUSION eCT Power Source Check,Power2max NG (Principia D2S),Wahoo KICKR 18 (3),311,289,22
8347,53322,2020-01-07 20:46:37,wahoo,Zwift - FUSION eCT - Power Source Check,Power2max NG (Principia D2S),Wahoo KICKR 18 (3),311,294,17
8441,53322,2020-01-08 16:08:11,wahoo,Zwift - Calibration of Wahoo KICKR,Power2max NG (Principia D2S),Wahoo KICKR 18 (3),296,278,18
8443,53322,2020-01-08 16:42:45,wahoo,Zwift - Calibration of Wahoo KICKR,Power2max NG (Principia D2S),Wahoo KICKR 18 (3),306,291,15
8446,53322,2020-01-08 17:29:04,wahoo,Zwift - FUSION eCT - FreeRide,Power2max NG (Principia D2S),Wahoo KICKR 18 (3),260,248,12
8732,53322,2020-01-10 14:45:11,wahoo,Crit City Race,Power2max NG (Principia D2S),Wahoo KICKR 18 (3),335,328,7
8755,53322,2020-01-10 16:45:13,wahoo,Crit City Race,Power2max NG (Principia D2S),Wahoo KICKR 18 (3),325,321,4
8862,53322,2020-01-11 16:45:12,wahoo,Crit City Race,Power2max NG (Principia D2S),Wahoo KICKR 18 (3),342,332,10
8997,53322,2020-01-12 14:00:16,wahoo,Tour de Zwift: Stage 1 Group Ride,Power2max NG (Principia D2S),Wahoo KICKR 18 (3),322,313,9
9156,53322,2020-01-13 18:15:15,wahoo,Zwift - DBR Caresport Crit Cup  (A),Power2max NG (Principia D2S),Wahoo KICKR 18 (3),332,322,10
9693,53322,2020-01-16 18:30:12,wahoo,FUSION ECT BEUNSTOPPABLE Racing Series,Power2max NG (Principia D2S),Wahoo KICKR 18 (3),325,315,10
9860,53322,2020-01-18 09:00:13,wahoo,Zwift - Danmarks Cykle Union 2020 Cup (A),Power2max NG (Principia D2S),Wahoo KICKR 18 (3),339,325,14
9879,53322,2020-01-18 11:00:18,wahoo,Zwift - Tour de Zwift: Stage 2 Long Distance,Power2max NG (Principia D2S),Wahoo KICKR 18 (3),304,292,12
10157,53322,2020-01-20 18:15:13,wahoo,Zwift - DBR Caresport Crit Cup  (A),Power2max NG (Principia D2S),Wahoo KICKR 18 (3),319,308,11
10637,53322,2020-01-23 18:30:12,wahoo,Zwift - FUSION ECT BEUNSTOPPABLE Racing Series (A),Power2max NG (Principia D2S),Wahoo KICKR 18 (3),322,312,10
10638,53322,2020-01-23 19:30:18,wahoo,Zwift - Ride with Geraint Thomas and Eric Min,Power2max NG (Principia D2S),Wahoo KICKR 18 (3),225,218,7
11176,53322,2020-01-27 18:15:12,wahoo,Zwift - DBR Caresport Crit Cup  (A),Power2max NG (Principia D2S),Wahoo KICKR 18 (3),323,321,2
11320,53322,2020-01-28 18:20:13,wahoo,Zwift - WKG - CRITTY CRITTY BANG BANG (A),Power2max NG (Principia D2S),Wahoo KICKR 18 (3),319,312,7
11717,53322,2020-01-30 19:00:15,wahoo,Zwift - KALAS Cup - Round 1 (A),Power2max NG (Principia D2S),Wahoo KICKR 18 (3),342,332,10
11841,53322,2020-01-31 18:00:13,wahoo,Tour de Zwift: Stage 5 Group Ride,Power2max NG (Principia D2S),Wahoo KICKR 18 (3),343,336,7
11984,53322,2020-02-01 13:00:27,wahoo,Tour de Zwift: Stage 6 Group Ride,Power2max NG (Principia D2S),Wahoo KICKR 18 (3),307,304,3
12595,53322,2020-02-05 19:05:15,wahoo,DBR Wednesday Race,Power2max NG (Principia D2S),Wahoo KICKR 18 (3),329,323,6
12773,53322,2020-02-06 19:00:13,wahoo,Zwift - KALAS Cup - Round 2 (A),Power2max NG (Principia D2S),Wahoo KICKR 18 (3),340,335,5
12966,53322,2020-02-08 09:00:23,wahoo,Tour de Zwift: Stage 7 Group Ride,Power2max NG (Principia D2S),Wahoo KICKR 18 (3),312,311,1
13270,53322,2020-02-10 17:27:08,wahoo,Zwift -  Kiss Racing Team / FastFitnessTips iTT series,Power2max NG (Principia D2S),Wahoo KICKR 18 (3),343,338,5
13722,53322,2020-02-13 19:00:13,wahoo,Zwift - KALAS Cup - Round 3 (A) #DNF,Power2max NG (Principia D2S),Wahoo KICKR 18 (3),343,337,6
14044,53322,2020-02-15 11:00:12,wahoo,Zwift -  Chasing Cancellara Berlin (A),Power2max NG (Principia D2S),Wahoo KICKR 18 (3),323,318,5
14366,53322,2020-02-17 17:27:39,wahoo,Zwift -  Kiss Racing Team / FastFitnessTips iTT series,Power2max NG (Principia D2S),Wahoo KICKR 18 (3),344,338,6
15075,53322,2020-02-21 18:00:24,wahoo,Zwift - Tour of Innsbruck // Stage 1,Power2max NG (Principia D2S),Wahoo KICKR 18 (3),341,334,7
15147,53322,2020-02-22 09:30:19,wahoo,Zwift - Tour of Innsbruck // Stage 2 ,Power2max NG (Principia D2S),Wahoo KICKR 18 (3),323,317,6
15440,53322,2020-02-24 17:32:08,wahoo,Zwift -  Kiss Racing Team / FastFitnessTips iTT series,Power2max NG (BMC TM01),Wahoo KICKR 18 (3),343,334,9
15999,53322,2020-02-28 13:05:38,wahoo,Zwift - Zwift Fast Fridays: Tempus Fugit Time Trial (E),Power2max NG (BMC TM01),Wahoo KICKR 18 (3),356,347,9
16829,53322,2020-03-04 19:29:54,wahoo,Zwift - Zwift Beta Race (A) - No.34,Power2max NG (BMC TM01),Wahoo KICKR 18 (3),337,328,9
17360,53322,2020-03-09 16:00:23,wahoo,Zwift - Stage 1 - Longer Ride - Tour of Watopia 2020,Power2max NG (Principia D2S),Wahoo KICKR 18 (3),301,300,1
17677,53322,2020-03-11 16:01:22,wahoo,Zwift - Stage 1 - Shorter Ride - Tour of Watopia 2020,Power2max NG (Principia D2S),Wahoo KICKR 18 (3),324,321,3
17945,53322,2020-03-13 14:45:11,wahoo,Crit City Race,Power2max NG (Principia D2S),Wahoo KICKR 18 (3),342,342,0
18106,53322,2020-03-15 09:46:12,wahoo,Zwift - DIRTy Opposite Race (A),Power2max NG (Principia D2S),Wahoo KICKR 18 (3),320,316,4
18301,53322,2020-03-16 19:17:41,wahoo,Cape Epic Zwift Prologue - Tempus Fugit					 					,Power2max NG (Principia D2S),Wahoo KICKR 18 (3),278,278,0
18425,53322,2020-03-17 18:20:13,wahoo,WKG - CRITTY CRITTY BANG BANG,Power2max NG (Principia D2S),Wahoo KICKR 18 (3),329,329,0
18427,53322,2020-03-17 17:31:22,wahoo,Zwift - Stage 3 - Shorter Ride - Tour of Watopia 2020,Power2max NG (Principia D2S),Wahoo KICKR 18 (3),350,350,0
19982,53322,2020-03-27 18:30:13,wahoo,Slagelse Gold Race,Power2max NG (Principia D2S),Wahoo KICKR 18 (3),366,361,5
21789,53322,2020-04-03 16:00:25,wahoo, Haute Route Watopia Stage 1,Power2max NG (Principia D2S),Wahoo KICKR 18 (3),316,304,12
22345,53322,2020-04-04 07:00:23,wahoo,Zwift -  Haute Route Watopia Stage 2 (E),Power2max NG (Principia D2S),Wahoo KICKR 18 (3),288,281,7
22347,53322,2020-04-05 16:00:24,wahoo,Zwift -  Haute Route Watopia Stage 3 (E),Power2max NG (Principia D2S),Wahoo KICKR 18 (3),330,322,8
29803,53322,2020-04-30 19:00:02,wahoo,Zwift - Zwift Beta Race - No.10,Power2max NG (Principia D2S),Wahoo KICKR 18 (3),335,328,7
31694,53322,2020-05-05 18:15:24,wahoo,Zwift - UNO X CUP powered by DCU & Feltet.dk (A),Power2max NG (Principia D2S),Wahoo KICKR 18 (3),319,313,6
32018,53322,2020-05-06 15:00:16,wahoo,Boost Mode Test 1b,Power2max NG (Principia D2S),Wahoo KICKR 18 (3),325,317,8
32643,53322,2020-05-07 15:00:15,wahoo,Zwift - Boost Mode Test 3a (A),Power2max NG (Principia D2S),Wahoo KICKR 18 (3),353,333,20
34724,53322,2020-05-14 16:00:45,wahoo,"Zwift - Para-cycling Virtual Time Trial Series, hosted by U.S. Paralympics Cycling (E)",Power2max NG (Principia D2S),Wahoo KICKR 18 (3),346,344,2
34727,53322,2020-05-13 17:00:14,wahoo,Zwift - Boost Mode Test 5a (A),Power2max NG (Principia D2S),Wahoo KICKR 18 (3),324,317,7
35307,53322,2020-05-16 11:00:20,wahoo,Tour for All 2020: Stage 4 Group Ride,Power2max NG (Principia D2S),Wahoo KICKR 18 (3),336,329,7
45115,53322,2020-07-06 15:00:51,wahoo,Zwift - Virtual Tour de France - Open - Stage 1 Discovery Ride,Power2max NG (Principia D2S),Wahoo KICKR 18 (3),345,342,3
45776,53322,2020-07-10 11:00:53,wahoo,Zwift - Virtual Tour de France - Open - Stage 1 Discovery Ride - No.3,Power2max NG (Principia D2S),Wahoo KICKR 18 (3),347,342,5
45790,53322,2020-07-10 15:00:59,wahoo,Zwift - Virtual Tour de France - Open - Stage 2 Discovery Ride - No.4,Power2max NG (Principia D2S),Wahoo KICKR 18 (3),342,331,11
47531,53322,2020-07-22 13:01:17,wahoo,Zwift - Virtual Tour de France - Open - Stage 5 Discovery Ride,Power2max NG (Principia D2S),Wahoo KICKR 18 (3),332,323,9
47534,53322,2020-07-24 11:01:12,wahoo,Zwift - Virtual Tour de France - A - Stage 6 Discovery Ride,Power2max NG (Principia D2S),Wahoo KICKR 18 (3),324,316,8
50410,53322,2020-08-17 16:00:22,wahoo,Zwift - Off The MAAP Stage 1 - Longer Ride with Matt Stephens,Power2max NG (Principia D2S),Wahoo KICKR 18 (3),345,341,4
57064,53322,2020-09-23 17:45:15,wahoo,Zwift - DCU powered by Feltet.dk (A),Power2max NG (Principia D2S),Wahoo KICKR 18 (3),322,316,6
58536,53322,2020-09-30 17:45:17,wahoo,Zwift - DCU powered by Feltet.dk (A),Power2max NG (Principia D2S),Wahoo KICKR 18 (3),328,323,5
58537,53322,2020-09-27 08:02:13,wahoo,Zwift - 40km - Dempsey Challenge Ride - No.5,Power2max NG (Principia D2S),Wahoo KICKR 18 (3),314,311,3
62203,53322,2020-10-15 17:30:19,wahoo,Zwift - FUSION ECT BEUNSTOPPABLE Racing Series (A),Power2max NG (Principia D2S),Wahoo KICKR 18 (3),305,302,3
67949,53322,2020-11-04 19:00:12,wahoo,Zwift - DCU – Feltet.dk November series,Power2max NG (Principia D2S),Wahoo KICKR v5,342,334,8
70254,53322,2020-11-11 17:15:16,wahoo,Zwift - 40-49 years,Power2max NG (Principia D2S),Wahoo KICKR v5,324,317,7
73232,53322,2020-11-19 19:30:22,wahoo,Zwift - World Championships Experience // Danish Cycling Federation,Power2max NG (Principia D2S),Wahoo KICKR v5,328,322,6
78835,53322,2020-12-02 18:00:01,wahoo,Zwift - Podcast Recon Ride: Episode 2 (E),Power2max NG (Principia D2S),Wahoo KICKR v5,309,301,8
79647,53322,2020-12-05 10:00:16,wahoo,Zwift - Nations Challenge // Denmark (E),Power2max NG (Principia D2S),Wahoo KICKR v5,304,302,2
83003,53322,2020-12-12 08:00:17,wahoo,Zwift - Zwift NL - Lekker tochtje hoor! (E),Power2max NG (Principia D2S),Wahoo KICKR v5,302,300,2
83005,53322,2020-12-13 09:00:33,wahoo,Zwift - Zwift Fondo Series 2020/21 (A),Power2max NG (Principia D2S),Wahoo KICKR v5,309,304,5
84333,53322,2020-12-17 17:05:40,wahoo,"Zwift - Para-cycling Virtual Time Trial Series, hosted by U.S. Paralympics Cycling - No.1",Power2max NG (Principia D2S),Wahoo KICKR v5,344,334,10
90996,53322,2021-01-03 17:02:24,wahoo,Zwift - Zwift Fondo Series 2020/21 (C),Power2max NG (Principia D2S),Wahoo KICKR v5,339,334,5
94910,53322,2021-01-11 18:10:46,wahoo,Zwift - TRI247 Manic Monday Time Trial (E),Power2max NG (Principia D2S),Wahoo KICKR v5,348,340,8
96913,53322,2021-01-14 17:02:30,wahoo,Zwift - TDZ Stage 3: Standard Ride,Power2max NG (Principia D2S),Wahoo KICKR v5,349,346,3
102736,53322,2021-01-24 15:00:26,wahoo,Zwift - TDZ Stage 5: Longer Ride,Power2max NG (Principia D2S),Wahoo KICKR v5,341,346,-5
103519,53322,2021-01-26 18:05:35,wahoo,Zwift - Zwift Time Trial Tuesday: Bologna (E),Power2max NG (Principia D2S),Wahoo KICKR v5,361,359,2
105190,53322,2021-01-29 17:00:22,wahoo,Zwift - TDZ Stage 6: Longer Ride,Power2max NG (Principia D2S),Wahoo KICKR v5,334,337,-3
109329,53322,2021-02-04 17:30:28,wahoo,Zwift - Ryzon Days of Dedication: Stage 1 ,Power2max NG (Principia D2S),Wahoo KICKR v5,349,347,2
113819,53322,2021-02-13 08:41:05,wahoo,Zwift - Chasing Cancellara Time Trial - No.9 - 352 watt AVG,Power2max NG (Principia D2S),Wahoo KICKR v5,357,355,2
114599,53322,2021-02-14 09:42:17,wahoo,Zwift - Chasing Cancellara Time Trial (A) No.17 - 337 watt AVG,Power2max NG (Principia D2S),Wahoo KICKR v5,344,345,-1
121391,53322,2021-02-26 17:00:16,wahoo,Zwift - Haute Route Watopia 2021 Stage 1 (A),Power2max NG (Principia D2S),Wahoo KICKR v5,332,332,0
121959,53322,2021-02-27 09:00:16,wahoo,Zwift - Haute Route Watopia 2021 Stage 2 (A),Power2max NG (Principia D2S),Wahoo KICKR v5,322,321,1
69312,53515,2020-11-09 10:53:13,wahoo,Zwift - KISS at Base Training Ride (B),Vector 3,Kick core Bluetooth ,283,286,-3
69314,53515,2020-11-06 10:53:18,wahoo,Zwift - KISS at Base Training Ride (B),Assioma,Kick core Bluetooth ,288,303,-15
69695,53515,2020-11-10 10:49:43,wahoo,Zwift - All American Bikes Ride presented by GRIT (B),Vector 3,Kick core Bluetooth ,289,300,-11
69697,53515,2020-11-10 11:50:25,wahoo,Zwift - Kinetic Group Ride (B),Vector 3,Kick core Bluetooth ,253,264,-11
104164,53544,2021-01-27 18:29:52,wahoo,Zwift - NCF Vintercup 2021 - Runde 3 - Herrer (A),Quarq Dzero til Wahoo Elemnt,Kickr V5,394,381,13
93516,53789,2021-01-08 18:49:59,wahoo,Zwift - Team CLS Racing - Hills &#039;n&#039; Thrills S5 (E),Stages,Wahoo Kickr,322,311,11
94948,53789,2021-01-11 18:33:22,wahoo,Zwift - XRS Races: Monday&#039;s blues (A),Stages,Wahoo Kickr,325,323,2
119307,53860,2021-02-22 21:30:11,neo,Zwift - France,2021-02-22-213018-ELEMNT ROAM AD23-19-0,Tacx Neo,152,154,-2
124712,53860,2021-03-05 20:03:56,neo,Zwift - Endurance (65%) 1.5 hrs,stages,Tacx Neo,257,259,-2
124713,53860,2021-03-04 20:04:01,neo,Zwift - Tempo 2x20,stages,Tacx Neo,309,316,-7
124960,53860,2021-03-06 13:36:23,neo,Zwift - 4x5 RPE 9 1:1,stages,Tacx Neo,414,435,-21
125579,53860,2021-03-07 21:48:25,neo,Zwift - 2x15 88% (1.5 hrs),stages,Tacx Neo,348,348,0
126983,53860,2021-03-11 14:00:02,neo,Zwift - TWENTY24 Road To Tokyo (D),stages,Tacx Neo,320,326,-6
14187,54019,2020-02-16 08:00:00,wahoo,Zwift - 🇫🇮 NikiBirling.com&#039;s Meetup - Tour of Fire and Ice,Quarq CX,Wahoo Kickr,320,310,10
15137,54019,2020-02-22 07:45:00,wahoo,Zwift - 3R 160 Steady Ride [~3.0w/kg avg] (B),Vector 3,Wahoo Kickr,255,244,11
83134,54019,2020-12-14 16:59:54,wahoo,Zwift - EVO CC Flux Ride [1.5 - 2.0w/kg avg] (D),Vector 3,Wahoo Kickr,225,221,4
84298,54019,2020-12-17 15:59:59,wahoo,Zwift - Antti Salonen&#039;s Meetup - Lutscher,Vector 3,Wahoo Kickr,265,266,-1
98655,54019,2021-01-17 16:30:14,wahoo,Zwift - Niki Birling [IBD]&#039;s Meetup - Big Foot Hills,Vector 3,Wahoo Kickr,353,357,-4
118990,54019,2021-02-21 17:00:00,wahoo,Zwift - Mikael Turunen [IBD]&#039;s Meetup - The Pretzel,Vector 3,Wahoo Kickr,287,288,-1
119542,54019,2021-02-23 15:59:46,wahoo,Zwift - Jussi Heiro&#039;s Meetup - Casse-Pattes,Vector 3,Wahoo Kickr,414,410,4
124187,54403,2021-03-04 18:48:08,wahoo,Zwift - AHDR Bacon Rolls (B),Quarq dzero,Wahoo kickr,357,334,23
124601,54403,2021-03-05 19:04:50,wahoo,Zwift - Zwift Racing League | WTRL Battle Royale Playoff - Men&#039;s Points Race (A),Quarq dzero,Wahoo kickr,454,428,26
125172,54403,2021-03-06 19:50:57,wahoo,Zwift - Zwift Racing League | WTRL Battle Royale Playoff - Men&#039;s TTT (A),Quarq dzero,Wahoo kickr,441,416,25
75853,54564,2020-11-26 11:10:01,wahoo,Power2max ANT to Wahoo Roam / Kickr BLE Zwift ,Power2max ANT to Wahoo Roam,Kickr BLE Zwift ,355,351,4
82290,54564,2020-12-12 08:59:42,wahoo,ZTS &quot;2&quot; Race 2,Power2max mit ANt+ Wahoo Roam,Kickr BLE Zwift ,409,386,23
90131,54564,2021-01-02 09:00:21,wahoo,ZTS II Race 3 ,4min später aufgezeichnet  Power2max mit ANt+ Wahoo Roam,Kickr BLE Zwift ,400,391,9
92992,54564,2021-01-07 19:02:54,wahoo,Zwift - WTRL Team Time Trial - Zone 7 (C),Power2max mit ANt+ Wahoo Roam,Kickr 2019 BLE Zwift ,405,394,11
95828,54564,2021-01-12 19:46:58,wahoo,Zwift - Zwift Racing League | WTRL - Men&#039;s/Mixed EMEA W1 DIVISION 3 (A),Power2max mit ANt+ Wahoo Roam,Kickr 2019 BLE Zwift ,394,422,-28
97169,54564,2021-01-14 19:08:19,wahoo,Zwift - WTRL Team Time Trial - Zone 7 (C) ,Später gestartet 6km Power2max mit ANt+ Wahoo Roam,Kickr 2019 BLE Zwift ,380,388,-8
97941,54564,2021-01-16 08:59:52,wahoo,Zwift - ZTS Season II - Race 4 ,Power2max mit ANt + Wahoo Roam,Kickr 2019 BLE Zwift ,388,384,4
101079,54564,2021-01-21 19:01:58,wahoo,Zwift - WTRL Team Time Trial - Zone 7 (C),Power2max mit ANt + Wahoo Roam,Kickr BLE Zwift ,377,374,3
103881,54564,2021-01-26 19:46:48,wahoo,Zwift - Zwift Racing League | WTRL - Men&#039;s/Mixed EMEA W1 DIVISION 3 (A),Power2max mit ANt+ Wahoo Roam,Kickr BLE Zwift ,427,419,8
104847,54564,2021-01-28 19:01:54,wahoo,Zwift - WTRL Team Time Trial - Zone 7 (C),Power2max mit ANt + Wahoo Roam,Kickr 2019 BLE Zwift ,379,379,0
105526,54564,2021-01-30 08:59:58,wahoo,Zwift - ZTS Season II - Race 5 (A),Power2max mit ANt + Wahoo Roam,Kickr 2019 BLE Zwift ,390,384,6
107603,54564,2021-02-02 19:46:54,wahoo,Zwift - Zwift Racing League | WTRL - Men&#039;s/Mixed EMEA W1 DIVISION 3 (A),Power2max mit ANt + Wahoo Roam,Kickr 2019 BLE Zwift ,435,405,30
109030,54564,2021-02-04 18:32:00,wahoo,Zwift - WTRL Team Time Trial - Zone 6 (C),Power2max mit ANt + Wahoo Roam,Kickr 2019 BLE Zwift ,404,390,14
127740,54564,2021-03-13 09:00:00,wahoo,Zwift - ZTS Season II - Race 8 - das grosse Finale! (A),2021-03-13-090000-ELEMNT_ROAM_D404-87-0,Kickr BLE Zwift ,390,391,-1
127745,54564,2021-03-13 09:00:00,wahoo,Zwift - ZTS Season II - Race 8 - das grosse Finale! (A),Power2max AnT Wahoo Roam,Kickr 2019 BLE Zwift ,390,391,-1
53735,54593,2020-09-07 11:29:50,wahoo,Zwift - 3R Innsbruckring Flat Race - 3 Laps (26.4km/16.4mi 231m) (A),Garmin 3S Vector Pedals,Wahoo Kickr,314,319,-5
53920,54593,2020-09-08 12:24:53,wahoo,Zwift - EMU Japan Race (A),Garmin 3S Vector Pedals,Wahoo Kickr,347,353,-6
54644,54593,2020-09-11 13:35:01,wahoo,Zwift - Crit City Race (A),Garmin 3S Vector Pedals,Wahoo Kickr,321,323,-2
55031,54593,2020-09-14 17:59:56,wahoo,Zwift - Invitational League // Qualifying Race #1,Garmin 3S Vector Pedals,Wahoo Kickr,380,360,20
55200,54593,2020-09-14 19:26:57,wahoo,Zwift - NYC,Garmin 3S Vector Pedals,Wahoo Kickr,282,266,16
55532,54593,2020-09-16 12:40:43,wahoo,Zwift - Nick Hird [CRYO RDT]&#039;s Meetup - Champs-Élysées,Garmin 3S Vector Pedals,Wahoo Kickr,302,294,8
55861,54593,2020-09-17 18:29:52,wahoo,Zwift - Invitational League // Qualifying Race #2 (Men) ,Garmin 3S Vector Pedals,Wahoo Kickr,337,338,-1
56251,54593,2020-09-19 11:14:59,wahoo,Zwift - Herd Summer Racing League Race 5 (A),Garmin 3S Vector Pedals,Wahoo Kickr,331,334,-3
56631,54593,2020-09-21 12:39:48,wahoo,Zwift - 3R Volcano Climb Race - 1 Lap (22.4km/14mi 204m) (A),Garmin 3S Vector Pedals,Wahoo Kickr,355,361,-6
56805,54593,2020-09-22 13:14:53,wahoo,Zwift - 3R Figure 8 Hilly Reverse Race - 1 Lap (29.2km/18.1mi 234m ) (A),Garmin 3S Vector Pedals,Wahoo Kickr,324,326,-2
56985,54593,2020-09-23 11:59:53,wahoo,Zwift - TTR Mini RACE (A),Garmin 3S Vector Pedals,Wahoo Kickr,358,362,-4
57207,54593,2020-09-24 11:30:05,wahoo,Zwift - Eastern Canadian Quest Racing Series (ECQRS) (A),Garmin 3S Vector Pedals,Wahoo Kickr,361,362,-1
57679,54593,2020-09-26 11:01:12,wahoo,Zwift - Herd Summer Racing League Series (A),Garmin 3S Vector Pedals,Wahoo Kickr,383,372,11
58229,54593,2020-09-29 11:49:50,wahoo,Zwift - TTR Weekly  (A),Garmin 3S Vector Pedals,Wahoo Kickr,347,342,5
58467,54593,2020-09-30 12:59:56,wahoo,Zwift - KISS at Race - Pacific AM (A),Garmin 3S Vector Pedals,Wahoo Kickr,335,333,2
59066,54593,2020-10-02 14:05:17,wahoo,Zwift - 3R Innsbruckring Flat Race - 2 Laps (17.6km/10.9m 154m) (A),Garmin 3S Vector Pedals,Wahoo Kickr,347,343,4
59430,54593,2020-10-04 13:44:47,wahoo,Zwift - Herd Summer Racing League Series (A),Garmin 3S Vector Pedals,Wahoo Kickr,334,345,-11
59571,54593,2020-10-05 13:39:57,wahoo,Zwift - 3R Richmond UCI Hilly Race - 1 Lap (16.2km/10.1mi 142m) (A),Garmin 3S Vector Pedals,Wahoo Kickr,344,348,-4
60573,54593,2020-10-09 12:49:57,wahoo,Zwift - KISS at Race - Pacific AM (A),Garmin 3S Vector Pedals,Wahoo Kickr,380,372,8
61067,54593,2020-10-11 13:44:55,wahoo,Zwift - Herd Summer Racing League Series (A),Garmin 3S Vector Pedals,Wahoo Kickr,393,376,17
61686,54593,2020-10-14 00:06:23,wahoo,Zwift - ZADA Test - Three Sisters,Garmin 3S Vector Pedals,Wahoo Kickr,346,341,5
62086,54593,2020-10-15 13:04:50,wahoo,Zwift - 3R Knickerbocker Climbing Race - 1 Lap (22.4km/13.9mi 365m) (A),Garmin 3S Vector Pedals,Wahoo Kickr,359,368,-9
62595,54593,2020-10-17 11:15:21,wahoo,Zwift - Herd Summer Racing League Series (A),Garmin 3S Vector Pedals,Wahoo Kickr,346,351,-5
63503,54593,2020-10-20 17:16:35,wahoo,Zwift - Zwift Racing League | WTRL - EMEA E (MEN) - TTT Grp 1,Garmin 3S Vector Pedals,Wahoo Kickr,328,342,-14
64208,54593,2020-10-22 17:25:44,wahoo,Zwift - Espresso,Garmin 3S Vector Pedals,Wahoo Kickr,356,349,7
64694,54593,2020-10-24 19:14:45,wahoo,Zwift - Herd Summer Racing League Series (A),Garmin 3S Vector Pedals,Wahoo Kickr,320,310,10
65612,54593,2020-10-27 23:44:55,wahoo,Zwift - Zwift Racing League | WTRL - AMERICAS E (MEN) -  Division 1 (A),Garmin 3S Vector Pedals,Wahoo Kickr,373,364,9
66031,54593,2020-10-29 11:29:56,wahoo,Zwift - Eastern Canadian Quest Racing Series (ECQRS) (A),Garmin 3S Vector Pedals,Wahoo Kickr,356,367,-11
66406,54593,2020-10-30 12:19:56,wahoo,Zwift - Peak-PTY Climb Challenge Fridays (A),Garmin 3S Vector Pedals,Wahoo Kickr,339,355,-16
66774,54593,2020-10-31 18:59:53,wahoo,Zwift - EVR Summer Series (A),Garmin 3S Vector Pedals,Wahoo Kickr,346,338,8
67178,54593,2020-11-02 12:59:56,wahoo,Zwift - ZA Road 2020 - Segment Ride #1: Three Sisters Course,Garmin 3S Vector Pedals,Wahoo Kickr,343,334,9
67537,54593,2020-11-03 13:14:52,wahoo,Zwift - 3R Figure 8 Hilly Reverse Race - 1 Lap (29.2km/18.1mi 234m ) (A),Garmin 3S Vector Pedals,Wahoo Kickr,330,330,0
68106,54593,2020-11-05 13:04:55,wahoo,Zwift - 3R Knickerbocker Climbing Race - 1 Lap (22.4km/13.9mi 365m) (A),Garmin 3S Vector Pedals,Wahoo Kickr,355,380,-25
68894,54593,2020-11-07 19:10:00,wahoo,Zwift - ZA Road Race #1: 4 - 5 w/kg,Garmin 3S Vector Pedals,Wahoo Kickr,367,361,6
69999,54593,2020-11-11 00:45:00,wahoo,Zwift - Zwift Racing League | WTRL - AMERICAS E (MEN) -  Division 1 (A),Garmin 3S Vector Pedals,Wahoo Kickr,392,391,1
70603,54593,2020-11-12 12:24:49,wahoo,Zwift - EMU Japan Race (A),Garmin 3S Vector Pedals,Wahoo Kickr,347,350,-3
71490,54593,2020-11-14 20:00:00,wahoo,Zwift - Cycling Australia&#039;s PretzHELL by AHDR (B),Garmin 3S Vector Pedals,Wahoo Kickr,324,299,25
72131,54593,2020-11-16 12:59:48,wahoo,Zwift - ZA Road 2020 - Segment Ride #1: Innsbruck Course,2020-11-16-06-59-48,Wahoo Kickr,343,334,9
72411,54593,2020-11-18 00:52:54,wahoo,Zwift - Zwift Racing League | WTRL - Men&#039;s AMERICAS E DIVISION 1 (A),Garmin 3S Vector Pedals,Wahoo Kickr,335,337,-2
73446,54593,2020-11-20 12:19:57,wahoo,Zwift - Peak-PTY Climb Challenge Fridays (A),Garmin 3S Vector Pedals,Wahoo Kickr,356,359,-3
73917,54593,2020-11-21 17:00:20,wahoo,Zwift - Cycling Canada Pre-Worlds Showdown Series (A),Garmin 3S Vector Pedals,Wahoo Kickr,412,390,22
75273,54593,2020-11-25 00:44:50,wahoo,Zwift - Zwift Racing League | WTRL - Men&#039;s AMERICAS E DIVISION 1,Garmin 3S Vector Pedals,Wahoo Kickr,372,363,9
75874,54593,2020-11-26 13:04:56,wahoo,Zwift - 3R Knickerbocker Climbing Race - 1 Lap (22.4km/13.9mi 365m) (A),Garmin 3S Vector Pedals,Wahoo Kickr,386,355,31
76578,54593,2020-11-27 18:29:51,wahoo,Zwift - Team WEZ Friday Race (E),Garmin 3S Vector Pedals,Wahoo Kickr,354,351,3
77584,54593,2020-11-30 13:39:53,wahoo,Zwift - 3R Richmond UCI Hilly Race - 1 Lap (16.2km/10.1mi 142m) (A),Garmin 3S Vector Pedals,Wahoo Kickr,350,354,-4
78285,54593,2020-12-02 00:53:45,wahoo,Zwift - Zwift Racing League | WTRL - Men&#039;s AMERICAS E DIVISION 1 (A),Garmin 3S Vector Pedals,Wahoo Kickr,349,347,2
78869,54593,2020-12-03 13:04:51,wahoo,Zwift - 3R Knickerbocker Climbing Race - 1 Lap (22.4km/13.9mi 365m) (A),Garmin 3S Vector Pedals,Wahoo Kickr,364,385,-21
79424,54593,2020-12-04 17:00:40,wahoo,Zwift - Zwift Fast Fridays: Bologna Time Trial (E),Garmin 3S Vector Pedals,Wahoo Kickr,368,345,23
79893,54593,2020-12-05 17:59:58,wahoo,Zwift - Nations Challenge // USA (E),Garmin 3S Vector Pedals,Wahoo Kickr,346,336,10
80796,54593,2020-12-08 18:14:59,wahoo,Zwift - Zwift Racing League | WTRL - Men&#039;s EMEA E1 DIVISION 1 (A),Garmin 3S Vector Pedals,Wahoo Kickr,377,367,10
80994,54593,2020-12-09 00:44:57,wahoo,Zwift - Zwift Racing League | WTRL - Men&#039;s AMERICAS E DIVISION 1 (A),Garmin 3S Vector Pedals,Wahoo Kickr,352,358,-6
81986,54593,2020-12-11 15:14:45,wahoo,Zwift - 3R Sand and Sequoias Race (A),Garmin 3S Vector Pedals,Wahoo Kickr,328,329,-1
82446,54593,2020-12-12 16:29:58,wahoo,Zwift - TEAM VEGAN Tofu Tornado (A),Garmin 3S Vector Pedals,Wahoo Kickr,383,377,6
83756,54593,2020-12-16 00:54:00,wahoo,Zwift - Zwift Racing League | WTRL - Men&#039;s AMERICAS E DIVISION 1 (A),Garmin 3S Vector Pedals,Wahoo Kickr,345,342,3
84250,54593,2020-12-17 13:04:50,wahoo,Zwift - 3R Knickerbocker Climbing Race - 1 Lap (22.4km/13.9mi 365m) (A),Garmin 3S Vector Pedals,Wahoo Kickr,367,370,-3
85224,54593,2020-12-19 16:59:50,wahoo,Zwift - Tour of New York Stage 2 - Open Longer,Garmin 3S Vector Pedals,Wahoo Kickr,365,372,-7
85225,54593,2020-12-19 18:02:58,wahoo,Zwift - World Uniform E-cycling Championship Frenchy Fuzion,Garmin 3S Vector Pedals,Wahoo Kickr,373,363,10
85437,54593,2020-12-20 14:59:54,wahoo,Zwift - Tour of New York Stage 3 - Open Longer,Garmin 3S Vector Pedals,Wahoo Kickr,345,355,-10
86462,54593,2020-12-23 13:59:39,wahoo,Zwift - KISS Race Series - Pacific AM (A),Garmin 3S Vector Pedals,Wahoo Kickr,356,371,-15
87191,54593,2020-12-25 13:49:54,wahoo,Zwift - KISS Race Series - Pacific AM (A),Garmin 3S Vector Pedals,Wahoo Kickr,394,373,21
88985,54593,2020-12-30 12:59:36,wahoo,Zwift - ZHQ FutureWorks Crit City Race - Boost mode (A),Garmin 3S Vector Pedals,Wahoo Kickr,319,339,-20
88986,54593,2020-12-30 13:29:32,wahoo,Zwift - ZHQ FutureWorks Circuit Race - Anti-sandbagging (A),Garmin 3S Vector Pedals,Wahoo Kickr,336,336,0
90353,54593,2021-01-02 16:29:51,wahoo,Zwift - TEAM VEGAN Tofu Tornado (A),Garmin 3S Vector Pedals,Wahoo Kickr,358,353,5
91212,54593,2021-01-04 13:39:49,wahoo,Zwift - 3R Richmond UCI Hilly Race - 1 Lap (16.2km/10.1mi 142m) (A),Garmin 3S Vector Pedals,Wahoo Kickr,345,346,-1
91669,54593,2021-01-05 11:59:54,wahoo,Zwift - TDZ Stage 1: Longer Ride,Garmin 3S Vector Pedals,Wahoo Kickr,358,351,7
92225,54593,2021-01-06 13:01:59,wahoo,Zwift - TDZ Stage 1: Standard Ride,Garmin 3S Vector Pedals,Wahoo Kickr,345,343,2
92700,54593,2021-01-07 13:04:57,wahoo,Zwift - 3R Knickerbocker Climbing Race - 1 Lap (22.4km/13.9mi 365m) (A),Garmin 3S Vector Pedals,Wahoo Kickr,370,389,-19
94030,54593,2021-01-09 18:01:59,wahoo,Zwift - TDZ Stage 2: Standard Ride,Garmin 3S Vector Pedals,Wahoo Kickr,348,343,5
94031,54593,2021-01-09 16:29:58,wahoo,Zwift - TEAM VEGAN Tofu Tornado (A),Garmin 3S Vector Pedals,Wahoo Kickr,355,357,-2
94439,54593,2021-01-10 14:59:55,wahoo,Zwift - TDZ Stage 2: Longer Ride,Garmin 3S Vector Pedals,Wahoo Kickr,359,347,12
95591,54593,2021-01-12 18:14:45,wahoo,Zwift - Zwift Racing League | WTRL - Men&#039;s/Mixed EMEA E1 DIVISION 1 (A),Garmin 3S Vector Pedals,Wahoo Kickr,380,371,9
96293,54593,2021-01-13 15:02:00,wahoo,Zwift - TDZ Stage 2: Standard Ride,Garmin 3S Vector Pedals,Wahoo Kickr,346,333,13
96811,54593,2021-01-14 11:59:59,wahoo,Zwift - TDZ Stage 3: Longer Ride,Garmin 3S Vector Pedals,Wahoo Kickr,336,332,4
97467,54593,2021-01-15 16:02:58,wahoo,Zwift - TDZ Stage 3: Shorter Ride,Garmin 3S Vector Pedals,Wahoo Kickr,326,308,18
98178,54593,2021-01-16 16:29:59,wahoo,Zwift - TEAM VEGAN Tofu Tornado (A),Garmin 3S Vector Pedals,Wahoo Kickr,374,355,19
99982,54593,2021-01-20 00:54:25,wahoo,Zwift - Zwift Racing League | WTRL - Men&#039;s/Mixed AMERICAS E DIVISION 1 (A),Garmin 3S Vector Pedals,Wahoo Kickr,355,356,-1
100199,54593,2021-01-20 14:00:00,wahoo,Zwift - KISS Race Series - Pacific AM (A),Garmin 3S Vector Pedals,Wahoo Kickr,345,346,-1
100759,54593,2021-01-21 12:59:54,wahoo,Zwift - TDZ Stage 4: Longer Ride,Garmin 3S Vector Pedals,Wahoo Kickr,341,337,4
102015,54593,2021-01-23 16:29:45,wahoo,Zwift - TEAM VEGAN Tofu Tornado (A),Garmin 3S Vector Pedals,Wahoo Kickr,418,404,14
102374,54593,2021-01-24 12:59:55,wahoo,Zwift - TDZ Stage 5: Standard Ride,Garmin 3S Vector Pedals,Wahoo Kickr,363,349,14
103796,54593,2021-01-27 00:45:43,wahoo,Zwift - Zwift Racing League | WTRL - Men&#039;s/Mixed AMERICAS E DIVISION 1 (A),Garmin 3S Vector Pedals,Wahoo Kickr,364,363,1
104018,54593,2021-01-27 14:03:12,wahoo,Zwift - TDZ Stage 5: Shorter Ride,Garmin 3S Vector Pedals,Wahoo Kickr,337,313,24
104524,54593,2021-01-28 12:59:54,wahoo,Zwift - TDZ Stage 5: Longer Ride,Garmin 3S Vector Pedals,Wahoo Kickr,388,375,13
105084,54593,2021-01-29 13:02:54,wahoo,Zwift - TDZ Stage 6: Shorter Ride,Garmin 3S Vector Pedals,Wahoo Kickr,318,316,2
105707,54593,2021-01-30 16:29:51,wahoo,Zwift - Veganuary21 Stage 5 iTT (A),Garmin 3S Vector Pedals,Wahoo Kickr,357,351,6
106626,54593,2021-02-01 13:00:00,wahoo,Zwift - TDZ Stage 6: Longer Ride,Garmin 3S Vector Pedals,Wahoo Kickr,399,389,10
107729,54593,2021-02-03 00:45:57,wahoo,Zwift - Zwift Racing League | WTRL - Men&#039;s/Mixed AMERICAS E DIVISION 1 (A),Garmin 3S Vector Pedals,Wahoo Kickr,368,359,9
108318,54593,2021-02-03 18:59:58,wahoo,Zwift - Open - Movistar Team Challenge Community Qualifier Race #1,Garmin 3S Vector Pedals,Wahoo Kickr,392,385,7
110065,54593,2021-02-06 15:59:58,wahoo,Zwift - TDZ Stage 7: Longer Ride,Garmin 3S Vector Pedals,Wahoo Kickr,363,364,-1
110877,54593,2021-02-08 13:59:53,wahoo,Zwift - TDZ Stage 8: Group Ride,Garmin 3S Vector Pedals,Wahoo Kickr,333,333,0
111886,54593,2021-02-10 00:54:22,wahoo,Zwift - Zwift Racing League | WTRL - Men&#039;s/Mixed AMERICAS E DIVISION 1 (A),Garmin 3S Vector Pedals,Wahoo Kickr,359,364,-5
112108,54593,2021-02-10 12:04:57,wahoo,Zwift - G7 Cycling Club CHINA Group Training Ride (B),Garmin 3S Vector Pedals,Wahoo Kickr,341,339,2
114226,54593,2021-02-13 15:37:18,wahoo,Zwift - Chasing Cancellara Time Trial,Garmin 3S Vector Pedals,Wahoo Kickr,381,402,-21
114230,54593,2021-02-13 16:16:58,wahoo,Zwift - TDZ Stage 2: Standard Ride,Garmin 3S Vector Pedals,Wahoo Kickr,343,326,17
116204,54593,2021-02-17 00:45:58,wahoo,Zwift - Zwift Racing League | WTRL - Men&#039;s/Mixed AMERICAS E DIVISION 1 (A),Garmin 3S Vector Pedals,Wahoo Kickr,382,390,-8
117128,54593,2021-02-18 13:02:52,wahoo,Zwift - TDZ Stage 5: Shorter Ride,Garmin 3S Vector Pedals,Wahoo Kickr,345,328,17
117759,54593,2021-02-19 15:29:58,wahoo,Zwift - BST Mountaingoat Race (A),Garmin 3S Vector Pedals,Wahoo Kickr,359,375,-16
118194,54593,2021-02-20 12:09:54,wahoo,Zwift - DIRT Dadurday Chase Race  (A),Garmin 3S Vector Pedals,Wahoo Kickr,339,327,12
119943,54593,2021-02-24 00:45:49,wahoo,Zwift - Zwift Racing League | WTRL - Men&#039;s/Mixed AMERICAS E DIVISION 1 (A),Garmin 3S Vector Pedals,Wahoo Kickr,344,351,-7
120506,54593,2021-02-24 13:59:59,wahoo,Zwift - KISS Race Series - Pacific AM (A),Garmin 3S Vector Pedals,Wahoo Kickr,398,398,0
121195,54593,2021-02-26 14:59:52,wahoo,Zwift - Haute Route Watopia 2021 Stage 1 (A),Garmin 3S Vector Pedals,Wahoo Kickr,375,361,14
121718,54593,2021-02-27 15:59:58,wahoo,Zwift - Haute Route Watopia 2021 Stage 2 (A),Garmin 3S Vector Pedals,Wahoo Kickr,366,369,-3
122081,54593,2021-02-28 13:59:55,wahoo,Zwift - Haute Route Watopia 2021 Stage 3 (A),Garmin 3S Vector Pedals,Wahoo Kickr,333,333,0
123249,54593,2021-03-03 00:54:21,wahoo,Zwift - Zwift Racing League | WTRL - Men&#039;s/Mixed AMERICAS E DIVISION 1 (A),Garmin 3S Vector Pedals,Wahoo Kickr,353,353,0
123470,54593,2021-03-03 14:00:00,wahoo,Zwift - KISS Race Series - Pacific AM (A),Garmin 3S Vector Pedals,Wahoo Kickr,371,369,2
123923,54593,2021-03-04 13:04:59,wahoo,Zwift - 3R Knickerbocker Climbing Race - 1 Lap (22.4km/13.9mi 365m) (A),Garmin 3S Vector Pedals,Wahoo Kickr,367,388,-21
125053,54593,2021-03-06 16:04:45,wahoo,Zwift - 3R Endurance Series p/b OTE Sports (E),Garmin 3S Vector Pedals,Wahoo Kickr,336,329,7
125421,54593,2021-03-07 15:29:52,wahoo,Zwift - Absa Cape Epic Stage 1 pb Oakley - Open (A),Garmin 3S Vector Pedals,Wahoo Kickr,368,376,-8
125742,54593,2021-03-08 14:29:56,wahoo,Zwift - Aero Army Wyn TT Series (A),Garmin 3S Vector Pedals,Wahoo Kickr,388,390,-2
126066,54593,2021-03-09 11:34:14,wahoo,Zwift - Absa Cape Epic Stage 2 Time Trial pb Dimension Data - Open (A),Garmin 3S Vector Pedals,Wahoo Kickr,365,374,-9
126730,54593,2021-03-10 21:31:51,wahoo,Zwift - Absa Cape Epic Stage 2 Time Trial pb Dimension Data - Open (A),Garmin 3S Vector Pedals,Wahoo Kickr,373,399,-26
126973,54593,2021-03-11 14:59:06,wahoo,Zwift - Watopia,Garmin 3S Vector Pedals,Wahoo Kickr,321,322,-1
127518,54593,2021-03-12 16:29:52,wahoo,Zwift - Absa Cape Epic Stage 3 pb ABUS - Open	 (A),Garmin 3S Vector Pedals,Wahoo Kickr,357,348,9
127970,54593,2021-03-13 15:29:53,wahoo,Zwift - Absa Cape Epic Stage 4 pb Assos - Open (A),Garmin 3S Vector Pedals,Wahoo Kickr,364,367,-3
129024,54593,2021-03-16 12:26:55,wahoo,Zwift - Innsbruck,Garmin 3S Vector Pedals,Wahoo Kickr,354,348,6
129589,54593,2021-03-17 12:59:52,wahoo,Zwift - KISS Race Series - Pacific AM (A),Garmin 3S Vector Pedals,Wahoo Kickr,361,373,-12
115300,54943,2021-02-15 19:19:52,wahoo,Zwift - Team TFC Mad Monday Winter Series (A),Quarq Dzero ,Wahoo Kickr Power V5 (Loes),329,327,2
125843,54943,2021-03-08 19:20:22,wahoo,Zwift - Team TFC Mad Monday Race Series (low-end categories) (A),Quarq Dzero ,Wahoo Kickr Power V5 (Loes),340,336,4
36999,55166,2020-05-23 08:59:59,wahoo,Zwift - EUROSPORT Polska ,Stages,Kickr,364,345,19
37316,55166,2020-05-24 10:09:56,wahoo,Zwift - 3R Sand & Sequoias - 1 Lap (20km/12.5mi 173m) (A),Zwift,Kickr,326,324,2
61792,55166,2020-10-14 11:09:50,wahoo,TT,Stages,Kickr,350,339,11
64751,55166,2020-10-25 06:09:52,wahoo,ZA Road - Race #2,Stages,Kickr,341,334,7
64968,55166,2020-10-26 00:19:58,wahoo,Zwift - Watopia,Stages,Kickr,351,338,13
65270,55166,2020-10-26 23:44:50,wahoo,Zwift - Endurance,Stages,Kickr,281,277,4
82680,55166,2020-12-13 11:53:01,wahoo,Zwift - Test,Assioma Duo,Kickr,288,305,-17
83055,55166,2020-12-14 10:48:27,wahoo,Zwift - Watopia,Assioma Duo,Kickr,175,171,4
83059,55166,2020-12-14 11:19:53,wahoo,Crit City,Assioma Duo,Kickr,303,291,12
4484,55688,2019-11-19 18:59:56,wahoo,Zwift - ZwiftTeamPL League – Sprinters Series (A),Power2Max NGEco,Wahoo Kickr,332,335,-3
6735,55688,2019-12-19 18:29:59,wahoo,Zwift - FUSION ECT BEUNSTOPPABLE Racing Series (A),Power2Max NGEco,Wahoo Kickr,336,335,1
10006,55688,2020-01-19 15:10:17,wahoo,Zwift - Tour de Zwift: Stage 2 Race (A),Power2Max NGEco,Wahoo Kickr,343,349,-6
10284,55688,2020-01-21 18:10:16,wahoo,Zwift - Tour de Zwift: Stage 3 Race (A),Power2Max NGEco,Wahoo Kickr,363,358,5
10285,55688,2020-01-21 18:59:59,wahoo,Zwift - ZTPL.CC League – Climbers Series (A),Power2Max NGEco,Wahoo Kickr,336,334,2
10792,55688,2020-01-24 18:10:01,wahoo,Zwift - Tour de Zwift: Stage 4 Race (A),Power2Max NGEco,Wahoo Kickr,380,378,2
11363,55688,2020-01-28 19:39:52,wahoo,Tour de Zwift: Stage 5 Race,Power2Max NGEco,Wahoo Kickr,330,330,0
12379,55688,2020-02-04 18:09:57,wahoo,Tour de Zwift: Stage 6 Race,Power2Max NGEco,Wahoo Kickr,361,363,-2
12383,55688,2020-02-04 19:00:00,wahoo,ZwiftTeamPL League – Sprinters Series,Power2Max NGEco,Wahoo Kickr,316,316,0
12758,55688,2020-02-06 18:20:03,wahoo,Zwift -  Kiss Racing Team / FastFitnessTips iTT series (E),Power2Max NGEco,Wahoo Kickr,374,371,3
13038,55688,2020-02-08 18:09:58,wahoo,Tour de Zwift: Stage 7 Race,Power2Max NGEco,Wahoo Kickr,347,343,4
13423,55688,2020-02-11 19:00:05,wahoo,Zwift - ZwiftTeamPL League – Climbers Series (A),Power2Max NGEco,Wahoo Kickr,356,362,-6
14539,55688,2020-02-18 19:00:15,wahoo,Zwift - ZwiftTeamPL League – Classic Series (A),Power2Max NGEco,Wahoo Kickr,357,354,3
14912,55688,2020-02-20 18:21:55,wahoo,Zwift - WTRL Team Time Trial (C),Power2Max NGEco,Wahoo Kickr,350,345,5
15576,55688,2020-02-25 18:59:57,wahoo,Zwift - ZTPL.CC League  – Sprinters Series (A),Power2Max NGEco,Wahoo Kickr,357,358,-1
15762,55688,2020-02-26 19:20:21,wahoo,Zwift - ZTPL.CC CoffeeRide (B),Power2Max NGEco,Wahoo Kickr,332,341,-9
67605,55688,2020-11-03 18:30:16,wahoo,Zwift - ZTPL.CC 3daysINhell Stage 1 (E),Power2Max NGEco,Wahoo Kickr,337,329,8
68710,55688,2020-11-07 08:59:57,wahoo,Zwift - ZTPL.CC 3daysINhell Stage 2 (E),Power2Max NGEco,Wahoo Kickr,312,310,2
69806,55688,2020-11-10 18:30:02,wahoo,Zwift - ZTPL.CC 3daysINhell Stage 3 (E),Power2Max NGEco,Wahoo Kickr,348,342,6
76078,55688,2020-11-26 19:00:11,wahoo,Zwift - ZTPL.CC ITT League (E),Power2Max NGEco,Wahoo Kickr,313,309,4
76726,55688,2020-11-28 08:59:59,wahoo,Zwift - ZTPL.CC ITT League (E),Power2Max NGEco,Wahoo Kickr,352,342,10
95683,55688,2021-01-12 18:30:14,wahoo,Zwift - ZTPL.CC Classic Race (E),Power2Max NGEco,Wahoo Kickr,351,349,2
99839,55688,2021-01-19 18:30:03,wahoo,Zwift - The Carnival Race League Stage 1 with ZTPL.CC (A),Power2Max NGEco,Wahoo Kickr,339,335,4
107636,55688,2021-02-02 18:30:01,wahoo,Zwift - The Carnival Race League Stage 5 with ZTPL.CC (A),Power2Max NGEco,Wahoo Kickr V5,342,345,-3
110124,55688,2021-02-06 17:00:01,wahoo,Zwift - The Carnival Race League Stage 6 with ZTPL.CC (A),Power2Max NGEco,Wahoo Kickr V5,333,336,-3
114288,55688,2021-02-13 17:00:00,wahoo,Zwift - ZTPL.CC Winter League 2021 Stage 8 (A),Power2Max NGEco,Wahoo Kickr V5,346,347,-1
115953,55688,2021-02-16 18:29:59,wahoo,Zwift - ZTPL.CC Winter League 2021 Stage 9 (A),Power2Max NGEco,Wahoo Kickr V5,354,365,-11
118511,55688,2021-02-20 16:59:53,wahoo,Zwift - ZTPL.CC Winter League 2021 Stage 10 (A),Power2Max NGEco,Wahoo Kickr V5,337,337,0
121771,55688,2021-02-27 16:59:55,wahoo,Zwift -  ZTPL.CC Winter League 2021 Stage 12 (A),Karoo-Evening_Ride-Feb-27-2021-175957,Wahoo Kickr V5,331,335,-4
125570,55688,2021-03-07 17:00:15,wahoo,Zwift - MISTRZOSTWA ZTPL.CC (E),Karoo-Evening_Ride-Mar-07-2021-180017,Wahoo Kickr V5,357,361,-4
6422,56138,2019-12-16 18:01:50,wahoo,Zwift - SZR Evening Joyride (C),Garmin Vector 3.0,Wahoo Kickr 2018,188,188,0
6639,56138,2019-12-18 19:04:37,wahoo,Zwift - DBR HEINO CUP (E),Garmin Vector 3.0,Wahoo Kickr 2018,265,266,-1
8221,56138,2020-01-06 17:54:59,wahoo,Zwift - 4x9 min Tempo intervals,Garmin Vector 3.0,Wahoo Kickr 2018,228,232,-4
8597,56138,2020-01-08 18:35:42,wahoo,Zwift - DBR HEINO CUP (E),Garmin Vector 3.0,Wahoo Kickr 2018,257,257,0
8883,56138,2020-01-11 19:03:52,wahoo,Zwift - Tour de Zwift // Pro-Am Invitational,Garmin Vector 3.0,Wahoo Kickr 2018,255,260,-5
9529,56138,2020-01-15 19:04:30,wahoo,Zwift - DBR HEINO CUP (E),Garmin Vector 3.0,Wahoo Kickr 2018,262,263,-1
10041,56138,2020-01-19 19:12:24,wahoo,Zwift - Tour de Zwift // Pro-Am Invitational,Garmin Vector 3.0,Wahoo Kickr 2018,264,269,-5
10480,56138,2020-01-22 19:04:17,wahoo,Zwift - DBR HEINO CUP (E),Garmin Vector 3.0,Wahoo Kickr 2018,257,260,-3
11727,56138,2020-01-30 19:01:29,wahoo,Zwift - KALAS Cup - Round 1 (E),Garmin Vector 3.0,Wahoo Kickr 2018,254,256,-2
12387,56138,2020-02-04 19:42:58,wahoo,Zwift - Tour de Zwift // Pro-Am Invitational (A),Garmin Vector 3.0,Wahoo Kickr 2018,264,268,-4
12785,56138,2020-02-06 18:59:34,wahoo,Zwift - KALAS Cup - Round 2 (E),Garmin Vector 3.0,Wahoo Kickr 2018,276,284,-8
13741,56138,2020-02-13 19:02:38,wahoo,Zwift - KALAS Cup - Round 3 (E),Garmin Vector 3.0,Wahoo Kickr 2018,245,249,-4
14945,56138,2020-02-20 19:00:37,wahoo,Zwift - KALAS Cup - Round 4 (E),Garmin Vector 3.0,Wahoo Kickr 2018,248,247,1
15889,56138,2020-02-27 19:02:01,wahoo,Zwift - KALAS Cup - Round 5 (E),Garmin Vector 3.0,Wahoo Kickr 2018,236,251,-15
16170,56138,2020-02-29 18:54:24,wahoo,Zwift - Fierce Felines Racing Series: Circuit (A),Garmin Vector 3.0,Wahoo Kickr 2018,253,260,-7
16947,56138,2020-03-05 19:02:13,wahoo,Zwift - KALAS Cup - Round 6 (E),Garmin Vector 3.0,Wahoo Kickr 2018,246,247,-1
17297,56138,2020-03-08 19:12:39,wahoo,Zwift - Tour of Watopia Pro-Am Women&#039;s Race #1 (A),Garmin Vector 3.0,Wahoo Kickr 2018,286,294,-8
17847,56138,2020-03-12 19:02:44,wahoo,Zwift - KALAS Cup - Round 7 (E),Garmin Vector 3.0,Wahoo Kickr 2018,237,243,-6
18012,56138,2020-03-14 09:08:48,wahoo,Zwift - Stage 2 Race (B) - Tour of Watopia 2020,Garmin Vector 3.0,Wahoo Kickr 2018,247,257,-10
18297,56138,2020-03-16 19:13:27,wahoo,Tour of Watopia Pro-Am Womens Race #2,Garmin Vector 3.0,Wahoo Kickr 2018,281,292,-11
18725,56138,2020-03-19 19:02:36,wahoo,Zwift - KALAS Cup - Round 8 (E),Garmin Vector 3.0,Wahoo Kickr 2018,259,262,-3
19439,56138,2020-03-24 19:42:35,wahoo,Tour of Watopia Pro-Am Womens Race #3,Garmin Vector 3.0,Wahoo Kickr 2018,257,264,-7
19803,56138,2020-03-26 19:02:16,wahoo,Zwift - KALAS Cup - Round 9 (E),Garmin Vector 3.0 (Secondary pw source),Wahoo Kickr 2018 (Zwift),267,277,-10
20869,56138,2020-03-31 18:02:59,wahoo,Zwift - NCF Spring Cup (E),Garmin Vector 3.0 (Secondary pw source),Wahoo Kickr 2018 (Zwift),274,282,-8
22349,56138,2020-04-05 18:09:10,wahoo,Zwift - Yorkshire Grand Prix // Zwift Classic,Garmin Vector 3.0 (Secondary pw source),Wahoo Kickr 2018 (Zwift),274,280,-6
22797,56138,2020-04-07 17:57:58,wahoo,Zwift - NCF Spring Cup (E),Garmin Vector 3.0 (Secondary pw source),Wahoo Kickr 2018 (Zwift),279,286,-7
24317,56138,2020-04-13 18:08:50,wahoo,Zwift - Trofeo Bologna // Zwift Classic (A),Garmin Vector 3.0 (Secondary pw source),Wahoo Kickr 2018 (Zwift),296,301,-5
24637,56138,2020-04-14 18:03:02,wahoo,Zwift - NCF Spring Cup (E),Garmin Vector 3.0 (Secondary pw source),Wahoo Kickr 2018 (Zwift),260,268,-8
28820,56138,2020-04-28 18:03:06,wahoo,Zwift - NCF Spring Cup (E),Garmin Vector 3.0 (Secondary pw source),Wahoo Kickr 2018 (Zwift),250,258,-8
30624,56138,2020-05-02 15:58:59,wahoo,Zwift - YANA Pro/AM Invitiational (B),Garmin Vector 3.0 (Secondary pw source),Wahoo Kickr 2018 (Zwift),260,265,-5
36829,56138,2020-05-22 10:04:00,wahoo,Zwift - Team 3R&#039;s Choice: Stage 5 Longer Race A/B,Garmin Vector 3.0 (Secondary pw source),Wahoo Kickr 2018 (Zwift),249,252,-3
46077,56138,2020-07-12 17:58:58,wahoo,Zwift - L&#039;Etape du Tour Stage 2 - Women Only,Garmin Vector 3.0 (Secondary pw source),Wahoo Kickr 2018 (Zwift),254,257,-3
53576,56138,2020-09-05 17:27:00,wahoo,Zwift - EVR Summer Series (B),Verve Infocranc - Secondary pw source,"Kickr 2018, Zwift pw source",272,282,-10
53767,56138,2020-09-07 18:10:31,wahoo,Zwift - Forte Race Series (E),Verve Infocranc - Secondary pw source,"Kickr 2018, Zwift pw source",250,254,-4
55143,56138,2020-09-14 18:25:53,wahoo,Zwift - Invitational League // Qualifying Race #1 (Women),Verve Infocranc - Secondary pw source,"Kickr 2018, Zwift pw source",265,272,-7
55798,56138,2020-09-17 17:51:29,wahoo,Zwift - Invitational League // Qualifying Race #2 (Women) (A),Verve Infocranc - Secondary pw source,"Kickr 2018, Zwift pw source",252,255,-3
56539,56138,2020-09-20 13:24:03,wahoo,Zwift - Invitational League // Qualifying Race #3 (Women) (A),Verve Infocranc - Secondary pw source,"Kickr 2018, Zwift pw source",255,265,-10
57023,56138,2020-09-23 17:16:58,wahoo,Zwift - NCF Vinter Cup 2020 - Runde 1 - Kvinner (A),Verve Infocranc - Secondary pw source,"Kickr 2018, Zwift pw source",263,269,-6
57737,56138,2020-09-26 13:40:16,wahoo,Zwift - Watopia three sisters,Verve Infocranc - Secondary pw source,"Kickr 2018, Zwift pw source",269,277,-8
60181,56138,2020-10-07 17:40:58,wahoo,Zwift - NCF Vinter Cup 2020 - Runde 3 - Kvinner (A),Verve Infocranc - Secondary pw source,"Kickr 2018, Zwift pw source",257,268,-11
61292,56138,2020-10-12 17:42:24,wahoo,Zwift - Premier Division // Zwift Racing League (women) (A),Verve Infocranc - Secondary pw source,"Kickr 2018, Zwift pw source",263,271,-8
63176,56138,2020-10-19 19:00:00,wahoo,Zwift - Premier Division // Zwift Racing League (women) (A),Verve Infocranc - Secondary pw source,"Kickr 2018, Zwift pw source",248,248,0
63876,56138,2020-10-21 17:43:00,wahoo,Zwift - NCF Vinter Cup 2020 - Runde 5 - Kvinner (A),Verve Infocranc - Secondary pw source,"Kickr 2018, Zwift pw source",253,258,-5
65119,56138,2020-10-26 18:59:52,wahoo,Zwift - Premier Division // Zwift Racing League (women) ,Verve Infocranc - Secondary pw source,"Kickr 2018, Zwift pw source",259,257,2
65859,56138,2020-10-28 18:43:00,wahoo,Zwift - NCF Vinter Cup 2020 - Runde 6 - Kvinner (A),Verve Infocranc - Secondary pw source,"Kickr 2018, Zwift pw source",276,279,-3
67335,56138,2020-11-02 19:55:31,wahoo,Zwift - Premier Division // Zwift Racing League (women) (A),Verve Infocranc - Secondary pw source,"Kickr 2018, Zwift pw source",248,252,-4
69374,56138,2020-11-09 19:00:16,wahoo,Zwift - Premier Division // Zwift Racing League (women) (A),Verve Infocranc - Secondary pw source,"Kickr 2018, Zwift pw source",296,303,-7
70283,56138,2020-11-11 18:42:00,wahoo,Zwift - NCF Vinter Cup 2020 - Runde 8 - Kvinner (A),Verve Infocranc - Secondary pw source,"Kickr 2018, Zwift pw source",258,263,-5
71982,56138,2020-11-16 19:55:00,wahoo,Zwift - Premier Division // Zwift Racing League (women) (A),Verve Infocranc - Secondary pw source,"Kickr 2018, Zwift pw source",235,235,0
72694,56138,2020-11-18 18:41:14,wahoo,Zwift - NCF Vinter Cup 2020 - Runde 9 - Kvinner (A),Verve Infocranc - Secondary pw source,"Kickr 2018, Zwift pw source",256,260,-4
73186,56138,2020-11-19 19:31:38,wahoo,Zwift - World Championships Experience // Danish Cycling Federation,Verve Infocranc - Secondary pw source,"Kickr 2018, Zwift pw source",252,251,1
73762,56138,2020-11-21 08:45:05,neo,Zwift - Caroline Vamnes [DRAFT]&#039;s Meetup - Tire-Bouchon,Verve Infocranc - Secondary pw source,Taxc Neo,174,165,9
74632,56138,2020-11-23 18:49:21,wahoo,Zwift - Premier Division // Zwift Racing League (women) (A),Verve Infocranc - Secondary pw source,"Kickr 2018, Zwift pw source",273,274,-1
76063,56138,2020-11-25 18:40:50,wahoo,Zwift - NCF Vinter Cup 2020 - Runde 10 - Kvinner (A),Verve Infocranc - Secondary pw source,"Kickr 2018, Zwift pw source",277,280,-3
77786,56138,2020-11-30 19:58:00,wahoo,Zwift - Premier Division // Zwift Racing League (women) (A),Verve Infocranc - Secondary pw source,"Kickr 2018, Zwift pw source",251,260,-9
86850,56138,2020-12-24 08:27:18,wahoo,Zwift - KISS Race Series - Down Under (B),Garmin Vector 3.0 (Secondary pw source),"Kickr 2018, Zwift pw source",260,261,-1
92952,56138,2021-01-07 19:02:59,wahoo,Zwift - first TTT with new teammates :) ,Verve Infocranc - Secondary pw source,"Kickr 2018, Zwift pw source",253,259,-6
95157,56138,2021-01-11 20:01:45,wahoo,Zwift - Premier Division // Zwift Racing League (women) (A),Verve Infocranc - Secondary pw source,"Kickr 2018, Zwift pw source",271,277,-6
100965,56138,2021-01-21 18:46:39,wahoo,WTRL - TTT,Verve Infocranc - Secondary pw source,"Kickr 2018, Zwift pw source",251,255,-4
103035,56138,2021-01-25 19:58:48,wahoo,Zwift - Premier Division // Zwift Racing League (women) (A),Verve Infocranc - Secondary pw source,"Kickr 2018, Zwift pw source",264,271,-7
104720,56138,2021-01-28 18:46:40,wahoo,Zwift - Espresso,Verve Infocranc - Secondary pw source,"Kickr 2018, Zwift pw source",261,263,-2
111131,56138,2021-02-08 19:51:19,wahoo,Zwift - Premier Division // Zwift Racing League (women) (A),Verve Infocranc - Secondary pw source,"Kickr 2018, Zwift pw source",261,264,-3
113001,56138,2021-02-11 18:57:39,wahoo,Zwift - WTRL Team Time Trial - Zone 9 (E),Verve Infocranc - Secondary pw source,"Kickr 2018, Zwift pw source",258,258,0
115793,56138,2021-02-16 17:27:00,wahoo,Zwift - ZHR Masters (D),Verve Infocranc - Secondary pw source,"Kickr 2018, Zwift pw source",255,264,-9
129366,56138,2021-03-16 18:31:27,wahoo,Zwift - Women Only // CeramicSpeed Race Series: Open Race,Verve Infocranc - Secondary pw source,"Kickr 2018, Zwift pw source",254,259,-5
6496,56469,2019-12-17 17:56:40,wahoo,Zwift - Danmarks Cykle Union Racing League (A),Rotor 2Inpower,Wahoo KICKR,343,345,-2
8638,56469,2020-01-09 17:18:40,wahoo,Zwift - Danmarks Cykle Union 2020 Cup (A),Rotor 2Inpower,Wahoo KICKR,298,305,-7
9873,56469,2020-01-18 08:47:28,wahoo,Zwift - Danmarks Cykle Union 2020 Cup (A),Rotor 2Inpower,Wahoo KICKR,327,327,0
11003,56469,2020-01-11 14:44:34,wahoo,Zwift - Danmarks Cykle Union 2020 Cup (A),Rotor 2Inpower,Wahoo KICKR,377,380,-3
11337,56469,2020-01-28 17:59:59,wahoo,Zwift - Danmarks Cykle Union 2020 Cup (A),Rotor 2Inpower,Wahoo KICKR,359,367,-8
11960,56469,2020-02-01 08:46:29,wahoo,Zwift - Danmarks Cykle Union 2020 Cup (A),Rotor 2Inpower,Wahoo KICKR,390,384,6
12285,56469,2020-02-03 17:00:46,wahoo,Zwift - Danmarks Cykle Union 2020 Cup (A),Rotor 2Inpower,Wahoo KICKR,370,360,10
12771,56469,2020-02-06 17:08:49,wahoo,Zwift - Danmarks Cykle Union 2020 Cup (A),Rotor 2Inpower,Wahoo KICKR,356,357,-1
13096,56469,2020-02-09 08:47:28,wahoo,Zwift - Danmarks Cykle Union 2020 Cup (A),Rotor 2Inpower,Wahoo KICKR,348,356,-8
13099,56469,2020-02-09 08:47:28,wahoo,Zwift - Tour de Zwift: Stage 7 - Long Distance,Rotor 2Inpower,Wahoo KICKR,327,337,-10
13552,56469,2020-02-11 15:08:44,wahoo,Zwift - Tour de Zwift: Stage 3 Group Ride - Long Distance,Rotor 2Inpower,Wahoo KICKR,334,342,-8
13553,56469,2020-02-12 14:59:04,wahoo,Zwift - Tour de Zwift: Stage 5 Long Distance,Rotor 2Inpower,Wahoo KICKR,348,350,-2
13937,56469,2020-02-14 14:33:36,wahoo,Zwift - Tour de Zwift: Stage 1 Long Distance,Rotor 2Inpower,Wahoo KICKR,364,362,2
14338,56469,2020-02-16 13:57:52,wahoo,Zwift - KISS at Race 100 - Americas (A),Rotor 2Inpower,Wahoo KICKR,347,355,-8
14633,56469,2020-02-18 18:34:48,wahoo,Zwift - Feltet.dk Race Series,Rotor 2Inpower,Wahoo KICKR,344,351,-7
15026,56469,2020-02-21 07:33:02,wahoo,Zwift - Tour of Innsbruck // Stage 1,Rotor 2Inpower,Wahoo KICKR,340,348,-8
15156,56469,2020-02-22 09:00:53,wahoo,Zwift - Tour of Innsbruck // Stage 2 ,Rotor 2Inpower,Wahoo KICKR,355,362,-7
15252,56469,2020-02-23 08:15:55,wahoo,Zwift - Tour of Innsbruck // Stage 3,Rotor 2Inpower,Wahoo KICKR,359,362,-3
16001,56469,2020-02-28 12:30:04,wahoo,Zwift - Zwift Fast Fridays: Tempus Fugit Time Trial (E),Rotor 2Inpower,Wahoo KICKR,355,363,-8
16288,56469,2020-03-01 13:46:27,wahoo,Zwift - Zwift Medio Fondo,Rotor 2Inpower,Wahoo KICKR,356,362,-6
17495,56469,2020-03-10 14:59:22,wahoo,Zwift - Stage 1 - Longer Ride - Tour of Watopia 2020,Rotor 2Inpower,Wahoo KICKR,311,318,-7
31718,56469,2020-05-05 17:35:09,wahoo,Zwift -  RCC Zwift Mens Championships - EMEA Region (E),Rotor 2Inpower,Wahoo KICKR,356,363,-7
32515,56469,2020-05-07 17:33:23,wahoo,Zwift -  RCC Zwift Mens Championships - Semi Final 1 (EMEA) (E),Rotor 2Inpower,Wahoo KICKR,362,368,-6
32932,56469,2020-05-09 08:39:24,wahoo,Zwift -  EUROSPORT Polska ,Rotor 2Inpower,Wahoo KICKR,353,359,-6
33318,56469,2020-05-10 11:53:47,wahoo,Zwift -  RCC Zwift Championships - Men&#039;s Final,Rotor 2Inpower,Wahoo KICKR,370,381,-11
33949,56469,2020-05-12 15:02:13,wahoo,Zwift - 3R & Wahoo Ride Real Race Series - Round 1 of 7 (A),Rotor 2Inpower,Wahoo KICKR,338,349,-11
35027,56469,2020-05-14 16:20:06,wahoo,Zwift - Tour for All 2020: Stage 3 Longer Race A/B,Rotor2Inpower,Wahoo KICKR,360,365,-5
35028,56469,2020-05-14 16:20:06,wahoo,Zwift - FUSION ECT BEUNSTOPPABLE Racing Series (A),Rotor 2Inpower,Wahoo KICKR,373,382,-9
35273,56469,2020-05-16 08:38:20,wahoo,Zwift - EUROSPORT Polska ,Rotor 2Inpower to Zwift,Wahoo KICKR to Garmin Edge 1050,350,358,-8
36054,56469,2020-05-19 14:44:11,wahoo,Zwift - 3R & Wahoo Ride Real Race Series - Round 2 of 7 (A),Rotor 2Inpower to Zwift,Wahoo KICKR to Garmin Edge 1050,351,361,-10
37066,56469,2020-05-23 08:41:12,wahoo,Zwift - EUROSPORT Polska ,Rotor 2Inpower to Zwift,Wahoo KICKR to Garmin Edge 1030,349,356,-7
37402,56469,2020-05-24 12:52:37,wahoo,Zwift - Tour for All 2020: Stage 2 Longer Race A/B,Rotor 2Inpower to Zwift,Wahoo KICKR to Garmin Edge 1030,374,374,0
37404,56469,2020-05-24 12:52:37,wahoo,Zwift - Tour for All 2020: Stage 4 Longer Race A/B,Rotor 2Inpower to Zwift,Wahoo KICKR to Garmin Edge 1030,335,339,-4
37825,56469,2020-05-26 14:36:18,wahoo,Zwift - 3R & Wahoo Ride Real Race Series - Round 3 of 7 (A),Rotor 2Inpower to Zwift,Wahoo KICKR to Garmin Edge 1030,360,356,4
37827,56469,2020-05-26 14:36:18,wahoo,Zwift - Team 3R&#039;s Choice: Stage 5 Longer Race A/B,Rotor 2Inpower to Zwift,Wahoo KICKR to Garmin Edge 1030,370,367,3
38682,56469,2020-05-30 08:33:51,wahoo,Zwift - EUROSPORT Polska ,Rotor 2Inpower to Zwift,Wahoo KICKR to Garmin Edge 1030,383,379,4
39087,56469,2020-06-02 14:42:19,wahoo,Zwift - 3R & Wahoo Ride Real Race Series - Round 4 of 7 (A),Rotor 2Inpower to Zwift,Wahoo KICKR to Garmin Edge 1030,354,351,3
39704,56469,2020-06-03 16:41:36,wahoo,Zwift - 3R Classique Flat Race - 6 Laps (37.7km/23.4mi 114m) (A),Rotor 2Inpower to Zwift,Wahoo KICKR to Garmin Edge 1030,330,335,-5
39705,56469,2020-06-03 16:41:36,wahoo,Zwift - British Triathlon Handicap Race (A),Rotor 2Inpower to Zwift,Wahoo KICKR to Garmin Edge 1030,344,338,6
39958,56469,2020-06-06 08:17:42,wahoo,Zwift - DBR Sufferday League (A),Rotor 2Inpower to Zwift,Wahoo KICKR to Garmin Edge 1030,339,342,-3
41263,56469,2020-06-12 15:04:09,wahoo,Zwift - 3R Sand and Sequoias Race (A),Rotor 2Inpower to Zwift,Wahoo KICKR to Garmin Edge 1030,335,336,-1
44225,56469,2020-06-30 14:08:15,wahoo,Zwift - Sydkysten Cycling - Carl Ras Race (A),Rotor 2Inpower to Zwift,Wahoo KICKR to Garmin Edge 1030,347,347,0
44226,56469,2020-06-30 14:08:15,wahoo,Zwift - 3R Volcano Circuit Flat Race - 8 Laps (35.2km/21.9mi 160m) (A),Rotor 2Inpower to Zwift,Wahoo KICKR to Garmin Edge 1030,305,312,-7
44853,56469,2020-07-04 06:46:11,wahoo,Zwift - Zwift Fondo 2020 Series (Southern Hemisphere) (C),Rotor 2Inpower to Zwift,Wahoo KICKR to Garmin Edge 1030,359,358,1
44854,56469,2020-07-04 06:46:11,wahoo,Zwift - L&#039;Etape du Tour Stage 1 - Open,Rotor 2Inpower to Zwift,Wahoo KICKR to Garmin Edge 1030,345,343,2
45889,56469,2020-07-11 06:33:26,wahoo,Zwift - L&#039;Etape du Tour Stage 2 - Open,Rotor 2Inpower to Zwift,Wahoo KICKR to Garmin Edge 1030,369,366,3
50901,56469,2020-08-20 11:05:12,wahoo,Zwift - EMU Japan Short Race (A),Rotor 2Inpower to Zwift,Wahoo KICKR to Garmin Edge 1030,371,369,2
54183,56469,2020-09-09 17:37:49,wahoo,Zwift - DBR Wednesday Race (A),Rotor 2Inpower to Garmin Edge 1030,Wahoo KICKR to Zwift,318,337,-19
54691,56469,2020-09-12 08:08:03,wahoo,Zwift - DBR SufferDay League II (A),Rotor 2Inpower to Garmin Edge 1030,Wahoo KICKR to Zwift,358,358,0
55089,56469,2020-09-14 17:58:29,wahoo,Zwift - Invitational League // Qualifying Race #1,Rotor 2Inpower to Garmin Edge 1030,Wahoo KICKR to Zwift,343,346,-3
56232,56469,2020-09-19 08:10:58,wahoo,Zwift - DBR SufferDay League II (A),Rotor 2Inpower to Garmin Edge 1030,Wahoo KICKR to Zwift,344,351,-7
56450,56469,2020-09-20 12:58:34,wahoo,Zwift - Invitational League // Qualifying Race #3 (Men) (A),Rotor 2Inpower to Garmin Edge 1030,Wahoo KICKR to Zwift,354,359,-5
57060,56469,2020-09-23 17:44:53,wahoo,Zwift - DCU powered by Feltet.dk (A),Rotor 2Inpower to Garmin Edge 1030,Wahoo KICKR to Zwift,344,352,-8
57646,56469,2020-09-26 08:29:53,wahoo,Zwift - DBR SufferDay League II (A),Rotor 2Inpower to Garmin Edge 1030,Wahoo KICKR to Zwift,355,358,-3
59028,56469,2020-10-02 10:04:57,wahoo,Zwift - 3R Innsbruckring Flat Race - 4 Laps (35.2km/21.9mi 308m) (A),Rotor 2Inpower to Garmin Edge 1030,Wahoo KICKR to Zwift,346,352,-6
59190,56469,2020-10-03 08:29:54,wahoo,Zwift - DBR SufferDay League II (A),Rotor 2Inpower to Garmin Edge 1030,Wahoo KICKR to Zwift,360,355,5
60270,56469,2020-10-07 18:04:56,wahoo,Zwift - DBR HEINO CUP III (A),Rotor 2Inpower to Garmin Edge 1030,Wahoo KICKR 5 to Zwift,366,372,-6
60726,56469,2020-10-10 08:29:53,wahoo,Zwift - DBR SufferDay League II (A),Rotor2Inpower to Garmin Edge 1030,Wahoo KICKR 5 to Zwift,343,349,-6
61525,56469,2020-10-13 17:14:53,wahoo,Zwift - Zwift Racing League | WTRL,Rotor 2Inpower to Garmin Edge 1030,Wahoo KICKR 5 to Zwift,372,378,-6
62617,56469,2020-10-17 08:29:54,wahoo,Zwift - DBR SufferDay League II (A),Rotor 2Inpower to Garmin Edge 1030,Wahoo KICKR 5 to Zwift,343,346,-3
63695,56469,2020-10-20 17:20:04,wahoo,Zwift - Zwift Racing League | WTRL - EMEA E (MEN) - TTT Grp 1,Rotor 2Inpower to Garmin Edge 1030,Wahoo KICKR 5 to Zwift,329,336,-7
64098,56469,2020-10-22 09:59:54,wahoo,Zwift - KISS at Race - Americas AM (A),Rotor 2Inpower to Garmin Edge 1030,Wahoo KICKR 5 to Zwift,353,355,-2
64556,56469,2020-10-24 08:29:54,wahoo,Zwift - DBR SufferDay League II (A),Rotor 2Inpower to Garmin Edge 1030,Wahoo KICKR 5 to Zwift,359,369,-10
64885,56469,2020-10-25 13:14:55,wahoo,Zwift - KISS at Race 100 - Americas (A),Rotor 2Inpower to Garmin Edge 1030,Wahoo KICKR 5 to Zwift,303,304,-1
65458,56469,2020-10-27 18:14:55,wahoo,Zwift - Zwift Racing League | WTRL - EMEA E (MEN) -  Division 1 (A),Rotor 2Inpower to Garmin Edge 1030,Wahoo KICKR 5 to Zwift,364,373,-9
66011,56469,2020-10-29 09:59:53,wahoo,Zwift - KISS at Race - Americas AM (A),Rotor 2Inpower to Garmin Edge 1030,Wahoo KICKR 5 to Zwift,354,360,-6
66611,56469,2020-10-31 09:29:52,wahoo,Zwift - DBR Saturday Race (A),Rotor 2Inpower to Garmin Edge 1030,Wahoo KICKR 5 to Zwift,348,357,-9
66867,56469,2020-11-01 05:59:53,wahoo,Zwift - KISS at Race 100 - EU (A),Rotor 2Inpower to Garmin Edge 1030,Wahoo KICKR 5 to Zwift,349,351,-2
67969,56469,2020-11-04 18:59:52,wahoo,DCU – Feltet.dk November series,Rotor 2Inpower to Garmin Edge 1030,Wahoo KICKR 5 to Zwift,375,386,-11
69766,56469,2020-11-10 18:14:54,wahoo,Zwift - Zwift Racing League | WTRL - EMEA E1 (MEN) -  Division 1 (A),Rotor 2Inpower to Garmin Edge 1030,Wahoo KICKR 5 to Zwift,375,384,-9
70304,56469,2020-11-11 18:59:53,wahoo,Zwift - DCU – Feltet.dk November series (A),Rotor 2Inpower to Garmin Edge 1030,Wahoo KICKR 5 to Zwift,349,354,-5
71272,56469,2020-11-14 09:29:54,wahoo,Zwift - DBR Saturday Race (A),Rotor 2Inpower to Garmin Edge 1030,Wahoo KICKR 5 to Zwift,347,351,-4
72243,56469,2020-11-17 18:22:24,wahoo,Zwift - Zwift Racing League | WTRL - Men&#039;s EMEA E1 DIVISION 1 (A),Rotor 2Inpower to Garmin Edge 1030,Wahoo KICKR 5 to Zwift,343,348,-5
72656,56469,2020-11-18 18:59:52,wahoo,Zwift - DCU – Feltet.dk November series (A),Rotor 2Inpower to Garmin Edge 1030,Wahoo KICKR 5 to Zwift,318,321,-3
73171,56469,2020-11-19 19:29:53,wahoo,Zwift - World Championships Experience // Danish Cycling Federation,Rotor 2Inpower to Garmin Edge 1030,Wahoo KICKR 5 to Zwift,324,332,-8
75069,56469,2020-11-24 18:14:52,wahoo,Zwift - Zwift Racing League | WTRL - Men&#039;s EMEA E1 DIVISION 1,Rotor 2Inpower to Garmin Edge 1030,Wahoo KICKR 5 to Zwift,367,373,-6
75563,56469,2020-11-25 18:59:52,wahoo,Zwift - 11/25/2020,Rotor 2Inpower to Garmin Edge 1030,Wahoo KICKR 5 to Zwift,336,341,-5
76354,56469,2020-11-26 19:03:57,wahoo,Zwift - WTRL NOPINZ WORLD TTT CHAMPIONSHIPS - Zone 8 (C),Rotor 2Inpower to Garmin Edge 1030,Wahoo KICKR 5 to Zwift,337,337,0
78035,56469,2020-12-01 18:22:23,wahoo,Zwift - Zwift Racing League | WTRL - Men&#039;s EMEA E1 DIVISION 1 (A),Rotor 2Inpower to Garmin Edge 1030,Wahoo KICKR 5 to Zwift,348,350,-2
80152,56469,2020-11-16 15:22:08,wahoo,Zwift - OH MY CRIT - Saturday Smash Race (A),Rotor 2Inpower to Garmin Edge 1030,Wahoo KICKR 5 to Zwift,341,343,-2
80768,56469,2020-12-08 18:14:54,wahoo,Zwift - 12/08/2020,Rotor 2Inpower to Garmin Edge 1030,Wahoo KICKR 5 to Zwift,340,344,-4
81541,56469,2020-12-10 10:59:54,wahoo,Zwift - KISS Race Series - Americas AM (A),Rotor 2Inpower to Garmin Edge 1030,Wahoo KICKR 5 to Zwift,333,334,-1
82398,56469,2020-12-12 15:14:54,wahoo,Zwift - 12/12/2020,Rotor 2Inpower to Garmin Edge 1030,Wahoo KICKR 5 to Zwift,383,385,-2
83547,56469,2020-12-15 18:22:53,wahoo,Zwift - Zwift Racing League | WTRL - Men&#039;s EMEA E1 DIVISION 1 (A),Rotor 2Inpower to Garmin Edge 1030,Wahoo KICKR 5 to Zwift,342,346,-4
85466,56469,2020-12-20 14:14:53,wahoo,Zwift - KISS 100 Race Series - Americas (A),Rotor 2Inpower to Garmin Edge 1030,Wahoo KICKR 5 to Zwift,309,310,-1
86050,56469,2020-12-22 10:59:52,wahoo,Zwift - KISS Race Series - Americas AM (A),Rotor 2Inpower to Garmin Edge 1030,Wahoo KICKR 5 to Zwift,353,362,-9
86815,56469,2020-12-24 08:29:51,wahoo,Zwift - 12/24/2020,Rotor 2Inpower to Garmin Edge 1030,Wahoo KICKR 5 to Zwift,358,363,-5
86828,56469,2020-12-22 12:04:52,wahoo,Zwift - 3R Gotham Grind Flat Race - 2 Laps (18.5km/11.6mi 58m) (A),Rotor 2Inpower to Garmin Edge 1030,Wahoo KICKR 5 to Zwift,316,320,-4
87482,56469,2020-12-26 15:14:51,wahoo,Zwift - 12/26/2020,Rotor 2Inpower to Garmin Edge 1030,Wahoo KICKR 5 to Zwift,345,350,-5
90099,56469,2021-01-02 09:03:07,wahoo,Zwift - Newbury Velo Weekend TT,Rotor 2Inpower to Garmin Edge 1030,Wahoo KICKR 5 to Zwift,338,348,-10
90829,56469,2021-01-03 13:59:51,wahoo,Zwift - Zwift Fondo Series 2020/21 (A),Rotor 2Inpower to Garmin Edge 1030,Wahoo KICKR 5 to Zwift,339,344,-5
93868,56469,2021-01-09 11:59:50,wahoo,Zwift - WKG Winter League 2020 / 2021  (A),Rotor 2Inpower to Garmin Edge 1030,Wahoo KICKR 5 to Zwift,343,345,-2
95637,56469,2021-01-12 18:14:49,wahoo,Zwift - Zwift Racing League | WTRL - Men&#039;s/Mixed EMEA E1 DIVISION 1 (A),Rotor 2Inpower to Garmin Edge 1030,Wahoo KICKR 5 to Zwift,343,344,-1
98114,56469,2021-01-16 13:19:49,wahoo,Zwift - 3R Innsbruckring Flat Race - 5 Laps (44km/27.3mi 385m) (A),Rotor 2Inpower to Garmin Edge 1030,Wahoo KICKR 5 to Zwift,325,328,-3
103511,56469,2021-01-26 18:14:47,wahoo,Zwift Racing League | WTRL EMEA E1 DIVISION,Rotor 2Inpower to Garmin Edge 1030,Wahoo KICKR 5 to Zwift,355,360,-5
107305,56469,2021-02-02 18:14:47,wahoo,Zwift - Zwift Racing League | WTRL - Men&#039;s/Mixed EMEA E1 DIVISION 1 (A),Rotor 2Inpower to Garmin Edge 1030,Wahoo KICKR 5 to Zwift,371,372,-1
111519,56469,2021-02-09 18:23:47,wahoo,Zwift - 02/09/2021,Rotor 2Inpower to Garmin Edge 1030,Wahoo KICKR 5 to Zwift,358,363,-5
115815,56469,2021-02-16 18:14:45,wahoo,Zwift - Zwift Racing League | WTRL - Men&#039;s/Mixed EMEA E1 DIVISION 1 (A),Rotor 2Inpower to Garmin Edge 1030,Wahoo KICKR 5 to Zwift,393,398,-5
119631,56469,2021-02-23 18:14:54,wahoo,Zwift - Zwift Racing League | WTRL - Men&#039;s/Mixed EMEA E1 DIVISION 1 (A),Rotor 2Inpower to Garmin Edge 1030,Wahoo KICKR 5 to Zwift,340,341,-1
124844,56469,2021-03-06 09:29:54,wahoo,Zwift - 03/06/2021,Rotor 2Inpower to Garmin Edge 1030,Wahoo KICKR 5 to Zwift,320,323,-3
72574,56648,2020-11-18 00:49:38,wahoo,Zwift - Zwift Racing League | WTRL - Men&#039;s AMERICAS E DIVISION 1 (A),Vector 3,Wahoo Kicker,391,398,-7
120191,56648,2021-02-24 00:47:02,wahoo,Zwift - Zwift Racing League | WTRL - Men&#039;s/Mixed AMERICAS E DIVISION 4 (A),Vector 3,Wahoo Kicker,392,412,-20
122050,56648,2021-02-26 20:59:43,wahoo,Zwift - Haute Route Watopia 2021 Stage 1 (A),Vector 3,Wahoo Kicker,384,404,-20
122053,56648,2021-02-27 15:59:29,wahoo,Zwift - Haute Route Watopia 2021 Stage 2 (A),Vector 3,Wahoo Kicker,390,399,-9
122266,56648,2021-02-28 15:59:24,wahoo,Zwift - Haute Route Watopia 2021 Stage 3 (A),Vector 3,Wahoo Kicker,375,396,-21
129678,56648,2021-03-16 18:29:02,wahoo,Zwift - CeramicSpeed Race Series: Open Race (A),Vector 3,Wahoo Kicker,379,410,-31
13919,57004,2020-02-14 13:09:50,wahoo,Zwift - Tour de Zwift: Stage 1 Long Distance,Stages,Kickr,271,292,-21
18609,57004,2020-03-18 20:40:45,wahoo,Zwift - Watopia,Favero Assioma Dual,Kickr 2017,85,88,-3
18689,57004,2020-03-19 16:10:02,wahoo,Zwift - Stage 3 Race (A) - Tour of Watopia 2020,Assioma Dual,Kickr 2017,301,306,-5
18961,57004,2020-03-21 09:00:04,wahoo,Zwift - Stage 4 - Longer Ride - Tour of Watopia 2020,Assioma Dual,Kickr 2017,247,249,-2
19139,57004,2020-03-22 08:00:12,wahoo,Zwift - Stage 4 - Longer Ride - Tour of Watopia 2020,Assioma Dual,Kickr 2017,291,293,-2
19342,57004,2020-03-23 19:09:47,wahoo,Zwift - Stage 4 Race (A) - Tour of Watopia 2020,Assioma Dual,Kickr 2017,298,302,-4
19344,57004,2020-03-24 06:26:40,wahoo,Zwift - 3R VOLT Interval Ride [~2.6-3.2 w/kg avg] (C),Assioma Duo,Kickr 2017,201,205,-4
19820,57004,2020-03-26 19:00:21,wahoo,Zwift - Stage 5 - Longer Ride - Tour of Watopia 2020,Assioma Duo,Kickr 2017,233,235,-2
21665,57004,2020-04-03 09:00:02,wahoo,Zwift -  Haute Route Watopia Stage 1 (E),Assioma Duo,Kickr 2017,284,284,0
22143,57004,2020-04-05 06:59:58,wahoo,Zwift -  Haute Route Watopia Stage 3 (E),Assioma Duo,Kickr 2017,276,277,-1
22787,57004,2020-04-07 18:21:43,wahoo,Zwift - Yorkshire,Assioma Duo (170),Kickr 2017,243,246,-3
22965,57004,2020-04-08 10:00:00,wahoo,Zwift - Chris Sherriffs [KRT]&#039;s Meetup - London Loop,Assioma Duo (170),Kickr 2017,212,209,3
23517,57004,2020-04-10 12:16:10,wahoo,Zwift - Watopia,Assioma Duo (170),Kickr 2017,278,272,6
25648,57004,2020-04-17 18:09:45,wahoo,Richmond Challenge // Zwift Classic,Assioma Duo (170),Kickr 2017,317,315,2
34627,57004,2020-05-14 10:58:01,wahoo,Zwift - Watopia ZADA TEST,Assioma Duo (170),Kickr 2017,304,299,5
55619,57004,2020-09-16 19:17:45,wahoo,Zwift - Watopia,Assioma Duo (170),Kickr 2017,259,262,-3
55957,57004,2020-09-17 18:02:32,wahoo,Zwift - Invitational League // Qualifying Race #2 (Men) ,Assioma Duo (170),Kickr 2017,287,285,2
56220,57004,2020-09-19 09:18:10,wahoo,Zwift - Watopia,Assioma Duo (170),Kickr 2017,171,171,0
56318,57004,2020-09-19 19:58:33,wahoo,Zwift - Watopia,2020-09-19-20-58-33,Kickr 2017,141,142,-1
56448,57004,2020-09-20 12:33:02,wahoo,Zwift - Invitational League // Qualifying Race #3 (Men) (A),Assioma Duo (170),Kickr 2017,292,289,3
60697,57004,2020-10-10 07:04:54,wahoo,Zwift - 3R Flat Race (A),Assioma Duo (170),Kickr 2017,280,266,14
61308,57004,2020-10-12 18:40:13,wahoo,Zwift - Premier Division // Zwift Racing League (men) ,Assioma Duo (170),Kickr 2017,308,307,1
64181,57004,2020-10-22 17:20:17,wahoo,Zwift - Frappe,Assioma Duo (170),Kickr 2017,279,281,-2
64373,57004,2020-10-23 12:39:27,wahoo,Zwift - KISS at Race - Pacific AM (A),Assioma Duo (170),Kickr 2017,282,290,-8
65210,57004,2020-10-26 19:17:53,wahoo,Zwift - Premier Division // Zwift Racing League (men) (A),Assioma Duo (170),Kickr 2017,285,285,0
66136,57004,2020-10-29 16:19:08,wahoo,Three Sisters ZADA Test,Assioma Duo (170),Kickr 2017,298,298,0
66595,57004,2020-10-31 09:29:18,wahoo,Zwift - DBR Saturday Race (A),Assioma Duo (170),Kickr 2017,296,290,6
68744,57004,2020-11-07 10:05:02,wahoo,Zwift - 3R Racing (A),Assioma Duo (170),Kickr 2017,305,309,-4
68966,57004,2020-11-08 08:29:25,wahoo,Zwift - ZA Road Group Ride: 2.2 - 2.7 w/kg,Assioma Duo (165),Kickr 2017,166,167,-1
69452,57004,2020-11-09 19:35:54,wahoo,Zwift - Premier Division // Zwift Racing League (men) (A),Assioma Duo (165),Kickr 2017,331,326,5
70882,57004,2020-11-12 18:45:24,wahoo,Zwift - Frappe,Assioma Duo (165),Kickr 2017,291,288,3
74714,57004,2020-11-23 19:32:24,wahoo,Zwift - Premier Division // Zwift Racing League (men) (A),Assioma Duo (165),Kickr 2017,326,325,1
76204,57004,2020-11-26 18:45:02,wahoo,Zwift - WTRL NOPINZ WORLD TTT CHAMPIONSHIPS - Zone 7 (D),Assioma Duo (165),Kickr 2017,291,287,4
76765,57004,2020-11-28 08:53:11,wahoo,Zwift - ZLIT Triathlon Clubs League Weekly Race (E),Assioma Duo (165),Kickr 2017,306,310,-4
77727,57004,2020-11-30 18:26:14,wahoo,Zwift - Premier Division // Zwift Racing League (men) (A),Assioma Duo (165),Kickr 2017,295,294,1
78684,57004,2020-12-02 20:18:47,wahoo,Zwift - 3R Classique Flat Race - 5 Laps (32.3km/20.1mi 95m) (A),Assioma Duo (165),Kickr 2017,308,311,-3
79005,57004,2020-12-03 18:41:23,wahoo,Zwift - Frappe,Assioma Duo (165),Kickr 2017,290,295,-5
79617,57004,2020-12-05 08:25:47,wahoo,Zwift - TEAM VEGAN Tofu Tornado XL (A),Assioma Duo (165),Kickr 2017,307,302,5
82245,57004,2020-12-12 08:08:18,wahoo,Zwift - Matando o Corpo® by PETA-Z (A),Assioma Duo (165),Kickr 2017,294,287,7
84093,57004,2020-12-16 21:37:34,wahoo,Zwift - Watopia - Post Factory Spindown testing,Assioma Duo (165),Kickr 2017,129,127,2
84504,57004,2020-12-17 19:54:06,wahoo,Zwift - KISS Race Series - EU PM (A),Assioma Duo (165),Kickr 2017,337,340,-3
85176,57004,2020-12-19 18:01:52,wahoo,Zwift - Watopia,Assioma Duo (165),Kickr 2017,220,229,-9
85178,57004,2020-12-19 17:29:17,wahoo,Zwift - Watopia,Assioma Duo (165),Kickr 2017,234,227,7
85328,57004,2020-12-20 08:00:09,wahoo,Zwift -  KRT/KISS 100km Endurance Ride (B),Assioma Duo (165),Kickr 2017,252,250,2
86536,57004,2020-12-23 16:25:57,wahoo,Zwift - ZHQ FutureWorks Crit City Race - Anti-sandbagging (A),Assioma Duo (165),Kickr 2017,295,309,-14
87881,57004,2020-12-27 07:29:21,wahoo,Zwift - EVO CC 160km Base Ride [3.0-3.2w/kg avg] (B),Assioma Duo (165),Kickr 2017,274,277,-3
88523,57004,2020-12-29 08:20:17,wahoo,Zwift - James Ward [KRT]&#039;s Meetup - Tire-Bouchon,Assioma Duo (165),Kickr 2017,308,307,1
93889,57004,2021-01-09 14:53:23,wahoo,Zwift - DIRT Dadurday Chase Race  (A),Assioma Duo (165),Kickr 2017,286,288,-2
97414,57004,2021-01-15 12:55:18,wahoo,Zwift - TDZ Stage 3: Standard Ride,Assioma Duo (165),Kickr 2017,296,295,1
101664,57004,2021-01-23 07:09:19,wahoo,Zwift - EVO CC 160km Base Ride [3.0-3.2w/kg avg] (B),Assioma Duo (165),Kickr 2017,292,284,8
102080,57004,2021-01-23 21:20:27,wahoo,Zwift - Innsbruck,Assioma Duo (165),Kickr 2020,155,159,-4
102784,57004,2021-01-25 16:35:38,wahoo,Zwift - Watopia,Assioma Duo (165),Kickr 2020,154,158,-4
103051,57004,2021-01-25 20:48:48,wahoo,Zwift - Watopia,Assioma Duo (165),Kickr 2020,140,144,-4
104567,57004,2021-01-28 13:40:47,wahoo,Zwift - Watopia - Three Sisters ZADA test,Assioma Duo (165),Kickr 2020,300,293,7
105097,57004,2021-01-29 12:58:11,wahoo,Zwift - TDZ Stage 6: Longer Ride,Assioma Duo (165),Kickr 2020,290,284,6
106942,57004,2021-02-01 19:39:01,wahoo,Zwift - Premier Division // Zwift Racing League (men) (A),Assioma Duo (165),Kickr 2020,309,292,17
107222,57004,2021-02-02 13:48:14,wahoo,Zwift - TDZ Stage 6: Standard Ride,Assioma Duo (165),Kickr 2020,271,268,3
108117,57004,2021-02-03 15:58:48,wahoo,Zwift - TDZ Stage 7: Shorter Ride,Assioma Duo (165),Kickr 2020,312,303,9
109283,57004,2021-02-05 09:56:06,wahoo,Zwift - EVO CC AGUANTE 100km Ride [3.5-4.0w/kg avg] (B),Assioma Duo (165),Kickr 2020,304,296,8
109775,57004,2021-02-06 12:01:06,wahoo,Zwift - Watopia,Assioma Duo (165),Kickr 2020,148,149,-1
113841,57004,2021-02-13 07:59:39,wahoo,Zwift - TDZ Stage 1: Longer Ride,Assioma Duo (165),Kickr 2020,282,274,8
114506,57004,2021-02-14 07:26:08,wahoo,Zwift - TDZ Stage 8: Group Ride,Assioma Duo (165),Kickr 2020,262,256,6
115384,57004,2021-02-15 19:30:32,wahoo,Zwift - Premier Division // Zwift Racing League (men) (A),Assioma Duo (165),Kickr 2020,322,310,12
116410,57004,2021-02-17 10:00:01,wahoo,Zwift - Sprint workout - 10s max ,Assioma Duo (165),Kickr 2020,250,267,-17
117106,57004,2021-02-18 10:50:14,wahoo,Zwift - KISS Race Series - Americas AM (A),Assioma Duo (165),Kickr 2020,321,334,-13
117842,57004,2021-02-19 18:29:05,wahoo,Kickr 2020 / Assioma Duo (165),Assioma Duo (165),Kickr 2020,275,265,10
118576,57004,2021-02-21 07:41:20,wahoo,Zwift - Renegade Race (A),Assioma Duo (165),Kickr 2020,253,266,-13
119764,57004,2021-02-23 20:39:04,wahoo,Kickr 2020 / Assioma Duo (165),Assioma Duo (165),Kickr 2020,228,238,-10
120864,57004,2021-02-25 18:55:52,wahoo,Zwift - FLANDERS The BZR Ronde Watopian League (A),Assioma Duo (165),Kickr 2020,301,312,-11
123474,57004,2021-03-03 13:53:15,wahoo,Zwift - KISS Race Series - Pacific AM (A),Assioma Duo (165),Kickr 2020,310,321,-11
124062,57004,2021-03-04 16:10:57,wahoo,Zwift - Pure and Hard Road Sprinter (in saddle),Assioma Duo (165),Kickr 2020,250,262,-12
125310,57004,2021-03-07 07:56:40,wahoo,Zwift -  KRT/KISS 100km Endurance Ride (B),Assioma Duo (165),Kickr 2020,284,298,-14
125311,57004,2021-03-07 07:56:40,wahoo, KRT/KISS 100km Endurance Ride,Assioma Duo (165),Kickr 2020,284,298,-14
127498,57004,2021-03-12 16:03:17,wahoo,Zwift - 3R Volcano Flat Race - 3 Laps (36.6km/22.7mi 138m) (A),Assioma Duo (165),Kickr 2020(03-) ,277,271,6
127755,57004,2021-03-13 09:25:56,wahoo,Zwift - KRT/KISS 80 km Endurance Ride (C),Assioma Duo (165),Kickr 2020(03-) ,231,229,2
128241,57004,2021-03-14 09:12:07,wahoo,Zwift - Watopia,Assioma Duo (165),Kickr 2020(03-) ,144,147,-3
128549,57004,2021-03-14 19:49:16,wahoo,Zwift - KISS Race Series - EU PM (A),Assioma Duo (165),Kickr 2020(03-) ,296,292,4
112,57523,2019-08-14 07:25:18,neo,Zwift - PM dual comparison,Quarq Riken,Tacx Neo,241,232,9
3603,57523,2019-10-09 09:45:08,neo,Zwift - DIRT Cup Series (A) + cooldown,Quarq Riken,Tacx Neo,363,350,13
3641,57523,2019-11-02 09:49:41,neo,Neo / Quarq accuracy comparison,Quarq Riken (SRM PC8),Tacx Neo,291,282,9
3778,57523,2019-11-05 07:59:07,neo,Zwift - Watopia / Accuracy Test,Quarq Riken (SRM PC8),Tacx Neo,257,251,6
3995,57523,2019-11-09 10:09:19,neo,Pre Race Ride - Alp Du Zwift (DFour / Neo),Quarq DFour,Tacx Neo,330,318,12
6158,57523,2019-12-13 08:07:04,neo,Base Endurance ERG Accuracy Test,Quarq Riken (SRM PC8),Tacx Neo FE-C,234,230,4
6159,57523,2019-12-13 08:07:04,neo,Base Endurance Free Ride Accuracy Test,Quarq Riken (SRM PC8),Tacx Neo FE-C,248,238,10
6235,57523,2019-12-10 19:10:02,neo,Quarq Riken (SRM PC8) / Tacx Neo (Training Ride),Quarq Riken (SRM PC8),Tacx Neo,370,362,8
6238,57523,2019-12-14 08:59:46,neo,14/12 Neo vs. Quarq Riken,Quarq Riken (SRM PC8),Tacx Neo,370,362,8
6335,57523,2019-12-15 09:56:25,neo,15/12 Tacx Neo vs. Quarq DFour - 9 Stages of DIRT,Quarq DFour (SRM PC8),Tacx Neo,345,337,8
7189,57523,2019-12-24 09:30:21,neo,Tacx Test - 24/12,Quarq Riken (SRM PC8),Tacx Neo,211,205,6
7272,57523,2019-12-25 18:43:25,neo,Warmup + FIETS Magazine Race Series,Quarq Riken (SRM PC8),Tacx Neo,319,302,17
7392,57523,2019-12-27 08:09:56,neo,Warmup + 3R Whole Lotta Lava Hilly Race + Cooldown,Quarq Riken (SRM PC8),Tacx Neo,337,325,12
8987,57523,2020-01-12 09:47:45,neo,dPAC.fit Climbers Day + cooldown,Quarq Riken (SRM PC8),Tacx Neo,346,331,15
9583,57523,2020-01-15 18:26:12,neo,Warmup + Tour de Zwift // Pro-Am Invitational,Quarq DFour (SRM PC8),Tacx Neo,370,346,24
9763,57523,2020-01-17 07:52:34,neo,Another Neo accuracy Test,Quarq Riken - Edge 500,Tacx Neo FE-C,247,241,6
9877,57523,2020-01-18 09:18:32,neo,warmup + DBR Saturday Race + 1h Cooldown,Quarq DFour (SRM PC8),Tacx Neo,336,319,17
10225,57523,2020-01-21 08:40:51,neo,Warmup + 3R Whole Lotta Lava Hilly Race,Quarq Riken (SRM PC8),Tacx Neo,345,331,14
10757,57523,2020-01-24 08:30:31,neo,Warmup + Tour de Zwift Stage 4 - DNF,Quarq Riken (SRM PC8),Tacx Neo,374,364,10
11311,57523,2020-01-28 15:34:56,neo,Warmup + 3R Ultimate Racing League (A),Quarq Riken (SRM PC8),Tacx Neo,363,351,12
11913,57523,2020-01-30 16:13:08,neo,Quarq DFour (SRM PC8) / Tacx Neo,Quarq DFour (SRM PC8),Tacx Neo,346,327,19
12456,57523,2020-02-04 18:15:33,neo,Zwift - Tour de Zwift // Pro-Am Invitational (A),Quarq DFour (SRM PC8),Tacx Neo,343,340,3
13116,57523,2020-02-09 09:26:47,neo,Quarq Riken (SRM PC8) / Tacx Neo,Quarq Riken (SRM PC8),Tacx Neo,352,339,13
15530,57523,2020-02-25 09:52:59,neo,Warmup + Eat The Pain Race 25/02,Quarq Riken (SRM PC8),Tacx Neo,359,348,11
18153,57523,2020-03-15 10:13:28,neo,Ramp Test + Indoor Specialist Gravel Grinder,Quarq Riken (SRM PC8),Tacx Neo,381,377,4
19155,57523,2020-03-22 09:00:07,neo,3R Tour of Ice & Fire + Z2 ERG + Indoor Specialist Gravel Grinder,Quarq Riken (SRM PC8),Tacx Neo,334,324,10
19836,57523,2020-03-26 18:33:20,neo,Warmup + KALAS Cup,Quarq Riken (SRM PC8),Tacx Neo,343,323,20
21648,57523,2020-04-03 06:40:22,neo, Haute Route Watopia Stage 1,Quarq Riken (SRM PC8),Tacx Neo,367,358,9
21977,57523,2020-04-04 08:38:43,neo,Warmup +  Haute Route Watopia Stage 2 (E),Quarq Riken (SRM PC8),Tacx Neo,357,338,19
22245,57523,2020-04-05 08:30:28,neo,Haute Route Watopia Stage 3 (incl. warmup & cooldown),Quarq Riken (SRM PC8),Tacx Neo,343,335,8
23084,57523,2020-04-08 17:30:28,neo,USA Cycling Race League by Indoor Specialist (incl. warmup & cooldown),Quarq Riken (SRM PC8),Tacx Neo,351,331,20
23978,57523,2020-04-12 08:44:27,neo,dPAC.fit Climbers Day (12/04 - w/ warmup),Quarq Riken (SRM PC8),Tacx Neo,354,340,14
34258,57523,2020-05-13 09:09:25,neo,USA Cycling Race League by Indoor Specialist (incl. warmup & cooldown),Quarq Riken (SRM PC8),Tacx Neo (Garmin Edge),351,338,13
40492,57523,2020-06-09 08:47:23,neo,SRAM Send it Series - Race 5 - Mens (Warmup + Cooldown in ERG),Quarq Riken (SRM PC8),Tacx Neo (Garmin Edge),354,335,19
43500,57523,2020-06-25 07:35:21,neo,FutureWorks Boost Mode Test Race (w/ warmup and cooldown),Quarq Riken (SRM PC8),Tacx Neo (Garmin Edge),344,326,18
43732,57523,2020-06-26 17:40:03,neo,3R Lutscher CCW Climbing Race (w/ warmup & cooldown),Quarq Riken (SRM PC8),Tacx Neo (Garmin Edge),400,390,10
47136,57523,2020-07-21 08:37:42,neo,3R Turbocharged Team Race Series (w/ warmup & cooldown),Quarq Riken (SRM PC8),Tacx Neo (Garmin Edge),317,319,-2
49875,57523,2020-08-13 16:50:19,neo,WTRL Team Time Trial PREMIER LEAGUE,Quarq DFour (SRM PC8),Tacx Neo (Garmin Edge),334,317,17
52124,57523,2020-08-27 08:46:53,neo,Cycling Australias The Chop by AHDR (w/ warmup & cooldown),Quarq Riken (SRM PC8),Tacx Neo (Garmin Edge),348,329,19
52930,57523,2020-09-01 17:00:40,neo,WTRL Gravel Series (w/ warmup + cooldown9,Quarq Riken (SRM PC8),Tacx Neo (Garmin Edge),355,340,15
54312,57523,2020-09-10 08:18:02,neo,Zwift - Cycling Australia&#039;s The Chop by AHDR (A),Quarq Riken (SRM PC8),Tacx Neo FE-C (Zwift),343,322,21
55331,57523,2020-09-15 07:03:45,neo,Zwift - 3R UCI Worlds Race - 1 Lap (23.7km/14.7mi 494m) (A),Quarq Riken (SRM PC8),Tacx Neo FE-C (Zwift),357,340,17
56014,57523,2020-09-17 17:37:02,neo,Zwift - Invitational League // Qualifying Race #2 (A),Quarq Riken (SRM PC8),Tacx Neo FE-C (Zwift),357,340,17
102585,57693,2021-01-24 20:50:20,wahoo,Zwift - 45min Riders Choice,P2Max NG Eco,Kickr Core,207,210,-3
111006,57693,2021-02-08 18:57:21,wahoo,Zwift - 45min Riders Choice,P2Max NG Eco,Kickr Core,348,365,-17
112331,57693,2021-02-10 18:12:03,wahoo,Movistar Team Challenge // Round 1,P2Max NG Eco,Kickr Core,318,325,-7
128691,57693,2021-03-13 15:32:40,wahoo,Zwift - 3R Endurance Series p/b OTE Sports (E),P2Max NG Eco,Kickr Core,359,374,-15
3017,58160,2019-09-19 18:09:59,wahoo,Yorkshire Power Up,Vector2,KICKR,319,315,4
13379,58160,2020-02-11 14:51:54,wahoo,Power Comparion Test - KICKR,Vector2,KICKR,216,211,5
13380,58160,2020-02-11 15:12:32,wahoo,Power Test - KICKR after spindown,Vector2,KICKR,224,218,6
13413,58160,2020-02-11 19:19:07,wahoo,ZI Labs Power Meter Test - KICKR vs Garmin,Vector2,KICKR,260,240,20
13418,58160,2020-02-11 20:02:37,wahoo,"ZI Labs Power Meter Test - KICKR, no smoothing",Vector2,KICKR,257,245,12
13550,58160,2020-02-12 15:08:38,neo,ZI Labs Power Meter Test - NEO1,Vector2,NEO1,258,249,9
13667,58160,2020-02-13 13:43:41,wahoo,KICKR Warmup,Assioma,KICKR,205,190,15
13669,58160,2020-02-13 13:57:48,wahoo,ZI Labs Power Meter Test - KICKR vs Assioma,Assioma,KICKR,268,246,22
13671,58160,2020-02-13 14:42:04,neo,ZI Labs Power Meter Test - NEO1 vs Assioma,Assioma,NEO1,266,246,20
13672,58160,2020-02-13 15:23:59,wahoo,"ZI Labs Power Meter Test - KICKR vs Assioma, take 2",Assioma,KICKR,262,247,15
13922,58160,2020-02-14 13:25:10,wahoo,Zwift - DIRT Friday Pacific Sprintapalooza,Assioma,KICKR,268,251,17
14101,58160,2020-02-15 16:39:20,wahoo,Steady 10 minute KICKR Warmup,Assioma,KICKR,186,177,9
14102,58160,2020-02-15 16:58:00,wahoo,Zwift - Steady State Tests - KICKR,Assioma,KICKR,298,281,17
14127,58160,2020-02-15 19:48:36,wahoo,"Steady State Tests (shortened) - KICKR - new drivetrain, who dis?",Assioma,KICKR,255,239,16
14220,58160,2020-02-16 14:18:47,wahoo,Spinning Richmond Reverse,Assioma,KICKR,244,227,17
14365,58160,2020-02-17 17:15:15,wahoo,Zwift - Steady State Test short kickr,Assioma,KICKR,254,239,15
14418,58160,2020-02-17 21:30:01,wahoo,Zwift - The Kraken by TeamODZ (B) - Assioma,Assioma Bluetooth,KICKR via ELEMNT,299,286,13
14696,58160,2020-02-19 14:45:00,wahoo,Crit City Race,Assioma Bluetooth,KICKR via ELEMNT,329,313,16
14697,58160,2020-02-19 13:58:46,wahoo,Zwift - Watopia,Assioma Bluetooth,KICKR via ELEMNT,279,264,15
14888,58160,2020-02-20 14:05:01,wahoo,Zwift - Ascenders Team Social Thursday (D),Assioma Bluetooth,KICKR via ELEMNT,209,199,10
15037,58160,2020-02-21 13:25:01,wahoo,Zwift - DIRT Friday Pacific Sprintapalooza,Assioma Bluetooth,KICKR via ELEMNT,275,257,18
15303,58160,2020-02-23 14:18:16,wahoo,Zwift easy ride - 2 washers on Assiomas,Assioma Bluetooth,KICKR via ELEMNT,192,185,7
15437,58160,2020-02-24 15:19:33,wahoo,Rebel Route Recon (Eastern Eight),Assioma Bluetooth,KICKR via ELEMNT,253,238,15
15541,58160,2020-02-25 13:35:45,wahoo,Zwift - Crit City Race (B),Assioma Bluetooth,KICKR via ELEMNT,354,331,23
15846,58160,2020-02-27 13:33:58,wahoo,Zwift - Crit City Race (A) - yeeouch,Assioma Bluetooth,KICKR via ELEMNT,345,328,17
15847,58160,2020-02-27 14:05:01,wahoo,Zwift - Ascenders Team Social Thursday (D),Assioma Bluetooth,KICKR via ELEMNT,214,202,12
16007,58160,2020-02-28 13:25:22,wahoo,Zwift - DIRT Friday Pacific Sprintapalooza on new Seaside Sprint route,Assioma Bluetooth,KICKR via ELEMNT,242,226,16
16019,58160,2020-02-15 16:58:00,wahoo,Assioma Bluetooth / KICKR via ELEMNT,Assioma Bluetooth,KICKR via ELEMNT,298,281,17
16021,58160,2020-02-13 14:42:04,neo,Assioma Bluetooth / NEO1,Assioma Bluetooth,NEO1,266,246,20
16199,58160,2020-03-01 00:06:57,wahoo,Recovery Badger + Double Green,Assioma Bluetooth,KICKR via ELEMNT,243,226,17
16664,58160,2020-03-01 13:29:51,wahoo,Zwift - ODZentury Endurance Builder Ride,Assioma Bluetooth,KICKR via ELEMNT,295,278,17
16791,58160,2020-03-04 15:30:33,wahoo,Zwift - London 8 Badger - Fighting the Sickness,Assioma Bluetooth,KICKR via ELEMNT,229,214,15
16910,58160,2020-03-05 15:15:17,wahoo,"Three Little Sisters - first attempt, very intens",Assioma Bluetooth,KICKR via ELEMNT,306,289,17
17074,58160,2020-03-06 13:24:49,wahoo,Zwift - DIRT Friday Pacific Sprintapalooza,Assioma Bluetooth,KICKR via ELEMNT,265,247,18
17211,58160,2020-03-07 12:30:23,wahoo,Zwift - DIRT 100,Assioma Bluetooth,KICKR via ELEMNT,279,262,17
17816,58160,2020-03-12 18:00:01,wahoo,Zwift - Stage 1 - Longer Ride - Tour of Watopia 2020 (Z2),Assioma Bluetooth,KICKR via ELEMNT,236,220,16
17940,58160,2020-03-13 12:24:43,wahoo,Zwift - DIRT Friday Pacific Sprintapalooza + cooldown lap,Assioma Bluetooth,KICKR via ELEMNT,294,271,23
22038,58160,2020-04-04 13:05:01,wahoo,Zwift -  Haute Route Watopia Stage 2,Assioma Bluetooth,KICKR via ELEMNT,284,276,8
22573,58160,2020-04-06 14:25:00,wahoo,Nice to have an easy day!,Assioma Bluetooth,KICKR via ELEMNT,193,182,11
23257,58160,2020-04-09 14:05:10,wahoo,Zwift - 3R Classique Flat Race - 6 Laps (B),Assioma Bluetooth,KICKR via ELEMNT,337,318,19
23815,58160,2020-04-11 14:02:05,wahoo,Zwift - The P Race (B),Assioma Bluetooth,KICKR via ELEMNT,325,304,21
24027,58160,2020-04-12 14:54:59,wahoo,Zwift - Watopia KICKR test,Assioma Bluetooth,KICKR via ELEMNT,221,211,10
24243,58160,2020-04-13 12:59:49,wahoo,Zwift - ZSUN Rise & Shine,Assioma Bluetooth,KICKR via ELEMNT,265,250,15
26438,58160,2020-04-20 15:00:32,wahoo,ZHQ Beta Crit City Race,Assioma Bluetooth,KICKR via ELEMNT,349,331,18
29148,58160,2020-04-29 17:39:53,wahoo,Zwift - Bullseye Points Race Event (B) - SUPER FUN,Assioma Bluetooth,KICKR via ELEMNT,334,315,19
30523,58160,2020-05-02 13:42:52,wahoo,"Double test: TT miles, Vector 3",Vector 3,KICKR via ELEMNT,251,244,7
30577,58160,2020-05-02 14:15:22,wahoo,Big Foot Hills badger w/OSPW on TT,Vector 3,KICKR via ELEMNT,230,222,8
30950,58160,2020-05-03 12:30:19,wahoo,Zwift - OTAKAM Granfondo Series,Vector 3,KICKR via ELEMNT,332,303,29
31323,58160,2020-05-04 18:00:05,neo,"Zwift - Tour for All 2020: Stage 1 - Vector wandered, then recalibrated",Vector 3,NEO1,239,220,19
31624,58160,2020-05-05 14:16:40,neo,Zwift - Watopia,Vector 3,NEO1,234,224,10
31625,58160,2020-05-05 14:57:52,neo,Zwift - Boost Mode Test 1a (B),Vector 3,NEO1,354,338,16
31626,58160,2020-05-05 15:37:04,neo,Zwift - Watopia,Vector 3,NEO1,160,155,5
32162,58160,2020-05-06 18:12:23,wahoo,Zone 2 Quatch Quest badger,Vector 3,KICKR via ELEMNT,224,221,3
32420,58160,2020-05-07 13:00:30,wahoo,Zwift - TWENTY20 Road To Tokyo Ride + extra credit,Vector 3,KICKR via ELEMNT,250,244,6
32742,58160,2020-05-08 12:24:56,wahoo,Zwift - DIRT Friday Pacific Sprintapalooza - Vector wandered then recalibrated,Vector 3,KICKR via ELEMNT,289,278,11
33462,58160,2020-05-10 22:46:56,wahoo,Zwift - Tour for All 2020: Stage 2 Longer Ride - MTB miles,Vector 3,KICKR via ELEMNT,237,229,8
33597,58160,2020-05-11 13:33:28,wahoo,Zwift - Crit City Race (B) - sprinting on the wrong lap,Vector 3,KICKR via ELEMNT,370,355,15
34136,58160,2020-05-12 20:59:45,wahoo,Zwift - Sights and Sounds Tour,Vector 3,KICKR via ELEMNT,246,241,5
34689,58160,2020-05-14 12:57:53,wahoo,Zwift - TWENTY20 Road To Tokyo Ride (D),Vector 3,KICKR via ELEMNT,200,193,7
35367,58160,2020-05-16 13:29:47,wahoo,Zwift -  Haute Route Community Rides // Quatch Quest,Vector 3,KICKR via ELEMNT,315,310,5
35898,58160,2020-05-18 19:17:33,wahoo,Z1/2 Roll,Vector 3,KICKR via ELEMNT,217,209,8
38159,58160,2020-05-27 20:11:40,wahoo,Recovery ride next to the (virtual) Pacific,Vector 3,KICKR via ELEMNT,270,259,11
38547,58160,2020-05-29 12:23:31,wahoo,Zwift - DIRT Friday Pacific Sprintapalooza - Vector wandered then recalibrated,Vector 3,KICKR via ELEMNT,280,256,24
39077,58160,2020-06-02 13:33:49,wahoo,Zwift - Crit City Race (B),Vector 3,KICKR via ELEMNT,333,319,14
39629,58160,2020-06-04 17:28:20,wahoo,Zwift - FUSION ECT BEUNSTOPPABLE Racing Series (B),Vector 3,KICKR via ELEMNT,337,326,11
39790,58160,2020-06-05 12:21:01,wahoo,Zwift - DIRT Friday Pacific Sprintapalooza + extra credit,Vector 3,KICKR via ELEMNT,245,236,9
40029,58160,2020-06-06 15:27:49,wahoo,Zwift - Zwift Fondo 2020 Series (A) + cooldown,Vector 3,KICKR via ELEMNT,330,318,12
40552,58160,2020-06-09 17:12:46,wahoo,Zwift - WKG - CRITTY CRITTY BANG BANG (B),Vector 3,KICKR via ELEMNT,366,356,10
43704,58160,2020-06-26 12:20:26,wahoo,Zwift - DIRT Friday Pacific Sprintapalooza + extra credit,Vector 3,KICKR via ELEMNT,263,250,13
45794,58160,2020-07-10 12:24:04,wahoo,Zwift - DIRT Friday Pacific Sprintapalooza,Vector 3,KICKR via ELEMNT,272,260,12
47156,58160,2020-07-11 15:55:34,wahoo,Zwift - L&#039;Etape du Tour Stage 2 - Open,Vector 3,KICKR via ELEMNT,332,320,12
47545,58160,2020-07-24 12:24:27,wahoo,Zwift - DIRT Friday Pacific Sprintapalooza,Vector 3,KICKR via ELEMNT,259,245,14
48435,58160,2020-07-31 12:24:48,wahoo,Zwift - DIRT Friday Pacific Sprintapalooza on Champs Elysees!,Vector 3,KICKR via ELEMNT,252,239,13
48791,58160,2020-08-04 17:18:23,wahoo,Zwift - WKG - CRITTY CRITTY BANG BANG (B) win!,Vector 3,KICKR via ELEMNT,317,308,9
49126,58160,2020-08-06 18:59:12,wahoo,"Zwift - KISS at Race - EU PM (B) - going long, falling short",Vector 3,KICKR via ELEMNT,358,344,14
49298,58160,2020-08-08 13:51:47,wahoo,Zwift - DIRT Dadurday Chase Race  (B),Vector 3,KICKR via ELEMNT,316,299,17
50154,58160,2020-08-15 14:57:04,wahoo,ZHQ Steering Race // FutureWorks - 2nd place=first loser,Vector 3,KICKR via ELEMNT,335,321,14
50591,58160,2020-08-18 18:49:20,wahoo,Zwift - KISS at Race - EU PM (B),Vector 3,KICKR via ELEMNT,336,322,14
51992,58160,2020-08-26 12:57:37,wahoo,Zwift - 08/26/2020,Vector 3,KICKR via ELEMNT,321,310,11
52354,58160,2020-08-28 12:24:31,wahoo,Zwift - DIRT Friday Pacific Sprintapalooza  (C),Vector 3,KICKR via ELEMNT,261,251,10
56144,58160,2020-09-18 15:57:03,wahoo,Red Peloton TT - interrupted,Vector 3,KICKR via ELEMNT,323,316,7
56804,58160,2020-09-22 12:23:04,neo,Z1/2 Wakeup - Spinning with Sal (Red Peloton),Vector 3,NEO1,207,205,2
56900,58160,2020-09-22 18:37:50,wahoo,Zwift - 3R Sundown Race Series  (B),Vector 3,KICKR via ELEMNT,348,341,7
57491,58160,2020-09-25 12:21:35,wahoo,Zwift - DIRT Friday Pacific Sprintapalooza  (C),Vector 3,KICKR via ELEMNT,236,231,5
57492,58160,2020-09-25 13:35:54,wahoo,Crit City Race,Vector 3,KICKR via ELEMNT,341,334,7
59065,58160,2020-10-02 12:22:08,wahoo,DIRT Friday Pacific Sprintapalooza ,Vector 3,KICKR via ELEMNT,287,272,15
59913,58160,2020-10-06 18:54:03,wahoo,Zwift - KISS at Race - EU PM (B),Vector 3,KICKR via ELEMNT,371,358,13
60305,58160,2020-10-08 14:10:29,wahoo,Zwift - ZA Road Race #1 (B),Vector 3,KICKR via ELEMNT,347,336,11
61354,58160,2020-10-12 20:09:04,wahoo,Zwift - Watopia KICKR 5 tests,Vector 3,KICKR 5,226,222,4
61556,58160,2020-10-13 17:12:17,wahoo,Zwift - Zwift Racing League | WTRL,Vector 3,KICKR 5,347,348,-1
62097,58160,2020-10-15 12:57:16,wahoo,Zwift - TWENTY20 Road To Tokyo Ride (D),Vector 3,KICKR 5,222,222,0
63234,58160,2020-10-17 13:13:45,wahoo,Zwift - Watopia,Vector 3,KICKR 5,244,266,-22
63235,58160,2020-10-17 14:58:35,wahoo,Zwift - ZHQ Steering Race // FutureWorks (B),Vector 3,KICKR 5,337,333,4
63374,58160,2020-10-19 21:27:00,wahoo,Drop Farming with Bowie,Vector 3,KICKR 5,251,244,7
63556,58160,2020-10-20 17:14:39,wahoo,Zwift - Zwift Racing League | WTRL - EMEA E (MEN) - TTT Grp 4 (D),Vector 3,KICKR 5,359,353,6
64380,58160,2020-10-23 12:22:46,wahoo,Zwift - DIRT Friday Pacific Sprintapalooza (C),Vector 3,KICKR 5,257,249,8
64381,58160,2020-10-23 13:50:21,wahoo,Quick test,Assioma,KICKR 5,190,190,0
64663,58160,2020-10-24 15:31:15,wahoo,Zwift - ZHQ FutureWorks Crit City Race - Anti-sandbagging (B),Assioma,KICKR 5,359,353,6
65489,58160,2020-10-27 18:13:05,wahoo,Zwift - Zwift Racing League | WTRL - EMEA E (MEN) -  Division 5 (B),Assioma,KICKR 5,354,350,4
66072,58160,2020-10-29 12:58:45,wahoo,Testing Assioma cutout power numbers,Assioma,KICKR 5,178,171,7
67201,58160,2020-10-31 14:01:36,wahoo,Zwift - The P Race (B),Assioma,KICKR 5,337,335,2
67709,58160,2020-11-03 18:23:12,wahoo,Zwift - Zwift Racing League | WTRL - Men&#039;s EMEA E2 DIVISION 1 (B),Assioma,KICKR 5,347,348,-1
68165,58160,2020-11-05 15:43:36,wahoo,Zwift - Crit City Race (B),Assioma,KICKR 5,362,361,1
69985,58160,2020-11-10 17:41:46,wahoo,Zwift - Zwift Racing League | WTRL - EMEA E2 (MEN) -  Division 1 (B),Assioma,KICKR 5,372,370,2
70744,58160,2020-11-12 18:35:27,wahoo,Zwift - Mocha,Assioma,KICKR 5,324,323,1
71083,58160,2020-11-13 13:20:39,wahoo,Zwift - DIRT Friday Pacific Sprintapalooza  (C),Assioma,KICKR 5,244,241,3
72254,58160,2020-11-17 18:26:49,wahoo,Zwift - Zwift Racing League | WTRL - Men&#039;s EMEA E2 DIVISION 1 (B),Assioma,KICKR 5,328,325,3
73131,58160,2020-11-19 18:28:42,wahoo,Zwift - Frappe TTT,Assioma,KICKR 5,342,337,5
73509,58160,2020-11-20 13:23:18,wahoo,Zwift - DIRT Friday Pacific Sprintapalooza  (C),Assioma,KICKR 5,265,258,7
75116,58160,2020-11-24 18:08:25,wahoo,Zwift - Zwift Racing League | WTRL - Men&#039;s EMEA E2 DIVISION 1,Assioma,KICKR 5,343,335,8
78725,58160,2020-12-02 23:03:47,wahoo,Assioma VS KICKR 5 BLE,Assioma via ELMNT,KICKR 5 BLE,172,159,13
79422,58160,2020-12-04 13:20:14,wahoo,Zwift - DIRT Friday Pacific Sprintapalooza,Assioma via ELMNT,KICKR 5,259,257,2
80953,58160,2020-12-08 18:18:06,wahoo,KICKR 5 / Assioma via ELMNT,Assioma via ELMNT,KICKR 5,376,358,18
83588,58160,2020-12-15 18:01:00,wahoo,Zwift - Zwift Racing League | WTRL - Men&#039;s EMEA E2 DIVISION 1 (B),Assioma via ELMNT,KICKR 5,330,326,4
84339,58160,2020-12-17 15:37:01,wahoo,Zwift - Crit City Race (B),Assioma via ELMNT,KICKR 5,343,336,7
86162,58160,2020-12-22 00:23:52,wahoo,Serpentine 8 Badger,Assioma via ELMNT,KICKR 5,208,208,0
86269,58160,2020-12-22 20:26:47,wahoo,Zwift - Aussie Crit Crushers Race 2 of 2 (B),Assioma via ELMNT,KICKR 5,351,349,2
86270,58160,2020-12-22 19:54:40,wahoo,Crit Crushers Race 1,Assioma via ELMNT,KICKR 5,355,345,10
86970,58160,2020-12-24 13:53:51,wahoo,Zwift - TWENTY20 Road To Tokyo Ride (D),Assioma via ELMNT,KICKR 5,236,231,5
86971,58160,2020-12-24 15:44:47,wahoo,Zwift - Crit City Race (B) win!,Assioma via ELMNT,KICKR 5,356,350,6
88237,58160,2020-12-27 13:58:17,wahoo,Zwift - Dutch Diesel Cycling Back To Our Roots Ride (C),Assioma via ELMNT,KICKR 5,239,234,5
94857,58160,2021-01-10 14:58:28,wahoo,Zwift - TDZ Stage 2: Longer Ride,Assioma via ELMNT,KICKR 5,285,279,6
95254,58160,2021-01-11 21:07:17,wahoo,RichmondRevRecce,Assioma via ELMNT,KICKR 5,244,242,2
95760,58160,2021-01-12 18:07:24,wahoo,Zwift - Zwift Racing League | WTRL - Men&#039;s/Mixed EMEA E2 DIVISION 1 (B),Assioma,KICKR 5,363,356,7
99685,58160,2021-01-19 17:53:35,wahoo,Zwift Racing League | WTRL - Mens/Mixed EMEA E2 DIVISION 1,Assioma via ELMNT,KICKR 5,354,354,0
100826,58160,2021-01-21 15:45:48,wahoo,Zwift - Crit City Race (B),Assioma via ELMNT,KICKR 5,345,342,3
103491,58160,2021-01-26 18:23:56,wahoo,Zwift - Zwift Racing League | WTRL - Men&#039;s/Mixed EMEA E2 DIVISION 1 (B),Assioma,KICKR 5,355,351,4
104590,58160,2021-01-28 15:46:14,wahoo,Zwift - Crit City Race (B) win,Assioma,KICKR 5,345,341,4
107265,58160,2021-02-02 13:29:30,wahoo,Zwift - 3R LaGuardia Super Sprint Race (B),Assioma,KICKR 5,381,380,1
107269,58160,2021-02-02 13:29:30,wahoo,Zwift - DBR Tuesday Race (B),Assioma,KICKR 5,309,309,0
109053,58160,2021-02-04 19:45:36,wahoo,Zwift - KISS Race Series - EU PM (B),Assioma,KICKR,335,330,5
111715,58160,2021-02-09 18:27:40,wahoo,Zwift - Zwift Racing League | WTRL - Men&#039;s/Mixed EMEA E2 DIVISION 1 (B),Assioma,KICKR 5,355,355,0
115198,58160,2021-02-15 17:47:54,wahoo,Hanging with Cara and Sore Ribs,Assioma,KICKR 5,192,192,0
116919,58160,2021-02-17 21:37:32,wahoo,Another spin with Cara,Assioma,KICKR 5,219,216,3
123032,58160,2021-03-02 18:03:25,wahoo,Zwift - Zwift Racing League | WTRL - Men&#039;s/Mixed EMEA E2 DIVISION 1 (B),Assioma,KICKR 5,344,336,8
124719,58160,2021-03-05 19:02:53,wahoo,Zwift - Zwift Racing League | WTRL Division Championships - Men&#039;s Points Race (A),Assioma,KICKR 5,351,353,-2
126276,58160,2021-03-09 19:06:37,wahoo,Zwift - DIRT ZRL Afterparty (B),Assioma,KICKR 5,364,359,5
24122,58570,2020-04-12 12:38:40,wahoo,Kickr / Stages gen 3,Stages gen 3,Kickr,295,295,0
24904,58570,2020-04-15 14:22:45,wahoo,5x6 min Kickr vs Stages gen 3,Stages gen 3,Kickr,362,364,-2
35040,58570,2020-05-15 13:00:15,wahoo,Stages gen 2 33267 vs Kickr,Stages gen 2 33267,Kickr,239,251,-12
82902,58570,2020-12-13 15:28:06,wahoo,Zwift - ZA Tri: TT Race - 40k ,Stages gen 3,Kickr,357,358,-1
100828,58570,2021-01-19 12:05:40,wahoo,Kickr vs Stages 50222 (dual),Stages gen 3 50222 (dual),Kickr,348,350,-2
2713,58638,2019-09-27 09:45:25,neo,Zwift - KISS AT Base,SRM,Tacx Neo,281,290,-9
2953,58638,2019-10-01 08:50:46,neo,Zwift - Eat The Pain Race #KODAnutrition,SRM,Tacx Neo,380,379,1
3042,58638,2019-10-02 09:06:19,neo,Zwift - DIRT Cup Series - Team Sweep,SRM,Neo,403,408,-5
3121,58638,2019-10-03 09:09:16,neo,Zwift - KISS Americas AM,SRM,Tacx Neo,366,376,-10
3418,58638,2019-10-29 08:47:35,neo,Eat The Pain Race,SRM,Tacx Neo,393,398,-5
43944,58978,2020-06-28 12:13:12,wahoo,Zwift - BMTR Chillin Party Ride (B),Powertap pedals,Wahoo Kickr,312,312,0
127222,60739,2021-03-11 18:26:22,wahoo,Wahoo Kickr &#039;17 / SRM Dura Ace 9000,SRM Dura Ace 9000,Wahoo Kickr &#039;18,345,361,-16
129714,60739,2021-03-17 15:19:59,wahoo,Sydkysten Race (A),Rotor 2in Power &#039;17,Kickr &#039;17,352,353,-1
129716,60739,2021-03-17 15:19:59,wahoo,Zwift - MIDWEEK Crit Race Series by SZR (A),Rotor 2in Power &#039;17,Kickr &#039;17,352,372,-20
95962,60994,2021-01-12 23:27:41,wahoo,Zwift - SweatFest Fall/Winter Series 2020/21 (A),Stages,Kickr,347,350,-3
97237,60994,2021-01-15 00:32:29,wahoo,Zwift - WTRL Team Time Trial - Zone 10 (D),Stages,Kickr,337,356,-19
99965,60994,2021-01-19 23:15:46,wahoo,Zwift - SweatFest Fall/Winter Series 2020/21 (A),Stages,Kickr,378,387,-9
110496,61535,2021-02-07 15:12:41,wahoo,Zwift - TDZ Stage 7: Longer Ride,Garmin Vector 1,Wahoo Kickr 4.0,301,287,14
111454,61535,2020-11-11 17:44:19,wahoo,TTR Party Animal Race ,Garmin Vector 1,Wahoo Kickr 4.0,257,251,6
111817,61535,2021-02-09 19:56:25,wahoo,Zwift - Zwift Racing League | WTRL - Men&#039;s/Mixed EMEA W2 DIVISION 3 (A),Garmin Vector 1,Wahoo Kickr 4.0,318,307,11
116886,61535,2021-02-17 18:58:48,wahoo,Zwift - Zwift Duathlon League - Bike,Garmin Vector 1,Wahoo Kickr 4.0 ,306,295,11
120418,61535,2021-02-24 18:56:31,wahoo,Zwift - Zwift Duathlon League - Bike (B),Garmin Vector 1,Wahoo Kickr 4.0,302,293,9
123660,61535,2021-03-03 19:00:21,wahoo,Zwift - Zwift Duathlon League - Bike (B),Garmin Vector 1,Wahoo Kickr 4.0,313,309,4
126743,61535,2021-03-10 14:53:39,wahoo,Zwift - Zwift Duathlon League - Bike (B),Garmin Vector 1,Wahoo Kickr 4.0,308,296,12
94127,62016,2021-01-09 19:04:58,wahoo,Zwift - 3R Innsbruckring Sprint Race - 1 Lap (8.8km/5.5mi 77m) (A),Power Tap P1 Dual Pedals,2017 KICKR,309,318,-9
94129,62016,2021-01-09 17:00:01,wahoo,Zwift - TDZ Stage 2: Longer Ride,Power Tap P1 Dual Pedals,2017 KICKR,184,185,-1
94133,62016,2021-01-02 19:05:22,wahoo,Zwift - 3R Innsbruckring Sprint Race - 1 Lap (8.8km/5.5mi 77m) (A),Power Tap P1 Dual Pedals,2017 KICKR,324,324,0
94135,62016,2020-12-26 19:04:58,wahoo,Zwift - 3R Innsbruckring Sprint Race - 1 Lap (8.8km/5.5mi 77m) (A),Power Tap P1 Dual Pedals,2017 KICKR,317,329,-12
94136,62016,2020-12-12 19:04:57,wahoo,Zwift - 3R Innsbruckring Sprint Race - 1 Lap (8.8km/5.5mi 77m) (A),Power Tap P1 Dual Pedals,2017 KICKR,305,316,-11
95874,62016,2021-01-12 19:52:59,wahoo,Zwift Racing League | WTRL - Mens/Mixed EMEA W2 DIVISION 1,Power Tap P1 Dual Pedals,2017 KICKR,312,297,15
116808,62016,2021-02-16 19:52:58,wahoo,Zwift - Zwift Racing League | WTRL - Men&#039;s/Mixed EMEA W2 DIVISION 1 (B),Power Tap P1 Dual Pedals,2017 KICKR,313,311,2
119868,62016,2021-02-23 19:52:56,wahoo,Zwift - Zwift Racing League | WTRL - Men&#039;s/Mixed EMEA W2 DIVISION 1 (B),Power Tap P1 Dual Pedals,2017 KICKR,315,321,-6
68270,62108,2020-11-05 18:19:26,neo,Zwift - FUSION ECT BEUNSTOPPABLE Racing Series (B),Power2Max,Tack Neo,298,288,10
70191,62108,2020-11-10 17:41:52,neo,Zwift - Zwift Racing League | WTRL - EMEA E2 (MEN) -  Division 3 (B),Power2Max,Tack Neo,317,316,1
70438,62108,2020-11-11 18:38:00,neo,Zwift - DCU – Feltet.dk November series (B),Power2Max,Tack Neo,312,309,3
72955,62108,2020-11-18 18:38:33,neo,Zwift - DCU – Feltet.dk November series (B),Power2Max,Tack Neo,308,312,-4
73213,62108,2020-11-19 19:12:12,neo,Zwift - World Championships Experience // Danish Cycling Federation,Power2Max,Tack Neo,297,298,-1
75074,62108,2020-11-24 17:40:11,neo,Zwift - Zwift Racing League | WTRL - Men&#039;s EMEA E1 DIVISION 4,Evening_Ride (3),Tack Neo,307,294,13
78155,62108,2020-12-01 17:48:37,neo,Zwift - Zwift Racing League | WTRL - Men&#039;s EMEA E1 DIVISION 4 (B),Power2Max,Tack Neo,285,290,-5
80831,62108,2020-12-08 17:47:55,neo,Zwift - Zwift Racing League | WTRL - Men&#039;s EMEA E2 DIVISION 3 (B),Power2Max,Tack Neo,305,302,3
83676,62108,2020-12-15 17:41:51,neo,Zwift - Zwift Racing League | WTRL - Men&#039;s EMEA E2 DIVISION 3 (B),Power2Max,Tack Neo,291,278,13
96883,62108,2021-01-13 18:22:26,neo,Zwift - Danmarks Cykle Union & Partners 1/6 (B),Power2Max,Tack Neo,307,309,-2
103554,62108,2021-01-26 17:51:51,neo,Zwift - Zwift Racing League | WTRL - Men&#039;s/Mixed EMEA E1 DIVISION 5 (B),Power2Max,Tack Neo,304,310,-6
107379,62108,2021-02-02 17:48:23,neo,Zwift - Zwift Racing League | WTRL - Men&#039;s/Mixed EMEA E1 DIVISION 5 (B),Power2Max,Tack Neo,315,326,-11
111682,62108,2021-02-07 20:04:24,neo,Zwift - Zwift Racing League | WTRL - Men&#039;s/Mixed EMEA E1 DIVISION 5 (B),Power2Max,Tack Neo,292,299,-7
116542,62108,2021-02-16 17:55:08,neo,Zwift - Zwift Racing League | WTRL - Men&#039;s/Mixed EMEA E1 DIVISION 7 (B),Power2Max,Tack Neo,295,303,-8
97725,62241,2021-01-16 07:59:20,wahoo,Zwift - Serge Faber UTT (A)&#039;s Meetup - 2018 UCI Worlds Short Lap,Sages gen3,Wachoo kickr core,360,372,-12
98616,62241,2021-01-17 15:59:11,wahoo,Zwift - TDZ Stage 3: Longer Ride,Zwift +Stages gen3,Garmin + Wahoo kickr core ,359,362,-3
109842,62241,2021-02-06 07:59:12,wahoo,Zwift - KOM-on Winter Race Series&#039;s Meetup - Surrey Hills,Sages gen3,Wachoo kickr core,371,385,-14
121408,62241,2021-02-27 07:59:29,wahoo,Zwift - Serge Faber UTT (A)&#039;s Meetup - Serpentine 8,Assioma DUO,Wachoo kickr core,396,404,-8
124774,62241,2021-03-06 07:58:54,wahoo,Zwift - Serge Faber UTT (A)&#039;s Meetup - Champs-Élysées,Stages gen3,Wachoo kickr core,370,360,10
127718,62241,2021-03-13 08:00:01,wahoo,Zwift - Serge Faber UTT (A)&#039;s Meetup - Tour of Fire and Ice,Stages gen3,Wachoo kickr core,376,382,-6
85799,62777,2020-12-19 17:18:57,wahoo,Zwift - EVR Summer Series (A),Stages Gen3LR (Secondary),Kickr 2020 (Primary),318,332,-14
86716,62777,2020-12-23 22:47:00,wahoo,Zwift - 3R Volcano Flat Reverse 50k Race - 4 Laps (48.8km/30.7mi 184m) (A),"Power2Max NG (Secondary, TT bike)",Kickr 2020 (Primary),337,326,11
87000,62777,2020-12-24 16:31:53,wahoo,Zwift - OH MY CRIT! - The Double Race 2/2 (A),"Power2Max NG (Secondary, TT bike)",Kickr 2020 (Primary),352,339,13
87537,62777,2020-12-26 17:07:53,wahoo,Zwift - EVR Summer Series (A),"Power2Max NG (Secondary, TT bike)",Kickr 2020 (Primary),353,332,21
89662,62777,2020-12-31 18:23:53,wahoo,Zwift -  Flanders The BZR Ronde  (A),"Power2Max NG (Secondary, TT bike)",Kickr 2020 (Primary),333,323,10
91021,62777,2021-01-03 17:09:38,wahoo,Zwift - 3R Racing (A),Stages Gen3LR (Secondary),Kickr 2020 (Primary),341,334,7
93109,62777,2021-01-07 23:26:22,wahoo,Zwift - Crit City Race (A),Stages Gen3LR (Secondary),Kickr 2020 (Primary),337,346,-9
94192,62777,2021-01-09 19:35:27,wahoo,Zwift - 3R Flat Race (A),"Power2Max NG (Secondary, TT bike)",Kickr 2020 (Primary),365,350,15
96009,62777,2021-01-13 00:07:47,wahoo,Zwift - Zwift Racing League | WTRL - Men&#039;s/Mixed AMERICAS E DIVISION 3 (A),"Power2Max NG (Secondary, TT bike)",Kickr 2020 (Primary),354,350,4
97498,62777,2021-01-14 23:46:01,wahoo,Zwift - Watopia (Epic KOM),"Power2Max NG (Secondary, TT bike)",Kickr 2020 (Primary),360,346,14
97676,62777,2021-01-15 23:22:45,wahoo,Zwift - Yorkshire,Stages Gen3LR (Secondary),Kickr 2020 (Primary),242,251,-9
98007,62777,2021-01-16 14:27:00,wahoo,Zwift - G et Zwifty (NeXT)&#039;s Meetup - R.G.V.,Stages Gen3LR (Secondary),Kickr 2020 (Primary),271,283,-12
98320,62777,2021-01-16 22:44:13,wahoo,Zwift - 30-20-10,Stages Gen3LR (Secondary),Kickr 2020 (Primary),323,340,-17
99988,62777,2021-01-20 00:16:39,wahoo,Zwift - Zwift Racing League | WTRL - Men&#039;s/Mixed AMERICAS E DIVISION 3 (A),"Power2Max NG (Secondary, TT bike)",Kickr 2020 (Primary),363,358,5
102130,62777,2021-01-23 23:16:58,wahoo,Zwift - TEAM VEGAN Tofu Tornado (A),"Power2Max NG (Secondary, TT bike)",Kickr 2020 (Primary),376,360,16
103787,62777,2021-01-27 00:16:51,wahoo,Zwift - Zwift Racing League | WTRL - Men&#039;s/Mixed AMERICAS E DIVISION 3 (A),"Power2Max NG (Secondary, TT bike)",Kickr 2020 (Primary),364,351,13
105936,62777,2021-01-30 14:20:49,wahoo,Zwift - VACA Saturday Smackdown (A),"Power2Max NG (Secondary, TT bike)",Kickr 2020 (Primary),363,352,11
107712,62777,2021-02-03 00:16:02,wahoo,Zwift - Zwift Racing League | WTRL - Men&#039;s/Mixed AMERICAS E DIVISION 3 (A),"Power2Max NG (Secondary, TT bike)",Kickr 2020 (Primary),388,384,4
111885,62777,2021-02-10 00:18:12,wahoo,Zwift - Zwift Racing League | WTRL - Men&#039;s/Mixed AMERICAS E DIVISION 3 (A),"Power2Max NG (Secondary, TT bike)",Kickr 2020 (Primary),366,351,15
112563,62777,2021-02-11 00:40:27,wahoo,Zwift - TDZ Stage 8: Group Ride,"Power2Max NG (Secondary, TT bike)",Kickr 2020 (Primary),373,359,14
113213,62777,2021-02-12 00:04:15,wahoo,Zwift - Watopia (Alpe du Zwift),"Power2Max NG (Secondary, TT bike)",Kickr 2020 (Primary),359,349,10
114448,62777,2021-02-13 19:38:50,wahoo,Zwift - JETT Endurance Ride 100km 3.0~3.3w/kg (B),"Power2Max NG (Secondary, TT bike)",Kickr 2020 (Primary),376,357,19
114825,62777,2021-02-14 13:53:29,wahoo,Zwift - Paul Lengermann [DTRacing]&#039;s Meetup - Petit Boucle,"Power2Max NG (Secondary, TT bike)",Kickr 2020 (Primary),406,393,13
116202,62777,2021-02-17 00:20:49,wahoo,Zwift - Zwift Racing League | WTRL - Men&#039;s/Mixed AMERICAS E DIVISION 3 (A),"Power2Max NG (Secondary, TT bike)",Kickr 2020 (Primary),372,365,7
117502,62777,2021-02-19 00:42:41,wahoo,Zwift - KISS Race Series - Americas PM (A),"Power2Max NG (Secondary, TT bike)",Kickr 2020 (Primary),393,388,5
118869,62777,2021-02-21 13:54:01,wahoo,Zwift - Paul Lengermann [DTRacing]&#039;s Meetup - The PRL Half,"Power2Max NG (Secondary, TT bike)",Kickr 2020 (Primary),393,387,6
119940,62777,2021-02-24 00:16:17,wahoo,Zwift - Zwift Racing League | WTRL - Men&#039;s/Mixed AMERICAS E DIVISION 3 (A),"Power2Max NG (Secondary, TT bike)",Kickr 2020 (Primary),350,352,-2
120991,62777,2021-02-25 23:56:32,wahoo,Zwift - Haute Route Watopia 2021 Stage 1 (A),"Power2Max NG (Secondary, TT bike)",Kickr 2020 (Primary),395,385,10
121696,62777,2021-02-27 14:29:16,wahoo,Zwift - Haute Route Watopia 2021 Stage 2 (A),"Power2Max NG (Secondary, TT bike)",Kickr 2020 (Primary),367,360,7
126884,62777,2021-03-11 10:48:33,wahoo,Zwift - KISS Race Series - Americas AM (A),"Power2Max NG (Secondary, TT bike)",Kickr 2020 (Primary),339,332,7
118012,63482,2021-02-20 00:34:53,wahoo,Zwift - ZHR Prison Break!,Karoo - FAVERO ASSIOMA ,Zwift - KICKR 5 ,341,332,9
114403,63664,2021-02-13 17:08:03,wahoo,"Zwift - Laktathandling: 1,5h mit 3x2&#039;/5&#039; Schwellenkreuzen",Garmin Vector 2,Wahoo Kickr,269,276,-7
64407,64147,2020-10-23 15:42:21,wahoo,Kickr / Assioma,Assioma,Kickr,361,352,9
20315,64419,2020-03-29 08:01:10,wahoo,100km Vikings søndagstur,SRM wattcrank,Kickr,266,262,4
20868,64419,2020-03-31 18:00:20,wahoo,NCF Spring Cup (B) OH yea,SRM wattcrank,Kickr,331,325,6
21746,64419,2020-04-03 13:46:46,wahoo,Zwift - Flat Race - 2 Laps (17.6km/10.9m 154m) (B) #3 ,Vector 2 wattpedals,Kickr 2018,354,364,-10
22792,64419,2020-04-07 17:37:38,wahoo,Zwift - NCF Spring Cup (A),SRM wattcrank Factory slope,Kickr 2018 w/6x Wrist HR,359,348,11
23540,64419,2020-04-10 09:19:58,wahoo,SRM wattcrank Factory slope / Kickr 2018,SRM wattcrank Factory slope,kickr,327,331,-4
24613,64419,2020-04-14 17:37:28,wahoo,Zwift - NCF Spring Cup (A),SRM wattcrank Factory slope,Kickr 2018,354,344,10
26744,64419,2020-04-21 18:39:02,wahoo,3R Spring Loaded Race Series - Round 4of6 (A),SRM wattcrank Factory slope,Kickr 2018 w/6x Wrist HR,346,343,3
28808,64419,2020-04-28 17:49:27,wahoo,Kickr 2018 w/6x Wrist HR,SRM wattcrank Factory slope,Kickr 2018 w/6x Wrist HR,347,348,-1
34213,64419,2020-05-12 17:28:46,wahoo,Zwift - UNO X CUP powered by DCU & Feltet.dk (A),SRM wattcrank Factory slope,Kickr 2018 w/6x Wrist HR,335,335,0
36104,64419,2020-05-19 17:32:53,wahoo,Vector 2 wattpedals,Vector 2 wattpedals,Kickr 2018,375,373,2
37895,64419,2020-05-26 17:31:17,wahoo,Zwift - NCF Grand Prix 2020 - Runde 4 - Aldersbestemt (D),SRM wattcrank Factory slope,Kickr 2018 w/6x Wrist HR,321,316,5
81908,64419,2020-12-11 11:47:26,wahoo,Zwift - 3R Greater London 8 Hilly Race - 1 Lap (23.8km/14.8mi 238m) (B),SRM aeroad,Kickr 2018 w/6x Wrist HR,306,306,0
83114,64419,2020-12-14 15:59:34,wahoo,Zwift - 3R Classique Reverse Flat Race - 4 Laps (26.9km/16.7mi 57m) (B),SRM LTD,Kickr 2018 w/6x Wrist HR,314,317,-3
85375,64419,2020-12-20 11:04:05,neo,Zwift - Stages of DIRT (B),SRM LTD,Taxc NEO,282,282,0
101411,64419,2021-01-22 14:58:56,neo,Zwift - DBR Friday Race (B),SRM LTD,Taxc NEO,307,305,2
112811,64419,2021-02-11 14:19:38,neo,razeing,SRM aeroad,Taxc NEO,317,327,-10
54001,64515,2020-09-08 18:43:59,neo,Zwift - 3R Sundown Race Series  (E),Winter Bike 4iiii,Tacx Neo ,374,379,-5
54399,64515,2020-09-10 17:35:59,neo,Zwift - Espresso TTT - had drop out dammit,Favero Assiamo Duo,Tacx Neo ,375,376,-1
55389,64515,2020-09-15 18:59:56,neo,Zwift - KISS at Race - EU PM (A),Favero Assiamo Duo,Tacx Neo ,374,368,6
55781,64515,2020-09-17 17:26:55,neo,Zwift - Frappe,Favero Assiamo Duo,Tacx Neo ,349,339,10
56438,64515,2020-09-20 12:48:01,neo,Zwift - Invitational League // Qualifying Race #3 (Men) (A),Favero Assiamo Duo,Tacx Neo ,374,366,8
56842,64515,2020-09-22 18:41:49,neo,Zwift - 3R Sundown Race Series  (E),Favero Assiamo Duo,Tacx Neo ,364,354,10
58414,64515,2020-09-30 07:59:54,neo,Zwift - Watopia T,Favero Assiamo Duo,Tacx Neo ,377,379,-2
58831,64515,2020-10-01 17:38:02,neo,Zwift - Espresso TTT,Favero Assiamo Duo,Tacx Neo ,366,367,-1
61261,64515,2020-10-12 18:49:49,neo,Zwift - Premier Division // Zwift Racing League (men) ,Favero Assiamo Duo,Tacx Neo ,393,384,9
62149,64515,2020-10-15 17:24:02,neo,Zwift - TTT,Favero Assiamo Duo,Tacx Neo ,385,373,12
64378,64515,2020-10-23 13:35:00,neo,Zwift - Crit City Race (A),Favero Assiamo Duo,Tacx Neo ,373,363,10
68578,64515,2020-11-06 18:56:59,neo,Zwift - Warm up for zwift races,Favero Assiamo Duo,Tacx Neo ,379,383,-4
68865,64515,2020-11-07 18:55:46,neo,Zwift -  Tour De Spartacus  (A),Favero Assiamo Duo,Tacx Neo ,370,369,1
69117,64515,2020-11-08 18:55:59,neo,Zwift -  Tour De Spartacus  (A),Favero Assiamo Duo,Tacx Neo ,407,406,1
76066,64515,2020-11-26 18:25:41,neo,Zwift - WTRL TTT World Champs,Favero Assiamo Duo,Tacx Neo ,379,378,1
77730,64515,2020-11-30 19:00:59,neo,Zwift - Premier Division // Zwift Racing League (men) (A),Favero Assiamo Duo,Tacx Neo ,379,380,-1
90943,64515,2021-01-03 19:33:21,neo,Zwift - ITS Seated Accelerations,Favero Assiamo Duo,Tacx Neo ,316,318,-2
91408,64515,2021-01-04 19:17:37,neo,Zwift - Team TFC Mad Monday Winter Series (A),Favero Assiamo Duo,Tacx Neo ,349,354,-5
93989,64515,2021-01-09 16:07:53,neo,Zwift - TEAM VEGAN Tofu Tornado (A),Favero Assiamo Duo,Tacx Neo ,367,371,-4
99203,64515,2021-01-18 19:35:59,neo,Zwift - Premier Division // Zwift Racing League (men) (A),Favero Assiamo Duo,Tacx Neo ,373,379,-6
102947,64515,2021-01-25 19:20:11,neo,Zwift - Team TFC Mad Monday Winter Series (A),Favero Assiamo Duo,Tacx Neo ,346,341,5
104835,64515,2021-01-28 19:50:28,neo,Zwift - TTT,Favero Assiamo Duo,Tacx Neo ,378,381,-3
106984,64515,2021-02-01 19:47:02,neo,Zwift - Premier Division // Zwift Racing League (men) (A),Favero Assiamo Duo,Tacx Neo ,391,395,-4
108910,64515,2021-02-04 18:13:45,neo,Zwift - Vienna,Favero Assiamo Duo,Tacx Neo ,373,369,4
111066,64515,2021-02-08 19:14:17,neo,Zwift - Premier Division // Zwift Racing League (men) (A),Favero Assiamo Duo,Tacx Neo ,392,390,2
113140,64515,2021-02-11 18:13:39,neo,Zwift - Vienna,Favero Assiamo Duo,Tacx Neo ,363,361,2
115471,64515,2021-02-15 19:59:41,neo,Premier Division // Zwift Racing League (men) (A),Favero Assiamo Duo,Tacx Neo ,385,380,5
117340,64515,2021-02-18 18:20:00,neo,Zwift - Vienna,Favero Assiamo Duo,Tacx Neo ,363,364,-1
122599,64515,2021-03-01 20:02:15,neo,Zwift - Premier Division // Zwift Racing League (men) (A),Favero Assiamo Duo,Tacx Neo ,377,383,-6
124189,64515,2021-03-04 19:16:43,neo,Zwift - BRT Criterium Racing League (A) 3rd,Favero Assiamo Duo,Tacx Neo ,359,360,-1
120417,65112,2021-02-24 20:06:25,wahoo,KICKR CORE Zwift / Powerbox Garmin,Powerbox,KICKR CORE,270,271,-1
122217,65112,2021-02-28 20:15:21,wahoo,KICKR CORE Zwift / Powerbox Garmin,Powerbox,KICKR CORE,347,356,-9
122218,65112,2021-02-28 21:23:47,wahoo,KICKR CORE Zwift / Powerbox Garmin,Powerbox,KICKR CORE,221,221,0
125104,65112,2021-03-06 16:05:58,wahoo,KICKR CORE Zwift / Powerbox Garmin,Powerbox,KICKR CORE,294,298,-4
125873,65112,2021-03-08 19:20:06,wahoo,Team TFC Mad Monday Race Series (low-end categories),Powerbox,KICKR CORE,376,375,1
128816,65112,2021-03-15 19:20:22,wahoo,Zwift - Team TFC Mad Monday Race Series (low-end categories) (A),Powerbox,KICKR CORE,392,391,1
79221,65129,2020-12-04 04:56:48,wahoo,Zwift - SZR Musette Morgonchock (C),Stages Dual no HR,Wahoo Kickr (2016) + Tickr,249,254,-5
80535,65129,2020-12-07 17:13:41,wahoo,Zwift - Michael Stromgren CHOCK&#039;s Meetup - Volcano Circuit CCW,Stages Dual,Wahoo Kickr (2016),222,232,-10
81207,65129,2020-12-09 17:55:09,wahoo,Zwift - MIDWEEK Winter Series by SZR (C)- DNF,Stages Dual,Wahoo Kickr 16 Tickr,266,281,-15
95753,66410,2021-01-12 18:54:23,neo,Zwift - Team Italy & Frenchy Fuzion League (A),Powertap P1,Tacx Neo,324,321,3
97049,66410,2021-01-14 18:18:09,neo,Zwift - Espresso,Powertap P1 dual,Tacx Neo,410,412,-2
97751,66410,2021-01-16 09:09:33,neo,Zwift - Newbury Velo Weekend TT,Powertap P1 dual,Tacx Neo,404,407,-3
100939,66410,2021-01-21 18:41:29,neo,Zwift - WTRL Team Time Trial - Zone 6 (C),Powertap P1 dual,Tacx Neo,377,374,3
101722,66410,2021-01-23 09:29:17,neo,Zwift - DBR SufferDay League III (A),Powertap P1 dual,Tacx Neo,392,398,-6
102223,66410,2021-01-24 08:59:22,neo,Zwift - TDZ Stage 5: Longer Ride,Powertap P1 dual,Tacx Neo,382,388,-6
103479,66410,2021-01-26 18:14:11,neo,Zwift - ZESP ,Powertap P1 dual,Tacx Neo,340,341,-1
104186,66410,2021-01-27 18:29:22,neo,Zwift - NCF Vintercup 2021 - Runde 3 - Herrer (A),Powertap P1 dual,Tacx Neo,445,453,-8
105481,66410,2021-01-30 09:29:30,neo,Zwift - DBR SufferDay League III (A),Powertap P1 dual,Tacx Neo,411,414,-3
106097,66410,2021-01-31 08:29:22,neo,Zwift - Flanders Endurance Race League (A),Powertap P1 dual,Tacx Neo,382,383,-1
108261,66410,2021-02-03 18:29:23,neo,Zwift - NCF Vintercup 2021 - Runde 4 - Herrer (A),Powertap P1 dual,Tacx Neo,376,381,-5
110294,66410,2021-02-07 09:14:24,neo,Zwift - Fantasy Nutrinovex Rice by PETA-Z (A),Powertap P1 dual,Tacx Neo,401,404,-3
111665,66410,2021-02-09 18:54:11,neo,Zwift - Team Italy & Frenchy Fuzion League (A),Powertap P1 dual,Tacx Neo,346,348,-2
112333,66410,2021-02-10 18:29:22,neo,Zwift - NCF Vintercup 2021 - Runde 5 - Herrer (A),Powertap P1 dual,Tacx Neo,423,425,-2
113908,66410,2021-02-13 09:29:09,neo,Zwift - DBR SufferDay League III (A),Powertap P1 dual,Tacx Neo,415,415,0
114562,66410,2021-02-14 09:04:22,neo,Zwift - Newbury Velo Road Race (A),Powertap P1 dual,Tacx Neo,392,390,2
115846,66410,2021-02-16 18:09:12,neo,Zwift - SZR iTT Winter Racing League (A),Powertap P1 dual,Tacx Neo,310,307,3
116672,66410,2021-02-17 18:29:23,neo,Zwift - NCF Vintercup 2021 - Runde 6 - Herrer (A),Powertap P1 dual,Tacx Neo,401,406,-5
118100,66410,2021-02-20 09:05:10,neo,Zwift - 3R Endurance Series p/b OTE Sports- Stage 1 (A),Powertap P1 dual,Tacx Neo,398,397,1
119705,66410,2021-02-23 18:54:03,neo,Zwift - Team Italy & Frenchy Fuzion League (A),Powertap P1 dual,Tacx Neo,356,358,-2
120365,66410,2021-02-24 18:44:23,neo,Zwift - Scandinavian Cup 2021 - Round 1 - Men (A),Powertap P1 dual,Tacx Neo,403,394,9
122415,66410,2021-03-01 17:34:17,neo,Zwift - Kiss Racing Team / FastFitnessTips iTT series (E),Powertap P1 dual,Tacx Neo,427,422,5
123639,66410,2021-03-03 18:44:25,neo,Zwift - Scandinavian Cup 2021 - Round 2 - Men (A),Powertap P1 dual,Tacx Neo,411,410,1
126181,66410,2021-03-09 18:09:13,neo,Zwift - SZR iTT Spring Racing League (A),Powertap P1 dual,Tacx Neo,320,319,1
126652,66410,2021-03-10 18:44:14,neo,Zwift - Scandinavian Cup 2021 - Round 3 - Men (A),Powertap P1 dual,Tacx Neo,417,419,-2
129231,66410,2021-03-16 18:29:11,neo,Zwift - CeramicSpeed Race Series: Open Race (A),Powertap P1 dual,Tacx Neo,408,409,-1
129762,66410,2021-03-17 18:44:22,neo,Zwift - Scandinavian Cup 2021 - Round 4 - Men (A),Powertap P1 dual,Tacx Neo,413,405,8
52380,66453,2020-08-28 16:24:31,wahoo,World Elite Zwifters Friday&#039;s Race Series - Round 5 (A) - 2nd,Shimano dual power meter,Kickr w/out drops,375,374,1
109936,66453,2021-02-06 13:39:51,wahoo,Kickr / Shimano dual power meter,Shimano dual power meter,Kickr,403,409,-6
109937,66453,2021-02-06 13:39:51,wahoo,XRS Races: Saturday Climbing Series,Shimano dual power meter,Kickr,403,409,-6
111505,66453,2021-02-09 16:37:22,wahoo,Muir & The Mountain TT,Shimano dual power meter,Kickr,392,402,-10
111508,66453,2021-02-09 16:37:22,wahoo,Muir & The Mountain TT,2021-02-09-16-37-22,Kickr,392,402,-10
71730,66970,2020-11-15 15:03:37,wahoo,Zwift - Ramp Test,P2M,Kick5,410,401,9
78086,66970,2020-12-01 18:11:22,wahoo,Zwift - Watopia,S Works PM,Kick5,255,249,6
78092,66970,2020-12-01 17:59:59,wahoo,Zwift - KIRCHMAIR TT Race (A),S Works PM,Kick5,398,371,27
79776,66970,2020-12-05 14:33:45,wahoo,Zwift - SST (Short) ERGO Mode,P2M NG,Kick5,337,325,12
81485,66970,2020-12-10 12:39:39,wahoo,Zwift - SST (Med),P2M NG,Kick5,336,322,14
82256,66970,2020-12-12 10:44:11,wahoo,Zwift - Watopia,P2M NG,Kick5,277,266,11
84678,66970,2020-12-18 12:53:04,wahoo,Zwift - 8wk Race Day Prep Week 8 PRE-RACE DAY SPIN,P2M NG,Kick5,327,325,2
84992,66970,2020-12-19 09:05:01,wahoo,Zwift - e-liga | eCycling league Austria Race 3 (A),P2M NG,Kick5,402,383,19
86005,66970,2020-12-22 10:02:19,wahoo,Zwift - Zwift Time Trial Tuesday: Bologna (E),P2M NG,Kick5,379,410,-31
89755,66970,2021-01-01 10:05:00,wahoo,Zwift - 3R Innsbruckring Flat Race - 4 Laps (35.2km/21.9mi 308m) (A),P2M NG,Kick5,399,373,26
112806,66970,2021-02-11 11:49:31,wahoo,Zwift - Watopia,S Works P2M NG,Kick5,353,341,12
113322,66970,2021-02-12 08:35:17,wahoo,Zwift - NYC,S Works PM,Kick5,331,332,-1
118372,66970,2021-02-20 18:03:51,wahoo,Zwift - Watopia,Quarg ,Kick5,339,341,-2
121801,66970,2021-02-27 14:54:40,wahoo,Zwift - DIRT Dadurday Chase Race  (A),Quarg Inflite,Kick5,350,350,0
127936,66970,2021-03-13 09:04:57,wahoo,Zwift - e-liga | eCycling league Austria Race 9 (A),Quarg Inflite,Kick5,353,345,8
16023,67290,2020-02-27 18:50:27,wahoo,4iiii Precision L,4iiii Precision L,Wahoo Kickr,303,300,3
71912,67290,2020-11-16 12:05:01,wahoo,ZSUN Flat Irons CO Ride (C),4iiii Precision L,Wahoo Kickr v5,195,180,15
73923,67290,2020-11-20 19:02:00,wahoo,Zwift - TFC Autumn Race Series (C),4iiii Precision L,Wahoo Kickr v5,230,218,12
76638,67290,2020-11-27 18:00:02,wahoo,Zwift - FOCUS: Colours of PARI / Stage Lilac - Focus Team (A),4iiii Precision L,Wahoo Kickr v5,207,189,18
77020,67290,2020-11-28 15:00:09,wahoo,Zwift - Focus: Colours of PARI,4iiii Precision L,Wahoo Kickr v5,167,159,8
77200,67290,2020-11-29 07:00:03,wahoo,Zwift - Focus: Colours of PARI,4iiii Precision L,Wahoo Kickr v5,168,161,7
77573,67290,2020-11-30 10:51:06,wahoo,KISS at Base,4iiii Precision L,Wahoo Kickr v5,220,204,16
78481,67290,2020-12-02 10:51:34,wahoo,Zwift - KISS at Base,4iiii Precision L,Wahoo Kickr v5,231,214,17
81935,67290,2020-12-11 10:51:13,wahoo,Zwift - KISS at Base ,4iiii Precision L,Wahoo Kickr v5,242,232,10
83093,67290,2020-12-14 10:51:18,wahoo,Zwift - KISS at Base,4iiii Precision L,Wahoo Kickr v5,270,253,17
85729,67290,2020-12-21 10:55:09,wahoo,Zwift - KISS at Base ,4iiii Precision L,Wahoo Kickr v5,246,234,12
87193,67290,2020-12-25 09:04:58,wahoo,Zwift - 3R Whole Lotta Lava Hilly Race - 2 Laps (28.9km/12.53mi 336m) (B),4iiii Precision L,Wahoo Kickr v5,280,259,21
87443,67290,2020-12-26 09:02:11,wahoo,Zwift - KRT/KISS 80 km Endurance Ride (C),4iiii Precision L,Wahoo Kickr v5,196,183,13
88155,67290,2020-12-28 10:51:07,wahoo,Zwift - KISS at Base,4iiii Precision L,Wahoo Kickr v5,205,195,10
116723,67290,2021-02-17 18:46:10,wahoo,Zwift - Danmarks Cykle Union & Partners 6/6 (B),4iiii Precision L,Wahoo Kickr v5,301,286,15
8127,67632,2020-01-05 10:45:13,wahoo,Zwift - The Season - 3 Days of Yorkshire #2 (E),Power2Max NGeco,Wahoo Kickr &#039;18,382,368,14
8415,67632,2020-01-08 12:30:09,wahoo,Zwift - 3R LaGuardia Loop Flat Race - 10 Laps (28.3km/17.6mi 270m) (A),Power2Max NGeco,Wahoo Kickr &#039;18,374,360,14
8710,67632,2020-01-10 09:05:08,wahoo,Zwift - 3R Whole Lotta Lava Hilly Race - 2 Laps (28.9km/12.53mi 336m) (A),Power2Max NGeco,Wahoo Kickr &#039;18,385,376,9
8711,67632,2020-01-10 10:05:16,wahoo,Zwift - 3R Innsbruckring Flat Race - 4 Laps (35.2km/21.9mi 308m) (A),Power2Max NGeco,Wahoo Kickr &#039;18,360,350,10
9161,67632,2020-01-13 18:15:12,wahoo,Zwift - DBR Caresport Crit Cup  (A),Power2Max NGeco,Wahoo Kickr &#039;18,382,367,15
9448,67632,2020-01-15 08:05:20,wahoo,Zwift - 3R Tempus Fugit Flat Race - 1 Lap (19.8km/12.3mi 20m) (A),Power2Max NGeco,Wahoo Kickr &#039;18,355,343,12
12499,67632,2020-02-04 19:15:11,wahoo,Zwift - Tour de Zwift // Pro-Am Invitational (A),Power2Max NGeco,Wahoo Kickr &#039;18,411,402,9
13324,67632,2020-02-10 19:05:14,wahoo,Zwift - ITT League - The Stampede by Herd Racing League (Europe) (A),Power2Max NGeco,Wahoo Kickr &#039;18,364,356,8
13325,67632,2020-02-10 19:50:12,wahoo,Zwift - EVR Europe Race (A),Power2Max NGeco,Wahoo Kickr &#039;18,362,358,4
17447,67632,2020-03-10 09:20:09,wahoo,Zwift - Eat The Pain Race (A),Power2Max NGeco,Wahoo Kickr &#039;18,367,355,12
17835,67632,2020-03-12 19:15:13,wahoo,Zwift - Tour of Watopia Pro-Am Men&#039;s Race #1 (A),Power2Max NGeco,Wahoo Kickr &#039;18,394,383,11
22168,67632,2020-04-05 09:00:14,wahoo,Zwift - Ronde van Zwift (A),Power2Max NGeco,Wahoo Kickr &#039;18,394,377,17
56062,67632,2020-09-17 17:31:37,wahoo,Zwift - FUSION ECT BEUNSTOPPABLE Racing Series (B),Power2Max NGeco,Wahoo Kickr &#039;18,372,351,21
57315,67632,2020-09-21 17:15:25,wahoo,Zwift - DBR Ride´N´Roll League (A),Power2Max NGeco,Wahoo Kickr &#039;18,334,305,29
57319,67632,2020-09-24 18:45:13,wahoo,Zwift - XRS - ZTR Thursday Night Race (B),Power2Max NGeco,Wahoo Kickr &#039;18,363,339,24
58605,67632,2020-09-30 17:45:15,wahoo,Zwift - DCU powered by Feltet.dk (B),Power2Max NGeco,Wahoo Kickr &#039;18,346,336,10
60499,67632,2020-10-08 18:59:04,wahoo,Zwift - WTRL Team Time Trial - Zone 6 (C),Power2Max NGeco,Wahoo Kickr &#039;18,334,316,18
62471,67632,2020-10-15 17:30:11,wahoo,Zwift - FUSION ECT BEUNSTOPPABLE Racing Series (A),Power2Max NGeco,Wahoo Kickr &#039;18,379,369,10
67632,67632,2020-11-03 18:55:14,wahoo,Zwift - Team Italy & Frenchy Fuzion League (A),Power2Max NGeco,Wahoo Kickr &#039;18,371,353,18
70308,67632,2020-11-11 19:00:12,wahoo,Zwift - DCU – Feltet.dk November series (A),Power2Max NGeco,Wahoo Kickr &#039;18,391,381,10
70803,67632,2020-11-12 18:30:12,wahoo,Zwift - FUSION ECT BEUNSTOPPABLE Racing Series (A),Power2Max NGeco,Wahoo Kickr &#039;18,334,322,12
73182,67632,2020-11-19 19:30:12,wahoo,Zwift - World Championships Experience // Danish Cycling Federation,Power2Max NGeco,Wahoo Kickr 5,382,373,9
77656,67632,2020-11-30 18:15:15,wahoo,Zwift -  DBR Monday Race (A),Power2Max NGeco,Wahoo Kickr 5,372,365,7
79019,67632,2020-12-03 18:30:14,wahoo,Zwift - FUSION DECEMBER CUP (A),Power2Max NGeco,Wahoo Kickr 5,337,326,11
80536,67632,2020-12-07 19:02:19,wahoo,Zwift - EVR Europe Race (A),Power2Max NGeco,Wahoo Kickr 5,348,346,2
83778,67632,2020-12-15 18:24:23,wahoo,Zwift - Zwift Racing League | WTRL - Men&#039;s EMEA E1 DIVISION 1 (A),Power2Max NGeco,Wahoo Kickr 5,374,360,14
84489,67632,2020-12-17 18:29:54,wahoo,Zwift - FUSION DECEMBER CUP (A),Power2Max NGeco,Wahoo Kickr 5,351,345,6
85817,67632,2020-12-21 18:14:48,wahoo,Zwift -  DBR Monday Race (A),Power2Max NGeco,Wahoo Kickr 5,340,326,14
90923,67632,2021-01-03 18:59:45,wahoo,Zwift - BRT Iron Goat Racing League (A),Power2Max NGeco,Wahoo Kickr 5,368,356,12
92981,67632,2021-01-07 18:30:08,wahoo,Zwift - FUSION WINTER CUP (A),Power2Max NGeco,Wahoo Kickr 5,361,349,12
95647,67632,2021-01-12 18:15:09,wahoo,Zwift - Zwift Racing League | WTRL - Men&#039;s/Mixed EMEA E1 DIVISION 1 (A),Power2Max NGeco,Wahoo Kickr 5,360,353,7
97317,67632,2021-01-14 18:30:04,wahoo,Zwift - FUSION WINTER CUP (A),Power2Max NGeco,Wahoo Kickr 5,382,377,5
104764,67632,2021-01-28 18:29:53,wahoo,Zwift - FUSION WINTER CUP (A),Power2Max NGeco,Wahoo Kickr 5,371,366,5
110991,67632,2021-02-08 18:14:42,wahoo,Zwift -  DBR Monday Race (A),Power2Max NGeco,Wahoo Kickr 5,399,395,4
111349,67632,2021-02-09 08:29:49,wahoo,Zwift - DBR Morning Race (A),Power2Max NGeco,Wahoo Kickr 5,346,338,8
113045,67632,2021-02-11 18:29:49,wahoo,Zwift - FUSION WINTER CUP (A),Power2Max NGeco,Wahoo Kickr 5,377,369,8
116976,67632,2021-02-17 18:44:36,wahoo,Zwift - Danmarks Cykle Union & Partners 6/6 (A),Power2Max NGeco,Wahoo Kickr 5,353,349,4
120387,67632,2021-02-18 18:29:36,wahoo,Zwift - FUSION WINTER CUP (A),Power2Max NGeco,Wahoo Kickr 5,349,343,6
120409,67632,2021-02-23 19:51:35,wahoo,Zwift - Zwift Racing League | WTRL - Men&#039;s/Mixed EMEA W2 DIVISION 1 (A),Power2Max NGeco,Wahoo Kickr 5,359,350,9
125993,67632,2021-03-07 18:30:08,wahoo,Zwift - SCANNELLATORI SERIALI TOUR,Power2Max NGeco,Wahoo Kickr 5,378,369,9
126908,67632,2021-03-11 11:00:21,wahoo,Zwift - KISS Race Series - Americas AM (A),Power2Max NGeco,Wahoo Kickr 5,321,309,12
9052,68432,2020-01-12 19:09:32,wahoo,Tour de Zwift // Pro-Am Invitational,garmin v2,Wahoo Kicker 2018,353,347,6
9514,68432,2020-01-15 19:14:59,wahoo,Tour de Zwift // Pro-Am Invitational,garmin v2,Wahoo Kicker 2018,402,412,-10
10635,68432,2020-01-23 19:14:13,wahoo,Tour de Zwift // Pro-Am Invitational,garmin v2,Wahoo Kicker 2018,457,455,2
12429,68432,2020-02-04 19:14:57,wahoo,Tour de Zwift // Pro-Am Invitational,garmin v2,wahoo kickr 2018,424,430,-6
25660,68432,2020-04-17 18:11:00,wahoo,Zwift - Richmond Challenge // Zwift Classic (A),vector 3s,Wahoo Kicker 2018,404,414,-10
28021,68432,2020-04-25 18:09:01,wahoo,Zwift - Crit City Slam // Zwift Classic (A),vector 3s,wahoo kickr 2018,420,418,2
38381,68432,2020-05-28 18:16:00,wahoo,Zwift - Tour for All Invitational Race // Men (A),4iiii,kickr,430,443,-13
49332,68432,2020-08-08 14:14:55,wahoo,OH MY CRIT - Saturday Smash Race,vector 3s,kickr to Zwift ,384,389,-5
49769,68432,2020-08-12 23:29:56,wahoo,Zwift - Austin Driveway Series Criterium (A),vector 3s,kickr to Zwift ,349,361,-12
49929,68432,2020-08-13 00:59:59,wahoo,Off the MAAP Invitational Race // Stage 1 (Men),4iiii to 4iiii app,kickr to Zwift ,394,389,5
50830,68432,2020-08-20 08:49:49,wahoo,Zwift - Off the MAAP Invitational Race // Stage 3 (men) ,vector 3s,kickr to Zwift ,402,400,2
55354,68432,2020-09-15 15:08:52,wahoo,Zwift - 3R Sundown Race Series  (E),4iiii to garmin,kickr to Zwift ,377,374,3
56020,68432,2020-09-17 18:29:00,wahoo,Zwift - Invitational League // Qualifying Race #2 (Men) ,4iiii,kickr,363,380,-17
56273,68432,2020-09-19 14:14:22,wahoo,Zwift - OH MY CRIT - Saturday Smash Race (A) in 25 degrees not fan laundry room,4iiii to garmin,kickr,343,333,10
56411,68432,2020-09-20 12:43:09,wahoo,Zwift - Invitational League // Qualifying Race #3 (Men) (A),4iiii to garmin,kickr to Zwift ,408,406,2
56725,68432,2020-09-21 23:59:08,wahoo,Zwift - Back to Work North America Ride (B),4iiii to garmin,kickr to Zwift ,341,352,-11
57775,68432,2020-09-26 17:48:54,wahoo,Zwift - 3 sisters zada for training Watopia,4iiii to garmin,kickr to Zwift ,426,429,-3
61017,68432,2020-10-11 15:59:43,wahoo,Zwift - ZA Road Group Ride (A),vector 3s,kickr to Zwift ,272,270,2
61260,68432,2020-10-12 18:49:07,wahoo,Zwift - Premier Division // Zwift Racing League (men) ,vector 3s,kickr to Zwift ,426,435,-9
61484,68432,2020-10-13 12:03:11,wahoo,Zwift Academy Road: Workout 2 | Sprint Profile,vector 3s,kickr to Zwift ,295,293,2
63064,68432,2020-10-19 18:17:26,wahoo,Zwift - Drop outs :( Premier Division // Zwift Racing League (men) drop out :(,4iiii to garmin,kickr to Zwift ,401,421,-20
63627,68432,2020-10-21 02:11:30,wahoo,Zwift - 1ama lab test new kickr v5,4iiii to garmin,kickr v5 to Zwift ,238,238,0
63992,68432,2020-10-22 00:00:51,wahoo,BRT Wednesday Night Crit City  Race,4iiii to garmin,kickr to Zwift ,358,355,3
64119,68432,2020-10-22 12:24:48,wahoo,EMU Japan Race,4iiii to garmin,Kickr V5 to Zwift ,378,373,5
64713,68432,2020-10-24 22:14:45,wahoo,Zwift - 3R Classique Flat Race (A),4iiii to garmin,Kickr V5 to Zwift ,407,397,10
64949,68432,2020-10-25 22:53:57,wahoo,Zwift - Watopia w brevet,4iiii to garmin,Kickr V5 to Zwift ,281,277,4
65159,68432,2020-10-26 19:59:29,wahoo,Zwift - Premier Division // Zwift Racing League (men) (A),4iiii to garmin,Kickr V5 to Zwift ,414,409,5
65452,68432,2020-10-27 18:58:34,wahoo,Zwift - Watopia,4iiii to garmin,kickr to zwift,294,294,0
66042,68432,2020-10-29 12:36:52,wahoo,Erg mode Zwift Academy Road: Workout 7 | VO2 Development,4iiii to garmin,kickr to zwift,373,363,10
66700,68432,2020-10-31 15:14:36,wahoo,Zwift - OH MY CRIT - Saturday Smash Race (A),4iiii to garmin,kickr to zwift,381,379,2
67258,68432,2020-11-02 19:08:56,wahoo,Zwift - Premier Division // Zwift Racing League (men) (A),4iiii to garmin,kickr to zwift,404,405,-1
68098,68432,2020-11-05 01:02:54,wahoo,Zwift - Cycling Canada Wednesday Night Race Series,4iiii to garmin,kickr to zwift,385,388,-3
69136,68432,2020-11-08 18:59:31,wahoo,tour de spartacus - working for the team,4iiii to garmin,kickr to zwift,447,432,15
69160,68432,2020-11-08 21:04:41,wahoo,3R Gotham Grind Flat Race - 3 Laps (27.8km/17.4mi 87m),4iiii to garmin,kickr to zwift,339,329,10
69531,68432,2020-11-10 01:00:01,wahoo,Zwift - ZA Road Group Ride: 2.2 - 2.7 w/kg,4iiii to garmin,kickr to zwift,338,336,2
69993,68432,2020-11-10 23:59:40,wahoo,Zwift - ZHR Masters Atlantic (A),4iiii to garmin,kickr to zwift,403,403,0
70228,68432,2020-11-11 17:59:29,wahoo,Zwift - MIDWEEK Autumn Series by SZR (A),4iiii to garmin,kickr to zwift,380,376,4
70942,68432,2020-11-13 01:14:20,wahoo,Zwift Academy Road: Workout 1 | Aerobic Power,4iiii to garmin,kickr to zwift,438,448,-10
71206,68432,2020-11-13 22:59:40,wahoo,Zwift - 2020 UCI Cycling Esports World Championships Practice Event,4iiii to garmin,kickr to zwift,391,408,-17
72130,68432,2020-11-16 19:02:32,wahoo,Zwift - Premier Division // Zwift Racing League (men) (A),4iiii to garmin,kickr to zwift,386,391,-5
76985,68432,2020-11-28 15:14:36,wahoo,Zwift - OH MY CRIT - Saturday Smash Race (A),4iiii to garmin,kickr to zwift,375,371,4
78739,68432,2020-12-03 01:04:21,wahoo,Zwift - Cycling Canada Wednesday Night Race Series (A),4iiii to garmin,kickr to zwift,393,384,9
80136,68432,2020-12-06 14:14:04,wahoo,Zwift - KISS 100 Race Series - Americas (A),4iiii to garmin,kickr to zwift,363,362,1
82392,68432,2020-12-12 02:43:58,wahoo,Zwift - oh crit,4iiii to garmin,kickr to zwift,422,419,3
83754,68432,2020-12-15 00:07:41,wahoo,Zwift - Watopia zada 3 sisters,4iiii to garmin,kickr to zwift,375,379,-4
84137,68432,2020-12-17 01:04:41,wahoo,Cycling Canada Wednesday Night Race Series,4iiii to garmin,kickr to zwift,404,407,-3
85113,68432,2020-12-19 15:14:37,wahoo,Zwift - OH CRIT SMASH,4iiii to garmin,kickr to zwift,421,417,4
86949,68432,2020-12-24 16:14:20,wahoo,OH MY CRIT! - The Double Race 1/2,4iiii to garmin,kickr to zwift,383,402,-19
86973,68432,2020-12-24 17:04:34,wahoo,OH MY CRIT! - The Double Race 2/2,4iiii to garmin,kickr to zwift,368,377,-9
87248,68432,2020-12-25 18:29:39,wahoo,Zwift - KIRCHMAIR Race Series (A),4iiii to garmin,kickr to zwift,319,329,-10
87266,68432,2020-12-25 19:18:48,wahoo,Zwift - Watopia A Anqueyil,4iiii to garmin,kickr to zwift,280,284,-4
88023,68432,2020-12-28 00:34:37,wahoo,Toronto Hustle Holiday Classic Stage  Race: Stage One,4iiii to garmin,kickr to zwift,371,380,-9
88389,68432,2020-12-29 00:29:23,wahoo,Zwift - Toronto Hustle Holiday Classic Stage Race: Stage Two,4iiii to garmin,kickr to zwift,373,364,9
89883,68432,2021-01-01 17:59:24,wahoo,Zwift - endurance,4iiii to garmin,kickr to zwift,357,347,10
89885,68432,2021-01-01 18:29:24,wahoo,Zwift - nyd race,4iiii to garmin,kickr to zwift,325,316,9
98034,68432,2021-01-16 14:30:04,wahoo,Zwift - Jed Scott&#039;s Meetup - R.G.V.,4iiii to garmin,kickr to zwift,348,348,0
99176,68432,2021-01-18 19:49:33,wahoo,Zwift - Premier Division // Zwift Racing League (men) (A),4iiii to garmin,kickr to zwift,385,390,-5
100566,68432,2021-01-21 01:04:35,wahoo,Zwift - 1 drop out Cycling Canada Wednesday Night Race Series (A),4iiii to garmin,kickr to zwift,385,401,-16
101952,68432,2021-01-23 16:29:26,wahoo,Zwift - vegan team tofu race,4iiii to garmin,kickr to zwift,399,404,-5
102897,68432,2021-01-25 19:01:47,wahoo,Zwift - Premier Division // Zwift Racing League (men) (A),4iiii to garmin,Kickr V5 to Zwift ,390,393,-3
105649,68432,2021-01-30 15:13:29,wahoo,Zwift - OH MY CRIT!! - Saturday Smash Race (A),4iiii to garmin,kickr to zwift,394,387,7
107016,68432,2021-02-02 00:44:15,wahoo,crit city,4iiii to garmin,kickr to zwift,389,392,-3
107020,68432,2021-02-02 01:24:24,wahoo,Zwift race - 02/01/2021,4iiii to garmin,kickr to zwift,383,368,15
108485,68432,2021-02-03 23:59:26,wahoo,Zwift - Open - Movistar Team Challenge Community Qualifier Race #2,4iiii to garmin,kickr to zwift,417,407,10
109914,68432,2021-02-06 15:14:17,wahoo,Zwift - OH MY CRIT!! - Saturday Smash Race (A),4iiii to garmin,kickr to zwift,422,410,12
110985,68432,2021-02-08 19:14:22,wahoo,Zwift - Premier Division // Zwift Racing League (men) (A),4iiii to garmin,Kickr V5 to Zwift ,406,410,-4
112130,68432,2021-02-10 13:35:15,wahoo,Zwift - Crit City Race (A),4iiii to garmin,kickr to zwift,398,393,5
112719,68432,2021-02-11 11:31:44,wahoo,Zwift - EMU Japan Short Race (A) call back race,4iiii to garmin,kickr to zwift,370,369,1
114149,68432,2021-02-13 15:13:55,wahoo,OH MY CRIT!! - Saturday Smash Race,4iiii to garmin,kickr to zwift,395,387,8
115378,68432,2021-02-15 20:00:28,wahoo,Zwift -  Premier Division // Zwift Racing League (men) (A),4iiii to garmin 530,Kickr V5 to Zwift ,408,431,-23
116188,68432,2021-02-17 00:28:53,wahoo,Midweek Crit: Around the World BONUS (Cobbled Climbs),4iiii to garmin,Kickr V5 to Zwift ,368,364,4
118452,68432,2021-02-20 19:30:14,wahoo,Zwift - 3R Endurance Series p/b OTE Sports- Stage 1 (E),4iiii to garmin,kickr to zwift,409,400,9
119093,68432,2021-02-22 18:34:08,wahoo,Zwift - Premier Division // Zwift Racing League (men) (A),4iiii to garmin,Kickr V5 to Zwift ,368,367,1
120510,68432,2021-02-25 01:04:51,wahoo,Cycling Canada Wednesday Night Race Series,4iiii to garmin,Kickr V5 to Zwift ,399,384,15
121337,68432,2021-02-26 12:59:26,wahoo,Zwift - Haute Route Watopia 2021 Stage 1 (A),4iiii to garmin,kickr to zwift,373,375,-2
121662,68432,2021-02-27 15:13:47,wahoo,Zwift - OH MY CRIT!! - Saturday Smash Race (A),4iiii to garmin,kickr to zwift,358,356,2
122097,68432,2021-02-28 14:14:34,wahoo,Zwift - KISS 100 Race Series - Americas (A),4iiii to garmin,kickr to zwift,387,381,6
122432,68432,2021-03-01 18:14:11,wahoo,Zwift -  DBR Monday Race (A),4iiii to garmin,kickr to zwift,369,364,5
123239,68432,2021-03-03 00:28:10,wahoo,Zwift - Midweek Crit: The Bell Lap (A),4iiii to garmin,kickr to zwift,423,430,-7
128008,68432,2021-03-13 15:13:47,wahoo,Zwift - OH MY CRIT!! - Saturday Smash Race (A),4iiii to garmin,kickr to zwift,422,403,19
7786,69210,2019-12-31 13:15:01,wahoo,Zwift - 3R Figure 8 Hilly Reverse Race - 1 Lap (29.2km/18.1mi 234m ) (A),Vector 3,wahoo kickr,373,383,-10
8267,69210,2020-01-07 10:19:59,wahoo,Zwift - Eat The Pain Race (A),Vector 3,wahoo kickr,352,369,-17
10911,69210,2020-01-24 17:02:33,wahoo,Zwift - KALAS at Second Base  (B),Vector 3,kickr,327,346,-19
11903,69210,2020-01-31 19:15:01,wahoo,Zwift - Tour de Zwift // Pro-Am Invitational (A),Vector 3,kickr to zwift,397,396,1
12544,69210,2020-02-04 19:15:01,wahoo,Zwift - Tour de Zwift // Pro-Am Invitational (A),Vector 3,kickr to zwift,414,417,-3
15980,69210,2020-02-27 19:00:13,wahoo,Zwift - KALAS Cup - Round 5 (A),Vector 3,kickr to zwift,346,360,-14
19824,69210,2020-03-26 19:00:13,wahoo,Zwift - KALAS Cup - Round 9 (A),Vector 3,kickr,394,407,-13
19971,69210,2020-03-27 17:00:13,wahoo,Zwift -  KALAS Indoor EFCT race series #iTT (A),Vector 3,kickr,366,374,-8
20424,69210,2020-03-29 08:00:15,wahoo,Zwift -  KALAS Indoor EFCT race series #Road race (A),Vector 3,kickr,380,392,-12
24360,69210,2020-04-13 18:20:22,wahoo,Zwift - TFC Mad Monday World Series (1 of 6) (A),Vector 3,kickr to zwift,389,395,-6
24690,69210,2020-04-14 18:00:14,wahoo,Zwift - NCF Spring Cup (A),Vector 3,kickr to zwift,385,390,-5
55417,69210,2020-09-15 17:55:10,wahoo,Zwift - Team Italy & Frenchy Fuzion League (A),Vector 3,kickr,366,350,16
55866,69210,2020-09-17 18:30:01,wahoo,Zwift - Invitational League // Qualifying Race #2 (Men) ,Vector 3,kickr to zwift,405,386,19
126554,70139,2021-03-10 14:57:52,neo,cadence session - trek quarq v neo,trek sc quarq,neo,274,286,-12
73358,70672,2020-11-19 17:29:53,wahoo,Zwift - Braquasse by Frenchy Fuzion (E),Power2Max,Wahoo Kickr Core,399,386,13
75639,70672,2020-11-25 17:37:51,wahoo,Zwift - Frenchy Fuzion Criterium League (A),Power2Max,Wahoo Kickr Core,391,383,8
77672,70672,2020-11-30 18:27:24,wahoo,Zwift - Frenchy Fuzion Watopia Tour - Etape 1 (E),Power2Max,Wahoo Kickr Core,399,391,8
78111,70672,2020-12-01 18:54:27,wahoo,Zwift - Team Italy & Frenchy Fuzion League (A),Power2Max,Wahoo Kickr Core,377,365,12
79491,70672,2020-12-04 18:29:40,wahoo,Zwift - Frenchy Fuzion Watopia Tour - Etape 5 (E),Power2Max,Wahoo Kickr Core,371,351,20
79732,70672,2020-12-05 13:06:54,wahoo,Zwift - Frenchy Fuzion Watopia Tour – Etape 6 (A),Power2Max,Wahoo Kickr Core,382,372,10
81101,70672,2020-12-09 17:58:28,wahoo,Zwift - Frenchy Fuzion Criterium League,Power2Max,Wahoo Kickr Core,373,362,11
81549,70672,2020-12-10 17:57:19,wahoo,Zwift - Braquasse by Frenchy Fuzion (E),Power2Max,Wahoo Kickr Core,405,390,15
84008,70672,2020-12-16 17:59:34,wahoo,Zwift - Frenchy Fuzion Criterium League (A),Power2Max,Wahoo Kickr Core,402,402,0
88702,70672,2020-12-29 18:54:37,wahoo,Zwift - Team Italy & Frenchy Fuzion League (A),Power2Max,Wahoo Kickr Core,402,394,8
89588,70672,2020-12-31 17:59:17,wahoo,Zwift - Braquasse by Frenchy Fuzion (E),Power2Max,Wahoo Kickr Core,407,397,10
98210,70672,2021-01-16 18:02:41,wahoo,Zwift - Championnat des departements Frenchy Fuzion (E),Power2Max,Wahoo Kickr Core,409,403,6
108189,70672,2021-02-03 17:59:38,wahoo,Zwift - LES ROUTES DE ZWIFT Frenchy Fuzion - Etape 1 (C),Power2Max,Wahoo Kickr Core,391,381,10
22416,70690,2020-04-05 19:00:16,wahoo,Zwift - BRT Iron Goat Racing League (A),S-Works Power Cranks,Kickr,347,354,-7
26560,70690,2020-04-21 06:06:13,wahoo,Zwift - Zwift Time Trial Tuesday: Tempus Fugit (E),S-Works Power Cranks,Kickr,384,395,-11
57752,71062,2020-09-26 16:04:56,wahoo,Zwift - 3R Classique Flat Race - 4 Laps (26.9km/16.7mi 76m) (A),Quarq DZero,KICKR &#039;14 v1.5.68,365,358,7
58305,71062,2020-09-29 18:39:01,wahoo,3R Sundown Race Series ,Quarq DZero,KICKR &#039;14 v1.5.68,389,382,7
59876,71062,2020-10-06 18:37:39,wahoo,Zwift - 3R Sundown Race Series - iTT (A),Quarq DZero,KICKR &#039;14 v1.5.68,378,374,4
60469,71062,2020-10-08 15:10:52,wahoo,Zwift - OH MY CRIT! - The Double Race 1/2 (A),Quarq DZero,KICKR &#039;14 v1.5.68,379,374,5
65669,71062,2020-10-27 19:44:57,wahoo,Zwift Racing League | WTRL - Mens EMEA W2 DIVISION 2,Quarq DZero,KICKR &#039;14 v1.5.68,395,411,-16
116708,72977,2020-09-03 11:25:44,wahoo,Zwift - TTR Climb Chase Race (B),Power2Max,Wahoo Kickr,276,296,-20
116727,72977,2020-07-20 11:00:57,wahoo,Zwift - Virtual Tour de France - Open - Stage 5 Discovery Ride,Power2Max,Wahoo Kickr,260,272,-12
69191,73702,2020-11-08 20:00:14,wahoo,Zwift - KISS at Race - EU PM (A),Quarq,Kickr V5,374,345,29
69541,73702,2020-11-10 03:29:35,wahoo,Updated Kickr Firmware / Forced Spin Down,Quarq DZero,Kickr V5,226,210,16
71117,73702,2020-11-13 17:59:37,wahoo,Zwift - KIRCHMAIR Race Series (A),Quarq DZero,Kickr V5,397,375,22
71430,73702,2020-11-14 16:02:51,wahoo,Zwift - 3R Classique Flat Race - 4 Laps (26.9km/16.7mi 76m) (A),Quarq DZero,Kickr V5,422,397,25
71737,73702,2020-11-15 17:46:59,wahoo,Zwift - France,Quarq DZero,Kickr V5,327,329,-2
72412,73702,2020-11-18 00:55:44,wahoo,Zwift - Zwift Racing League | WTRL - Men&#039;s AMERICAS E DIVISION 2 (A),Quarq DZero,Kickr V5,412,413,-1
74019,73702,2020-11-21 20:02:15,wahoo,Zwift - 3R Flat Race (A),Quarq DZero,Kickr V5,397,369,28
74318,73702,2020-11-22 17:19:29,wahoo,Zwift - 3R Racing (A),Quarq DZero,Kickr V5,458,443,15
75278,73702,2020-11-25 00:42:28,wahoo,Zwift - Zwift Racing League | WTRL - Men&#039;s AMERICAS E DIVISION 2 (A),Quarq DZero,Kickr V5,442,416,26
75562,73702,2020-11-25 18:51:04,wahoo,Zwift - DCU – Feltet.dk November series (A),Quarq DZero,Kickr V5,437,413,24
77665,73702,2020-11-30 18:08:44,wahoo,Zwift - Watopia,5896013908_ACTIVITY,Kickr V5,231,219,12
78310,73702,2020-12-01 18:57:07,wahoo,Zwift - Innsbruck,Quarq DZero,Kickr V5,232,238,-6
79469,73702,2020-12-04 17:29:30,wahoo,EVO CC / Le Col - Sprint Race Series,Quarq DZero,Kickr V5,409,388,21
79472,73702,2020-12-04 17:29:30,wahoo,Zwift - KIRCHMAIR Race Series (A),Quarq DZero,Kickr V5,403,389,14
80513,73702,2020-12-07 19:24:44,wahoo,Zwift - London,Quarq DZero,Kickr V5,261,242,19
80553,73702,2020-12-07 19:59:36,wahoo,Ride with Coco and Bowie,Quarq DZero,Kickr V5,291,280,11
80997,73702,2020-12-09 00:42:41,wahoo,Zwift - Zwift Racing League | WTRL - Men&#039;s AMERICAS E DIVISION 2 (A),Quarq DZero,Kickr V5,428,409,19
81254,73702,2020-12-09 20:08:56,wahoo,Zwift - Watopia,Quarq DZero,Kickr V5,257,252,5
81683,73702,2020-12-10 18:55:54,wahoo,ZADA 3 Sisters Test - Post Calibration,Quarq DZero,Kickr V5,418,401,17
82538,73702,2020-12-12 22:15:07,wahoo,Zwift - 3R Classique Flat Race (A),Quarq DZero,Kickr V5,391,371,20
82982,73702,2020-12-13 21:02:21,wahoo,Zwift - 3R Gotham Grind Flat Race - 3 Laps (27.8km/17.4mi 87m) (A),Quarq DZero,Kickr V5,401,376,25
83774,73702,2020-12-16 00:10:17,wahoo,Zwift - Zwift Racing League | WTRL - Men&#039;s AMERICAS E DIVISION 2 (A),Quarq DZero,Kickr V5,410,391,19
84524,73702,2020-12-17 18:07:10,wahoo,WTRL Team Time Trial - Zone 6,Quarq DZero,Kickr V5,422,398,24
84805,73702,2020-12-18 17:38:35,wahoo,Zwift - KIRCHMAIR Race Series (A),Quarq DZero,Kickr V5,439,416,23
84813,73702,2020-12-18 17:38:35,wahoo,Zwift - KIRCHMAIR Race Series (A),Quarq DZero,Kickr V5,426,401,25
85792,73702,2020-12-21 16:44:35,wahoo,Zwift - Endurance Build ERG Mode,Quarq DZero,Kickr V5,293,292,1
85794,73702,2020-12-21 16:44:40,wahoo,Zwift - Endurance Build - Zwift Slope Mode,Quarq DZero,Kickr V5,257,244,13
86138,73702,2020-12-22 16:43:48,wahoo,Zwift - Watopia,Quarq DZero,Kickr V5,322,310,12
86153,73702,2020-12-22 17:58:31,wahoo,Zwift - KIRCHMAIR TT Race (A),Quarq DZero,Kickr V5,413,394,19
87024,73702,2020-12-24 17:52:58,wahoo,Zwift - Vienna,Quarq DZero,Kickr V5,441,419,22
88748,73702,2020-12-29 19:57:17,wahoo,Zwift - KISS Race Series - EU PM (A),Quarq DZero,Kickr V5,413,384,29
94589,73702,2021-01-10 18:50:34,wahoo,Zwift - The Alpe Dash by Herd Racing League (A),6087349301_ACTIVITY,Kickr V5,413,391,22
95003,73702,2021-01-11 18:16:23,wahoo,Zwift - Watopia,Quarq DZero,Kickr V5,275,260,15
95663,73702,2021-01-12 17:29:34,wahoo,Zwift - WTRL Racing (A),Quarq DZero,Kickr V5,382,369,13
96998,73702,2021-01-14 18:17:22,wahoo,Zwift - Vienna,Quarq DZero,Kickr V5,418,404,14
98761,73702,2021-01-17 20:47:52,wahoo,Zwift - France,Quarq DZero,Kickr V5,317,309,8
99213,73702,2021-01-18 19:48:06,wahoo,Zwift - Premier Division // Zwift Racing League (men) (A),Quarq DZero,Kickr V5,425,405,20
104938,73702,2021-01-28 18:10:04,wahoo,Zwift - Vienna,Quarq DZero,Kickr V5,400,381,19
105783,73702,2021-01-30 16:41:10,wahoo,Crit City Race,Quarq DZero,Kickr V5,422,396,26
105787,73702,2021-01-30 16:41:10,wahoo,EVR Winter Series,Quarq DZero,Kickr V5,369,346,23
111100,73702,2021-02-08 19:03:29,wahoo,Zwift - Premier Division // Zwift Racing League (men) (A),Quarq DZero,Kickr V5,435,419,16
117859,73702,2021-02-19 18:22:12,wahoo,Zwift - Watopia,Quarq DZero,Kickr V5,223,233,-10
120875,73702,2021-02-25 18:11:02,wahoo,Zwift - Espresso,Quarq DZero,Kickr V5,410,391,19
122506,73702,2021-03-01 18:00:04,wahoo,Zwift -  DBR Monday Race (A),Quarq DZero,Kickr V5,430,415,15
126671,73702,2021-03-10 17:50:44,wahoo,Zwift - MIDWEEK Crit Race Series by SZR (A),Quarq DZero,Kickr V5,443,421,22
127203,73702,2021-03-11 18:25:37,wahoo,Zwift - FUSION SPRING CUP (A),Quarq DZero,Kickr V5,413,387,26
88319,73794,2020-12-28 18:16:02,wahoo,Zwift -  DBR Monday Race (B),Assioma Power Meter Pedals DUO,Zwift - Kickr Core,324,331,-7
90180,73794,2021-01-02 09:30:17,wahoo,DBR SufferDay League III (B),Assioma Power Meter Pedals DUO,Zwift - Kickr Core,313,315,-2
91341,73794,2021-01-04 18:15:09,wahoo,Zwift -  DBR Monday Race (B),Assioma Power Meter Pedals DUO,Zwift - Kickr Core,335,346,-11
94943,73794,2021-01-11 18:15:44,wahoo,Zwift -  DBR Monday Race (B),Assioma Power Meter Pedals DUO,Zwift - Kickr Core,333,330,3
99053,73794,2021-01-18 18:15:39,wahoo,Zwift - DBR Monday Race (B),Assioma Power Meter Pedals DUO,Zwift - Kickr Core,330,337,-7
106749,73794,2021-02-01 18:15:53,wahoo,Zwift -  DBR Monday Race (B),Assioma (2),Zwift - Kickr Core0,329,339,-10
108180,73794,2021-02-03 15:00:14,wahoo,Zwift - TDZ Stage 7: Longer Ride,Assioma Power Meter Pedals DUO,Zwift - Kickr Core,322,336,-14
110968,73794,2021-02-08 18:15:50,wahoo,Zwift -  DBR Monday Race (B),Assioma Power Meter P8edals DUO,Zwift - Kickr Core,325,335,-10
121547,73794,2021-02-27 11:00:22,wahoo,Zwift - DIRT Badge Hunts (B),Assioma Power Meter Pedals DUO,Zwift - Kickr Core,320,329,-9
125819,73794,2021-03-08 18:15:45,wahoo,Zwift - DBR Monday Race (B),Assioma Power Meter Pedals DUO,Zwift - Kickr Core,331,341,-10
127464,73794,2021-03-12 13:37:42,wahoo,Zwift - Friday Freight Train (C),Assioma Power Meter Pedals DUO,Zwift - Kickr Core,279,281,-2
118620,73799,2021-02-20 14:00:00,neo,Zwift -  Zwift Insider Badge Hunters - The Uber Pretzel Edition (E),Rotor Inpower,Tacx Neo,264,264,0
4621,74371,2019-11-20 19:06:05,wahoo,Zwift - DBR HEINO CUP (B),Vector 3,Kickr,325,328,-3
6038,74371,2019-12-11 19:06:02,wahoo,Zwift - DBR HEINO CUP (B),Vector 3,Kickr,345,350,-5
11329,74371,2020-01-28 18:01:00,wahoo,Zwift - Danmarks Cykle Union 2020 Cup (B),Vector 3,Kickr,349,351,-2
16627,74371,2020-03-03 19:12:31,wahoo,Zwift - Feltet.dk Race Series (B),Garmin Vector 3,Wahoo Kickr 2018,330,333,-3
17091,74371,2020-03-06 14:42:14,wahoo,Zwift - Crit City Race (B),Garmin Vector 3,Wahoo Kickr 2018,316,317,-1
17094,74371,2020-03-06 15:11:13,wahoo,Zwift - 3R Sand and Sequoias Race (B),Garmin Vector 3,Wahoo Kickr 2018,288,292,-4
17845,74371,2020-03-12 19:00:52,wahoo,Zwift - KALAS Cup - Round 7 (B),Garmin Vector 3,Wahoo Kickr 2018,317,322,-5
18013,74371,2020-03-14 09:01:39,wahoo,Danmarks Cykle Union 2020 Cup,Garmin Vector 3,Wahoo Kickr 2018,337,341,-4
18289,74371,2020-03-16 17:31:27,wahoo,Danmarks Cykle Union 2020 Cup,Garmin Vector 3,Wahoo Kickr 2018,315,321,-6
18448,74371,2020-03-17 19:15:19,wahoo,Zwift - Feltet.dk Race Series (B),Garmin Vector 3,Wahoo Kickr 2018,350,354,-4
18713,74371,2020-03-19 17:31:15,wahoo,Zwift - Danmarks Cykle Union 2020 Cup (B),Garmin Vector 3,Wahoo Kickr 2018,330,338,-8
25774,74371,2020-04-18 08:29:33,wahoo,Zwift - DBR Sufferday League (B),Wahoo Kickr 2018 - With Pulse,Wahoo Kickr 2018,330,330,0
28462,74371,2020-04-27 17:15:54,wahoo,Zwift - DBR Wahoo League (B),Garmin Vector 3,Wahoo Kickr 2018,355,352,3
29170,74371,2020-04-29 18:05:43,wahoo,Zwift - DBR Sprinthooligan Cup (B),Garmin Vector 3,Wahoo Kickr 2018,333,335,-2
30764,74371,2020-05-02 08:30:02,wahoo,Zwift - DBR Sufferday League (B),Garmin Vector 3,Wahoo Kickr 2018,342,351,-9
31312,74371,2020-05-04 17:15:46,wahoo,Zwift - DBR Wahoo League (B),Garmin Vector 3,Wahoo Kickr 2018,336,337,-1
35379,74371,2020-05-16 08:09:51,wahoo,Zwift - Tour for All 2020: Stage 4 Longer Race A/B,Garmin Vector 3,Wahoo Kickr 2018,326,310,16
37865,74371,2020-05-26 18:14:50,wahoo,Zwift - UNO X CUP powered by DCU & Feltet.dk (B),Garmin Vector 3,Wahoo Kickr 2018,375,369,6
39218,74371,2020-06-01 17:16:08,wahoo,Zwift - DBR Wahoo League (B),Garmin Vector 3,Wahoo Kickr 2018,359,361,-2
40415,74371,2020-06-08 17:15:54,wahoo,Zwift - DBR Wahoo League (B),Garmin Vector 3,Wahoo Kickr 2018,361,353,8
40416,74371,2020-06-04 17:31:01,wahoo,Zwift - FUSION ECT BEUNSTOPPABLE Racing Series (B),Garmin Vector 3,Wahoo Kickr 2018,313,307,6
60297,74371,2020-10-07 18:06:01,wahoo,Zwift - DBR HEINO CUP III (B),Garmin Vector 3,Wahoo Kickr 2018,320,316,4
61606,74371,2020-10-13 18:46:02,wahoo,Zwift - Zwift Racing League | WTRL,Garmin Vector 3,Wahoo Kickr 2018,331,329,2
62234,74371,2020-10-15 18:01:04,wahoo,Zwift -  Flanders The BZR Ronde  (B),Garmin Vector 3,Wahoo Kickr 2018,333,331,2
63665,74371,2020-10-20 18:51:28,wahoo,Zwift - Zwift Racing League | WTRL - EMEA (MEN) - TTT Grp 4 (C),Garmin Vector 3,Wahoo Kickr 2018,311,309,2
65522,74371,2020-10-27 19:45:48,wahoo,Zwift - Zwift Racing League | WTRL - EMEA W (MEN) -  Division 1 (B),Garmin Vector 3,Wahoo Kickr 2018,338,338,0
67693,74371,2020-11-03 19:54:22,wahoo,Zwift - Zwift Racing League | WTRL - Men&#039;s EMEA W1 DIVISION 1 (B),Garmin Vector 3,Wahoo Kickr 2018,336,337,-1
69886,74371,2020-11-10 19:46:03,wahoo,Zwift - Zwift Racing League | WTRL - EMEA W1 (MEN) -  Division 1 (B),Garmin Vector 3,Wahoo Kickr 2018,357,354,3
72334,74371,2020-11-17 19:54:47,wahoo,Zwift - Zwift Racing League | WTRL - Men&#039;s EMEA W1 DIVISION 1 (B),Garmin Vector 3,Wahoo Kickr 2018,305,313,-8
78213,74371,2020-12-01 19:54:44,wahoo,Zwift - Zwift Racing League | WTRL - Men&#039;s EMEA W2 DIVISION 1 (B),Garmin Vector 3,Wahoo Kickr 2018,315,314,1
80925,74371,2020-12-08 19:49:55,wahoo,Zwift - Zwift Racing League | WTRL - Men&#039;s EMEA W2 DIVISION 1 (B),Garmin Vector 3,Wahoo Kickr 2018,358,360,-2
84034,74371,2020-12-16 19:06:10,wahoo,Zwift - DBR Wednesday Race (B),Garmin Vector 3,Wahoo Kickr 2018,337,334,3
85822,74371,2020-12-21 18:16:08,wahoo,Zwift -  DBR Monday Race (B),Garmin Vector 3,Wahoo Kickr 2018,335,338,-3
89909,74371,2021-01-01 19:00:17,wahoo,Herd Beginner Racing Series,Garmin Vector 3,Wahoo Kickr 2018,349,358,-9
91329,74371,2021-01-04 18:15:52,wahoo,Zwift -  DBR Monday Race (B),Garmin Vector 3,Wahoo Kickr 2018,350,354,-4
92418,74371,2021-01-06 19:06:08,wahoo,Zwift - DBR Wednesday Race (B),Garmin Vector 3,Wahoo Kickr 2018,322,321,1
96528,74371,2021-01-13 18:46:00,wahoo,Zwift - Danmarks Cykle Union & Partners 1/6 (B),Garmin Vector 3,Wahoo Kickr 2018,374,364,10
99025,74371,2021-01-18 18:16:00,wahoo,Zwift -  DBR Monday Race (B),Garmin Vector 3,Wahoo Kickr 2018,343,340,3
100330,74371,2021-01-20 18:46:01,wahoo,Zwift - Danmarks Cykle Union & Partners 2/6 (B),Garmin Vector 3,Wahoo Kickr 2018,347,344,3
104208,74371,2021-01-27 18:46:01,wahoo,Zwift - Danmarks Cykle Union & Partners 3/6 (B),Garmin Vector 3,Wahoo Kickr 2018,337,331,6
108236,74371,2021-02-03 18:46:01,wahoo,Zwift - Danmarks Cykle Union & Partners 4/6 (B),Garmin Vector 3,Wahoo Kickr 2018,348,351,-3
112290,74371,2021-02-10 18:46:00,wahoo,Zwift - Danmarks Cykle Union & Partners 5/6 (B),Garmin Vector 3,Wahoo Kickr 2018,358,356,2
116678,74371,2021-02-17 18:45:35,wahoo,Zwift - Danmarks Cykle Union & Partners 6/6 (B),Garmin Vector 3,Wahoo Kickr 2018,354,351,3
120386,74371,2021-02-24 18:45:43,wahoo,Zwift - Scandinavian Cup 2021 - Round 1 - Men (B),Garmin Vector 3,Wahoo Kickr 2018,356,350,6
121248,74371,2021-02-26 06:01:52,wahoo,Zwift - Haute Route Watopia 2021 Stage 1 (B),Garmin Vector 3,Wahoo Kickr 2018,337,331,6
121603,74371,2021-02-27 06:01:59,wahoo,Zwift - Haute Route Watopia 2021 Stage 2 (B),Garmin Vector 3,Wahoo Kickr 2018,341,337,4
123684,74371,2021-03-03 18:46:04,wahoo,Zwift - Scandinavian Cup 2021 - Round 2 - Men (B),Garmin Vector 3,Wahoo Kickr 2018,355,353,2
125801,74371,2021-03-08 18:15:53,wahoo,Zwift -  DBR Monday Race (B),Garmin Vector 3,Wahoo Kickr 2018,358,354,4
129788,74371,2021-03-17 18:46:00,wahoo,Zwift - Scandinavian Cup 2021 - Round 4 - Men (B),Garmin Vector 3,Wahoo Kickr 2018,385,372,13
82324,74791,2020-12-12 13:30:13,neo,Zwift - ZHQ FutureWorks Circuit Race - Anti-sandbagging (B),Assioma,Tacx Neo,311,317,-6
58900,74813,2020-10-01 18:59:59,wahoo,Zwift - KISS at Race - EU PM (A),4iiii Single Sided,Wahoo Kickr Gen1,312,322,-10
62876,74813,2020-10-18 14:00:34,wahoo,Zwift - ZA Road 2020 - Segment Ride #1: Innsbruck Course,4iiii Single Sided,Wahoo Kickr Gen1,332,342,-10
114346,74828,2021-02-13 17:59:38,wahoo,Favero Assioma Duo,Favero Assioma Duo,Kickr,378,377,1
33828,75106,2020-05-12 09:10:01,wahoo,Zwift - SRAM Send it Series - Race 1 - Men&#039;s (E),assioma,Kickr ant +,418,432,-14
50838,75106,2020-08-20 08:49:57,wahoo,Zwift - Off the MAAP Invitational Race // Stage 3 (men) ,quarq dzero,Kickr,450,435,15
56401,75106,2020-09-20 12:59:57,wahoo,Zwift - Invitational League // Qualifying Race #3 (Men) (A),quarq dzero,Kickr,449,407,42
77709,75106,2020-11-30 19:06:00,neo,Zwift - Premier Division // Zwift Racing League (men) (A),quarq dzero,Neo,414,410,4
91426,75106,2021-01-04 02:54:57,wahoo,Zwift - Watopia,dzero,Kickr,463,451,12
95494,75106,2021-01-12 08:45:56,wahoo,Zwift Racing League | WTRL - Mens/Mixed APAC DIVISION 2,dzero,Kickr,457,442,15
114453,75106,2021-02-14 00:52:12,wahoo,Zwift - Watopia,dzero,Kickr,419,409,10
6559,75218,2019-12-17 18:30:13,neo,Zwift - Flanders De Ronde Race (A),Garmin V3,TACX NEO,352,344,8
21140,75218,2020-03-31 19:07:29,neo,Zwift - Stage 1 Race (C) - Tour of Watopia 2020,Garmin V3,TACX NEO,183,173,10
21777,75218,2020-04-03 15:59:46,neo,Zwift - J Santa Comba[3CY]&#039;s Meetup - Figure 8 Reverse,Garmin V3,Tacx Neo (Zwift),332,334,-2
22782,75218,2020-04-07 17:55:16,neo,Zwift - Team Italy & Frenchy Fuzion League (A),Garmin V3,Tacx Neo (Zwift),438,435,3
26122,75218,2020-04-19 07:20:13,neo,Zwift - Team Italy & Frenchy Fuzion Endurance Race (A),Garmin V3,Tacx Neo (Zwift),400,400,0
26987,75218,2020-04-22 16:00:14,neo,Zwift - LES ROUTES DE ZWIFT - ETAPE 2 (A),Garmin V3,Tacx Neo (Zwift),419,419,0
32787,75421,2020-05-08 10:38:42,neo,Zwift - 3R LaGuardia Loop Reverse Flat Race - 8 Laps (24.5km/15.2mi 216m) (B),PowerTap P1,Neo,308,314,-6
33042,75421,2020-05-09 11:07:39,neo,Zwift - 3R Tick Tock Flat Race - 2 Lap (36km/22.4mi 100m) (B),PowerTap P1,Neo,302,311,-9
34230,75421,2020-05-12 18:14:42,neo,Zwift - 3R & Wahoo Ride Real Race Series - Round 1 of 7 (B),PowerTap P1,Neo,316,315,1
34961,75421,2020-05-14 16:37:49,neo,Zwift - ZHR Hare & Hounds Race (B),PowerTap P1,Neo,323,325,-2
36471,75421,2020-05-19 18:24:09,neo,Zwift - 3R & Wahoo Ride Real Race Series - Round 2 of 7 (B),PowerTap P1,Neo,339,351,-12
108549,75424,2021-02-04 00:00:27,neo,Zwift - Open - Movistar Team Challenge - Kept it to tempo,SRM,Neo,344,344,0
108553,75424,2021-02-04 00:00:00,neo,Zwift - Open - Movistar Team Challenge - Kept it to tempo,SRM,Neo,337,344,-7
123278,75424,2021-03-03 00:57:06,neo,Zwift - Zwift Racing League | WTRL - Men&#039;s/Mixed AMERICAS E DIVISION 4 (A) - Technical issues in the last race of the season :-(,SRM,Neo,294,294,0
116697,76507,2021-02-17 17:54:53,neo,Zwift - Watopia,Stages G3 Dual sided,Tacx Neo,319,339,-20
117172,76507,2021-02-18 16:14:53,neo,Zwift - OH MY CRIT!! - The Double Race 1/2 (A),Stages G3 dual sided,Tacx Neo,342,366,-24
117200,76507,2021-02-18 17:04:59,neo,Zwift - OH MY CRIT!! - The Double Race 2/2 (A),Stages G3 dual sided,Tacx Neo,347,360,-13
118339,76507,2021-02-20 16:05:59,neo,Zwift - 3R Endurance Series p/b OTE Sports- Stage 1 (A),Stages G3 dual sided,Tacx Neo,330,344,-14
120402,76507,2021-02-24 17:59:52,neo,Zwift - MIDWEEK Winter Series by SZR (A),Stages G3 dual sided,Tacx Neo,337,358,-21
120856,76507,2021-02-25 16:14:53,neo,Zwift - OH MY CRIT!! - The Double Race 1/2 (A),Stages G3 dual sided,Tacx Neo,323,348,-25
120857,76507,2021-02-25 17:04:52,neo,Zwift - OH MY CRIT!! - The Double Race 2/2 (A),Stages G3 dual sided,Tacx Neo,303,317,-14
123619,76507,2021-03-03 18:28:23,neo,Zwift - 3R Race - France Petit Boucle - 45KM (A),Stages G3 dual sided,Tacx Neo,326,347,-21
124059,76507,2021-03-04 16:15:06,neo,Zwift - OH MY CRIT!! - The Double Race 1/2 (A),Stages G3 dual sided,Tacx Neo,335,351,-16
124061,76507,2021-03-04 17:05:11,neo,Zwift - OH MY CRIT!! - The Double Race 2/2 (A),Stages G3 dual sided,Tacx Neo,354,362,-8
125059,76507,2021-03-06 16:05:52,neo,Zwift - 3R Endurance Series p/b OTE Sports (A),Stages G3 dual sided,Tacx Neo,315,317,-2
127086,76507,2021-03-11 17:04:44,neo,Zwift - OH MY CRIT!! - The Double Race 2/2 (A),Stages G3 dual sided,Tacx Neo,333,356,-23
127556,76507,2021-03-12 17:04:54,neo,Zwift - 3R Racing (A),Stages G3 dual sided,Tacx Neo,329,337,-8
128042,76507,2021-03-13 16:05:55,neo,Zwift - 3R Endurance Series p/b OTE Sports (A),Stages G3 dual sided,Tacx Neo,350,354,-4
129313,76507,2021-03-16 18:29:50,neo,Zwift - CeramicSpeed Race Series: Open Race (A),Stages left,Tacx Neo,332,353,-21
98798,76514,2021-01-17 20:50:50,wahoo,Zwift - JETT Monday Morning Ride (2.5~3.0w/kg)  (B),Garmin 2inPower,ZWIFT KICKR V5 ant+,253,241,12
99955,76514,2021-01-19 20:06:23,wahoo,Zwift - JETT ZWIFT Morning Race (A),Garmin 2inPower,ZWIFT KICKR V5 ANT+ FE-C,288,281,7
100532,76514,2021-01-20 20:43:07,wahoo,Zwift - I Tsan 555&#039;s Meetup - Beach Island Loop,Garmin 2inPower,ZWIFT KICKR V5,266,254,12
101142,76514,2021-01-21 19:53:50,wahoo,Zwift - JETT Base Ride (2.7~4.5w/kg) (B),Garmin 2inPower,ZWIFT KICKR V5,235,224,11
101571,76514,2021-01-22 20:52:55,wahoo,Zwift - TDZ Stage 4: Shorter Ride,Garmin 2inPower,ZWIFT KICKR V5,302,290,12
102273,76514,2021-01-24 07:21:39,wahoo,Zwift - Cingles du Ventoux Badge Hunter Ride p/b Cafe du Cycliste,Garmin 2inPower,ZWIFT KICKR V5 ANT+ FE-C,264,251,13
103138,76514,2021-01-25 20:54:08,wahoo,Zwift - TDZ Stage 5: Shorter Ride,Garmin 2inPower,ZWIFT KICKR V5 ANT+ FE-C,260,251,9
103766,76514,2021-01-26 20:49:50,wahoo,Zwift - GGCC Glasgow Green CC Tuesday Training ride (C),Garmin 2inPower,ZWIFT KICKR V5 ANT+ FE-C,239,230,9
105323,76514,2021-01-29 20:39:45,wahoo,Zwift - TDZ Stage 6: Longer Ride,Garmin 2inPower,ZWIFT KICKR V5 ANT+ FE-C,268,263,5
105990,76514,2021-01-30 20:04:31,wahoo,JETT Endurance Ride 100km 3.0~3.3w/kg,Garmin 2inPower,ZWIFT KICKR V5 ANT+ FE-C,266,255,11
107695,76514,2021-02-02 20:03:34,wahoo,Zwift - JETT ZWIFT Morning Race (A),Garmin 2inPower,ZWIFT KICKR V5 ANT+ FE-C,270,262,8
108466,76514,2021-02-03 20:50:50,wahoo,Zwift - I Tsan 555&#039;s Meetup - Volcano Flat,Garmin 2inPower,ZWIFT KICKR V5 ANT+ FE-C,273,262,11
109094,76514,2021-02-04 19:52:45,wahoo,Zwift - JETT Base Ride (2.7~4.5w/kg) (B),Garmin 2inPower,ZWIFT KICKR V5 ANT+ FE-C,275,262,13
109546,76514,2021-02-05 20:48:50,wahoo,Zwift - TDZ Stage 7: Standard Ride,Garmin 2inPower,ZWIFT KICKR V5 ANT+ FE-C,279,270,9
111845,76514,2021-02-09 20:41:56,wahoo,Zwift - TDZ Stage 8: Group Ride,Garmin 2inPower,ZWIFT KICKR V5 ANT+ FE-C,279,272,7
114412,76514,2021-02-13 19:20:48,wahoo,Zwift - Chasing Cancellara Time Trial,Garmin 2inPower,ZWIFT KICKR V5 ANT+ FE-C,294,287,7
116161,76514,2021-02-16 20:50:49,wahoo,Zwift - 3R Volcano Flat Reverse Race - 3 Laps (36.6km/22.7mi 138m) (A),Garmin 2inPower,ZWIFT KICKR V5 ANT+ FE-C,277,266,11
117467,76514,2021-02-18 19:31:35,wahoo,Zwift - JETT Base Ride (2.7~4.5w/kg) (B),Garmin 2inPower,ZWIFT KICKR V5 ANT+ FE-C,259,246,13
118482,76514,2021-02-20 19:21:21,wahoo,Zwift - 3R Endurance Series p/b OTE Sports- Stage 1 (A),Garmin 2inPower,ZWIFT KICKR V5 ANT+ FE-C,279,271,8
121335,76514,2021-02-26 19:54:15,wahoo,Zwift - Haute Route Watopia 2021 Stage 1 (A),Garmin 2inPower,ZWIFT KICKR V5 ANT+ FE-C,263,257,6
121911,76514,2021-02-27 19:23:33,wahoo,3R Endurance Series p/b OTE Sports,Garmin 2inPower,ZWIFT KICKR V5 ANT+ FE-C,268,263,5
124289,76514,2021-03-04 19:40:55,wahoo,Zwift - JETT Base Ride (2.7~4.5w/kg) (B),Garmin 2inPower,ZWIFT KICKR V5 ANT+ FE-C,284,266,18
125235,76514,2021-03-06 19:22:42,wahoo,Zwift - 3R Endurance Series p/b OTE Sports (A),Garmin 2inPower,ZWIFT KICKR V5 ANT+ FE-C,271,262,9
126313,76514,2021-03-09 20:54:55,wahoo,Zwift - 3R Volcano Flat Reverse Race - 3 Laps (36.6km/22.7mi 138m) (A),Garmin 2inPower,ZWIFT KICKR V5 ANT+ FE-C,287,272,15
126746,76514,2021-03-10 20:48:31,wahoo,Zwift - Absa Cape Epic Stage 2 Time Trial pb Dimension Data - Open (A),Garmin 2inPower,ZWIFT KICKR V5 Bluetooth,293,280,13
127272,76514,2021-03-11 19:34:14,wahoo,Zwift - JETT Base Ride (2.7~4.5w/kg) (B),Garmin 2inPower,ZWIFT KICKR V5 Bluetooth,291,279,12
128184,76514,2021-03-13 19:27:20,wahoo,Zwift - 3R Endurance Series p/b OTE Sports (A),Garmin 2inPower,ZWIFT KICKR V5 ANT+ FE-C,312,303,9
128863,76514,2021-03-15 20:27:23,wahoo,The Kraken by TeamODZ,Garmin 2inPower,ZWIFT KICKR V5 ANT+ FE-C,280,268,12
129416,76514,2021-03-16 20:44:31,wahoo,Zwift - 3R Volcano Flat Reverse Race - 3 Laps (36.6km/22.7mi 138m) (A),Garmin 2inPower,ZWIFT KICKR V5 ANT+ FE-C,291,282,9
7474,77017,2019-12-28 09:22:15,wahoo,Zwift - DBR Saturday Race (A),Vector-2,Wahoo kickr gen 1,395,382,13
7680,77017,2019-12-30 18:10:52,wahoo,Zwift - DBR Monday Race (A),Vector-2,Wahoo kickr gen 1,398,375,23
8031,77017,2020-01-04 09:22:34,wahoo,Vector-2 / Wahoo kickr gen 1,Vector-2,Wahoo kickr gen 1,397,373,24
8226,77017,2020-01-06 18:05:21,wahoo,Vector-2 / Wahoo kickr gen 1,Vector-2,Wahoo kickr gen 1,369,362,7
8474,77017,2020-01-08 18:42:48,wahoo,DBR HEINO CUP,Vector-2,Wahoo kickr gen 1,373,372,1
8824,77017,2020-01-11 09:21:49,wahoo,Zwift - DBR Saturday Race (A),Vector-2,Wahoo kickr gen 1,373,367,6
9162,77017,2020-01-13 17:56:57,wahoo,Zwift - DBR Caresport Crit Cup  (A),Vector-2,Wahoo kickr gen 1,354,344,10
9678,77017,2020-01-15 18:57:54,wahoo,Zwift - Tour de Zwift // Pro-Am Invitational (A),Vector-2,Wahoo kickr gen 1,386,378,8
9788,77017,2020-01-17 13:47:59,wahoo,Zwift - Tour de Zwift: Stage 2 Race (A),Vector-2,Wahoo kickr gen 1,387,365,22
10470,77017,2020-01-22 19:01:48,wahoo,Zwift - DBR HEINO CUP (A),Vector-2,Wahoo kickr gen 1,360,349,11
10657,77017,2020-01-23 19:12:53,wahoo,Zwift - Tour de Zwift // Pro-Am Invitational,Vector-2,Wahoo kickr gen 1,397,396,1
12577,77017,2020-02-04 19:13:23,wahoo,Zwift - Tour de Zwift // Pro-Am Invitational (A),Vector-2,Wahoo kickr gen 1,395,392,3
21179,77017,2020-04-01 18:05:13,wahoo,Zwift - DBR Wednesday Race (A),Vector-2,Wahoo kickr gen 1,365,347,18
22056,77017,2020-04-04 08:28:44,wahoo,Zwift - DBR Sufferday League (A),Vector-2,Wahoo kickr gen 1,355,340,15
23062,77017,2020-04-08 18:03:58,wahoo,Zwift - DBR Sprinthooligan Cup (A),Vector-2,Wahoo kickr gen 1,357,336,21
25236,77017,2020-04-15 18:04:13,wahoo,Zwift - DBR Sprinthooligan Cup (A),Vector-2,Wahoo kickr gen 1,341,329,12
30788,77017,2020-05-02 08:29:03,wahoo,Zwift - DBR Sufferday League (A),Vector-2,Wahoo kickr gen 1,367,358,9
30790,77017,2020-04-29 18:03:45,wahoo,Zwift - DBR Sprinthooligan Cup (A),Vector-2,Wahoo kickr gen 1,356,336,20
31291,77017,2020-05-04 17:13:16,wahoo,Zwift - DBR Wahoo League (A),Vector-2,Wahoo kickr gen 1,397,388,9
32500,77017,2020-05-07 18:00:58,wahoo,Zwift - WTRL Team Time Trial (C),Vector-2,Wahoo kickr gen 1,369,351,18
34404,77017,2020-05-13 18:02:35,wahoo,Zwift - DBR Sprinthooligan Cup (A) #7,Vector-2,Wahoo kickr gen 1,360,339,21
35191,77017,2020-05-14 18:13:27,wahoo,Zwift - WTRL Team Time Trial (C),Vector-2,Wahoo kickr gen 1,372,359,13
35837,77017,2020-05-18 17:13:24,wahoo,Zwift - DBR Wahoo League (A),Vector-2,Wahoo kickr gen 1,401,384,17
36421,77017,2020-05-20 18:03:20,wahoo,Zwift - DBR Boerkop Cykler Cup (A),Vector-2,Wahoo kickr gen 1,368,371,-3
38105,77017,2020-05-27 18:03:56,wahoo,Zwift - DBR Boerkop Cykler Cup (A),Vector-2,Wahoo kickr gen 1,399,384,15
39571,77017,2020-06-03 18:04:19,wahoo,Zwift - DBR Boerkop Cykler Cup (A),Vector-2,Wahoo kickr gen 1,356,345,11
39594,77017,2020-06-04 17:17:44,wahoo,Zwift - Espresso,Vector-2,Wahoo kickr gen 1,366,352,14
40808,77017,2020-06-08 17:14:04,wahoo,Zwift - DBR Wahoo League (A),Vector-2,Wahoo kickr gen 1,385,385,0
40812,77017,2020-06-10 18:04:30,wahoo,Zwift - DBR Boerkop Cykler Cup (A),Vector-2,Wahoo kickr gen 1,363,356,7
43424,77017,2020-06-24 18:04:28,wahoo,Zwift - DBR Boerkop Cykler Cup (A) #6,Vector-2,Wahoo kickr gen 1,355,335,20
44071,77017,2020-06-29 17:14:27,wahoo,Zwift - DBR Monday Race  (A),Vector-2,Wahoo kickr gen 1,348,351,-3
45124,77017,2020-07-06 17:14:28,wahoo,Zwift - DBR Monday Race  (A) #7,Vector-2,Wahoo kickr gen 1,367,363,4
45470,77017,2020-07-08 18:03:59,wahoo,Zwift - DBR Wednesday Race (A) #2,Vector-2,Wahoo kickr gen 1,394,405,-11
52460,77017,2020-08-29 08:28:58,wahoo,Zwift - 08/29/2020,Vector-2,Wahoo kickr gen 1,361,371,-10
53757,77017,2020-09-07 17:13:58,wahoo,Zwift - 09/07/2020,Vector-2,Wahoo kickr gen 1,374,370,4
55547,77017,2020-09-14 17:14:31,wahoo,Zwift - DBR Ride´N´Roll League (A),Vector-2,Wahoo kickr gen 1,368,359,9
55594,77017,2020-09-16 18:03:52,wahoo,Zwift - DBR Wednesday Race (A)#5,Vector-2,Wahoo kickr gen 1,363,378,-15
58076,77017,2020-09-28 17:14:00,wahoo,Zwift - DBR Ride´N´Roll League (A),Vector-2,Wahoo kickr gen 1,345,370,-25
63914,77017,2020-10-21 18:03:53,wahoo,Zwift - DBR HEINO CUP III (A),Vector-2,Wahoo kickr gen 1,356,356,0
67243,77017,2020-11-02 18:14:00,wahoo,Zwift -  DBR Monday Race (A),Vector-2,Wahoo kickr gen 1,348,342,6
73162,77017,2020-11-19 19:29:28,wahoo,Zwift - World Championships Experience // Danish Cycling Federation,Vector-2,Wahoo kickr gen 1,377,396,-19
75577,77017,2020-11-25 18:58:57,wahoo,Zwift - DCU – Feltet.dk November series (A),Vector-2,Wahoo kickr gen 1,368,371,-3
77651,77017,2020-11-30 18:13:26,wahoo,Zwift -  DBR Monday Race (A),Vector-2,Wahoo kickr gen 1,385,382,3
78623,77017,2020-12-02 19:04:00,wahoo,Zwift - DBR Wednesday Race (A)#7,Vector-2,Wahoo kickr gen 1,358,353,5
81170,77017,2020-12-09 19:03:57,wahoo,Zwift - DBR Wednesday Race (A),Vector-2,Wahoo kickr gen 1,353,348,5
85001,77017,2020-12-19 09:13:22,wahoo,Zwift - DBR Saturday Race (A),Vector-2,Wahoo kickr gen 1,381,389,-8
90118,77017,2021-01-02 09:29:42,wahoo,Zwift - DBR SufferDay League III (A),Vector-2,Wahoo kickr gen 1,359,359,0
92401,77017,2021-01-06 19:03:56,wahoo,Zwift - DBR Wednesday Race (A),Vector-2,Wahoo kickr gen 1,362,375,-13
93732,77017,2021-01-09 09:29:57,wahoo,Zwift - DBR SufferDay League III (A),Vector-2,Wahoo kickr gen 1,398,416,-18
94924,77017,2021-01-11 18:13:59,wahoo,Zwift -  DBR Monday Race (A),Vector-2,Wahoo kickr gen 1,351,356,-5
99033,77017,2021-01-18 18:13:59,wahoo,Zwift -  DBR Monday Race (A),Vector-2,Wahoo kickr gen 1,347,357,-10
102875,77017,2021-01-25 18:13:56,wahoo,Zwift -  DBR Monday Race (A) #4,Vector-2,Wahoo kickr gen 1,375,360,15
110950,77017,2021-02-08 18:13:00,wahoo,Zwift -  DBR Monday Race (A),Vector-2,Wahoo kickr gen 1,357,355,2
52134,77288,2020-08-27 10:31:39,wahoo,Zwift - Japan ZWIFT Hill Climb Race (A),Power2MaxNG,KICKR CORE,279,283,-4
73504,77502,2020-11-20 10:00:00,wahoo,EVO CC 100km Base Ride [3.2-3.8w/kg avg] (B),Quarq D Zero Sram Red ,Wahoo Kickr 2018,308,284,24
94631,77502,2021-01-10 14:14:58,wahoo,Zwift - KISS 100 Race Series - Americas (A),Garmin Vector 2,Wahoo Kickr 2018,401,396,5
95704,77502,2021-01-12 18:19:57,wahoo,Zwift - Zwift Racing League | WTRL - Men&#039;s/Mixed EMEA E1 DIVISION 6 (A),Garmin Vector 2,Wahoo Kickr 2018,392,374,18
99751,77502,2021-01-19 17:42:40,wahoo,Zwift - WTRL,Garmin Vector 2,Wahoo Kickr 2018,387,382,5
105240,77502,2021-01-29 18:53:35,wahoo,Zwift - GGCC GlasgowGreen CC TT  (E),Garmin Vector 2,Wahoo Kickr 2018,437,424,13
111552,77502,2021-02-09 17:42:17,wahoo,Zwift - Spin Ups 2.,Garmin Vector 2,Wahoo Kickr 2018,420,406,14
112901,77502,2021-02-11 16:14:57,wahoo,Zwift - OH MY CRIT!! - The Double Race 1/2 (A),Garmin Vector 2,Wahoo Kickr 2018,394,374,20
112908,77502,2021-02-11 16:14:57,wahoo,Zwift - OH MY CRIT!! - The Double Race 2/2 (A),Garmin Vector 2,Wahoo Kickr 2018,394,398,-4
115915,77502,2021-02-16 18:19:59,wahoo,Zwift - Zwift Racing League | WTRL - Men&#039;s/Mixed EMEA E1 DIVISION 6 (A),Garmin Vector 2,Wahoo Kickr 2018,449,457,-8
119666,77502,2021-02-23 18:19:58,wahoo,Zwift - Zwift Racing League | WTRL - Men&#039;s/Mixed EMEA E1 DIVISION 6 (A),Garmin Vector 2,Wahoo Kickr 2018,398,404,-6
127000,77538,2021-03-11 16:15:55,neo,Zwift - OH MY CRIT!! - The Double Race 1/2 (B),Quarq DZero,Tacx Neo Smart(Zwift),297,293,4
128705,77538,2021-03-15 16:45:56,neo,Zwift - Crit City Race (B),Quarq DZero,Tacx Neo Smart(Zwift),300,297,3
129235,77538,2021-03-16 19:01:28,neo,Zwift - 3R Omnium Event - Race 2 - iTT (B),Quarq DZero,Tacx Neo Smart(Zwift),278,301,-23
80738,77783,2020-12-08 16:18:22,wahoo,Wahoo Kickr 2018 / Garmin Vector 2,Garmin Vector 2,Wahoo Kickr 2018,327,331,-4
23,78451,2019-08-13 09:50:00,wahoo,SZR Lunch Race,Quarq ,Kickr,369,359,10
168,78451,2019-08-14 17:59:01,wahoo,Trofeo Bologna // Zwift Classic,Quarq ,Kickr,403,399,4
592,78451,2019-08-21 09:40:10,wahoo,The Morning Grind,Quarq ,Kickr,376,373,3
664,78451,2019-08-22 09:59:30,wahoo,KISS Race - Americas AM,Quarq ,kickr,369,365,4
764,78451,2019-08-24 10:11:46,wahoo,Zwift - Teamervals,Quarq ,Kickr,414,413,1
820,78451,2019-08-27 09:43:44,wahoo,Zwift - SZR Lunch Race (A),Quarq ,Kickr,368,366,2
822,78451,2019-08-27 09:43:44,wahoo,3R Innsbruckring Race,Quarq ,Kickr,349,347,2
898,78451,2019-08-28 10:41:58,wahoo,TTR Summer Race #15,Quarq ,Kickr,335,331,4
1000,78451,2019-08-30 12:58:05,wahoo,Zwift Fast Fridays: Tempus Fugit Time Trial,Quarq ,Kickr,370,365,5
1056,78451,2019-08-31 11:12:45,wahoo, 3R Tick Tock Flat Race - 2 Lap,Quarq ,Kickr,360,357,3
1092,78451,2019-09-01 10:07:34,wahoo,3R Sand & Sequoias - 1 Lap,Quarq ,Kickr,332,330,2
1199,78451,2019-09-03 09:56:59,wahoo,KISS Race - Americas AM,Quarq ,Kickr,354,347,7
1292,78451,2019-09-04 19:00:44,wahoo,EVR Europe Race 9/4/2019,Quarq ,Kickr,375,374,1
1420,78451,2019-09-07 12:42:28,wahoo,WTRL KOM Series,Quarq ,Kickr,368,358,10
4062,78451,2019-11-10 12:28:55,wahoo,Fun in the Sunday Race,Quarq Dzero ,Kickr,367,367,0
4126,78451,2019-11-12 10:20:15,wahoo,Eat The Pain Race,Quarq Dzero ,Kickr 18,389,389,0
90859,78597,2021-01-03 17:19:27,neo,Zwift - 3R Racing (A),4iii Left Crank,TACX Neo,333,339,-6
92491,78597,2021-01-06 22:05:28,neo,Zwift - 3R Innsbruckring Flat Race - 3 Laps (26.4km/16.4mi 231m) (A),4iii Left Crank,TACX Neo,345,353,-8
55236,78803,2020-09-14 17:59:58,wahoo,14/09/2020 - Invitational League // Qualifying Race #1,Vector3,Kickr,344,351,-7
55345,78803,2020-09-15 15:06:23,wahoo,15/09/2020 - 3R Sundown Race 3,Vector3-ElemntBolt,Kickr-Zwift,336,351,-15
56453,78803,2020-09-20 13:00:02,wahoo,20/09/2020 - Invitational League // Qualifying Race #3,Vector3-ElemntBolt,Kickr-Zwift,348,362,-14
63575,78803,2020-10-20 18:57:00,wahoo,20/10/2020 - ZRL Round 2 TTT,Vector3-ElemntBolt,Kickr-Zwift,342,345,-3
67688,78803,2020-11-03 20:06:14,wahoo,03/11/2020 - ZRL Round 4 TTT,Vector3-ElemntBolt,Kickr-Zwift,336,333,3
86524,78803,2020-12-23 16:08:07,wahoo,23/12/2020 - ZADA 3 Sisters Test,Vector3-ElemntBolt,Kickr-Zwift,336,349,-13
89600,78803,2020-12-31 18:09:01,wahoo,31/12/2020 - WTRL TTT - Absolute Howler HNY!,Vector3-ElemntBolt,Kickr-Zwift,341,335,6
90276,78803,2021-01-02 15:15:14,wahoo,02/01/2021 - Zwift Race,Vector3-ElemntBolt,Kickr-Zwift,317,334,-17
91615,78803,2021-01-05 11:00:01,wahoo,05/01/2021 - Zwift Race,Vector3-ElemntBolt,Kickr-Zwift,348,362,-14
92637,78803,2021-01-07 11:00:03,wahoo,07/01/2021 - Zwift Race w/ Laptop Snooze,Vector3-ElemntBolt,Kickr-Zwift,338,341,-3
93354,78803,2021-01-08 13:50:02,wahoo,08/01/2021 - Zwift Race,Vector3-ElemntBolt,Kickr-Zwift,351,352,-1
95453,78803,2021-01-12 11:00:12,wahoo,12/01/2021 - Zwift Race,Vector3-ElemntBolt,Kickr-Zwift,317,329,-12
99255,78803,2021-01-18 19:53:02,wahoo,18/01/2021 - Prem League ZRL Round 2 TTT,Vector3-ElemntBolt,Kickr-Zwift,332,349,-17
99517,78803,2021-01-19 11:00:15,wahoo,19/01/2021 - Zwift Race,Vector3-ElemntBolt,Kickr-Zwift,331,344,-13
101032,78803,2021-01-21 20:00:01,wahoo,Zwift - KISS Race Series - EU PM (A),Vector3-ElemntBolt,Kickr-Zwift,322,331,-9
101409,78803,2021-01-22 15:15:10,wahoo,22/01/2021 - Zwift Race,Vector3-ElemntBolt,Kickr-Zwift,307,320,-13
103283,78803,2021-01-26 11:00:03,wahoo,26/01/2021 - Zwift Race,Vector3-ElemntBolt,Kickr-Zwift,353,343,10
104074,78803,2021-01-27 16:00:02,wahoo,27/01/2021 - Zwift Race,Vector3-ElemntBolt,Kickr-Zwift,312,323,-11
106934,78803,2021-02-01 20:07:00,wahoo,01/02/2021 - Prem ZRL Round 4 spat obvz,Vector3-ElemntBolt,Kickr-Zwift,335,352,-17
108134,78803,2021-02-03 16:00:04,wahoo,03/02/2021 - Zwift Race,Vector3-ElemntBolt,Kickr-Zwift,317,329,-12
109951,78803,2021-02-06 15:15:06,wahoo,06/02/2021 - Zwift Race,Vector3-ElemntBolt,Kickr-Zwift,355,368,-13
112361,78803,2021-02-10 18:59:59,wahoo,10/02/2021 - Movistar Invite Round 1,Vector3-ElemntBolt,Kickr-Zwift,316,325,-9
113618,78803,2021-02-12 19:00:12,wahoo,12/02/2021  - Movistar Invite Round 1 - Race 2,Vector3-ElemntBolt,Kickr-Zwift,362,363,-1
115409,78803,2021-02-15 20:02:01,wahoo,15/02/2021 - Prem ZRL Round 6,Vector3-ElemntBolt,Kickr-Zwift,350,363,-13
116750,78803,2021-02-17 19:00:02,wahoo,17/02/2021 - Movistar Invite Round 2 - Race 1,Vector3-ElemntBolt,Kickr-Zwift,309,330,-21
117900,78803,2021-02-19 19:00:04,wahoo,19/02/2021 - Movistar Invite Round 2 Race 2 - noooooope!,Vector3-ElemntBolt,Kickr-Zwift,362,363,-1
119434,78803,2021-02-23 11:29:59,wahoo,23/02/2021 - Zwift Race,Vector3-ElemntBolt,Kickr-Zwift,309,319,-10
120204,78803,2021-02-24 14:00:02,wahoo,24/02/2021 - Zwift Race,Vector3-ElemntBolt,Kickr-Zwift,376,372,4
122621,78803,2021-03-01 20:14:57,wahoo,01/03/2021 - ZRL Prem - Round 8 TTT,Vector3-ElemntBolt,Kickr-Zwift,337,341,-4
124463,78803,2021-03-05 13:50:02,wahoo,05/03/2021 - Zwift Race,Garmin Vector 3 (vers. 3.80) &gt; ElemntBolt,Kickr18 (vers.3.4.71) &gt; Zwift,311,305,6
125024,78803,2021-03-06 15:15:03,wahoo,06/03/2021 - Zwift Race,Garmin Vector 3 (vers. 3.80) &gt; ElemntBolt,Kickr18 (vers.3.4.71) &gt; Zwift,313,304,9
126035,78803,2021-03-09 11:00:07,wahoo,"09/03/2021 - Zwift - No Legs, No Race",Garmin Vector 3 (vers.3.80) &gt; ElemntBolt,Kickr18 (vers.3.4.71) &gt; Zwift,329,327,2
126896,78803,2021-03-11 11:00:16,wahoo,11/03/2021 - Zwift Race,Garmin Vector 3 (vers.3.80) &gt; ElemntBolt,Kickr18 (vers.3.4.71) &gt; Zwift,307,300,7
129185,78803,2021-03-16 18:30:17,wahoo,16/03/2021 - Zwift CeramicSpeed Race,Garmin Vector 3 (vers.3.80) &gt; ElemntBolt,Kickr18 (vers.3.4.71) &gt; Zwift,336,324,12
99889,78811,2021-01-19 20:03:53,wahoo,Zwift - Zwift Racing League | WTRL - Men&#039;s/Mixed EMEA W2 DIVISION 3 (B),Favero Assioma Duo,Wahoo Kickr V5,342,339,3
6497,79648,2019-12-17 18:11:26,neo,Zwift - Danmarks Cykle Union Racing League (A),Quarq Dfour91,Tacx Neo (1),321,323,-2
7014,79648,2019-12-22 10:27:14,neo,Zwift - The Season - Crit City Cup (A) #14th,Quarq Dfour91,Tacx Neo (1),311,309,2
7548,79648,2019-12-29 10:30:46,neo,Zwift - The Season - 3 Days of Yorkshire #1 (A) 19th,Quarq Dfour91,Tacx Neo (1),324,314,10
7721,79648,2019-12-31 10:04:05,neo,Zwift - Ultimate - Goodbye 2019 By 3R (B),Quarq Dfour91,Tacx Neo (1),316,319,-3
8133,79648,2020-01-05 10:39:06,neo,Zwift - The Season - 3 Days of Yorkshire #2 (A) #12th,Quarq Dfour91,Tacx Neo (1),326,321,5
8343,79648,2020-01-07 18:34:38,neo,Zwift - Team Italy Gladiators Race (B),Quarq Dfour91,Tacx Neo (1),331,334,-3
8616,79648,2020-01-09 17:23:06,neo,Zwift - Danmarks Cykle Union 2020 Cup (B),Quarq Dfour91,Tacx Neo (1),315,310,5
9380,79648,2020-01-14 17:55:51,neo,Zwift - Danmarks Cykle Union 2020 Cup (B),Quarq Dfour91,Tacx Neo (1),320,316,4
9868,79648,2020-01-18 08:55:20,neo,Zwift - Danmarks Cykle Union 2020 Cup (B) #4th (DCU:#2nd),Quarq Dfour91,Tacx Neo (1),315,316,-1
9980,79648,2020-01-19 10:21:16,neo,Zwift - The Season - Richmond Cup (B),Quarq Dfour91,Tacx Neo (1),331,329,2
10161,79648,2020-01-20 17:29:23,neo,Zwift - Danmarks Cykle Union 2020 Cup (B) DCU:#2nd,Quarq Dfour91,Tacx Neo (1),324,324,0
10650,79648,2020-01-23 17:30:04,neo,Zwift - Danmarks Cykle Union 2020 Cup (B) #5th,Quarq Dfour91,Tacx Neo (1),317,314,3
10970,79648,2020-01-26 08:58:31,neo,Zwift - Danmarks Cykle Union 2020 Cup (B) #1st,Quarq Dfour91,Tacx Neo (1),329,331,-2
11357,79648,2020-01-28 17:58:04,neo,Zwift - Danmarks Cykle Union 2020 Cup (B),Quarq Dfour91,Tacx Neo (1),306,307,-1
11734,79648,2020-01-30 19:00:21,neo,Zwift - KALAS Cup - Round 1 (B),Quarq Dfour91,Tacx Neo (1),322,319,3
11954,79648,2020-02-01 08:56:13,neo,Zwift - Danmarks Cykle Union 2020 Cup (B),Quarq Dfour91,Tacx Neo (1),344,348,-4
12277,79648,2020-02-03 17:30:01,neo,Zwift - Danmarks Cykle Union 2020 Cup (B) #2nd,Quarq Dfour91,Tacx Neo (1),347,346,1
12824,79648,2020-02-06 17:28:44,neo,Zwift - Danmarks Cykle Union 2020 Cup (B) #5th,Quarq Dfour91,Tacx Neo (1),321,322,-1
13093,79648,2020-02-09 09:00:55,neo,Danmarks Cykle Union 2020 Cup (B) #8th,Quarq Dfour91,Tacx Neo (1),327,325,2
13441,79648,2020-02-11 17:56:48,neo,Zwift - Danmarks Cykle Union 2020 Cup (B) #3rd,Quarq Dfour91,Tacx Neo (1),332,330,2
13445,79648,2020-02-11 19:11:05,neo,Zwift - ,Quarq Dfour91,Tacx Neo (1),304,304,0
14378,79648,2020-02-17 17:29:50,neo,Zwift - Danmarks Cykle Union 2020 Cup (B) #2nd,Quarq Dfour91,Tacx Neo (1),313,315,-2
14608,79648,2020-02-18 19:09:22,neo,Zwift - Feltet.dk Race Series #6th,Quarq Dfour91,Tacx Neo (1),301,300,1
14913,79648,2020-02-20 17:28:25,neo,Zwift - Danmarks Cykle Union 2020 Cup (B) #1st,Quarq Dfour91,Tacx Neo (1),325,326,-1
15264,79648,2020-02-23 09:01:17,neo,Zwift - Danmarks Cykle Union 2020 Cup (B) #2nd,Quarq Dfour91,Tacx Neo (1),320,318,2
15581,79648,2020-02-25 17:59:41,neo,Zwift - Danmarks Cykle Union 2020 Cup (B) #2nd,Quarq Dfour91,Tacx Neo (1),326,323,3
15743,79648,2020-02-26 17:03:01,neo,Zwift - 2RR ITT Bologna (A) #12th,Quarq Dfour91,Tacx Neo (1),343,341,2
16091,79648,2020-02-29 09:00:00,neo,Zwift - Danmarks Cykle Union 2020 Cup (B) #4th,Quarq Dfour91,Tacx Neo (1),288,291,-3
16487,79648,2020-03-02 17:26:38,neo,Zwift - Danmarks Cykle Union 2020 Cup (B) #3rd,Quarq Dfour91,Tacx Neo (1),288,289,-1
16662,79648,2020-03-03 19:10:01,neo,Feltet.dk Race Series,Quarq Dfour91,Tacx Neo (1),317,313,4
16928,79648,2020-03-05 17:29:10,neo,Zwift - Danmarks Cykle Union 2020 Cup (B) #4th,Quarq Dfour91,Tacx Neo (1),317,321,-4
17226,79648,2020-03-08 08:51:56,neo,Zwift - Danmarks Cykle Union 2020 Cup (B) #2nd,Quarq Dfour91,Tacx Neo (1),304,302,2
17568,79648,2020-03-10 18:00:38,neo,Zwift - Danmarks Cykle Union 2020 Cup (B) #2nd,Quarq Dfour91,Tacx Neo (1),356,356,0
17574,79648,2020-03-10 19:15:16,neo,Zwift - Feltet.dk Race Series (B) #12th DCU+Feltet,Quarq Dfour91,Tacx Neo (1),303,303,0
18027,79648,2020-03-14 09:01:20,neo,Zwift - Danmarks Cykle Union 2020 Cup (B) #2nd,Quarq Dfour91,Tacx Neo (1),346,347,-1
18298,79648,2020-03-16 17:25:20,neo,Zwift - Danmarks Cykle Union 2020 Cup (B) #2nd (DCU),Quarq Dfour91,Tacx Neo (1),311,307,4
18472,79648,2020-03-17 19:12:42,neo,Zwift - Feltet.dk Race Series (B),Quarq Dfour91,Tacx Neo (1),329,329,0
18719,79648,2020-03-19 17:30:39,neo,Zwift - Danmarks Cykle Union 2020 Cup (B) #3rd,Quarq Dfour91,Tacx Neo (1),317,318,-1
19115,79648,2020-03-22 08:58:30,neo,Zwift - Danmarks Cykle Union 2020 Cup (B),Quarq Dfour91,Tacx Neo (1),327,324,3
20672,79648,2020-03-30 16:19:09,neo,Zwift - Danmarks Cykle Union 2020 Cup (B) Overall Winner,Quarq Dfour91,Tacx Neo (1),340,344,-4
20890,79648,2020-03-31 17:52:25,neo,Zwift - Feltet.dk Race Series (B),Quarq Dfour91,Tacx Neo (1),323,319,4
28502,79648,2020-04-27 16:31:02,neo,Zwift - ZHR Zwift Handicap Race (B) #FTP,Quarq Dfour91,Tacx Neo (1),325,323,2
35311,79648,2020-05-16 12:45:00,neo,Zwift - WTRL iTT Series  (A) ,Quarq Dfour91,Tacx Neo (1),319,318,1
36184,79648,2020-05-19 18:09:59,neo,Zwift - UNO X CUP powered by DCU & Feltet.dk (A),Quarq Dfour91,Tacx Neo (1),319,329,-10
37326,79648,2020-05-24 08:33:15,neo,Zwift - Tour for All 2020: Stage 4 Longer Race A/B #5th (ZP:#3rd),Quarq Dfour91,Tacx Neo (1),316,319,-3
44276,79648,2020-06-30 17:53:48,neo,Zwift - Team Italy & Frenchy Fuzion League (A),Quarq Dfour91,Tacx Neo (1),335,338,-3
48953,79648,2020-08-05 16:52:52,neo,Zwift - MIDWEEK Summer Series by SZR (A),Quarq Dfour91,Tacx Neo (1),321,319,2
52006,79648,2020-08-26 14:37:50,neo,Zwift - Team Italy Specialissima Race  (B),Quarq Dfour91,Tacx Neo (1),304,305,-1
52351,79648,2020-08-28 13:35:03,neo,Zwift - Crit City Race (B),Quarq Dfour91,Tacx Neo (1),293,294,-1
57497,79648,2020-09-25 15:00:23,neo,Zwift - 3R Sand and Sequoias Race (B),Quarq Dfour91,Tacx Neo (1),323,324,-1
59864,79648,2020-10-06 16:34:32,neo,Zwift - ZRG Race (B),Quarq Dfour91,Tacx Neo (1),305,301,4
63950,79648,2020-10-21 16:54:53,neo,Zwift - MIDWEEK Autumn Series by SZR (B),Quarq Dfour91,Tacx Neo (1),330,330,0
65844,79648,2020-10-28 17:51:04,neo,Zwift - MIDWEEK Autumn Series by SZR (B),Quarq Dfour91,Tacx Neo (1),336,337,-1
67271,79648,2020-11-02 18:08:02,neo,Zwift - TRI247 Manic Monday Time Trial (E) #FTP,Quarq Dfour91,Tacx Neo (1),328,330,-2
67939,79648,2020-11-04 18:52:07,neo,Zwift - DCU – Feltet.dk November series,Quarq Dfour91,Tacx Neo (1),347,348,-1
70400,79648,2020-11-11 18:56:53,neo,Zwift - DCU – Feltet.dk November series (B),Quarq Dfour91,Tacx Neo (1),338,342,-4
72721,79648,2020-11-18 18:54:15,neo,Zwift - DCU – Feltet.dk November series (B) #7th,Quarq Dfour91,Tacx Neo (1),324,324,0
73201,79648,2020-11-19 19:13:32,neo,Zwift - World Championships Experience // Danish Cycling Federation,Quarq Dfour91,Tacx Neo (1),307,302,5
75597,79648,2020-11-25 18:55:18,neo,Zwift - DCU – Feltet.dk November series (B),Quarq Dfour91,Tacx Neo (1),316,320,-4
78198,79648,2020-12-01 18:01:42,neo,Zwift - Zwift Time Trial Tuesday: Bologna (E),Quarq Dfour91,Tacx Neo (1),354,357,-3
79159,79648,2020-12-03 18:31:14,neo,Zwift - FUSION DECEMBER CUP (B),Quarq Dfour91,Tacx Neo (1),305,304,1
81694,79648,2020-12-10 18:28:01,neo,Zwift - FUSION DECEMBER CUP (B) ,Quarq Dfour91,Tacx Neo (1),321,317,4
85071,79648,2020-12-19 12:57:09,neo,Zwift Academy Tri: Bike Workout 4 | FTP Development,Quarq Dfour91,Tacx Neo (1),276,275,1
90107,79648,2021-01-02 08:46:40,neo,Zwift - Newbury Velo Weekend TT #Ballast#+9kg,Quarq Dfour91,Tacx Neo (1),328,324,4
93063,79648,2021-01-07 18:30:12,neo,Zwift - FUSION WINTER CUP (B) ,Quarq Dfour91,Tacx Neo (1),307,306,1
95786,79648,2021-01-12 18:25:59,neo,Zwift - Zwift Racing League | WTRL - Men&#039;s/Mixed EMEA E2 DIVISION 6 (B),Quarq Dfour91,Tacx Neo (1),315,316,-1
96472,79648,2021-01-13 18:43:41,neo,Zwift - Danmarks Cykle Union & Partners 1/6 (B) #9th,Quarq Dfour91,Tacx Neo (1),316,314,2
97153,79648,2021-01-14 18:22:40,neo,Zwift - FUSION WINTER CUP (B) #restdaysareimportant,Quarq Dfour91,Tacx Neo (1),302,299,3
100485,79648,2021-01-20 18:40:20,neo,Zwift - Danmarks Cykle Union & Partners 2/6 (B),Quarq Dfour91,Tacx Neo (1),317,317,0
101419,79648,2021-01-22 15:13:30,neo,Zwift - DBR Friday Race (B) #4th,Quarq Dfour91,Tacx Neo (1),335,324,11
107550,79648,2021-02-02 18:16:28,neo,Zwift - Zwift Racing League | WTRL - Men&#039;s/Mixed EMEA E2 DIVISION 6 (B) #2nd,Quarq Dfour91,Tacx Neo (1),316,312,4
109083,79648,2021-02-04 18:26:38,neo,Zwift - FUSION WINTER CUP (B) #8th,Quarq Dfour91,Tacx Neo (1),321,320,1
123702,79648,2021-03-03 18:45:27,neo,Zwift - Scandinavian Cup 2021 - Round 2 - Men (B),Quarq Dfour91,Tacx Neo (1),329,329,0
126704,79648,2021-03-10 18:42:18,neo,Zwift - Scandinavian Cup 2021 - Round 3 - Men (B),Quarq Dfour91,Tacx Neo (1),318,315,3
129840,79648,2021-03-17 18:41:38,neo,Zwift - Scandinavian Cup 2021 - Round 4 - Men (B),Quarq Dfour91,Tacx Neo (1),320,329,-9
40813,79710,2020-06-10 17:02:42,neo,Zwift - Bike: Sweet spot turbo session,shiv 4iiii dual,Tacx Neo,294,299,-5
108002,79710,2021-02-03 12:04:33,neo,Zwift - Bike: Tempo turbo session,Venge 4IIII,Tacx Neo,286,283,3
73547,79918,2020-11-20 14:00:00,neo,Zwift Academy Road: Workout 7 | VO2 Development Neo vs Vector,Garmin Vector,Tacx Neo,280,283,-3
82455,79918,2020-12-12 16:15:00,neo,Zwift - Deeside Snowman Sprint Series (B),Tacx Neo,Tacx Neo,191,188,3
29672,80450,2020-04-19 08:05:04,wahoo,3R Watopia Flat Route Race - 4 Laps (40.5km/25.1mi 216m),4iiii,kickr,384,359,25
29688,80450,2020-04-18 16:50:03,wahoo,3R Innsbruckring Flat Race - 3 Laps (26.4km/16.4mi 231m),4iiii,kickr,382,373,9
29701,80450,2020-04-17 14:59:59,wahoo,ZHQ Beta Crit City Race,4iiii,kickr,384,379,5
48038,81574,2020-07-28 18:40:16,wahoo,Zwift - 3R Turbocharged Team Race Series - Round 3 (A) 1st mini V,Quarq Dzero,Wahoo Kickr 18,438,428,10
50563,81574,2020-08-18 18:40:05,wahoo,Zwift - 3R Turbocharged Team Race Series - Round 6 (A) mini V,Quarq Dzero,Wahoo Kickr 18,391,386,5
58053,81574,2020-09-28 16:40:02,wahoo,Zwift - Team Italy PISSEI Race (A) mini V win,39D4C5E1,Wahoo Kickr 18,377,375,2
59626,81574,2020-10-05 18:19:59,wahoo,Zwift - TFC Mad Monday Autumn Series (A) mini V WIN!,Quarq Dzero,Wahoo Kickr 18,363,363,0
60314,81574,2020-10-08 16:05:17,wahoo,Zwift - OH MY CRIT! - The Double Race 2/2 (A) mini V,Quarq Dzero,Wahoo Kickr 18,394,399,-5
61182,81574,2020-10-12 17:14:58,wahoo,Zwift - DBR Ride´N´Roll League  mini V,Quarq Dzero,Wahoo Kickr 18,357,357,0
61874,81574,2020-10-14 17:00:01,wahoo,Zwift - MIDWEEK Autumn Series by SZR (A) mini V 2nd p/b sprinting at 500m to go,39E9E290,Wahoo Kickr 18,404,415,-11
68576,81574,2020-11-06 18:59:42,wahoo,Zwift -  Tour De Spartacus  (E) mini V,Quarq Dzero,Wahoo Kickr 18,459,478,-19
68860,81574,2020-11-07 19:03:58,wahoo,Zwift -  Tour De Spartacus  (E) mini V,Quarq Dzero 3 sec,Wahoo Kickr 18,388,397,-9
76067,81574,2020-11-26 18:49:08,wahoo,Zwift - WTRL NOPINZ WORLD TTT CHAMPIONSHIPS - Zone 7 (C) mini V owww,Quarq Dzero,Wahoo Kickr 18,429,411,18
121674,81574,2021-02-27 15:10:06,wahoo,Zwift - OH MY CRIT!! - Saturday Smash Race (A) mini V,Quarq Dzero,Wahoo Kickr 18,395,375,20
121676,81574,2021-02-27 16:44:57,wahoo,Zwift - 02/27/2021,Quarq Dzero,Wahoo Kickr 18,399,385,14
123968,81574,2021-03-04 16:12:24,wahoo,Zwift - OH MY CRIT!! - The Double Race 1/2 (A) mini V,Quarq Dzero,Wahoo Kickr 18,418,410,8
123979,81574,2021-03-04 17:05:23,wahoo,Zwift - OH MY CRIT!! - The Double Race 2/2 (A) mini V,Evening_ride_dr2,Wahoo Kickr 18,427,420,7
126994,81574,2021-03-11 17:05:16,wahoo,Zwift - OH MY CRIT!! - The Double Race 2/2 (A) mini V felt better than race 1,Quarq Dzero,Wahoo Kickr 18,410,410,0
127009,81574,2021-03-11 17:05:16,wahoo,Zwift - OH MY CRIT!! - The Double Race 2/2 (A) mini V felt better than race 1,Quarq Dzero,Wahoo Kickr 18,423,410,13
22812,81778,2020-04-07 18:39:58,wahoo,Zwift - 3R Spring Loaded Race Series - Round 2of6 (A),Garmin 2 Pedal,Wahoo kickr,371,394,-23
93112,81778,2021-01-08 01:29:59,wahoo,Zwift - 01/07/2021,4iiii left,Wahoo kickr,421,412,9
93581,81778,2021-01-08 23:29:59,wahoo,Wahoo kickr / 4iiii left,4iiii left,Wahoo kickr,391,406,-15
107704,81778,2021-02-03 00:46:00,wahoo,Zwift - 02/02/2021,4iiii left,Wahoo kickr,435,418,17
112541,81778,2021-02-11 00:10:02,wahoo,Zwift - 02/10/2021,4iiii,Wahoo kickr,417,408,9
16162,82201,2020-02-29 16:59:46,wahoo,Zwift - Lee Zavarise (MIVA)&#039;s Meetup - 2018 UCI Worlds Short Lap,Stages Dual Gen 3,Wahoo Kickr 2018,244,236,8
29789,82201,2020-04-30 19:45:45,wahoo,Zwift - Vault,Stages Dual Gen 3,Wahoo Kickr 2018,304,288,16
128163,82201,2021-03-13 14:01:04,wahoo,Zwift - Zwift Insider Badge Hunters - The PRL Full Edition,Stages Dual Gen 3,Wahoo Kickr V5,282,269,13
11658,82297,2020-01-30 14:00:00,wahoo,Tour de Zwift: Stage 5 Long Distance - Ride with some pulls,Zwift,Kickr,340,335,5
11813,82297,2020-01-31 13:11:59,wahoo,DIRT Friday Pacific Sprintapalooza,Quarq,Kickr,253,251,2
83991,82297,2020-12-16 16:29:35,wahoo,TEAM VEGAN Mixed Salad,Quarq,Kickr,370,362,8
84118,82297,2020-12-16 15:14:32,wahoo,Zwift - Watopia,Quarq,Kickr V3 2018,257,252,5
84235,82297,2020-12-16 23:49:14,wahoo,Wednesday Worlds Testing,Quarq,Kickr V1 2015,241,248,-7
84698,82297,2020-12-18 13:17:41,wahoo,DIRT Friday Pacific Sprintapalooza  (C)homps,Quarq New,Kickr V1 2015,227,232,-5
85289,82297,2020-12-19 13:57:22,wahoo,The P Race (A),Quarq New,Kickr V1 2015,312,319,-7
92696,82306,2021-01-06 22:02:05,wahoo,p2max / kickr,p2max,kickr,293,267,26
96296,82306,2021-01-09 18:58:13,wahoo,p2max / kickr / optical hr,p2max,kickr / optical hr,338,317,21
96926,82306,2021-01-13 22:19:09,wahoo,p2max / kickr,p2max,kickr,335,306,29
113772,82306,2021-02-12 21:32:01,wahoo,P2Max / Kickr,P2Max,Kickr,183,196,-13
114120,82306,2021-02-13 11:47:33,wahoo,p2max / kickr,p2max,kickr,334,345,-11
115073,82306,2021-02-14 18:47:13,wahoo,Zwift - BRT Iron Goat Racing League (A),P2Max,Wahoo Kickr,342,356,-14
7389,83405,2019-12-27 09:03:02,neo,Zwift Fast Fridays: Bologna Time Trial,Rotor InPower,Tacx Neo ,366,369,-3
8027,83405,2020-01-04 09:28:59,neo,Zwift - DBR Saturday Race (A),Rotor InPower,Tacx Neo ,396,384,12
8120,83405,2020-01-05 09:58:48,neo,Zwift - dPAC.fit Climbers Day (A),Rotor InPower,Tacx Neo ,373,370,3
8477,83405,2020-01-08 19:03:44,neo,Zwift - DBR HEINO CUP (A),Rotor InPower,Tacx Neo ,369,364,5
8642,83405,2020-01-09 18:20:37,neo,Zwift - WTRL Team Time Trial (C),Rotor InPower,Tacx Neo ,363,347,16
8960,83405,2020-01-12 09:58:55,neo,Zwift - dPAC.fit Climbers Day (A),Rotor InPower,Tacx Neo ,385,371,14
9150,83405,2020-01-13 16:09:02,neo,Zwift - 3R Classique Reverse Flat Race - 4 Laps (26.9km/16.7mi 57m) (A),Rotor InPower,Tacx Neo ,363,351,12
9577,83405,2020-01-15 19:05:14,neo,Zwift - DBR HEINO CUP (A),Rotor InPower,Tacx Neo ,364,352,12
10487,83405,2020-01-22 19:02:56,neo,Zwift - DBR HEINO CUP (A),Rotor InPower,Tacx Neo ,377,358,19
10629,83405,2020-01-23 17:29:02,neo,Zwift - Danmarks Cykle Union 2020 Cup (A),Rotor InPower,Tacx Neo ,376,353,23
10760,83405,2020-01-23 17:29:02,neo,Zwift - Danmarks Cykle Union 2020 Cup (A),Rotor InPower,Tacx Neo ,376,360,16
11325,83405,2020-01-28 17:08:01,neo,Zwift - 3R Volcano KOM After Party Race - 2 laps + climb (40.2km/25mi 286m) (A),Rotor 2inpower,Tacx Neo ,370,361,9
12603,83405,2020-02-05 17:58:30,neo,Zwift - SZR Winter Race Series (A),Rotor 2inpower,Tacx Neo ,395,387,8
12766,83405,2020-02-06 18:17:13,neo,Zwift - WTRL Team Time Trial (C),Rotor 2inpower,Tacx Neo ,372,362,10
13665,83405,2020-02-12 19:03:39,neo,Zwift - DBR Wednesday Race (A),Rotor 2inpower,Tacx Neo ,370,355,15
14185,83405,2020-02-16 10:00:16,neo,Zwift - dPAC.fit Climbers Day (A),Rotor InPower,Tacx Neo ,360,356,4
14555,83405,2020-02-18 19:11:12,neo,Zwift - Feltet.dk Race Series,Rotor InPower,Tacx Neo ,367,360,7
15151,83405,2020-02-22 09:19:26,neo,Zwift - DBR Saturday Race (A),Rotor InPower,Tacx Neo ,349,350,-1
16086,83405,2020-02-29 09:21:46,neo,Zwift - DBR Saturday Race (A),Rotor 2inpower,Tacx Neo ,345,336,9
16641,83405,2020-03-03 18:38:33,neo,Zwift - Feltet.dk Race Series (A),Rotor 2inpower,Tacx Neo ,414,390,24
17542,83405,2020-03-10 19:11:09,neo,Zwift - Feltet.dk Race Series (A),Rotor 2inpower,Tacx Neo ,389,381,8
18016,83405,2020-03-14 08:14:58,neo,Zwift - VZT Tofu Tornado XL (A),Rotor 2inpower,Tacx Neo ,373,368,5
18452,83405,2020-03-17 18:49:30,neo,Zwift - Feltet.dk Race Series (A),Rotor InPower,Tacx Neo ,373,364,9
19398,83405,2020-03-21 09:25:47,neo,Zwift - DBR Saturday Race (A),Rotor InPower,Tacx Neo ,393,399,-6
19554,83405,2020-03-24 19:05:25,neo,Zwift - Feltet.dk Race Series (A),Rotor InPower,Tacx Neo ,361,363,-2
20269,83405,2020-03-28 09:27:18,neo,Zwift - DBR Saturday Race (A),Rotor 2inpower,Tacx Neo ,420,408,12
21705,83405,2020-03-31 18:06:10,neo,Zwift - Feltet.dk Race Series (A),Rotor InPower,Tacx Neo ,376,372,4
21938,83405,2020-04-04 08:30:16,neo,Zwift - DBR Sufferday League (A),Rotor InPower,Tacx Neo ,366,366,0
23292,83405,2020-04-09 17:00:08,neo,Zwift - WTRL Team Time Trial (C),Rotor InPower,Tacx Neo ,361,355,6
23864,83405,2020-04-11 08:30:17,neo,Zwift - DBR Sufferday League (A),Rotor InPower,Tacx Neo ,370,349,21
26187,83405,2020-04-18 08:05:49,neo,Zwift - DBR Sufferday League (A),Rotor InPower,Tacx Neo ,376,369,7
27981,83405,2020-04-25 08:23:21,neo,Zwift - DBR Sufferday League (A),Rotor 2inpower,Tacx Neo ,377,371,6
30418,83405,2020-05-02 08:28:36,neo,Zwift - DBR Sufferday League (A),Rotor InPower,Tacx Neo ,405,399,6
31720,83405,2020-05-05 17:50:11,neo,Zwift - UNO X CUP powered by DCU & Feltet.dk (A),Rotor InPower,Tacx Neo ,420,402,18
32994,83405,2020-05-09 08:24:52,neo,Zwift - DBR Sufferday League (A),Rotor InPower,Tacx Neo ,381,369,12
35347,83405,2020-05-16 08:27:20,neo,Zwift - DBR Sufferday League (A),Rotor InPower,Tacx Neo ,374,367,7
36117,83405,2020-05-19 17:59:42,neo,Zwift - UNO X CUP powered by DCU & Feltet.dk (A),Rotor 2inpower,Tacx Neo ,411,394,17
37017,83405,2020-05-23 08:28:35,neo,Zwift - DBR Sufferday League (A),Rotor InPower,Tacx Neo ,383,374,9
37851,83405,2020-05-26 17:59:15,neo,Zwift - UNO X CUP powered by DCU & Feltet.dk (A),Rotor InPower,Tacx Neo ,430,417,13
38342,83405,2020-05-28 17:21:16,neo,Zwift - WTRL Team Time Trial Premier League (C),Rotor InPower,Tacx Neo ,395,378,17
38351,83405,2020-05-28 17:21:16,neo,Zwift - Tour for All 2020: Stage 2 Longer Race A/B,Rotor InPower,Tacx Neo ,374,363,11
38669,83405,2020-05-30 08:29:22,neo,Zwift - DBR Sufferday League (A),Rotor 2inpower,Tacx Neo ,397,388,9
39971,83405,2020-06-06 08:30:16,neo,Zwift - DBR Sufferday League (A),Rotor InPower,Tacx Neo ,347,352,-5
44980,83405,2020-07-05 08:32:56,neo,Zwift - Newbury Velo Road Race (A),Rotor InPower,Tacx Neo ,372,350,22
59173,83405,2020-10-03 07:29:20,neo,Zwift - TEAM VEGAN Tofu Tornado XL (A),Rotor InPower,Tacx Neo ,364,363,1
60580,83405,2020-10-07 15:01:03,neo,Zwift - Sydkysten / KST Race (A),Rotor InPower,Tacx Neo ,347,347,0
60738,83405,2020-10-10 08:28:11,neo,Zwift - DBR SufferDay League II (A),Rotor InPower,Tacx Neo ,343,339,4
61490,83405,2020-10-13 15:29:42,neo,Zwift - TEAM VEGAN Tofu Tornado (A),Rotor InPower,Tacx Neo ,363,353,10
62206,83405,2020-10-15 17:40:42,neo,Zwift - Espresso,Rotor InPower,Tacx Neo ,356,351,5
63015,83405,2020-10-19 14:13:11,neo,Zwift - 3R Classique Reverse Flat Race - 5 Laps (32km/20.1mi 76m) (A),Rotor InPower,Tacx Neo ,335,335,0
63795,83405,2020-10-21 15:00:16,neo,Zwift - Sydkysten / KST Race (A),Rotor InPower,Tacx Neo ,346,342,4
65405,83405,2020-10-27 15:00:20,neo,Zwift - ZA Road 2020 - Segment Ride #1: Innsbruck Course,Rotor InPower,Tacx Neo ,365,348,17
66147,83405,2020-10-29 18:12:16,neo,Zwift - WTRL Team Time Trial - Zone 3 (C),Rotor InPower,Tacx Neo ,344,331,13
66886,83405,2020-11-01 09:05:15,neo,Zwift - Newbury Velo Road Race (A),Rotor InPower,Tacx Neo ,360,355,5
69004,83405,2020-11-04 15:58:13,neo,Zwift - Sydkysten / KST Race (A),Rotor InPower,Tacx Neo ,344,338,6
70202,83405,2020-11-11 15:59:06,neo,Sydkysten / KST Race,Rotor InPower,Tacx Neo ,358,347,11
70799,83405,2020-11-12 18:19:37,neo,Zwift - Frappe,Rotor InPower,Tacx Neo ,320,312,8
77208,83405,2020-11-29 08:34:02,neo,Zwift - ZHR Masters Weekender (B),Rotor InPower,Tacx Neo ,328,318,10
78984,83405,2020-12-02 15:58:57,neo,Zwift - Sydkysten / KST Race (A),Rotor InPower,Tacx Neo ,346,337,9
78990,83405,2020-12-03 18:19:09,neo,Zwift - WTRL Team Time Trial - Zone 4 (D),Rotor InPower,Tacx Neo ,298,294,4
78992,83405,2020-12-03 19:16:04,neo,Zwift - BRT Criterium Racing League (A),Rotor InPower,Tacx Neo ,333,329,4
81034,83405,2020-12-09 15:58:06,neo,Zwift - Sydkysten / KST Race (A),Rotor InPower,Tacx Neo ,357,342,15
108224,83405,2021-02-03 18:44:05,neo,Zwift - Danmarks Cykle Union & Partners 4/6 (A),Rotor InPower,Tacx Neo ,387,373,14
117714,83405,2021-02-19 12:59:31,neo,Zwift - TDZ Stage 5: Longer Ride,Rotor InPower,Tacx Neo ,364,349,15
39680,83731,2020-06-04 17:19:37,wahoo,TTT w Velocity Ferocity,Quarq DZero v10,Wahoo KICKR CORE 1.0.12,301,299,2
70932,86182,2020-11-12 18:51:38,wahoo,Zwift - Vienna,Allied Cinch ,Wahoo Kickr,285,275,10
75214,86182,2020-11-24 19:14:59,wahoo,Zwift - Zwift Racing League | WTRL - Women&#039;s EMEA W1 DIVISION 1,Allied Cinch ,Wahoo Kickr,316,288,28
76120,86182,2020-11-26 18:55:55,wahoo,Zwift - WTRL NOPINZ WORLD TTT CHAMPIONSHIPS - Zone 7 (E),Allied Cinch ,Wahoo Kickr,282,257,25
7140,86292,2019-12-23 17:45:29,wahoo,Zwift - 3R Impact Interval Ride [~3.25-3.75w/kg avg] (B),Quarq Riken,KICKR &#039;17,315,315,0
7141,86292,2019-12-23 17:43:32,wahoo,Zwift - 3R Impact Interval Ride [~3.25-3.75w/kg avg] (B),Quarq Riken,KICKR &#039;17,310,315,-5
14529,86292,2020-02-17 17:44:33,wahoo,Zwift - 3R Impact Interval Ride [~3.25-3.75w/kg avg] (B),Quarq Riken,KICKR &#039;17 (NEW),304,313,-9
59298,86292,2020-10-02 22:04:50,wahoo,Zwift - 3R Volcano Flat 50k Race - 4 Laps (48.8km/30.7mi 184m) (A),Quarq Riken,KICKR &#039;17 (NEW),321,331,-10
82549,86292,2020-12-08 18:19:10,wahoo,Zwift - Zwift Racing League | WTRL - Men&#039;s EMEA E2 DIVISION 2 (A),Quarq Riken,KICKR &#039;17 (NEW),313,327,-14
107694,86292,2021-02-02 19:53:01,wahoo,Zwift - Zwift Racing League | WTRL - Men&#039;s/Mixed EMEA W2 DIVISION 2 (A),Quarq Riken,KICKR &#039;17 (NEW),328,340,-12
109949,86292,2021-02-06 15:14:59,wahoo,Zwift - OH MY CRIT!! - Saturday Smash Race (A),Quarq Riken,KICKR &#039;17 (NEW),334,346,-12
112176,86292,2021-02-09 20:02:48,wahoo,Zwift - Zwift Racing League | WTRL - Men&#039;s/Mixed EMEA W2 DIVISION 2 (A),Quarq Riken to Garmin Edge 530,KICKR &#039;17 (NEW),320,334,-14
116065,86292,2021-02-16 19:53:10,wahoo,Zwift - Zwift Racing League | WTRL - Men&#039;s/Mixed EMEA W2 DIVISION 2 (A),Quarq Riken to Garmin Edge 530,KICKR &#039;17 (NEW),338,352,-14
119973,86292,2021-02-23 19:53:05,wahoo,Zwift - Zwift Racing League | WTRL - Men&#039;s/Mixed EMEA W2 DIVISION 2 (A),Quarq Riken to Garmin Edge 530,KICKR &#039;17 (NEW),322,334,-12
123138,86292,2021-03-02 20:01:24,wahoo,Zwift - Zwift Racing League | WTRL - Men&#039;s/Mixed EMEA W2 DIVISION 2 (A),Quarq Riken to Garmin Edge 530,KICKR &#039;17 (NEW),322,332,-10
57002,87980,2020-09-23 16:09:59,wahoo,Zwift - 3R Tick Tock Flat Race - 2 Lap (36km/22.4mi 100m) (A),Assioma Favero,Wahoo Kickr Core,327,327,0
59617,87980,2020-10-05 18:09:58,wahoo,Zwift - TRI247 Manic Monday Time Trial (E),Assioma Favero,Wahoo Kickr Core,338,340,-2
61624,87980,2020-10-13 18:45:01,wahoo,Zwift - Zwift Racing League | WTRL,Assioma Favero,Wahoo Kickr Core,331,337,-6
63393,87980,2020-10-20 17:16:00,wahoo,Zwift - Zwift Racing League | WTRL - EMEA E (MEN) - TTT Grp 1,Assioma Favero,Wahoo Kickr Core,340,336,4
65441,87980,2020-10-27 18:19:58,wahoo,Zwift - Zwift Racing League | WTRL - EMEA E (MEN) -  Division 6 (A),Assioma Favero,Wahoo Kickr Core,330,339,-9
68521,87980,2020-11-06 16:59:57,wahoo,Zwift - ZHQ FutureWorks Crit City Race - Boost mode (A),Assioma Favero,Wahoo Kickr Core,315,317,-2
69847,87980,2020-11-10 18:19:50,wahoo,Zwift - Zwift Racing League | WTRL - EMEA E2 (MEN) -  Division 2 (A),Assioma Favero,Wahoo Kickr Core,366,371,-5
72220,87980,2020-11-17 18:15:00,wahoo,Zwift - Zwift Racing League | WTRL - Men&#039;s EMEA E1 DIVISION 1 (A),Assioma Favero,Wahoo Kickr Core,340,342,-2
79643,87980,2020-12-05 09:59:57,wahoo,Zwift - Nations Challenge // France (E),Assioma Favero,Wahoo Kickr Core,341,347,-6
80212,87980,2020-12-06 16:59:55,wahoo,Zwift - Nations Challenge // France (E),Assioma Favero,Wahoo Kickr Core,324,332,-8
83531,87980,2020-12-15 18:24:24,wahoo,Zwift - Zwift Racing League | WTRL - Men&#039;s EMEA E1 DIVISION 1 (A),Assioma Favero,Wahoo Kickr Core,333,344,-11
95625,87980,2021-01-12 18:15:17,wahoo,Zwift Racing League | WTRL - Mens/Mixed EMEA E1 DIVISION 1,Assioma Favero,Wahoo Kickr Core,336,333,3
99671,87980,2021-01-19 18:23:59,wahoo,Zwift Racing League | WTRL - Mens/Mixed EMEA E2 DIVISION 1,Assioma Favero,Wahoo Kickr Core,318,315,3
103503,87980,2021-01-26 18:23:49,wahoo,Zwift - Zwift Racing League | WTRL - Men&#039;s/Mixed EMEA E2 DIVISION 1 (A),Assioma Favero,Wahoo Kickr Core,341,341,0
107300,87980,2021-02-02 18:14:40,wahoo,Zwift - Zwift Racing League | WTRL - Men&#039;s/Mixed EMEA E1 DIVISION 1 (A),Assioma Favero,Wahoo Kickr Core,350,332,18
115902,87980,2021-02-16 18:14:49,wahoo,Zwift - Zwift Racing League | WTRL - Men&#039;s/Mixed EMEA E1 DIVISION 1 (A),Assioma Favero,Wahoo Kickr Core,356,353,3
117283,88349,2021-02-18 18:38:33,wahoo,Zwift - WTRL Team Time Trial - Zone 7 (D),QUARQ,WAHOO KICKR,284,280,4
93364,88821,2021-01-05 17:09:58,neo,Zwift - 3R Volcano KOM After Party Race - 2 laps + climb (40.2km/25mi 286m) (B),Quarq,TACX NEO,297,298,-1
94510,88821,2021-01-10 16:44:28,neo,Zwift - Watopia,Quarq,TACX NEO,181,173,8
95253,88821,2021-01-11 19:45:00,neo,Zwift - Gareth Tupling [BRT]&#039;s Meetup - 2015 UCI Worlds Course,Quarq,TACX NEO,192,189,3
98060,88821,2021-01-16 09:30:01,neo,Four Horsemen,Quarq,TACX NEO,284,285,-1
103938,88821,2021-01-26 19:54:17,neo,Zwift - Zwift Racing League | WTRL - Men&#039;s/Mixed EMEA W2 DIVISION 2 (B),Quarq,TACX NEO,305,302,3
14675,90541,2020-02-19 01:30:00,neo,Zwift - 3R SuperCRITical Race Series - Round 1of4 (A),Garmin Vector 3,Tacx NEO (Gen 1),320,316,4
10736,90946,2020-01-23 19:15:15,wahoo,Zwift - Tour de Zwift // Pro-Am Invitational,Garmin Vector 3,Wahoo Kickr,420,424,-4
11355,90946,2020-01-28 09:00:01,wahoo,Zwift - Tour de Zwift: Stage 5 Long Distance,Garmin Vector 3,Wahoo Kickr,385,389,-4
12012,90946,2020-01-31 19:15:03,wahoo,Zwift - Tour de Zwift // Pro-Am Invitational (A),Garmin Vector 3,Wahoo Kickr,383,392,-9
12177,90946,2020-02-02 09:30:00,wahoo,Zwift - Slovenian Zwift League - Spring Series (A),Garmin Vector 3,Wahoo Kickr,399,398,1
12522,90946,2020-02-04 19:15:01,wahoo,Zwift - Tour de Zwift // Pro-Am Invitational (A),Garmin Vector 3,Wahoo Kickr,386,401,-15
13111,90946,2020-02-09 09:30:04,wahoo,Zwift - Slovenian Zwift League - Spring Series (A),4530788217,Wahoo Kickr,379,378,1
13112,90946,2020-02-09 11:00:04,wahoo,Zwift - Tour de Zwift: Stage 7 - Long Distance,4531172441,Wahoo Kickr,333,337,-4
13311,90946,2020-02-10 18:15:04,wahoo,Zwift - DBR Winter Cup (A),Garmin Vector 3,Wahoo Kickr,385,387,-2
14216,90946,2020-02-16 09:30:08,wahoo,Zwift - Slovenian Zwift League - Spring Series (A),Garmin Vector 3,Wahoo Kickr,402,390,12
14747,90946,2020-02-19 19:05:01,wahoo,Zwift - DBR Winter Cup (A),Garmin Vector 3,Wahoo Kickr,364,372,-8
15315,90946,2020-02-23 09:30:00,wahoo,Zwift - Slovenian Zwift League - Spring Series (A),Garmin Vector 3,Wahoo Kickr,342,355,-13
16242,90946,2020-03-01 09:30:03,wahoo,Zwift - Slovenian Zwift League - Spring Series (A),Garmin Vector 3,Wahoo Kickr,356,357,-1
16492,90946,2020-03-02 18:15:04,wahoo,Zwift - DBR Winter Cup (A),Garmin Vector 3,Wahoo Kickr,366,373,-7
16826,90946,2020-03-04 19:05:05,wahoo,Zwift - DBR Winter Cup (A),Garmin Vector 3,Wahoo Kickr,381,378,3
17717,90946,2020-03-11 19:05:09,wahoo,Zwift - DBR Winter Cup (A),Garmin Vector 3,Wahoo Kickr,411,413,-2
20004,90946,2020-03-26 08:10:02,wahoo,Zwift - Cervelo Jungle Rush Series Rd 1 - Cervelo Aspero (B),Garmin Vector 3,Wahoo Kickr,388,393,-5
20005,90946,2020-03-22 08:20:01,wahoo,Zwift - Team Italy & Frenchy Fuzion Fondo (A),Garmin Vector 3,Wahoo Kickr,382,378,4
20226,90946,2020-03-28 12:44:59,wahoo,Zwift - WTRL iTT Series  (A),Garmin Vector 3,Wahoo Kickr,367,370,-3
20304,90946,2020-03-29 07:19:59,wahoo,Zwift - Team Italy & Frenchy Fuzion Fondo (A),Garmin Vector 3,Wahoo Kickr,405,396,9
21962,90946,2020-04-02 19:10:01,wahoo,Zwift - Cervelo Jungle Rush Series Rd 2 - Cervelo Aspero (A),Garmin Vector 3,Wahoo Kickr,384,375,9
21963,90946,2020-04-04 09:05:03,wahoo,Zwift - 3R Sand & Sequioas Race - 2 Laps (A),Garmin Vector 3,Wahoo Kickr,392,388,4
23707,90946,2020-04-09 08:10:00,wahoo,Zwift - Cervelo Jungle Rush Series Rd 3 - Cervelo R5 (A),Garmin Vector 3,Wahoo Kickr,401,395,6
23709,90946,2020-04-11 08:30:00,wahoo,Zwift - DBR Sufferday League (A),Garmin Vector 3,Wahoo Kickr,397,396,1
24886,90946,2020-04-15 11:30:00,wahoo,Zwift - Trofeo Bologna Race (A),Garmin Vector 3,Wahoo Kickr,428,427,1
25155,90946,2020-04-16 10:10:00,wahoo,Zwift - Cervelo Jungle Rush Series Rd 4 - Battle of the Bikes (A),Garmin Vector 3,Wahoo Kickr,404,406,-2
25809,90946,2020-04-18 08:14:58,wahoo,Zwift - EVR Asia Weekend (A),Garmin Vector 3,Wahoo Kickr,387,386,1
27045,90946,2020-04-21 08:29:59,wahoo,Zwift - Richmond Challenge Race // Zwift Classic (A),Garmin Vector 3,Wahoo Kickr,369,376,-7
27847,90946,2020-04-25 08:05:00,wahoo,Zwift - 3R Crit City - Downtown Dolphin - 16laps (A),Garmin Vector 3,Wahoo Kickr,378,385,-7
28756,90946,2020-04-28 09:19:59,wahoo,Zwift - The After Party Race (A),Garmin Vector 3,Wahoo Kickr,400,406,-6
29014,90946,2020-04-29 09:45:00,wahoo,Zwift - USA Cycling Race League by Indoor Specialist  (A),Garmin Vector 3,Wahoo Kickr,393,394,-1
30427,90946,2020-05-02 07:59:59,wahoo,Zwift - e-liga FINALE - eCycling Austria (C),Garmin Vector 3,Wahoo Kickr,388,378,10
31546,90946,2020-05-05 09:20:02,wahoo,Zwift - The After Party Race (A),Garmin Vector 3,Wahoo Kickr,375,386,-11
32470,90946,2020-05-07 17:17:30,wahoo,Zwift - WTRL Team Time Trial (C),Garmin Vector 3,Wahoo Kickr,376,368,8
34242,90946,2020-05-13 09:45:01,wahoo,Zwift - USA Cycling Race League by Indoor Specialist (A),Garmin Vector 3,Wahoo Kickr,399,405,-6
34795,90946,2020-05-14 17:19:00,wahoo,Zwift - WTRL Team Time Trial Premier League (C),Garmin Vector 3,Wahoo Kickr,380,396,-16
36019,90946,2020-05-19 09:04:59,wahoo,Zwift - 3R & Wahoo Ride Real Race Series - Round 2 of 7 (A),Garmin Vector 3,Wahoo Kickr,392,389,3
36793,90946,2020-05-21 17:14:00,wahoo,Zwift - WTRL Team Time Trial (C),Garmin Vector 3,Wahoo Kickr,380,393,-13
37051,90946,2020-05-23 09:00:00,wahoo,Zwift - EUROSPORT Polska ,Garmin Vector 3,Wahoo Kickr,379,370,9
38327,90946,2020-05-28 17:19:02,wahoo,Zwift - WTRL Team Time Trial Premier League (C),Garmin Vector 3,Wahoo Kickr,387,392,-5
38664,90946,2020-05-30 09:00:00,wahoo,Zwift - Cycling Ireland Zwift League Rd 10 (A),Garmin Vector 3,Wahoo Kickr,406,415,-9
39622,90946,2020-06-04 17:17:00,wahoo,Zwift - Espresso,Garmin Vector 3,Wahoo Kickr,371,380,-9
40998,90946,2020-06-11 10:35:00,wahoo,Zwift - Japan ZWIFT Hill Climb Race (A),Garmin Vector 3,Wahoo Kickr,407,408,-1
42664,90946,2020-06-19 23:30:01,wahoo,Zwift - VIRTUAL JOE MARTIN STAGE RACE ITT,Garmin Vector 3,Wahoo Kickr,411,411,0
42906,90946,2020-06-20 16:02:02,wahoo,Zwift - VIRTUAL JOE MARTIN STAGE RACE,Garmin Vector 3,Wahoo Kickr,397,398,-1
42999,90946,2020-06-21 16:00:00,wahoo,Zwift - VIRTUAL JOE MARTIN STAGE RACE (A),Garmin Vector 3,Wahoo Kickr,394,405,-11
43582,90946,2020-06-25 18:06:01,wahoo,Zwift - Espresso,Garmin Vector 3,Wahoo Kickr,369,380,-11
44580,90946,2020-07-02 18:06:01,wahoo,Zwift - Espresso,Garmin Vector 3,Wahoo Kickr,376,375,1
45662,90946,2020-07-09 18:06:59,wahoo,Zwift - Espresso,Garmin Vector 3,Wahoo Kickr,386,385,1
46636,90946,2020-07-16 17:18:00,wahoo,Zwift - Espresso,Garmin Vector 3,Wahoo Kickr,370,390,-20
52190,90946,2020-08-27 17:23:01,wahoo,Zwift - Espresso,Garmin Vector 3,Wahoo Kickr,386,386,0
53245,90946,2020-09-03 17:21:58,wahoo,Zwift - Espresso,Garmin Vector 3,Wahoo Kickr,370,373,-3
54450,90946,2020-09-10 17:20:58,wahoo,Zwift - Espresso,Garmin Vector 3,Wahoo Kickr,402,390,12
55101,90946,2020-09-14 18:00:01,wahoo,Zwift - Invitational League // Qualifying Race #1,Garmin Vector 3,Wahoo Kickr,401,413,-12
56447,90946,2020-09-20 13:00:00,wahoo,Zwift - Invitational League // Qualifying Race #3 (Men) (A),Garmin Vector 3,Wahoo Kickr,382,389,-7
58858,90946,2020-10-01 17:28:01,wahoo,Zwift - Espresso,Garmin Vector 3,Wahoo Kickr,364,357,7
60039,90946,2020-10-07 09:44:58,wahoo,Zwift - USA Cycling Race League by Indoor Specialist (A),Favero Assioma,Wahoo Kickr,390,384,6
61266,90946,2020-10-11 07:30:00,wahoo,Zwift - Flanders Endurance Series (E),Favero Assioma,Wahoo Kickr,353,362,-9
61559,90946,2020-10-13 17:15:00,wahoo,Zwift - Zwift Racing League | WTRL,Favero Assioma,Wahoo Kickr,373,385,-12
62273,90946,2020-10-15 17:10:57,wahoo,Zwift - Espresso,Favero Assioma,Wahoo Kickr,359,367,-8
64216,90946,2020-10-22 17:21:57,wahoo,Zwift - Espresso,Favero Assioma,Wahoo Kickr,376,383,-7
66259,90946,2020-10-29 18:22:55,wahoo,Zwift - WTRL Team Time Trial Platinum League (C),Favero Assioma,Wahoo Kickr,346,366,-20
68148,90946,2020-11-03 18:28:58,wahoo,Zwift - Zwift Racing League | WTRL - Men&#039;s EMEA E1 DIVISION 1 (A),Favero Assioma,Wahoo Kickr,381,394,-13
68321,90946,2020-11-05 18:54:00,wahoo,Zwift - Espresso,Favero Assioma,Wahoo Kickr,363,383,-20
70098,90946,2020-11-10 18:15:01,wahoo,Zwift - Zwift Racing League | WTRL - EMEA E1 (MEN) -  Division 1 (A),Favero Assioma,Wahoo Kickr,416,428,-12
70873,90946,2020-11-12 18:53:59,wahoo,Zwift - Espresso,Favero Assioma,Wahoo Kickr,365,383,-18
71275,90946,2020-11-14 09:05:03,wahoo,Zwift - e-liga | eCycling league Austria Race 1 (A),Favero Assioma,Wahoo Kickr,397,409,-12
71580,90946,2020-11-15 10:05:04,wahoo,Zwift - Open: 2020 El Giro de Rigo - Official Route,Favero Assioma,Wahoo Kickr,371,377,-6
71921,90946,2020-11-16 11:42:19,wahoo,Zwift - France,Favero Assioma,Wahoo Kickr,256,259,-3
72280,90946,2020-11-17 18:23:02,wahoo,Zwift - Zwift Racing League | WTRL - Men&#039;s EMEA E1 DIVISION 1 (A),Favero Assioma,Wahoo Kickr,373,377,-4
73220,90946,2020-11-19 18:56:03,wahoo,Zwift - Espresso,Favero Assioma,Wahoo Kickr,380,374,6
74471,90946,2020-11-23 08:30:10,wahoo,Zwift - Flanders Endurance Series (E),Favero Assioma,Wahoo Kickr,393,392,1
76114,90946,2020-11-26 17:48:09,wahoo,WTRL NOPINZ WORLD TTT CHAMPIONSHIPS - Zone 3 (C),Favero Assioma,Wahoo Kickr,386,389,-3
76789,90946,2020-11-28 09:05:11,wahoo,Zwift - e-liga | eCycling league Austria Race 2 (A),Favero Assioma,Wahoo Kickr,380,383,-3
78443,90946,2020-12-02 10:45:12,wahoo,Zwift - USA Cycling Race League by Indoor Specialist (A),Favero Assioma,Wahoo Kickr,387,397,-10
79141,90946,2020-12-03 18:48:11,wahoo,Zwift - Espresso,Favero Assioma,Wahoo Kickr,373,376,-3
81682,90946,2020-12-09 10:45:13,wahoo,Zwift - USA Cycling Race League by Indoor Specialist (A),Favero Assioma,Wahoo Kickr,390,387,3
81685,90946,2020-12-10 18:51:10,wahoo,Zwift - Espresso,Favero Assioma,Wahoo Kickr,369,370,-1
82941,90946,2020-12-13 14:15:16,wahoo,Zwift - KISS 100 Race Series - Americas (A),Favero Assioma,Wahoo Kickr,412,406,6
83645,90946,2020-12-15 18:22:26,wahoo,Zwift - Zwift Racing League | WTRL - Men&#039;s EMEA E1 DIVISION 1 (A),Favero Assioma,Wahoo Kickr,371,377,-6
84414,90946,2020-12-17 18:16:56,wahoo,Zwift - WTRL Team Time Trial Platinum League (C),Favero Assioma,Wahoo Kickr,363,369,-6
85019,90946,2020-12-19 09:05:00,wahoo,Zwift - e-liga | eCycling league Austria Race 3 (A),Favero Assioma,Wahoo Kickr,376,377,-1
87933,90946,2020-12-27 14:15:11,wahoo,Zwift - KISS 100 Race Series - Americas (A),Favero Assioma,Wahoo Kickr,396,397,-1
92137,90946,2021-01-06 10:45:10,wahoo,Zwift - The Morning Grind by STPC (A),Favero Assioma,Wahoo Kickr,436,434,2
92909,90946,2021-01-07 18:18:08,wahoo,Zwift - Vienna,Favero Assioma,Wahoo Kickr,390,394,-4
95644,90946,2021-01-12 18:14:57,wahoo,Zwift - Zwift Racing League | WTRL - Men&#039;s/Mixed EMEA E1 DIVISION 1 (A),Favero Assioma,Wahoo Kickr,401,386,15
97010,90946,2021-01-14 18:14:54,wahoo,Zwift - Vienna,Favero Assioma,Wahoo Kickr,387,386,1
97855,90946,2021-01-16 09:04:58,wahoo,Zwift - e-liga | eCycling league Austria Race 4 (A),Favero Assioma,Wahoo Kickr,417,425,-8
99792,90946,2021-01-19 18:19:57,wahoo,Zwift - Zwift Racing League | WTRL - Men&#039;s/Mixed EMEA E1 DIVISION 1 (A),Favero Assioma,Wahoo Kickr,384,383,1
101067,90946,2021-01-21 18:22:57,wahoo,Zwift - Vienna,Favero Assioma,Wahoo Kickr,384,376,8
101703,90946,2021-01-23 09:05:01,wahoo,Zwift - e-liga | eCycling league Austria Race 5 (A),Favero Assioma,Wahoo Kickr,398,395,3
103468,90946,2021-01-26 18:15:03,wahoo,Zwift - Zwift Racing League | WTRL - Men&#039;s/Mixed EMEA E1 DIVISION 1 (A),Favero Assioma,Wahoo Kickr,400,389,11
107475,90946,2021-02-02 18:15:06,wahoo,Zwift - Zwift Racing League | WTRL - Men&#039;s/Mixed EMEA E1 DIVISION 1 (A),Favero Assioma,Wahoo Kickr,396,392,4
109734,90946,2021-02-06 09:04:59,wahoo,Zwift - e-liga | eCycling league Austria Race 6 (A),Favero Assioma,Wahoo Kickr,374,381,-7
112086,90946,2021-02-09 18:20:01,wahoo,Zwift - Zwift Racing League | WTRL - Men&#039;s/Mixed EMEA E1 DIVISION 1 (A),Favero Assioma,Wahoo Kickr,400,401,-1
113091,90946,2021-02-11 18:22:02,wahoo,Zwift - Vienna,Favero Assioma,Wahoo Kickr,381,378,3
113985,90946,2021-02-13 09:30:05,wahoo,Zwift - DBR SufferDay League III (A),Favero Assioma,Wahoo Kickr,390,387,3
115958,90946,2021-02-16 18:15:07,wahoo,Zwift - Zwift Racing League | WTRL - Men&#039;s/Mixed EMEA E1 DIVISION 1 (A),Favero Assioma,Wahoo Kickr,416,426,-10
117371,90946,2021-02-18 18:22:03,wahoo,Zwift - Vienna,Favero Assioma,Wahoo Kickr,372,385,-13
118154,90946,2021-02-20 09:05:06,wahoo,Zwift - e-liga | eCycling league Austria Race 7 (A),Favero Assioma,Wahoo Kickr,377,378,-1
119693,90946,2021-02-23 18:15:02,wahoo,Zwift - Zwift Racing League | WTRL - Men&#039;s/Mixed EMEA E1 DIVISION 1 (A),Favero Assioma,Wahoo Kickr,412,413,-1
123006,90946,2021-03-02 18:21:01,wahoo,Zwift - Zwift Racing League | WTRL - Men&#039;s/Mixed EMEA E1 DIVISION 1 (A),Favero Assioma,Wahoo Kickr,378,381,-3
124080,90946,2021-03-04 18:16:17,wahoo,Zwift - Vienna,Favero Assioma,Wahoo Kickr,385,390,-5
124817,90946,2021-03-06 09:05:03,wahoo,Zwift - e-liga | eCycling league Austria Race 8 (A),Favero Assioma,Wahoo Kickr,412,416,-4
126089,90946,2021-03-09 14:04:01,wahoo,Zwift - Zwift Time Trial Tuesday: Tempus Fugit (E),Favero Assioma,Wahoo Kickr,356,368,-12
127783,90946,2021-03-13 09:05:01,wahoo,Zwift - e-liga | eCycling league Austria Race 9 (A),Favero Assioma,Wahoo Kickr,380,385,-5
128528,90946,2021-03-14 09:15:01,wahoo,Zwift - Spanish Sunday Rice by PETA-Z (A),Favero Assioma,Wahoo Kickr,393,375,18
129254,90946,2021-03-16 18:30:02,wahoo,Zwift - CeramicSpeed Race Series: Open Race (A),Favero Assioma,Wahoo Kickr,416,418,-2
3445,91105,2019-10-29 19:10:00,wahoo,Zwift - WORLDOFFUSION Racing League (A),Shimano dura ace power meter,Wahoo kicker 2018,458,452,6
8382,91105,2020-01-07 18:57:10,wahoo,Zwift - 3R Ultimate Racing League - Round 1 (A) Dobbel KALAS,Shimano dura ace power meter,Wahoo kicker 2018,395,392,3
8529,91105,2020-01-08 17:30:00,wahoo,Zwift - FIETS Magazine Race Series (A),Shimano dura ace power meter,Wahoo kicker 2018,440,429,11
12776,91105,2020-02-06 19:00:00,wahoo,Zwift - KALAS Cup - Round 2 (A) #hammeren,Shimano dura ace power meter,Wahoo kicker 2018,451,446,5
13839,91105,2020-02-13 19:00:03,wahoo,Zwift - KALAS Cup - Round 3 (A),Shimano dura ace power meter,Wahoo kicker 2018 to Wahoo Bolt,415,403,12
19511,91105,2020-03-24 18:07:37,wahoo,Zwift - Tour of Watopia Pro-Am Men&#039;s Race #3 (A),Shimano dura ace power meter,Wahoo kicker 2018,399,391,8
58980,91105,2020-10-01 16:56:06,wahoo,Zwift - Espresso,Assioma duo to Wahoo roam,Wahoo kicker 2018,384,385,-1
1875,91920,2019-08-27 18:29:56,neo,Zwift - ZHR Masters (C),Favero Assioma Duo,NEO 1,309,305,4
1992,91920,2019-09-17 18:11:00,neo,FUSION ECT Racing League,Favero Assioma Duo,NEO 1,294,293,1
2556,91920,2019-09-25 17:09:50,neo,Zwift - Yorkshire World Championships Week - ITT #3 (C),Zwift - Favero Assioma Duo,Garmin - NEO 1,287,298,-11
2985,91920,2019-10-01 18:29:17,neo,ZHR Masters,Zwift - Favero Assioma Duo,Garmin - NEO 1,293,292,1
3440,91920,2019-10-29 19:10:47,neo,Zwift - WORLDOFFUSION Racing League (B),Zwift - Favero Assioma Duo,Garmin - NEO 1,302,298,4
3808,91920,2019-11-05 19:10:19,neo,Zwift - WORLDOFFUSION Racing League (B),Zwift - Favero Assioma Duo,Garmin - NEO 1,337,330,7
4150,91920,2019-11-12 19:10:43,neo,Zwift - WORLDOFFUSION Racing League (B),Zwift - Favero Assioma Duo,Garmin - NEO 1,297,295,2
4237,91920,2019-11-14 18:59:43,neo,Zwift - ZA Tri 2020 TT Race - Open B,Zwift - Favero Assioma Duo,Garmin - NEO 1,298,293,5
4356,91920,2019-11-17 08:34:59,neo,Zwift - ZHR Masters Weekender (C),Zwift - Favero Assioma Duo,Garmin-TacxNeo,321,321,0
4921,91920,2019-11-26 18:44:32,neo,Zwift - II ZESP League Stage 2 - Mina Terra Galega,Zwift - Favero Assioma Duo,Edge 520 - Neo 1,313,307,6
5388,91920,2019-12-03 18:44:04,neo,"II ZESP League Stage 3 - Die, Die My Darling",Zwift - Favero Assioma Duo,Edge 520 - Neo 1,310,311,-1
6007,91920,2019-12-10 18:44:32,neo,II ZESP League Stage 4,Zwift - Favero Assioma Duo,Edge 520 - Neo 1,329,324,5
6532,91920,2019-12-17 18:42:59,neo,Zwift - II ZESP League Stage 5 (B),Zwift - Favero Assioma Duo,Garmin - NEO 1,314,317,-3
6533,91920,2019-12-17 18:42:59,neo,II ZESP League Stage 5,Zwift - Favero Assioma Duo,Garmin - NEO 1,314,317,-3
7310,91920,2019-12-26 11:00:03,neo,Zwift - KISS at Race - Americas AM (B),Zwift - Favero Assioma Duo,Edge 520 - Neo 1,311,314,-3
7543,91920,2019-12-29 08:34:02,neo,Zwift - ZHR Masters Weekender (C),Zwift - Favero Assioma Duo,Garmin - NEO 1,317,316,1
8333,91920,2020-01-07 18:44:02,neo,Zwift - II ZESP League Stage 6 (B),Zwift - Favero Assioma Duo,Garmin - NEO 1,324,320,4
9501,91920,2020-01-14 18:44:26,neo,Zwift - II ZESP League Stage 7 (B),Zwift - Favero Assioma Duo,Edge 520 - Neo 1,326,328,-2
10601,91920,2020-01-21 18:44:27,neo,Zwift - II ZESP League Stage 8 (A),Zwift - Favero Assioma Duo,Edge 520 - Neo 1,318,321,-3
12157,91920,2020-02-02 08:34:05,neo,Zwift - ZHR Masters Weekender (C),Zwift - Favero Assioma Duo,Garmin - NEO 1,331,335,-4
12804,91920,2020-02-04 18:46:53,neo,Zwift - II ZESP League Stage 10 (A),Zwift - Favero Assioma Duo,Edge 520 - Neo 1,315,316,-1
13584,91920,2020-02-11 19:29:34,neo,Zwift - ZHR Masters (C),Garmin - Assioma Favero Duo,Zwift- Neo 1,317,316,1
17714,91920,2020-03-10 19:29:19,neo,Zwift - ZHR Masters (C),Zwift - Favero Assioma Duo,Garmin - NEO 1,318,317,1
21441,91920,2020-03-31 18:29:14,neo,Zwift - ZHR Masters (C),Zwift - Favero Assioma Duo,Garmin - NEO 1,310,306,4
21998,91920,2020-04-04 07:59:45,neo,Zwift - Matando O Corpo ZESP (A),Zwift - Favero Assioma Duo,Garmin - NEO 1,304,307,-3
22563,91920,2020-04-05 09:05:06,neo,Zwift -  Haute Route Watopia Stage 3,Zwift - Favero Assioma Duo,Garmin - NEO 1,301,296,5
22824,91920,2020-04-07 18:29:29,neo,Zwift - ZHR Masters (C),Zwift - Favero Assioma Duo,Garmin - NEO 1,320,320,0
23804,91920,2020-04-11 07:59:06,neo,Zwift - Matando O Corpo ZESP (A),Zwift - Favero Assioma Duo,Garmin - NEO 1,336,333,3
26077,91920,2020-04-18 17:26:24,neo,Zwift - Campeonato INTERCLUBES por equipos (A),Zwift - Favero Assioma Duo,Edge 520 - Neo 1,331,333,-2
27973,91920,2020-04-25 07:59:16,neo,Zwift - Matando O Corpo ZESP by SARIS (A),Zwift - Favero Assioma Duo,Garmin - NEO 1,340,340,0
28789,91920,2020-04-28 17:14:19,neo,Zwift - ZESP Hamsters by GOBIK (A),Zwift - Favero Assioma Duo,Edge 520 - Neo 1,330,333,-3
30368,91920,2020-05-01 16:59:05,neo,Zwift - Spring Tour by Tri Infinity Mostoles & ADZ,Zwift - Favero Assioma Duo,Edge 520 - Neo 1,324,325,-1
32046,91920,2020-05-05 18:29:02,neo,Zwift - ZHR Masters Britain (C),Zwift - Favero Assioma Duo,Edge 520 - Neo 1,326,321,5
32047,91920,2020-05-03 08:26:37,neo,Zwift - Spring Tour by Tri Infinity Mostoles & ADZ (A),Zwift - Favero Assioma Duo,Edge 520 - Neo 1,312,314,-2
32479,91920,2020-05-07 17:27:27,neo,Zwift - FUSION ECT BEUNSTOPPABLE Racing Series (A),Zwift - Favero Assioma Duo,Edge 520 - Neo 1,325,324,1
35255,91920,2020-05-16 08:24:33,neo,Zwift - Infinitri Sports Olympic Race (A),Favero Assioma Duo,Tacx NEO 1,309,303,6
36083,91920,2020-05-19 17:11:35,neo,Zwift - ZESP Hamsters by GOBIK (A),Favero Assioma Duo,Tacx NEO 1,335,333,2
37349,91920,2020-05-24 08:40:14,neo,Zwift - Ganas de Mussara (ciclismo sin condiciones) Powered by ADZteam.eu (A),Favero Assioma Duo,Tacx NEO 1,308,307,1
39115,91920,2020-06-02 17:26:40,neo,Zwift - Flanders Ronde Race (A),Favero Assioma Duo,Tacx NEO 1,324,325,-1
41988,91920,2020-06-16 17:28:41,neo,Zwift - Flanders Ronde Race (A),Favero Assioma Duo,Tacx NEO 1,314,318,-4
42451,91920,2020-06-18 17:25:36,neo,Zwift - FUSION ECT BEUNSTOPPABLE Racing Series (A),Favero Assioma Duo,Tacx NEO 1,299,298,1
44279,91920,2020-06-30 17:29:19,neo,Zwift - Flanders Ronde Race (A),Favero Assioma Duo,Tacx NEO 1,307,309,-2
44564,91920,2020-07-02 17:29:22,neo,Zwift - FUSION ECT BEUNSTOPPABLE Racing Series (A),Favero Assioma Duo,Tacx NEO 1,303,307,-4
52025,91920,2020-08-25 18:29:47,neo,Zwift - ZHR Masters Britain (C),Favero Assioma Duo,Tacx NEO 1,330,329,1
52910,91920,2020-09-01 17:13:51,neo,Zwift - ZESP Hamster (A),Favero Assioma Duo,Tacx NEO 1,331,336,-5
54839,91920,2020-09-13 09:04:52,neo,Zwift - Newbury Velo Road Race (A),Favero Assioma Duo,Tacx NEO 1,304,304,0
55578,91920,2020-09-16 17:45:11,neo,Zwift - 6Points Mallorca GGCC Race (A),Favero Assioma Duo,Tacx NEO 1,304,305,-1
55779,91920,2020-09-17 17:16:56,neo,ZESP TT,Favero Assioma Duo,Tacx NEO 1,296,297,-1
56358,91920,2020-09-20 07:45:22,neo,100km ZESP Fondo,Favero Assioma Duo,Tacx NEO 1,334,338,-4
56828,91920,2020-09-22 17:28:46,neo,Zwift - Flanders Ronde Race (A),Favero Assioma Duo,Tacx NEO 1,313,319,-6
57271,91920,2020-09-24 17:29:26,neo,Zwift - FUSION ECT BEUNSTOPPABLE Racing Series (A),Favero Assioma Duo,Tacx NEO 1,324,322,2
59171,91920,2020-10-03 07:13:06,neo,Zwift - Matando o Corpo PETA-Z (A),Favero Assioma Duo,Tacx NEO 1,330,325,5
59388,91920,2020-10-04 09:04:13,neo,Zwift - Newbury Velo Road Race (A),Favero Assioma Duo,Tacx NEO 1,324,318,6
59842,91920,2020-10-06 17:13:04,neo,Zwift - ZESP Hamster (A),Favero Assioma Duo,Tacx NEO 1,333,330,3
60338,91920,2020-10-08 17:15:52,neo,Zwift - ZESP TT (A),Favero Assioma Duo,Tacx NEO 1,293,292,1
60735,91920,2020-10-10 07:14:08,neo,Zwift - Matando o Corpo® PETA-Z (A),Favero Assioma Duo,Tacx NEO 1,344,344,0
64753,91920,2020-10-20 17:27:27,neo,Zwift - Zwift Racing League | WTRL - EMEA E (MEN) - TTT Grp 1,Favero Assioma Duo,Tacx NEO 1,314,317,-3
64754,91920,2020-10-24 07:14:07,neo,Zwift - Matando o Corpo® PETA-Z (A),Favero Assioma Duo,Tacx NEO 1,303,307,-4
64815,91920,2020-10-25 08:44:30,neo,100km ZESP Fondo,Favero Assioma Duo,Tacx NEO 1,350,345,5
65464,91920,2020-10-27 18:18:10,neo,Zwift - Zwift Racing League | WTRL - EMEA E (MEN) -  Division 7 (A),Favero Assioma Duo,Tacx NEO 1,314,315,-1
66685,91920,2020-10-31 08:13:58,neo,Zwift - Matando o Corpo® PETA-Z (A),Favero Assioma Duo,Tacx NEO 1,321,321,0
68526,91920,2020-11-03 18:23:27,neo,Zwift - Zwift Racing League | WTRL - Men&#039;s EMEA E2 DIVISION 3 (A),Favero Assioma Duo,Tacx NEO 1,304,304,0
68803,91920,2020-11-07 08:14:12,neo,Zwift - Matando o Corpo® PETA-Z (A),Favero Assioma Duo,Tacx NEO 1,316,315,1
73776,91920,2020-11-21 08:14:57,neo,Zwift - Matando o Corpo® PETA-Z (A),Favero Assioma Duo,Tacx NEO 1,324,318,6
79889,91920,2020-12-05 08:12:39,neo,Zwift - Matando o Corpo® by PETA-Z (A),Favero Assioma Duo,Tacx NEO 1,306,306,0
80686,91920,2020-12-08 08:44:05,neo,Zwift - WTRL Racing (A),Favero Assioma Duo,Tacx NEO 1,291,291,0
84067,91920,2020-12-16 18:59:03,neo,Zwift - MUSSARA RACE DAY (A),Favero Assioma Duo,Tacx NEO 1,298,305,-7
85170,91920,2020-12-19 08:14:44,neo,Zwift - Matando o Corpo® by PETA-Z (A),Favero Assioma Duo,Tacx NEO 1,350,343,7
87919,91920,2020-12-20 08:28:15,neo,Zwift - Flanders Endurance Series (E),Favero Assioma Duo,Tacx NEO 1,301,302,-1
90577,91920,2021-01-03 08:43:56,neo,Zwift - Ratones o Leones,Favero Assioma Duo,Tacx NEO 1,312,305,7
91703,91920,2021-01-04 18:59:14,neo,Zwift - TDZ Stage 1: Longer Ride,Favero Assioma Duo,Tacx NEO 1,301,298,3
92371,91920,2021-01-06 08:29:32,neo,Zwift - Flanders Endurance Series (E),Favero Assioma Duo,Tacx NEO 1,314,306,8
93932,91920,2021-01-09 08:13:05,neo,Zwift - Matando o Corpo® by PETA-Z (A),Favero Assioma Duo,Tacx NEO 1,331,329,2
95735,91920,2021-01-12 18:24:25,neo,Zwift - Zwift Racing League | WTRL - Men&#039;s/Mixed EMEA E2 DIVISION 2 (A),Favero Assioma Duo,Tacx NEO 1,320,320,0
97901,91920,2021-01-16 08:13:09,neo,Zwift - Matando o Corpo® by PETA-Z (A),Favero Assioma Duo,Tacx NEO 1,338,328,10
98434,91920,2021-01-17 08:29:49,neo,Zwift - Flanders Endurance Race League,Favero Assioma Duo,Tacx NEO 1,352,346,6
101695,91920,2021-01-23 08:12:54,neo,Zwift - Matando o Corpo® by PETA-Z (A),Favero Assioma Duo,Tacx NEO 1,312,309,3
117786,91920,2021-02-18 18:11:35,neo,Zwift - MUSSARA RACE DAY (A),Favero Assioma Duo,Tacx NEO 1,345,337,8
118643,91920,2021-02-21 08:30:24,neo,Zwift - Flanders Endurance Race League (A),Favero Assioma Duo,Tacx NEO 1,295,300,-5
120256,91920,2021-02-23 18:24:26,neo,Zwift - Zwift Racing League | WTRL - Men&#039;s/Mixed EMEA E2 DIVISION 2 (A),Favero Assioma Duo,Tacx NEO 1,313,309,4
121229,91920,2021-02-25 18:13:03,neo,Zwift - MUSSARA RACE DAY (A),Favero Assioma Duo,Tacx NEO 1,329,324,5
124120,91920,2021-03-04 18:12:24,neo,Zwift - MUSSARA RACE DAY (A),Favero Assioma Duo,Tacx NEO 1,324,326,-2
126245,91920,2021-03-09 19:06:40,neo,Zwift - Pacman TT by PETA-Z (A),Favero Assioma Duo,Tacx NEO 1,294,291,3
126656,91920,2021-03-10 18:04:26,neo,Zwift - Guayaba Race by PETA-Z (A),Favero Assioma Duo,Tacx NEO 1,329,322,7
129626,91920,2021-03-16 19:07:50,neo,Zwift - Pacman TT by PETA-Z (A),Favero Assioma Duo,Tacx NEO 1,329,330,-1
129747,91920,2021-03-17 18:03:10,neo,Zwift - Guayaba Race by PETA-Z (A),Favero Assioma Duo,Tacx NEO 1,327,320,7
9655,92891,2020-01-16 00:39:59,neo,Zwift - 3R Volcano Circuit Flat Race - 4 Laps (18.9km/11.7mi 80m) (A),4iiii Precision,Tacs Neo,321,318,3
10709,92891,2020-01-24 01:00:01,neo,Zwift - Tour de Zwift: Stage 3 Group Ride - Long Distance,4iiii Precision,Tacs Neo,351,349,2
14234,92891,2020-02-16 15:29:59,neo,Zwift - Tour de Zwift: Stage 7 - Long Distance,4iiii Precision,Tacs Neo,342,340,2
73290,92891,2020-11-19 23:14:59,neo,Zwift - Koa Sports League Warrior Race (A),4iiii Precision,Tacs Neo,345,352,-7
76304,92891,2020-11-26 23:14:59,neo,Zwift - Koa Sports League Warrior Race (A),4iiii Precision,Tacs Neo,359,352,7
79183,92891,2020-12-03 23:14:58,neo,Zwift - Koa Sports League Warrior Race (A),4iiii Precision,Tacs Neo,335,338,-3
79816,92891,2020-12-05 15:15:01,neo,Zwift - OH MY CRIT - Saturday Smash Race (A),4iiii Precision,Tacs Neo,343,339,4
91463,92891,2021-01-04 22:59:58,neo,Zwift - TDZ Stage 1: Longer Ride,4iiii Precision,Tacs Neo,368,349,19
94906,92891,2021-01-11 16:59:58,neo,Zwift - 3R Queens Highway Race - 6 Laps (A),4iiii Precision,Tacs Neo,334,333,1
95991,92891,2021-01-13 00:46:00,neo,Zwift - Zwift Racing League | WTRL - Men&#039;s/Mixed AMERICAS E DIVISION 1 (A),4iiii Precision,Tacs Neo,365,365,0
108287,92891,2021-02-03 18:00:00,neo,Zwift - MIDWEEK Winter Series by SZR (A),4iiii Precision,Tacs Neo,360,352,8
43290,93680,2020-06-23 18:40:14,wahoo,3R & Wahoo Ride Real Race Series - Round 6 of 7,Quarq,kickr,413,400,13
44272,93680,2020-06-30 18:39:40,wahoo,3R & Wahoo Ride Real Race Series - Round 7 of 7,Quarq,kickr,389,419,-30
47159,93680,2020-07-21 15:01:03,wahoo,3R Turbocharged Team Race Series - Round 2,Quarq&gt;Zwift,kickr,350,359,-9
48772,93680,2020-08-04 15:03:33,wahoo,Zwift - 3R Turbocharged Team Race Series - Round 4 (A),Quarq&gt;Zwift,kickr,348,381,-33
52280,93680,2020-08-27 22:59:28,wahoo,Zwift - Crit City Race (A),Quarq to HeadUnit,kickr,333,342,-9
52281,93680,2020-08-27 22:59:28,wahoo,Zwift - Koa Sports League Warrior Race (A),Quarq to HeadUnit,kickr,350,361,-11
52397,93680,2020-08-28 20:59:56,wahoo,Zwift - Off The MAAP Stage 1 - Longer Ride,Quarq to HeadUnit,kickr,300,305,-5
52929,93680,2020-09-01 18:39:12,wahoo,Zwift - 3R Sundown Race Series - Round1 iTT,Quarq&gt;Zwift,kickr,361,348,13
55607,93680,2020-09-16 19:20:09,wahoo,Zwift - Watopia,STAGES TO STAGES,kickr,242,248,-6
56282,93680,2020-09-19 14:14:04,wahoo,Zwift - OH MY CRIT - Saturday Smash Race (A),SRM TO WAHOO,kickr,313,300,13
56964,93680,2020-09-23 09:43:45,wahoo,Zwift - USA Cycling Race League by Indoor Specialist (A),Quarq&gt;Zwift,kickr,377,361,16
57793,93680,2020-09-26 22:17:28,wahoo,Zwift - France,SAM Q,kickr,256,253,3
58255,93680,2020-09-29 15:03:19,wahoo,Zwift - 3R Sundown Race Series  (A),Quarq&gt;Zwift,kickr,326,328,-2
59834,93680,2020-10-06 17:46:48,wahoo,Zwift - Ramp Test,Quarq to HeadUnit,kickr,397,381,16
67764,93680,2020-11-04 02:11:40,wahoo,Zwift - Watopia,Quarq to HeadUnit,kickr,220,222,-2
67773,93680,2020-11-04 03:12:15,wahoo,Zwift - 11/03/2020,Quarq to HeadUnit,kickr,382,371,11
84881,93680,2020-12-18 22:59:26,wahoo,Zwift - 12/18/2020,Quarq to HeadUnit,kickr,350,341,9
87952,93680,2020-12-27 17:59:50,wahoo,Zwift - Alex TenElshof [Finesse]&#039;s Meetup - Three Sisters,Quarq to HeadUnit,kickr,346,343,3
96034,93680,2021-01-13 02:54:04,wahoo,Zwift - Zwift Racing League | WTRL - Men&#039;s/Mixed AMERICAS W DIVISION 1 (A),Quarq&gt;Zwift,kickr,368,370,-2
100563,93680,2021-01-21 01:02:53,wahoo,Zwift - Cycling Canada Wednesday Night Race Series (A),Stages To Garmin,kickr,341,344,-3
101133,93680,2021-01-21 21:59:08,wahoo,Zwift - TDZ Stage 4: Longer Ride,Stages D.A ,kickr,238,238,0
108257,93680,2021-02-03 18:57:16,wahoo,Movistar Team Challenge Community Qualifier Race #1,Quarq to HeadUnit,kickr v4,384,369,15
111676,93680,2021-02-09 18:58:48,wahoo,Zwift - TDZ Stage 8: Group Ride,Quarq DFour to HeadUnit,kickr v4,312,315,-3
123294,93680,2021-03-03 02:57:49,wahoo,Zwift - Zwift Racing League | WTRL - Men&#039;s/Mixed AMERICAS W DIVISION 1 (A),Stages To Garmin,kickr v4,344,340,4
65877,94244,2020-10-28 19:04:44,wahoo,Zwift - DBR HEINO CUP III (A),Garmin Vector 3,kickr wahoo,391,395,-4
66361,94244,2020-10-30 10:05:00,wahoo,Zwift - 3R Innsbruckring Flat Race - 4 Laps (35.2km/21.9mi 308m) (A),Mittagsradfahrt,kickr wahoo,419,430,-11
66590,94244,2020-10-31 09:30:00,wahoo,Zwift - DBR Saturday Race (A),Garmin Vector 3,kickr wahoo,411,420,-9
66990,94244,2020-11-01 13:45:01,wahoo,Zwift - La Bicicletta Toronto & Toronto Hustle Donut Race (A),Garmin Vector 3,kickr wahoo,444,469,-25
67513,94244,2020-11-03 11:00:06,wahoo,Zwift - KISS at Race - Americas AM (A),Garmin Vector 3,kickr wahoo,379,378,1
69384,94244,2020-11-09 19:20:01,wahoo,Zwift - TFC Mad Monday Autumn Series (A),Garmin Vector 3,kickr wahoo,375,385,-10
70271,94244,2020-11-11 19:05:01,wahoo,Zwift - DBR HEINO CUP III (A),Garmin Vector 3,kickr wahoo,344,368,-24
70637,94244,2020-11-12 16:15:18,wahoo,Zwift - OH MY CRIT! - The Double Race 1/2 (A),Garmin Vector 3,kickr wahoo,403,429,-26
71269,94244,2020-11-14 09:05:07,wahoo,Zwift - e-liga | eCycling league Austria Race 1 (A),Garmin Vector 3,kickr wahoo,418,417,1
71959,94244,2020-11-16 21:15:06,wahoo,Zwift - 3R Watopia Flat Route Race - 3 Laps (30.8km/19.1mi 162m) (A),Garmin Vector 3,kickr wahoo,380,403,-23
72247,94244,2020-11-17 18:25:30,wahoo,Zwift - Zwift Racing League | WTRL - Men&#039;s EMEA E1 DIVISION 1 (A),Garmin Vector 3,kickr wahoo,414,434,-20
72985,94244,2020-11-19 16:15:19,wahoo,Zwift - OH MY CRIT! - The Double Race 1/2 (A),Garmin Vector 3,kickr wahoo,384,405,-21
73021,94244,2020-11-19 17:05:16,wahoo,Zwift - OH MY CRIT! - The Double Race 2/2 (A),Garmin Vector 3,kickr wahoo,367,382,-15
75532,94244,2020-11-25 18:00:03,wahoo,Zwift - MIDWEEK Autumn Series by SZR (A),Garmin Vector 3,kickr wahoo,409,416,-7
76176,94244,2020-11-26 19:48:12,wahoo,Zwift - WTRL NOPINZ WORLD TTT CHAMPIONSHIPS - Zone 10 (C),Garmin Vector 3,kickr wahoo,421,424,-3
76731,94244,2020-11-28 09:05:20,wahoo,Zwift - e-liga | eCycling league Austria Race 2 (A),Garmin Vector 3,kickr wahoo,411,412,-1
77336,94244,2020-11-29 14:15:23,wahoo,Zwift - KISS 100 Race Series - Americas (A),Garmin Vector 3,kickr wahoo,353,357,-4
78031,94244,2020-12-01 18:25:31,wahoo,Zwift - Zwift Racing League | WTRL - Men&#039;s EMEA E1 DIVISION 1 (A),Garmin Vector 3,kickr wahoo,404,429,-25
78923,94244,2020-12-03 17:05:15,wahoo,Zwift - OH MY CRIT! - The Double Race 2/2 (A),Garmin Vector 3,kickr wahoo,389,407,-18
79793,94244,2020-12-05 15:15:15,wahoo,Zwift - OH MY CRIT - Saturday Smash Race (A),Garmin Vector 3,kickr wahoo,397,417,-20
80781,94244,2020-12-08 18:15:01,wahoo,Zwift - Zwift Racing League | WTRL - Men&#039;s EMEA E1 DIVISION 1 (A),Garmin Vector 3,kickr wahoo,446,449,-3
82895,94244,2020-12-13 14:00:00,wahoo,Zwift - Zwift Fondo Series 2020/21 (A),Garmin Vector 3,kickr wahoo,413,407,6
85781,94244,2020-12-21 17:30:06,wahoo,Zwift - ZHQ FutureWorks Circuit Race - Anti-sandbagging (A),Garmin Vector 3,kickr wahoo,375,384,-9
87241,94244,2020-12-25 18:30:11,wahoo,Zwift - KIRCHMAIR Race Series (A),Garmin Vector 3,kickr wahoo,344,342,2
87866,94244,2020-12-27 15:25:24,wahoo,Zwift - 3R Watopia 65km Race - 6 laps (40mi 324m) (A),Garmin Vector 3,kickr wahoo,417,412,5
90821,94244,2021-01-03 15:25:18,wahoo,Zwift - 3R Watopia 65km Race - 6 laps (40mi 324m) (A),Garmin Vector 3,kickr wahoo,391,408,-17
93923,94244,2021-01-09 15:15:11,wahoo,Zwift - OH MY CRIT - Saturday Smash Race (A),Garmin Vector 3,kickr wahoo,383,400,-17
94459,94244,2021-01-10 14:15:05,wahoo,Zwift - KISS 100 Race Series - Americas (A),Garmin Vector 3,kickr wahoo,434,427,7
94974,94244,2021-01-11 19:15:04,wahoo,Zwift - Premier Division // Zwift Racing League (men) (A),Garmin Vector 3,kickr wahoo,431,407,24
96354,94244,2021-01-13 18:00:08,wahoo,Zwift - MIDWEEK Winter Series by SZR (A),Garmin Vector 3,kickr wahoo,430,435,-5
97792,94244,2021-01-16 09:05:09,wahoo,Zwift - e-liga | eCycling league Austria Race 4 (A),Garmin Vector 3,kickr wahoo,457,477,-20
100313,94244,2021-01-20 18:45:01,wahoo,Zwift - Danmarks Cykle Union & Partners 2/6 (A),Garmin Vector 3,kickr wahoo,442,442,0
101667,94244,2021-01-23 09:05:04,wahoo,Zwift - e-liga | eCycling league Austria Race 5 (A),Garmin Vector 3,kickr wahoo,433,440,-7
102900,94244,2021-01-25 19:05:00,wahoo,Zwift - Premier Division // Zwift Racing League (men) (A),Garmin Vector 3,kickr wahoo,410,423,-13
104113,94244,2021-01-27 18:00:07,wahoo,Zwift - MIDWEEK Winter Series by SZR (A),Garmin Vector 3,kickr wahoo,370,382,-12
104576,94244,2021-01-28 16:15:11,wahoo,Zwift - OH MY CRIT!! - The Double Race 1/2 (A),Garmin Vector 3,kickr wahoo,382,398,-16
105736,94244,2021-01-30 17:00:03,wahoo,Zwift - GCA Liga 2021 #1,Garmin Vector 3,kickr wahoo,430,434,-4
108164,94244,2021-02-03 18:00:05,wahoo,Zwift - MIDWEEK Winter Series by SZR (A),Garmin Vector 3,kickr wahoo,360,373,-13
108778,94244,2021-02-04 17:05:02,wahoo,Zwift - OH MY CRIT!! - The Double Race 2/2 (A),Garmin Vector 3,kickr wahoo,403,425,-22
111013,94244,2021-02-08 19:21:27,wahoo,Zwift - Premier Division // Zwift Racing League (men) (A),Garmin Vector 3,kickr wahoo,416,444,-28
112854,94244,2021-02-11 17:05:03,wahoo,Zwift - OH MY CRIT!! - The Double Race 2/2 (A),Garmin Vector 3,kickr wahoo,386,407,-21
114665,94244,2021-02-14 13:05:01,wahoo,Zwift - 3R Watopia Flat Route Race - 4 Laps (40.5km/25.1mi 216m) (A),Garmin Vector 3,kickr wahoo,381,385,-4
115352,94244,2021-02-15 20:00:42,wahoo,Zwift - Premier Division // Zwift Racing League (men) (A),Garmin Vector 3,kickr wahoo,452,453,-1
116609,94244,2021-02-17 18:00:04,wahoo,Zwift - MIDWEEK Winter Series by SZR (A),Garmin Vector 3,kickr wahoo,384,385,-1
117166,94244,2021-02-18 16:14:43,wahoo,Zwift - OH MY CRIT!! - The Double Race 1/2 (A),Garmin Vector 3,kickr wahoo,389,412,-23
117191,94244,2021-02-18 17:04:52,wahoo,Zwift - OH MY CRIT!! - The Double Race 2/2 (A),Garmin Vector 3,kickr wahoo,398,420,-22
118070,94244,2021-02-20 09:04:40,wahoo,Zwift - e-liga | eCycling league Austria Race 7 (A),Garmin Vector 3,kickr wahoo,418,432,-14
119096,94244,2021-02-22 19:08:21,wahoo,Zwift - Premier Division // Zwift Racing League (men) (A),Garmin Vector 3,kickr wahoo,393,394,-1
122568,94244,2021-03-01 20:16:54,wahoo,Zwift - Premier Division // Zwift Racing League (men) (A),Garmin Vector 3,kickr wahoo,409,411,-2
124809,94244,2021-03-06 09:03:34,wahoo,Zwift - e-liga | eCycling league Austria Race 8 (A),Garmin Vector 3,kickr wahoo,425,427,-2
127733,94244,2021-03-13 09:04:18,wahoo,Zwift - e-liga | eCycling league Austria Race 9 (A),Garmin Vector 3,kickr wahoo,431,432,-1
129113,94244,2021-03-16 17:59:42,wahoo,Zwift - KIRCHMAIR Club Championship 2021 – Race #2 (A),Garmin Vector 3,kickr wahoo,383,407,-24
40652,94639,2020-06-09 18:39:34,wahoo,Zwift - 3R & Wahoo Ride Real Race Series - Round 4 of 7 (A),SRAM Red Quarq power meter,Wahoo Kickr Core,419,406,13
43108,94639,2020-06-20 14:16:56,wahoo,Zwift - OCA Indoor Race Series (EVR) (A),Garmin Vector2,Wahoo Kickr Core,431,433,-2
44065,94639,2020-06-27 14:14:56,wahoo,Zwift - OH MY CRIT!! - Saturday Smash Race (A),Garmin Vector2,Wahoo Kickr Core,375,379,-4
44246,94639,2020-06-30 15:29:49,wahoo,Zwift - TEAM VEGAN Tofu Tornado (A),Garmin Vector2,Wahoo Kickr Core,422,429,-7
46386,94639,2020-07-14 18:59:16,wahoo,Zwift - KISS at Race - EU PM (A),SRAM Red Quarq power meter,Wahoo Kickr Core,401,390,11
48078,94639,2020-07-29 00:08:37,wahoo,Zwift - Eldo Crit Series  (A),SRAM Red Quarq power meter,Wahoo Kickr Core,397,381,16
48386,94639,2020-07-31 01:07:35,wahoo,Zwift - WTRL Team Time Trial (C),SRAM Red Quarq power meter,Wahoo Kickr Core,404,389,15
48844,94639,2020-08-05 00:17:31,wahoo,Zwift - Eldo Crit Series  (A),Garmin Vector2,Wahoo Kickr Core,403,404,-1
49210,94639,2020-08-07 01:14:24,wahoo,Zwift - WTRL Team Time Trial (C),Garmin Vector2,Wahoo Kickr Core,412,412,0
49614,94639,2020-08-11 18:20:18,wahoo,Zwift - 3R Turbocharged Team Race Series - Round 5 (A),Garmin Vector2,Wahoo Kickr Core,438,435,3
49899,94639,2020-08-14 01:20:05,wahoo,Zwift - Espresso,Garmin Vector2,Wahoo Kickr Core,394,393,1
50171,94639,2020-08-15 17:13:22,wahoo,Zwift - EVR Summer Series (A),2020-08-15-10-13-22,Wahoo Kickr Core,407,399,8
50544,94639,2020-08-18 14:19:08,wahoo,Zwift - 3R Turbocharged Team Race Series - Round 6 (A),Garmin Vector2,Wahoo Kickr Core,405,389,16
50972,94639,2020-08-20 16:37:16,wahoo,Zwift - Espresso,Garmin Vector2,Wahoo Kickr Core,426,418,8
51029,94639,2020-08-21 01:15:53,wahoo,Espresso,Garmin Vector2,Wahoo Kickr Core,407,403,4
51928,94639,2020-08-26 00:17:51,wahoo,Zwift - Eldo Crit Series  (A),Garmin Vector2,Wahoo Kickr Core,395,389,6
52239,94639,2020-08-27 16:37:43,wahoo,Zwift - Espresso,Garmin Vector2,Wahoo Kickr Core,416,411,5
52305,94639,2020-08-28 01:07:45,wahoo,Zwift - Espresso,Garmin Vector2,Wahoo Kickr Core,397,389,8
52895,94639,2020-09-01 14:35:42,wahoo,Zwift - 3R Sundown Race Series - Round1 iTT,Garmin Vector2,Wahoo Kickr Core,416,407,9
52963,94639,2020-08-29 19:53:49,wahoo,Zwift - JETT Endurance Race(A) & Group Ride(B) 100km (A),Garmin Vector2,Wahoo Kickr Core,390,374,16
53253,94639,2020-09-03 17:05:47,wahoo,Zwift - Espresso,Garmin Vector2,Wahoo Kickr Core,409,399,10
54511,94639,2020-09-11 01:36:56,wahoo,Zwift - Espresso,Garmin Vector2,Wahoo Kickr Core,408,398,10
54784,94639,2020-09-12 19:14:46,wahoo,Zwift - Herd Summer Racing League Race 4 (A),Garmin Vector2,Wahoo Kickr Core,404,395,9
56049,94639,2020-09-18 01:30:15,wahoo,Zwift - WTRL Team Time Trial (C),Garmin Vector2,Wahoo Kickr Core,399,397,2
56732,94639,2020-09-16 14:59:46,wahoo,Zwift - Sydkysten / KST Race (A),Garmin Vector2,Wahoo Kickr Core,377,379,-2
57386,94639,2020-09-24 17:21:57,wahoo,Zwift - Espresso,Rotor 2inPower,Wahoo Kickr,409,399,10
58381,94639,2020-09-30 03:15:13,wahoo,Zwift - 3R Greater London 8 Hilly Race - 1 Lap (23.8km/14.8mi 238m) (A),Rotor 2inPower,Wahoo Kickr,420,454,-34
58862,94639,2020-10-01 16:53:20,wahoo,Zwift - Espresso,Rotor 2inPower,Wahoo Kickr,406,397,9
61684,94639,2020-10-13 23:10:05,wahoo,Zwift - Zwift Racing League | WTRL (A),Rotor 2inPower,Wahoo Kickr,445,446,-1
63974,94639,2020-10-21 19:14:54,wahoo,Zwift - 3R Tick Tock Flat Race - 2 Lap (36km/22.4mi 100m) (A),Rotor 2inPower,Wahoo Kickr,402,400,2
64470,94639,2020-10-22 23:42:54,wahoo,Zwift - Espresso,Rotor 2inPower,Wahoo Kickr,399,399,0
64731,94639,2020-10-25 00:00:02,wahoo,Zwift - ZHQ FutureWorks Crit City Race - Anti-sandbagging (A),Rotor 2inPower,Wahoo Kickr,404,405,-1
65614,94639,2020-10-27 23:45:00,wahoo,Zwift - Zwift Racing League | WTRL - AMERICAS E (MEN) -  Division 1 (A),Rotor 2inPower,Wahoo Kickr,455,452,3
68393,94639,2020-11-06 00:42:09,wahoo,Zwift - ZHR Hare & Hounds Race (A),Rotor 2inPower,Wahoo Kickr,405,399,6
68395,94639,2020-11-06 01:59:54,wahoo,Zwift - ZHQ FutureWorks Circuit Race - Anti-sandbagging (A),Rotor 2inPower,Wahoo Kickr,370,364,6
70014,94639,2020-11-11 00:45:12,wahoo,Zwift - Zwift Racing League | WTRL - AMERICAS E (MEN) -  Division 1 (A),Rotor 2inPower,Wahoo Kickr,478,478,0
70639,94639,2020-11-12 16:14:59,wahoo,Zwift - OH MY CRIT! - The Double Race 1/2 (A),Rotor 2inPower,Wahoo Kickr,440,437,3
73323,94639,2020-11-20 00:42:25,wahoo,Zwift - ZHR Hare & Hounds Race (A),Rotor 2inPower,Wahoo Kickr,411,417,-6
75274,94639,2020-11-25 00:45:20,wahoo,Zwift - Zwift Racing League | WTRL - Men&#039;s AMERICAS E DIVISION 1,Rotor 2inPower,Wahoo Kickr,453,455,-2
77137,94639,2020-11-28 20:05:19,wahoo,Zwift - 3R Flat Race (A),Rotor 2inPower,Wahoo Kickr,400,397,3
77453,94639,2020-11-29 18:39:55,wahoo,Zwift - XRS Races Crit (A),Rotor 2inPower,Wahoo Kickr,409,409,0
79190,94639,2020-12-03 23:42:15,wahoo,Zwift - ZHR Hare & Hounds Race (A),SRAM Red Quarq power meter,Wahoo Kickr,409,406,3
81977,94639,2020-12-09 00:44:54,wahoo,Zwift - Zwift Racing League | WTRL - Men&#039;s AMERICAS E DIVISION 1 (A),Rotor 2inPower,Wahoo Kickr,446,449,-3
81979,94639,2020-12-11 00:44:56,wahoo,Zwift - Crit City Race (A),Rotor 2inPower,Wahoo Kickr,422,421,1
81980,94639,2020-12-11 01:29:54,wahoo,Zwift - XRS - ZTR Thursday Night Race (A),Rotor 2inPower,Wahoo Kickr,432,426,6
82580,94639,2020-12-12 21:09:50,wahoo,Zwift - 3R Gotham Grind Flat Race - 3 Laps (27.8km/17.4mi 87m) (A),Rotor 2inPower,Wahoo Kickr,397,397,0
83970,94639,2020-12-16 00:52:45,wahoo,Zwift - Zwift Racing League | WTRL - Men&#039;s AMERICAS E DIVISION 1 (A),Rotor 2inPower,Wahoo Kickr,407,406,1
84579,94639,2020-12-18 00:59:49,wahoo,Zwift - KISS Race Series - Americas PM (A),Rotor 2inPower,Wahoo Kickr,454,457,-3
85641,94639,2020-12-20 19:00:13,wahoo,Zwift - Tour of New York Stage 3 - Open Longer,Rotor 2inPower,Wahoo Kickr,405,401,4
89888,94639,2020-12-31 20:00:21,wahoo,Zwift - KISS Race Series - EU PM (A),Rotor 2inPower,Wahoo Kickr,426,425,1
96035,94639,2021-01-13 00:47:17,wahoo,Zwift Racing League | WTRL - Mens/Mixed AMERICAS E DIVISION 2,Rotor 2inPower,Wahoo Kickr,440,425,15
104021,94639,2021-01-27 00:46:50,wahoo,Zwift - Zwift Racing League | WTRL - Men&#039;s/Mixed AMERICAS E DIVISION 2 (A),Rotor 2inPower,Wahoo Kickr,429,423,6
107728,94639,2021-02-03 00:45:17,wahoo,Zwift - Zwift Racing League | WTRL - Men&#039;s/Mixed AMERICAS E DIVISION 2 (A),Rotor 2inPower,Wahoo Kickr,445,447,-2
110738,94639,2021-02-05 00:28:40,wahoo,Zwift - WTRL Team Time Trial - Zone 10 (C),Rotor 2inPower,Wahoo Kickr,401,403,-2
111879,94639,2021-02-10 00:46:50,wahoo,Zwift - Zwift Racing League | WTRL - Men&#039;s/Mixed AMERICAS E DIVISION 2 (A),Rotor 2inPower,Wahoo Kickr,427,427,0
116277,94639,2021-02-17 00:47:23,wahoo,Zwift - Zwift Racing League | WTRL - Men&#039;s/Mixed AMERICAS E DIVISION 2 (A),Rotor 2inPower,Wahoo Kickr,449,449,0
123775,94639,2021-03-03 00:54:57,wahoo,Zwift - Zwift Racing League | WTRL - Men&#039;s/Mixed AMERICAS E DIVISION 2 (A),Rotor 2inPower,Wahoo Kickr,420,416,4
127306,94639,2021-03-12 00:51:28,wahoo,Zwift - KISS Race Series - Americas PM (A),Rotor 2inPower,Wahoo Kickr,386,397,-11
37672,94641,2020-05-15 16:00:29,neo,Zwift - Tour for All Invitational Race // Women (A),Garmin Vector3,Tacx Neo,219,218,1
37878,94641,2020-05-26 18:17:00,neo,Zwift - Tour for All Invitational Race // Women (A),Garmin Vector3,Tacx Neo,211,219,-8
55223,94641,2020-09-14 18:30:00,neo,Zwift - Invitational League // Qualifying Race #1 (Women),Garmin Vector3,Tacx Neo,206,211,-5
55919,94641,2020-09-17 18:00:00,neo,Zwift - Invitational League // Qualifying Race #2 (Women) (A),Garmin Vector3,Tacx Neo,217,218,-1
55921,95241,2020-09-17 18:30:13,neo,Zwift - Invitational League // Qualifying Race #2 (Men) ,Quarq D-Four,Tacx Neo,324,322,2
56777,95241,2020-09-22 09:09:21,neo,Zwift - 3R Sundown Race Series  (E),Quarq D-Four,Tacx Neo,309,301,8
61305,95241,2020-10-12 18:50:12,neo,Zwift - Premier Division // Zwift Racing League (men) ,Quarq D-Four,Tacx Neo,339,340,-1
65231,95241,2020-10-26 20:00:25,neo,Zwift - Premier Division // Zwift Racing League (men) (A),Quarq D-Four,Tacx Neo,299,298,1
69631,95241,2020-11-09 20:00:12,neo,Zwift - Premier Division // Zwift Racing League (men) (A),Quarq D-Four,Tacx Neo,342,341,1
106931,95241,2021-02-01 20:07:14,neo,Zwift - Premier Division // Zwift Racing League (men) (A),Quarq D-Four,Tacx Neo,318,311,7
39614,95589,2020-06-04 17:25:59,wahoo,Zwift - Espresso,V3s,Kickr,361,350,11
40599,95589,2020-06-09 18:40:01,wahoo,Zwift - 3R & Wahoo Ride Real Race Series - Round 4 of 7 (A),V3s,Kickr,366,360,6
41085,95589,2020-06-11 17:25:17,wahoo,Zwift - Espresso,V3s,Kickr,364,359,5
41698,95589,2020-06-13 07:35:02,wahoo,Zwift - INC Steady State - Group Training Ride 2.9 - 3.5w (B),V3 to zwift,Kickr,229,219,10
41699,95589,2020-06-12 09:59:14,wahoo,Zwift - KISS at Base Training Ride (B),V3 to zwift,Kickr,221,226,-5
43263,95589,2020-06-23 18:40:03,wahoo,Zwift - 3R & Wahoo Ride Real Race Series - Round 6 of 7 (A),V3 to zwift,Kickr (1st gen) to Garmin,404,383,21
43608,95589,2020-06-25 17:36:40,wahoo,Zwift - Espresso,V3 to zwift,Kickr (1st gen) to Garmin,354,343,11
44034,95589,2020-06-28 07:35:14,wahoo,Zwift - ZHR Masters Weekender (B),V3 to zwift,Kickr (1st gen) to Garmin,305,308,-3
44601,95589,2020-07-02 18:50:58,wahoo,Zwift - Espresso,V3 to zwift,Kickr (1st gen) to Garmin,348,344,4
50708,95589,2020-08-18 09:13:35,wahoo,"Zwift - SST (Long) - bailed 2/3 through, legs said no",dzero to garmin,Kickr (1st gen) to Garmin,318,317,1
54023,95589,2020-09-08 18:24:22,wahoo,Zwift - 3R Sundown Race Series  (E),Quarq to zwift,Kickr17,358,356,2
54167,95589,2020-09-09 12:06:08,wahoo,Zwift - TT Tune-Up - Neuromuscular + AC #2,Quarq to zwift,Kickr 17,320,301,19
54771,95589,2020-09-11 09:56:02,wahoo,Zwift - KISS at Base Training Ride (B),Quarq to zwift,Kickr 17,304,297,7
55039,95589,2020-09-14 17:23:32,wahoo,Zwift - Invitational League // Qualifying Race #1,Quarq to 830,Kickr 17,365,360,5
55623,95589,2020-09-16 16:49:51,wahoo,Zwift - MIDWEEK Autumn Series by SZR (A),Quarq to zwift,Kickr 17,348,347,1
56494,95589,2020-09-20 12:42:34,wahoo,Zwift - Invitational League // Qualifying Race #3 (Men) (A),Quarq to 830,Kickr 17,378,372,6
56893,95589,2020-09-17 15:00:19,wahoo,Zwift - OH MY CRIT! - The Double Race 1/2 (A),Quarq to 830,Kickr 17,365,352,13
56894,95589,2020-09-17 16:04:54,wahoo,Zwift - OH MY CRIT! - The Double Race 2/2 (A),Quarq to 830,Kickr 17,363,362,1
57332,95589,2020-09-24 18:15:44,wahoo,Zwift - Espresso,Quarq to zwift,Kickr 17,345,343,2
59460,95589,2020-10-02 16:19:37,wahoo,Zwift - EVO CC Sprint Race Series  (A),Quarq to zwift,Kickr to 830,372,359,13
60127,95589,2020-10-07 16:57:53,wahoo,Zwift - MIDWEEK Autumn Series by SZR (A),Quarq to zwift,Kickr 17,362,352,10
60409,95589,2020-10-08 15:03:40,wahoo,Zwift - OH MY CRIT! - The Double Race 1/2 (A),Quarq to zwift,Kickr 17,357,355,2
60852,95589,2020-10-09 16:27:15,wahoo,Zwift - EVO CC Sprint Race Series  (A),Quarq to zwift,Kickr 17,383,377,6
60853,95589,2020-10-10 14:09:56,wahoo,Zwift - OH MY CRIT - Saturday Smash Race (A),Quarq to zwift,Kickr 17,363,354,9
61947,95589,2020-10-14 10:04:14,wahoo,Zwift - 3R Road To Ruins Hilly Race - 1 Lap (29..2km/18.1mi 275m) (A),Quarq to zwift,Kickr 17,388,384,4
62583,95589,2020-10-15 18:47:03,wahoo,Zwift - Espresso,Quarq to zwift,Kickr 17,347,341,6
62584,95589,2020-10-16 16:01:02,wahoo,Zwift - EVO CC Sprint Race Series  (A),Quarq to zwift,Kickr 17,350,352,-2
63548,95589,2020-10-20 18:38:02,wahoo,Zwift - Zwift Racing League | WTRL - EMEA (MEN) - TTT Grp 2 (B),Quarq to zwift,Kickr 17,342,339,3
66275,95589,2020-10-29 19:10:40,wahoo,Zwift - WTRL Team Time Trial - Zone 6 (C),Quarq to zwift,Kickr 17,353,348,5
70222,95589,2020-11-10 18:51:03,wahoo,Zwift - Zwift Racing League | WTRL - EMEA W1 (MEN) -  Division 1 (A),Quarq to zwift,Kickr 17,414,416,-2
71280,95589,2020-11-14 08:02:09,wahoo,Zwift - Kyle Augustin iNC&#039;s Meetup - Tempus Fugit,Quarq to zwift,Kickr 17,325,336,-11
71283,95589,2020-11-12 18:20:41,wahoo,Zwift - Espresso,Quarq to zwift,Kickr 17,347,342,5
76172,95589,2020-11-26 18:15:56,wahoo,WTRL NOPINZ WORLD TTT CHAMPIONSHIPS - Zone 7,Quarq to 830,Kickr 17,356,352,4
78254,95589,2020-12-01 19:08:34,wahoo,Zwift - Zwift Racing League | WTRL - Men&#039;s EMEA W1 DIVISION 1 (A),Quarq to zwift,Kickr 17,353,348,5
81261,95589,2020-12-08 19:20:24,wahoo,Zwift - Zwift Racing League | WTRL - Men&#039;s EMEA W1 DIVISION 1 (A),V3,Kickr 17,369,369,0
81730,95589,2020-12-10 18:27:14,wahoo,Zwift - Espresso,V3,Kickr 17,345,345,0
84077,95589,2020-12-15 18:47:06,wahoo,Zwift - Zwift Racing League | WTRL - Men&#039;s EMEA W1 DIVISION 1 (A),V3,Kickr 17,355,358,-3
89499,95589,2020-12-31 08:11:20,wahoo,Zwift - WTRL Team Time Trial - Zone 1 (C),Quarq to 830,Kickr 17,356,351,5
97587,95589,2021-01-12 18:04:25,wahoo,Zwift - Zwift Racing League | WTRL - Men&#039;s/Mixed EMEA E1 DIVISION 1 (A),Quarq,Kickr 17,363,361,2
99710,95589,2021-01-19 17:47:56,wahoo,lots of dropouts - Zwift - Zwift Racing League | WTRL - Men&#039;s/Mixed EMEA E1 DIVISION 1 (A),Quarq,Kickr 17,338,323,15
107653,95589,2021-02-02 18:02:31,wahoo,Zwift - Zwift Racing League | WTRL - Men&#039;s/Mixed EMEA E2 DIVISION 1 (A),Quarq,Kickr 17,375,370,5
121840,95589,2021-02-26 15:23:47,wahoo,Zwift - the never rest fartlek ;) 120min version,Quarq,Kickr 17,290,286,4
121842,95589,2021-02-27 16:07:27,wahoo,Zwift - ,Quarq,Kickr 17,311,307,4
126285,95589,2021-03-09 18:46:27,wahoo,Zwift - 3R Omnium Event - Race 1 - Scatch Race,Quarq,Kickr 17,365,361,4
127243,95589,2021-03-11 19:45:31,wahoo,Zwift - KISS Race Series - EU PM (A),Quarq,Kickr 17,380,383,-3
129352,95589,2021-03-16 18:44:19,wahoo,Zwift - 3R Omnium Event - Race 2 - iTT (E),Quarq,Kickr 17,377,369,8
31202,95756,2020-05-04 10:14:19,wahoo,Zwift - Bike: Foundation ride,Quarq,Kickr 2017,224,220,4
41060,95756,2020-06-11 17:05:02,wahoo,Zwift - Bike: Threshold Thursday,Vector 3,Kickr 2017,295,287,8
41592,95756,2020-06-14 07:04:55,wahoo,Zwift - Mark Whittle (WhittleFit)&#039;s Meetup - Tour of Fire and Ice,Vector 3,Kickr 2017,300,286,14
41829,95756,2020-06-15 18:44:54,wahoo,Zwift - Luke England&#039;s Meetup - Dust In The Wind,Vector 3,Kickr 18,157,156,1
47831,95756,2020-07-25 09:04:59,wahoo,Zwift - 3R Hilly Race - Watopia Road To Sky - 1 lap (A),Quarq,Kickr 18 Old,330,318,12
89636,95756,2020-12-31 18:04:33,wahoo,Zwift - Bike: Threshold Thursday,twirpburrows.2020-12-31-19-05-53-876Z.GarminPush.77333092136,Kickr 18,284,282,2
90187,95756,2021-01-02 10:04:54,wahoo,Zwift - 3R Racing (A),Vector 3.2,Kickr 18,320,316,4
90192,95756,2021-01-02 10:01:01,wahoo,Granny Zwift Race ,JG Vector 3,JG Kickr 18,357,339,18
108703,95756,2021-02-04 12:07:49,wahoo,Zwift - Bike: Aero drills,Vector 2.0,Kickr 18,217,205,12
108877,95756,2021-02-04 18:04:58,wahoo,Zwift - Bike: Threshold Thursday...,Vector 3.2,Kickr 18,307,305,2
48741,96219,2020-08-04 09:29:05,wahoo,SRM / Kickr Gen1,SRM,Kickr Gen1,287,298,-11
125445,97200,2021-03-07 15:25:45,neo,Zwift - Pahrah,Quarq RIKEN AL,Tacx NEO,308,315,-7
126063,97200,2021-03-09 11:31:54,neo,Zwift - Absa Cape Epic Stage 2 Time Trial pb Dimension Data - Open (A),Quarq RIKEN AL,Tacx NEO,309,318,-9
126907,97200,2021-03-11 11:25:42,neo,Zwift - Absa Cape Epic Stage 3 pb ABUS - Open	 (A),Quarq RIKEN AL,Tacx NEO,321,321,0
127997,97200,2021-03-13 09:26:56,neo,Zwift - Absa Cape Epic Stage 4 pb Assos - Open (A),Quarq RIKEN AL,Tacx NEO,328,331,-3
15010,99560,2020-02-20 19:01:58,neo,Zwift - KALAS Cup - Round 4 (C),Quarq,Tacx Neo,333,333,0
67036,99560,2020-11-01 10:15:01,neo,Zwift - ZHR Audax (E),Quarq,Tacx Neo,309,294,15
67801,99560,2020-11-03 18:22:50,neo,Zwift - Zwift Racing League | WTRL - Men&#039;s EMEA E2 DIVISION 2 (B),Quarq,Tacx Neo,351,348,3
106482,99825,2021-01-31 23:08:02,wahoo,Zwift - TDZ Stage 6: Standard Ride,S-Works Dual Power Cranks,Wahoo Kickr,325,321,4
13291,100874,2020-02-10 18:29:50,neo,Zwift - Flanders Monday Blues Ride,Zpider,Tacx Neo,206,205,1
13640,100874,2020-02-12 14:46:50,neo,Zwift - Crit City Race,Zpider,Tacx Neo,316,314,2
15087,100874,2020-02-21 18:59:47,neo,Tour of Innsbruck // Stage 1,Zpider,Tacx Neo,284,282,2
30004,100874,2020-04-30 15:11:22,neo,Zwift - Ramp Test,Zpider,Tacx Neo,354,355,-1
44532,100874,2020-06-30 14:59:04,neo,Zwift - ZHQ Beta Crit City Race (C),Zpider,Tacx Neo,304,305,-1
66264,100874,2020-01-06 14:51:40,neo, Flanders The BZR Ronde ,Zpider,Tacx Neo,335,321,14
68469,100874,2020-11-01 07:29:38,neo,Zwift - LEQP Provence Badge Hunter Series (,Zpider,Tacx Neo,274,269,5
116293,100874,2021-02-16 17:58:37,neo,Zwift - Zwift Racing League | WTRL - Men&#039;s/Mixed EMEA E1 DIVISION 1 (C),Zpider,Tacx Neo,322,319,3
35417,100983,2020-05-16 12:48:56,wahoo,Zwift - WTRL iTT Series  (E), 2020-05-16 08-48-56,Kickr 2019,252,252,0
38739,100983,2020-05-30 12:48:59,wahoo,Zwift - WTRL iTT Series  (E) 5th!,PT Pedals,Kickr 2019,255,255,0
40027,100983,2020-06-06 12:49:00,wahoo,Zwift - WTRL iTT Series  (E) 2nd!,PT Pedals,Kickr 2019,254,254,0
41480,100983,2020-06-13 12:48:59,wahoo,Zwift - WTRL iTT Series  (E) Third!!!,PT Pedals,Kickr 2019,254,249,5
44393,100983,2020-06-30 22:03:14,wahoo,Zwift - Zwift Time Trial Tuesday: Tempus Fugit (E) new FTP LOL,PT Pedals,Kickr 2019,258,254,4
66526,100983,2020-10-30 17:02:12,wahoo,Zwift - Zwift Fast Fridays: Bologna Time Trial (E),PT Pedals,Kickr 2019,260,257,3
65912,101553,2020-10-28 21:55:12,wahoo,Zwift - Miracle,Assioma duo pedals,Kickr Core,268,270,-2
65919,101553,2020-07-19 18:01:02,wahoo,Zwift - L&#039;Etape du Tour Stage 3 - Ventoux!!,4iii left only,Kickr Core,357,360,-3
65922,101553,2020-10-15 17:58:53,wahoo,Zwift - Miracle 3,4iii left only,Kickr Core,292,271,21
66296,101553,2020-10-29 20:14:04,wahoo,Zwift Academy Road: Workout 3 | VO2 Capacity - bugged Alpe meetup,Assioma DUO pedals,Kickr Core,307,312,-5
66625,101553,2020-10-30 18:46:34,wahoo,Zwift Academy Road: Workout 4 | Anaerobic Resilience,Assioma duo pedals,Kick Core,269,268,1
66626,101553,2020-10-30 18:46:34,wahoo,Zwift Academy Road: Workout 4 | Anaerobic Resilience,Assioma duo pedals,Kickr Core,269,268,1
66784,101553,2020-10-31 16:00:00,wahoo,Zwift - ZA Road 2020 - Segment Ride #1: Three Sisters Course,Assioma duo pedals,Kickr Core,295,308,-13
67073,101553,2020-11-01 17:19:58,wahoo,Zwift - 3R Greater London 8 Hilly Race - 1 Lap (23.8km/14.8mi 238m) (B),Assioma duo pedals,Kickr Core,330,338,-8
67724,101553,2020-11-03 18:25:01,wahoo,Zwift - Zwift Racing League | WTRL - Men&#039;s EMEA E2 DIVISION 2 (A),Assioma duo pedals,Kickr Core,335,338,-3
68035,101553,2020-11-04 18:49:59,wahoo,Zwift - Flanders V Yorkshire - The Clubhouse Bash by ATR (B),Assioma duo pedals,Kickr Core,318,320,-2
69250,101553,2020-11-08 19:11:21,wahoo,Zwift - ZA Road Race #1: 3.2 - 4 w/kg,Assioma duo pedals,Kickr Core,324,325,-1
70139,101553,2020-11-10 18:20:00,wahoo,Zwift - Zwift Racing League | WTRL - EMEA E2 (MEN) -  Division 2 (A),Assioma duo pedals,Kickr Core,343,338,5
86425,101553,2020-12-22 19:06:24,wahoo,Zwift - NYC the 6 train,Assioma duo pedals,Kickr Core,217,225,-8
86426,101553,2020-12-22 19:26:43,wahoo,Zwift - NYC Mighty Met z2,Assioma duo pedals,Kickr Core,210,219,-9
98959,101553,2021-01-18 13:53:54,wahoo,Zwift - Paris,Assioma duo pedals,Kickr Core,201,203,-2
98961,101553,2021-01-18 14:14:00,wahoo,Zwift - Lutscher CCW,Assioma duo pedals,Kickr Core,228,239,-11
100506,101553,2021-01-20 18:35:48,wahoo,Zwift - Richmond,Assioma duo pedals,Kickr Core,204,206,-2
101025,101553,2021-01-21 17:29:59,wahoo,Zwift - Thurs eve social - Tire-Bouchon,Assioma duo pedals,Kickr Core,296,308,-12
105450,101553,2021-01-30 08:30:59,wahoo,Zwift - London Lockdown eRace Series: Race 1 (B),Assioma duo pedals,Kickr Core,321,333,-12
36204,102656,2020-05-19 18:14:49,wahoo,Zwift - UNO X CUP powered by DCU & Feltet.dk (A),SRam Quarq Elsa RS,Wahoo kickr ,327,318,9
39474,102816,2020-06-04 06:00:02,wahoo,Zwift - Kiwi Crew Ride (D),Assioma,Kickr,374,371,3
1544,103766,2019-09-10 10:00:16,wahoo,Zwift - KISS Race - Americas AM (E),Quarq to Zwift,Kickr to Elemnt Bolt,358,345,13
1745,103766,2019-09-13 10:05:22,wahoo,Zwift - 3R Innsbruckring Flat Race - 4 Laps (35.2km/21.9mi 308m) (A),Quarq to Zwift,Kickr to Elemnt Bolt,409,386,23
6000,104082,2019-12-11 16:09:45,wahoo,Zwift - 3R Tick Tock Flat Race - 2 Lap (36km/22.4mi 100m) (A),Quarq Dfour,Wahoo Kickr 2018,372,352,20
7346,104082,2019-12-26 16:04:59,wahoo,OH CRITMAS!! - The Double Race - Race 12 (A),Quarq Dfour,Wahoo Kickr 2018,367,355,12
7476,104082,2019-12-28 13:19:40,wahoo,Zwift - 3R Innsbruckring Flat Race - 5 Laps (44km/27.3mi 385m) (A),Quarq Dfour,Wahoo Kickr 2018,372,360,12
7667,104082,2019-12-30 17:30:04,wahoo,Zwift - Danmarks Cykle Union New Year&#039;s Special  (A),Quarq Dfour,Wahoo Kickr 2018,378,368,10
7740,104082,2019-12-31 15:04:39,wahoo,Zwift - 3R Volcano Circuit Flat Race - 8 Laps (35.2km/21.9mi 160m) (A),Quarq Dfour,Wahoo Kickr 2018,362,351,11
7900,104082,2020-01-02 18:30:09,wahoo,Zwift - FUSION ECT BEUNSTOPPABLE Racing Series (A),Quarq Dfour,Wahoo Kickr 2018,357,351,6
7982,104082,2020-01-03 16:44:50,wahoo,Zwift - Crit City Race (A),Quarq Dfour,Wahoo Kickr 2018,358,346,12
8297,104082,2020-01-07 16:02:59,wahoo,Zwift - 3R Ultimate Racing League - Round 1 (A),Quarq Dfour,Wahoo Kickr 2018,372,361,11
8472,104082,2020-01-08 19:03:20,wahoo,Zwift - DBR HEINO CUP (A),Quarq Dfour,Wahoo Kickr 2018,417,409,8
8620,104082,2020-01-09 17:29:25,wahoo,Zwift - Danmarks Cykle Union 2020 Cup (A),Quarq Dfour,Wahoo Kickr 2018,407,395,12
9326,104082,2020-01-14 17:59:41,wahoo,Zwift - Danmarks Cykle Union 2020 Cup (A),Quarq Dfour,Wahoo Kickr 2018,394,381,13
9493,104082,2020-01-15 16:08:57,wahoo,Zwift - 3R Tick Tock Flat Race - 2 Lap (36km/22.4mi 100m) (A),Quarq Dfour,3RTickTockFlatRace-kickr-bolt (2),357,345,12
9700,104082,2020-01-16 18:28:31,wahoo,Zwift - FUSION ECT BEUNSTOPPABLE Racing Series (A) #2,Quarq Dfour,Wahoo Kickr 2018,403,390,13
10164,104082,2020-01-20 18:14:39,wahoo,Zwift - DBR Caresport Crit Cup  (A),Quarq Dfour,Wahoo Kickr 2018,373,370,3
10283,104082,2020-01-21 18:29:40,wahoo,Zwift - Flanders De Ronde Race (A),Quarq Dfour,Wahoo Kickr 2018,390,393,-3
10475,104082,2020-01-22 19:04:19,wahoo,Zwift - DBR HEINO CUP (A),Quarq Dfour,DBRHEINOCUP-kickr-bolt,378,376,2
10961,104082,2020-01-26 05:58:10,wahoo,Zwift - KISS at Race 100 - EU (A),Quarq Dfour,Wahoo Kickr 2018,403,402,1
11518,104082,2020-01-29 17:59:09,wahoo,Zwift - SZR Winter Race Series (A),Quarq Dfour,Wahoo Kickr 2018,392,390,2
11868,104082,2020-01-31 18:21:06,wahoo,Zwift - Tour de Zwift // Pro-Am Invitational (A),Quarq Dfour,Wahoo Kickr 2018,402,403,-1
12263,104082,2020-02-03 17:29:17,wahoo,Zwift - Danmarks Cykle Union 2020 Cup (A) #allout fra start til slut :D,Quarq Dfour,Wahoo Kickr 2018,408,401,7
12548,104082,2020-02-04 19:10:13,wahoo,Zwift - &quot;No Pain No Gain&quot; Transparency Racing Series,Quarq Dfour,Wahoo Kickr 2018,350,347,3
12550,104082,2020-02-05 13:23:12,wahoo,Zwift - 3R Volcano Flat 50k Race (50km/31mi 202m) (A),Quarq Dfour,Wahoo Kickr 2018,366,361,5
12780,104082,2020-02-06 18:59:39,wahoo,Zwift - KALAS Cup - Round 2 (A),Quarq Dfour,Wahoo Kickr 2018,426,424,2
13090,104082,2020-02-09 08:58:17,wahoo,Zwift - Danmarks Cykle Union 2020 Cup (A),Quarq Dfour,Wahoo Kickr 2018,421,412,9
13733,104082,2020-02-13 18:59:25,wahoo,Zwift - KALAS Cup - Round 3 (A),Quarq Dfour,Wahoo Kickr 2018,378,370,8
15594,104082,2020-02-25 19:12:37,wahoo,Zwift - Feltet.dk Race Series (A),Quarq Dfour,Wahoo Kickr 2018,394,391,3
15735,104082,2020-02-26 17:02:10,wahoo,Zwift - 2RR ITT Bologna (A) #2,Quarq Dfour,Wahoo Kickr 2018,416,409,7
15855,104082,2020-02-27 16:14:47,wahoo,Zwift - OH CRIT!! - The Double Race - Race 1/2 (A),Quarq Dfour,Wahoo Kickr 2018,387,378,9
15856,104082,2020-02-27 17:02:06,wahoo,Zwift - OH CRIT!! - The Double Race - Race 2/2 (A),Quarq Dfour,Wahoo Kickr 2018,359,352,7
17525,104082,2020-03-10 19:13:04,wahoo,Zwift - Feltet.dk Race Series (A),Quarq Dfour,Wahoo Kickr 2018,398,389,9
17820,104082,2020-03-12 18:38:06,wahoo,Zwift - Tour of Watopia Pro-Am Men&#039;s Race #1 (A),Quarq Dfour,Wahoo Kickr 2018,435,429,6
17963,104082,2020-03-13 16:43:22,wahoo,Zwift - Crit City Race (A),Quarq Dfour,Wahoo Kickr 2018,373,365,8
18421,104082,2020-03-17 16:04:04,wahoo,Zwift - 3R SuperCRITical Race Series - Round 4of4 (A),Quarq Dfour,Wahoo Kickr 2018,426,420,6
19612,104082,2020-03-25 19:02:37,wahoo,Zwift - DBR Wednesday Race (A),Quarq Dfour,Wahoo Kickr 2018,405,391,14
19988,104082,2020-03-24 18:19:28,wahoo,Zwift - Tour of Watopia Pro-Am Men&#039;s Race #3 (A),Quarq Dfour,Wahoo Kickr 2018,380,373,7
19989,104082,2020-03-26 18:58:27,wahoo,Zwift - KALAS Cup - Round 9 (A),Quarq Dfour,Wahoo Kickr 2018,407,399,8
20865,104082,2020-03-31 18:13:50,wahoo,Zwift - Feltet.dk Race Series (A),Quarq Dfour,Wahoo Kickr 2018,405,403,2
21661,104082,2020-04-03 07:55:02,wahoo,Zwift - NTT Pro Cycling Flat Race (A),Quarq Dfour,Wahoo Kickr 2018,405,393,12
23296,104082,2020-04-09 17:44:47,wahoo,Zwift - London International // Zwift Classic (A) #72 #Profferne har indtaget zwift :D,Quarq Dfour,Wahoo Kickr 2018,433,423,10
28008,104082,2020-04-25 17:31:53,wahoo,Zwift - Crit City Slam // Zwift Classic (A),Quarq Dfour,Wahoo Kickr 2018,407,398,9
31707,104082,2020-05-05 17:56:02,wahoo,Zwift - UNO X CUP powered by DCU & Feltet.dk (A),Quarq Dfour,Wahoo Kickr 2018,418,408,10
44064,104082,2020-06-29 16:39:54,wahoo,Zwift - Team Italy PISSEI Race (A),Quarq Dfour,Wahoo Kickr 2018,426,421,5
44714,104082,2020-07-03 17:59:46,wahoo,Zwift - TeamPTz Friday&#039;s Race League (A),Quarq Dfour,Wahoo Kickr 2018,386,377,9
45415,104082,2020-07-08 09:44:52,wahoo,Zwift - USA Cycling Race League by Indoor Specialist (A),Quarq Dfour,USArace-kickr-bolt,362,361,1
46446,104082,2020-07-15 12:59:46,wahoo,Zwift - KISS at Race - Pacific AM (A),Quarq Dfour,Wahoo Kickr 2018,352,350,2
46814,104082,2020-07-18 10:29:49,wahoo,Zwift - 3R Volcano Climb Race - 1 Lap (22.4km/14mi 204m) (A),Quarq Dfour,Wahoo Kickr 2018,436,428,8
46928,104082,2020-07-19 10:09:57,wahoo,Zwift - 3R Sand & Sequoias - 1 Lap (20km/12.5mi 173m) (A),Quarq Dfour,Wahoo Kickr 2018,429,426,3
47427,104082,2020-07-23 10:44:49,wahoo,Zwift - Crit City Race (A),Quarq Dfour,Wahoo Kickr 2018,392,384,8
47428,104082,2020-07-23 11:19:45,wahoo,Zwift - Zone 2 workout,Quarq Dfour,Wahoo Kickr 2018,395,386,9
47616,104082,2020-07-25 08:04:43,wahoo,Zwift - 3R Race - Watopia - Magnificent 8 - 38.6km (A),Quarq Dfour,Wahoo Kickr 2018,412,405,7
47739,104082,2020-07-26 10:09:45,wahoo,Zwift - 3R Sand & Sequoias - 1 Lap (20km/12.5mi 173m) (A),Quarq Dfour,Wahoo Kickr 2018,400,394,6
47959,104082,2020-07-28 09:59:52,wahoo,Zwift - KISS at Race - Americas AM (A),Quarq Dfour,Wahoo Kickr 2018,403,401,2
48118,104082,2020-07-29 09:44:57,wahoo,Zwift - USA Cycling Race League by Indoor Specialist (A),Quarq Dfour,Wahoo Kickr 2018,381,377,4
48119,104082,2020-07-29 11:09:41,wahoo,Zwift - Peak-PTY Midweek TT Climb Challenge (A),Quarq Dfour,Wahoo Kickr 2018,427,417,10
48265,104082,2020-07-30 09:16:42,wahoo,Zwift - The Lamb Chop p/b Black Sheep (A),Quarq Dfour,Wahoo Kickr 2018,409,398,11
48405,104082,2020-07-31 08:44:49,wahoo,Crit City Race,Quarq Dfour,Wahoo Kickr 2018,387,381,6
50915,104082,2020-08-20 12:04:53,wahoo,3R Volcano Circuit Flat Race,Quarq Dfour,Wahoo Kickr 2018,380,373,7
51069,104082,2020-08-21 08:44:52,wahoo,Zwift - Crit City Race (A),Quarq Dfour,Wahoo Kickr 2018,402,397,5
51524,104082,2020-08-24 14:59:57,wahoo,Zwift - ZHQ Beta Crit City Race (A),Quarq Dfour,Wahoo Kickr 2018,388,381,7
52157,104082,2020-08-27 12:24:57,wahoo,Zwift - EMU Japan Race (A),Quarq Dfour,Wahoo Kickr 2018,368,361,7
52358,104082,2020-08-27 13:34:58,wahoo,Zwift - Crit City Race (A),Quarq Dfour,Wahoo Kickr 2018,340,323,17
52361,104082,2020-08-28 15:14:50,wahoo,Zwift - 3R Sand and Sequoias Race (A),Quarq Dfour,Wahoo Kickr 2018,375,364,11
53194,104082,2020-09-02 18:04:47,wahoo,Zwift - DBR Wednesday Race (A),Quarq Dfour,Wahoo Kickr 2018,376,364,12
53219,104082,2020-09-03 15:14:45,wahoo,Zwift - OH MY CRIT! - The Double Race 1/2 (A),Quarq Dfour,Wahoo Kickr 2018,374,364,10
53701,104082,2020-09-06 16:04:05,wahoo,Zwift - 3R Tick Tock Flat Race - 1 Lap (19km/11.8mi 50m) (A),Quarq Dfour,Wahoo Kickr 2018,346,330,16
54692,104082,2020-09-12 08:29:51,wahoo,Zwift - DBR SufferDay League II (A) #3,Quarq Dfour,Wahoo Kickr 2018,420,415,5
55579,104082,2020-09-16 17:44:49,wahoo,Zwift - DCU powered by Feltet.dk (A) #6,Quarq Dfour,Wahoo Kickr 2018,368,355,13
56666,104082,2020-09-21 17:14:49,wahoo,Zwift - DBR Ride´N´Roll League (A),Quarq Dfour,Wahoo Kickr 2018,399,386,13
57040,104082,2020-09-23 17:44:49,wahoo,Zwift - DCU powered by Feltet.dk (A),Quarq Dfour,Wahoo Kickr 2018,423,409,14
57248,104082,2020-09-24 16:04:52,wahoo,Zwift - OH MY CRIT! - The Double Race 2/2 (A),Quarq Dfour,Wahoo Kickr 2018,360,349,11
58067,104082,2020-09-28 17:14:50,wahoo,Zwift - DBR Ride´N´Roll League (A),Quarq Dfour,Wahoo Kickr 2018,370,355,15
59852,104082,2020-10-06 17:54:54,wahoo,Zwift - Team Italy & Frenchy Fuzion League (A),Quarq Dfour,Wahoo Kickr 2018,402,382,20
62716,104082,2020-10-17 17:29:54,wahoo,Zwift - EVR Summer Series (A),Quarq Dfour,Wahoo Kickr 2018,418,411,7
63034,104082,2020-10-19 16:09:49,wahoo,Zwift - 3R Classique Reverse Flat Race - 4 Laps (26.9km/16.7mi 57m) (A),Quarq Dfour,Wahoo Kickr 2018,404,405,-1
63409,104082,2020-10-20 17:21:01,wahoo,Zwift - Zwift Racing League | WTRL - EMEA E (MEN) - TTT Grp 1,Quarq Dfour,Wahoo Kickr 2018,397,393,4
64833,104082,2020-10-23 15:14:58,wahoo,Zwift - 3R Sand and Sequoias Race (A),Quarq Dfour,Wahoo Kickr 2018,367,362,5
64834,104082,2020-10-25 11:44:51,wahoo,Zwift - Crit City Race (A),Quarq Dfour,Wahoo Kickr 2018,390,382,8
65396,104082,2020-10-27 14:03:11,wahoo,Zwift - Zwift Time Trial Tuesday: Tempus Fugit (E),Quarq Dfour,Wahoo Kickr 2018,429,427,2
66761,104082,2020-10-31 19:04:51,wahoo,Zwift - 3R Innsbruckring Sprint Race - 1 Lap (8.8km/5.5mi 77m) (A),Quarq Dfour,Wahoo Kickr 2018,349,349,0
67185,104082,2020-11-02 15:15:40,wahoo,Zwift - 3R Volcano Circuit Sprint Flat Race - 1 Lap (6.6km/4.1mi 20m) (A),Quarq Dfour,Wahoo Kickr 2018 with Wahoo bolt,391,389,2
67595,104082,2020-11-03 18:16:31,wahoo,Zwift - Zwift Racing League | WTRL - Men&#039;s EMEA E1 DIVISION 1 (A),Quarq Dfour,Wahoo Kickr V5 2020 with Wahoo bolt,423,425,-2
68115,104082,2020-11-05 13:29:46,wahoo,Zwift - ZHQ FutureWorks Circuit Race - Anti-sandbagging (A),Quarq Dfour,Wahoo Kickr V5 2020 with Wahoo bolt,405,406,-1
69042,104082,2020-11-08 13:04:51,wahoo,Zwift - 3R Watopia Flat Route Race - 4 Laps (40.5km/25.1mi 216m) (A),Quarq Dfour,Wahoo Kickr V5 2020 with Wahoo bolt,371,374,-3
69742,104082,2020-11-10 17:52:01,wahoo,Zwift - Zwift Racing League | WTRL - EMEA E1 (MEN) -  Division 1 (A),Quarq Dfour,Wahoo Kickr V5 2020 with Wahoo bolt,477,468,9
70286,104082,2020-11-11 19:05:12,wahoo,Zwift - DBR HEINO CUP III (A),Quarq Dfour,Wahoo Kickr V5 2020 with Wahoo bolt,410,407,3
72216,104082,2020-11-17 17:56:07,wahoo,Zwift - Zwift Racing League | WTRL - Men&#039;s EMEA E1 DIVISION 1 (A),Quarq Dfour,Wahoo Kickr V5 2020 with Wahoo bolt,399,395,4
73184,104082,2020-11-19 19:22:56,wahoo,Zwift - World Championships Experience // Danish Cycling Federation,Quarq Dfour,Wahoo Kickr V5 2020 with Wahoo bolt,412,409,3
73514,104082,2020-11-20 15:14:50,wahoo,Zwift - 3R Sand and Sequoias Race (A),Quarq Dfour,Wahoo Kickr V5 2020 with Wahoo bolt,411,397,14
77314,104082,2020-11-29 14:15:01,wahoo,Zwift - KISS 100 Race Series - Americas (A),Quarq Dfour,Wahoo Kickr V5 2020 with Wahoo bolt,373,365,8
78054,104082,2020-12-01 18:00:05,wahoo,Zwift - Zwift Racing League | WTRL - Men&#039;s EMEA E1 DIVISION 1 (A),Quarq Dfour,Wahoo Kickr V5 2020 with Wahoo bolt,405,399,6
79939,104082,2020-12-05 18:59:46,wahoo,Zwift - EVR Summer Series (A) #1,Quarq Dfour with bolt,Wahoo Kickr V5 2020 with zwift,435,433,2
83529,104082,2020-12-15 17:59:49,wahoo,Zwift - Zwift Racing League | WTRL - Men&#039;s EMEA E1 DIVISION 1 (A),Quarq Dfour,Wahoo Kickr V5 2020 with Wahoo bolt,373,363,10
86477,104082,2020-12-20 15:00:00,wahoo,Zwift - Tour of New York Stage 3 - Open Longer,Quarq Dfour,Wahoo Kickr V5 2020 with Wahoo bolt,359,364,-5
86478,104082,2020-12-23 14:34:52,wahoo,Zwift - 3R Sand & Sequoias - 1 Lap (20km/12.5mi 173m) (A),Quarq Dfour,Wahoo Kickr V5 2020 with Wahoo bolt,386,380,6
86879,104082,2020-12-24 10:59:50,wahoo,Zwift - KISS Race Series - Merry xmas :D,Quarq Dfour,Wahoo Kickr V5 2020 with Wahoo bolt,412,403,9
87391,104082,2020-12-26 11:14:54,wahoo,Zwift - 3R Tick Tock Flat Race - 2 Lap (36km/22.4mi 100m) (A),Quarq Dfour,Wahoo Kickr V5 2020 with Wahoo bolt,380,379,1
88973,104082,2020-12-30 12:29:57,wahoo,Zwift - 3R LaGuardia Loop Flat Race - 10 Laps (28.3km/17.6mi 270m) (A),Quarq Dfour with bolt,Wahoo Kickr V5 2020 with zwift,384,379,5
90690,104082,2021-01-03 13:44:51,wahoo,Zwift - La Bicicletta Toronto & Toronto Hustle Donut Race (A),Quarq Dfour with bolt,Wahoo Kickr V5 2020 with zwift,411,407,4
108818,104082,2021-02-04 17:29:49,wahoo,Zwift - Ryzon Days of Dedication: Stage 1 ,Quarq Dfour,Wahoo Kickr V5 2020 with Wahoo bolt,401,397,4
111546,104082,2021-02-09 18:00:24,wahoo,Zwift - Zwift Racing League | WTRL - Men&#039;s/Mixed EMEA E1 DIVISION 1 (A),Quarq Dfour,Wahoo Kickr V5 2020 with Wahoo bolt,412,405,7
114557,104082,2021-02-14 09:59:57,wahoo,Zwift - DBR Sunday Race (A),Quarq Dfour,Wahoo Kickr V5 2020 with Wahoo bolt,391,387,4
117299,104082,2021-02-18 18:29:48,wahoo,Zwift - FUSION WINTER CUP (A),Quarq Dfour with bolt,Wahoo Kickr V5 2020 with Wahoo bolt,397,382,15
118689,104082,2021-02-21 13:04:48,wahoo,Zwift - 3R Watopia Flat Route Race - 4 Laps (40.5km/25.1mi 216m) (A),Quarq Dfour,Wahoo Kickr V5 2020 with Wahoo bolt,414,405,9
119487,104082,2021-02-23 14:29:50,wahoo,DBR Tuesday Race #3 + zone 2,Quarq Dfour,Wahoo Kickr V5 2020 with Wahoo bolt,439,434,5
121131,104082,2021-02-26 09:59:55,wahoo,Zwift - Haute Route Watopia 2021 Stage 1 (A),Quarq Dfour,Wahoo Kickr V5 2020 with Wahoo bolt,416,410,6
122984,104082,2021-03-02 18:18:46,wahoo,Zwift - Zwift Racing League | WTRL - Men&#039;s/Mixed EMEA E2 DIVISION 6 (A),Quarq Dfour,Wahoo Kickr V5 2020 with Wahoo bolt,412,406,6
124443,104082,2021-03-05 13:29:52,wahoo,Zwift - ZHQ FutureWorks Circuit Race - Anti-sandbagging (A),Quarq Dfour,Wahoo Kickr V5 2020 with Wahoo bolt,359,350,9
124445,104082,2021-03-03 18:44:52,wahoo,Zwift - Scandinavian Cup 2021 - Round 2 - Men (A),Quarq Dfour,Wahoo Kickr V5 2020 with Wahoo bolt,436,421,15
125382,104082,2021-03-07 12:59:53,wahoo,Zwift - WKG Winter League 2020 / 2021  (A) #1,Quarq Dfour,Wahoo Kickr V5 2020 with Wahoo bolt,397,386,11
126466,104082,2021-03-10 13:29:50,wahoo,Zwift ,Quarq Dfour,Wahoo Kickr V5 2020 with Wahoo bolt,352,339,13
127406,104082,2021-03-12 10:04:46,wahoo,Zwift - 3R Innsbruckring Flat Race - 4 Laps (35.2km/21.9mi 308m) (A),Quarq Dfour,Wahoo Kickr V5 2020 with Wahoo bolt,372,362,10
62328,104133,2020-10-15 17:30:05,wahoo,Zwift - FUSION ECT BEUNSTOPPABLE Racing Series (A),Stages ,Wahoo Kickr Core,286,292,-6
62447,104133,2020-10-16 14:05:06,wahoo,Zwift - 3R Innsbruckring Flat Race - 2 Laps (17.6km/10.9m 154m) (A),Stages ,Wahoo Kickr Core,283,287,-4
62981,104133,2020-10-18 14:35:01,wahoo,Zwift - 3R Alpe Du Zwift KOM Race (20km 1444m) (A),Stages ,Wahoo Kickr Core,304,307,-3
63957,104133,2020-10-21 18:05:02,wahoo,Zwift - DBR HEINO CUP III (A),Stages ,Wahoo Kickr Core,302,300,2
64250,104133,2020-10-22 17:30:01,wahoo,Zwift - FUSION ECT BEUNSTOPPABLE Racing Series (A),Stages ,Wahoo Kickr Core,317,324,-7
64651,104133,2020-10-24 14:10:08,wahoo,Zwift - ZA Road - Race #2 (A),Stages ,Wahoo Kickr Core,285,281,4
65606,104133,2020-10-27 19:48:02,wahoo,Zwift - Zwift Racing League | WTRL - EMEA W (MEN) -  Division 4 (A),Stages ,Wahoo Kickr Core,298,308,-10
66216,104133,2020-10-29 18:30:02,wahoo,Zwift - FUSION ECT BEUNSTOPPABLE Racing Series (A),Stages ,Wahoo Kickr Core,302,300,2
69981,104133,2020-11-10 18:20:01,wahoo,Zwift - Zwift Racing League | WTRL - EMEA E2 (MEN) -  Division 2 (A),Stages ,Wahoo Kickr Core,329,330,-1
71224,104133,2020-11-13 19:00:03,wahoo,Zwift - Team IRL Without Borders Race (A),Stages ,Wahoo Kickr Core,310,308,2
71781,104133,2020-11-15 15:10:26,wahoo,"Zwift - Open: 2020 El Giro de Rigo - Shorter Route (top 10 ude af 1080, men pis os; jeg mistede frontgruppen p� sidste nedk�rsel, fordi jeg supertuckede. Gruppen k�rte bare lige forbi mig, og s� kunne jeg ikke lukke hullet igen :()",Stages ,Wahoo Kickr Core,295,289,6
72552,104133,2020-11-17 19:52:03,wahoo,Zwift - Zwift Racing League | WTRL - Men&#039;s EMEA W1 DIVISION 1 (A),Stages ,Wahoo Kickr Core,283,286,-3
73286,104133,2020-11-19 19:30:03,wahoo,Zwift - World Championships Experience // Danish Cycling Federation,Stages ,Wahoo Kickr Core,296,313,-17
73525,104133,2020-11-20 16:05:01,wahoo,Zwift - 3R Volcano Flat Race - 3 Laps (36.6km/22.7mi 138m) (A),Stages ,Wahoo Kickr Core,294,307,-13
75159,104133,2020-11-24 19:48:03,wahoo,Zwift - Zwift Racing League | WTRL - Men&#039;s EMEA W1 DIVISION 4,Stages ,Wahoo Kickr Core,299,302,-3
76144,104133,2020-11-26 18:30:02,wahoo,Zwift - FUSION ECT BEUNSTOPPABLE Racing Series (A),Stages ,Wahoo Kickr Core,285,290,-5
83482,104133,2020-12-13 15:25:02,wahoo,Zwift - 3R Watopia 65km Race - 6 laps (40mi 324m) (A),Stages ,Wahoo Kickr Core,279,288,-9
85243,104133,2020-12-18 17:00:03,wahoo,Zwift - Tour of New York Stage 1 - Open Longer,Stages ,Wahoo Kickr Core,312,310,2
85246,104133,2020-12-15 18:23:33,wahoo,Zwift - Zwift Racing League | WTRL - Men&#039;s EMEA E2 DIVISION 2 (A),Stages ,Wahoo Kickr Core,281,280,1
88279,104133,2020-12-28 18:15:04,wahoo,Zwift -  DBR Monday Race (A),Stages ,Wahoo Kickr Core,299,301,-2
89492,104133,2020-12-31 14:05:06,wahoo,Zwift - 3R Classique Flat Race - 6 Laps (37.7km/23.4mi 114m) (A),Stages ,Wahoo Kickr Core,303,305,-2
91331,104133,2021-01-04 18:15:01,wahoo,Zwift -  DBR Monday Race (A),Stages ,Wahoo Kickr Core,317,316,1
92288,104133,2021-01-05 18:55:02,wahoo,Zwift - Team Italy & Frenchy Fuzion League (A),Stages ,Wahoo Kickr Core,318,313,5
94499,104133,2021-01-10 16:00:00,wahoo,Zwift - 3R Super Six Sunday Race (A),Stages ,Wahoo Kickr Core,307,306,1
94503,104133,2021-01-09 20:00:00,wahoo,Zwift - Herd Beginner Racing Series (E),Stages ,Wahoo Kickr Core,312,318,-6
94504,104133,2021-01-08 19:35:02,wahoo,Zwift - 3R Watopia Hilly Race - 3 Laps (27km/16.8mi 300m) (A),Stages ,Wahoo Kickr Core,309,311,-2
95905,104133,2021-01-12 19:54:01,wahoo,Zwift - Zwift Racing League | WTRL - Men&#039;s/Mixed EMEA W2 DIVISION 3 (A),Stages ,Wahoo Kickr Core,316,309,7
96460,104133,2021-01-13 18:45:01,wahoo,Zwift - Danmarks Cykle Union & Partners 1/6 (A),Stages ,Wahoo Kickr Core,327,313,14
97633,104133,2021-01-15 19:35:03,wahoo,Zwift - 3R Watopia Hilly Race - 3 Laps (27km/16.8mi 300m) (A),Stages ,Wahoo Kickr Core,307,306,1
99902,104133,2021-01-19 20:02:34,wahoo,Zwift - Zwift Racing League | WTRL - Men&#039;s/Mixed EMEA W2 DIVISION 3 (A),Stages ,Wahoo Kickr Core,280,296,-16
100359,104133,2021-01-20 18:45:02,wahoo,Zwift - Danmarks Cykle Union & Partners 2/6 (A),Stages ,Wahoo Kickr Core,299,296,3
101535,104133,2021-01-22 19:00:01,wahoo,Zwift - TFC Xmas Smash Fest (E),Stages ,Wahoo Kickr Core,313,317,-4
103735,104133,2021-01-26 19:54:03,wahoo,Zwift - Zwift Racing League | WTRL - Men&#039;s/Mixed EMEA W2 DIVISION 3 (A),Stages ,Wahoo Kickr Core,300,306,-6
104879,104133,2021-01-28 21:05:01,wahoo,Zwift - 3R Innsbruckring Flat Race - 2 Laps (17.6km/10.9m 154m) (A),Stages ,Wahoo Kickr Core,293,305,-12
107517,104133,2021-02-02 19:54:01,wahoo,Zwift - Zwift Racing League | WTRL - Men&#039;s/Mixed EMEA W2 DIVISION 3 (A),Stages ,Wahoo Kickr Core,316,312,4
109477,104133,2021-02-05 19:35:02,wahoo,Zwift - 3R Watopia Hilly Race - 3 Laps (27km/16.8mi 300m) (A),Stages ,Wahoo Kickr Core,303,306,-3
116148,104133,2021-02-16 19:54:03,wahoo,Zwift - Zwift Racing League | WTRL - Men&#039;s/Mixed EMEA W2 DIVISION 3 (A),Stages ,Wahoo Kickr Core,307,312,-5
128844,104133,2021-03-15 19:20:03,wahoo,Zwift - Team TFC Mad Monday Race Series (low-end categories) (A),Stages ,Wahoo Kickr Core,291,289,2
14714,104271,2020-02-19 10:41:36,neo,tacx neo / Dzero ,Dzero ,tacx neo,354,367,-13
19350,104271,2020-03-24 06:21:20,neo, 3R Watopia Flat Route Race - 3 Laps (30.3km/18.8mi 162m),Dzero ,tacx neo,410,399,11
21482,104271,2020-04-02 17:59:51,neo,Kalas Cup -Round 10 ,Dzero ,tacx neo,428,425,3
22068,104271,2020-04-04 16:42:00,neo,Crit City Race ,Dzero ,tacx neo,430,427,3
25310,104271,2020-04-16 09:15:50,neo,"Cycling, the chop ",Dzero ,tacx neo,415,404,11
25571,104271,2020-04-17 15:11:47,neo,3r Sand and Sequoias Race ,Dzero ,tacx neo,417,410,7
28739,104271,2020-04-28 14:23:33,neo,Carl Ras Race ,Dzero ,tacx neo,393,375,18
28747,104271,2020-04-28 13:26:24,neo,Crit city slam ,Dzero ,tacx neo,422,405,17
30918,104271,2020-05-03 09:00:31,neo,Newbury Velo RR ,Dzero ,tacx neo,412,396,16
32144,104271,2020-05-06 15:09:09,neo,USA cycle league ,Dzero ,tacx neo,391,375,16
34528,105137,2020-05-13 17:53:26,wahoo,Zwift - Zwift NL League - Woensdagavond Competitie (A),Giant Power Pro,Wahoo Kickr,418,426,-8
37104,105137,2020-05-20 17:21:19,wahoo,Zwift - Zwift NL League - Woensdagavond Competitie (A),Giant Power Pro,Wahoo Kickr,423,430,-7
39649,105137,2020-06-04 15:01:15,wahoo,Zwift - OH CRIT!! - Lockdown Series - Round 1 Race 1 (A),Giant Power Pro,Wahoo Kickr,411,409,2
39652,105137,2020-06-04 15:01:15,wahoo,Zwift - OH CRIT!! - Lockdown Series - Round 1 Race 2 (A),Giant Power Pro,Wahoo Kickr,387,389,-2
41016,105137,2020-06-10 17:27:47,wahoo,Zwift - Zwift NL League - Woensdagavond Competitie (A),Giant Power Pro,Wahoo Kickr,417,399,18
37739,105720,2020-05-26 09:10:08,wahoo,Zwift - SRAM Send it Series - Race 3 - Men&#039;s (E),Quarq DZero,Wahoo Kickr,406,410,-4
37740,105720,2020-05-19 09:20:02,wahoo,Zwift - The After Party Race (A),Quarq DZero,Wahoo Kickr,380,383,-3
75451,105720,2020-11-25 00:45:43,wahoo,Zwift - Zwift Racing League | WTRL - Men&#039;s AMERICAS E DIVISION 1,Quarq DZero,Wahoo Kickr,408,403,5
79901,105720,2020-05-07 00:44:58,wahoo,Zwift - OH MY CRIT - Saturday Smash Race (A),Quarq DZero,Wahoo Kickr,356,367,-11
79902,105720,2020-12-05 15:15:00,wahoo,Zwift - OH MY CRIT - Saturday Smash Race (A),Quarq DZero,Wahoo Kickr,372,367,5
121768,106184,2021-02-25 18:23:08,wahoo,Zwift - WTRL Team Time Trial - Zone 5 (C),Assioma,Wahoo Kickr V5 2021,347,345,2
39587,107740,2020-06-01 14:00:43,wahoo,Zwift - London - steam roller power up !!! :0),SRM DA7900 28130,kickr18,288,286,2
80429,107740,2020-12-06 15:58:47,wahoo,Zwift - Nations Challenge Presented By Toyota // South Africa (E),SRM DA7800,kickr18,318,328,-10
12983,108458,2020-02-08 09:15:01,wahoo,Assioma Duo / wahoo kickr 2016,Assioma Duo,wahoo kickr 2016,349,342,7
13068,108458,2020-02-08 15:15:02,wahoo,Zwift - OH CRIT!! - Saturday Smash Series (A),Assioma Left/Side,wahoo kickr 2016,444,452,-8
13069,108458,2020-02-08 17:00:00,wahoo,Zwift - Tour de Zwift: Stage 7 - Long Distance-2Place,Assioma Left/Side,wahoo kickr 2016,406,403,3
13109,108458,2020-02-09 09:00:01,wahoo,Zwift - Zwift Gran Fondo,Assioma Duo,wahoo kickr 2016,403,408,-5
13421,108458,2020-02-11 18:10:02,wahoo,Zwift - SZR iTT Winter Racing League (A)-Win...,Assioma Left/Side,wahoo kickr 2016,422,427,-5
13547,108458,2020-02-12 13:25:24,wahoo,Zwift - 3R Volcano Flat 50k Race (50km/31mi 202m) (A)-3 Place...,Assioma Duo,wahoo kickr 2016,437,434,3
13714,108458,2020-02-13 18:12:24,wahoo,Zwift - WTRL Team Time Trial (C)-WTRL Team Time Trial...,Assioma Left/Side,wahoo kickr 2016,401,427,-26
13958,108458,2020-02-14 16:30:01,wahoo,Zwift - BST Flying Cheetahs&#039; Race of Truth TT (A)-Win,Assioma Left/Side,wahoo kickr 2016,424,425,-1
14465,108458,2020-02-18 10:05:01,wahoo,Zwift - 3R SuperCRITical Race Series - Round 1of4 (A),Assioma Duo,wahoo kickr 2016,339,330,9
18207,108458,2020-03-12 18:20:15,wahoo,Zwift - WTRL Team Time Trial (C) - Team Volendam...,Assioma Left/Side,wahoo kickr 2016,419,419,0
18652,108458,2020-03-19 09:32:02,wahoo,Zwift - WTRL Team Time Trial (D) -WTRL Team TT Team  Pioneers...,Assioma Duo,wahoo kickr 2016,424,424,0
19021,108458,2020-03-21 12:00:00,wahoo,Zwift - Stage 4 - Longer Ride - Tour of Watopia 2020 - ,Assioma Duo,wahoo kickr 2016,450,450,0
19259,108458,2020-03-23 10:10:04,wahoo,Zwift - KISS at Base Training Ride (B) - 102km...,Assioma Duo,wahoo kickr 2016,319,316,3
20543,108458,2020-03-30 10:17:34,wahoo,Zwift - KISS at Base Training Ride (B) - 61km...,Assioma Duo,wahoo kickr 2016,362,348,14
22388,108458,2020-04-05 16:00:36,wahoo,Zwift -  Haute Route Watopia Stage 3 (E),Assioma Duo,wahoo kickr 2016,421,423,-2
22389,108458,2020-03-31 08:42:01,wahoo,Zwift - Oceania TT Tuesday (E),Assioma Duo,wahoo kickr 2016,421,403,18
23233,108458,2020-04-07 08:35:34,wahoo,Zwift - Oceania TT Tuesday (E),Assioma Duo,wahoo kickr 2016,417,429,-12
23235,108458,2020-04-09 09:28:09,wahoo,Zwift - WTRL Team Time Trial (C) - Pioneers...,Assioma Duo,wahoo kickr 2016,386,395,-9
65338,108458,2020-10-27 08:45:02,neo,Zwift - Zwift Racing League | WTRL - APAC (MEN) -  Division 1 (A),Assioma Duo,Tacx Neo Gen 1,398,388,10
66050,108458,2020-10-29 09:25:00,neo,Zwift - Espresso- WTRL TEAM TTT - PIONEERS...,Assioma Duo,Tacx Neo Gen 1,394,392,2
67628,108458,2020-11-03 18:26:31,neo,Zwift - Zwift Racing League | WTRL - Men&#039;s EMEA E2 DIVISION 2 (A),Assioma Duo,Tacx Neo Gen 1,397,391,6
67878,108458,2020-11-04 10:51:11,neo,1Zwift - KISS at Base Training Ride (C)-91 km...,Assioma Duo 60263,Tacx Neo Gen 1,295,296,-1
68220,108458,2020-11-05 18:20:00,neo,Zwift - WTRL Team Time Trial - Zone 5 (C)- WTRL Volendam,Assioma Duo,Tacx Neo Gen 1,396,396,0
70527,108458,2020-11-12 10:25:18,wahoo,Zwift - Espresso,Assioma Duo,Wahoo kickr Axis,404,411,-7
71583,108458,2020-11-15 09:43:02,wahoo,Zwift - ZA Tri: TT Race - 40k- phoe...,Assioma Duo,Wahoo kickr Axis,383,391,-8
72302,108458,2020-11-17 18:21:52,wahoo,Zwift - Zwift Racing League | WTRL - Men&#039;s EMEA E2 DIVISION 2 (A),Assioma Duo,Wahoo kickr Axis,395,401,-6
76804,108458,2020-11-26 08:20:00,wahoo,Zwift - WTRL NOPINZ WORLD TTT CHAMPIONSHIPS - Zone 1 (C),Assioma Duo,Wahoo kickr Axis,365,371,-6
76808,108458,2020-11-26 18:13:47,wahoo,Zwift - WTRL NOPINZ WORLD TTT CHAMPIONSHIPS - Zone 4 (C),Assioma Duo,Wahoo kickr Axis,371,381,-10
76813,108458,2020-11-28 09:00:26,wahoo,Zwift -  Flanders Toeristenkoers (A),Assioma Duo,Wahoo kickr Axis,400,404,-4
78503,108458,2020-12-01 18:27:29,wahoo,Zwift - Zwift Racing League | WTRL - Men&#039;s EMEA E2 DIVISION 2 (A),Assioma Duo,Wahoo kickr Axis,394,406,-12
78505,108458,2020-11-29 09:40:02,wahoo,Zwift - ZA Tri: TT Race - 40k ,Assioma Duo,Wahoo kickr Axis,396,402,-6
78981,108458,2020-12-03 18:21:01,wahoo,Zwift - WTRL Team Time Trial - Zone 5 (C)-Volendam...,Assioma Duo,Wahoo kickr Axis,406,417,-11
80677,108458,2020-12-08 10:07:17,wahoo,Zwift - Watopia-Base...,Assioma Duo,Wahoo kickr Axis,369,368,1
81253,108458,2020-12-09 20:40:31,wahoo,Zwift - Tri Aus TT (E),Assioma Duo,Wahoo kickr Axis,386,386,0
112785,108458,2021-02-10 10:25:26,wahoo,Zwift - Watopia-Base Ride With B. Brevet...,Assioma Duo,Wahoo kickr Axis,319,321,-2
117823,108458,2021-02-19 10:00:27,wahoo,Zwift - EVO CC AGUANTE 100km Ride [3.5-4.0w/kg avg] (B),Assioma Duo,Wahoo kickr Axis,306,311,-5
117824,108458,2021-02-18 10:42:16,wahoo,Zwift - ZHR Masters TT Series (E),Assioma Duo,Wahoo kickr Axis,398,401,-3
117826,108458,2021-02-11 18:29:02,wahoo,Zwift - WTRL Team Time Trial - Zone 6 (C)-Team Volendam...,Assioma Duo,Wahoo kickr Axis,391,396,-5
121533,108458,2021-02-27 08:24:36,wahoo,Zwift - Watopia-B.Brevet 173km,Assioma Duo,Wahoo kickr Axis,377,380,-3
121537,108458,2021-02-25 18:17:27,wahoo,Zwift - Vienna-WTRL TTT XtraTurboSnails...,Assioma Duo,Wahoo kickr Axis,391,388,3
37924,108895,2020-05-26 18:35:58,neo,Zwift - 3R & Wahoo Ride Real Race Series - Round 3 of 7 (B),Garmin Vector 2 pedals,Tacx Neo Gen 1,331,340,-9
38977,108895,2020-06-01 18:21:14,neo,Zwift - TFC Mad Monday Series (2 of 6) (B),Garmin Vector 2 pedals,Tacx Neo Gen 1,324,320,4
41294,108895,2020-06-12 18:01:13,neo,Zwift - The Friday Criterium Spring Race Series  (B),Garmin Vector 3 Pedals Dual Sided,Tacx Neo Gen 1,315,328,-13
41854,108895,2020-06-15 18:21:00,neo,Zwift - TFC Mad Monday Series (4 of 6) (B),Garmin Vector 3 Pedals Dual Sided,Tacx Neo Gen 1,341,347,-6
43129,108895,2020-06-22 18:21:00,neo,Zwift - TFC Mad Monday Series (5 of 6) (B),Garmin Vector 3 Pedals Dual Sided,Tacx Neo Gen 1,343,355,-12
58326,108895,2020-09-29 18:41:12,neo,Zwift - 3R Sundown Race Series  (B),Garmin Vector 3 Pedals Dual Sided,Tacx Neo Gen 1,338,347,-9
75095,108895,2020-11-24 18:16:26,neo,Zwift - Zwift Racing League | WTRL - Men&#039;s EMEA E1 DIVISION 1,Garmin Vector 3 Pedals Dual Sided,Tacx Neo Gen 1,323,333,-10
96398,108895,2021-01-13 17:27:24,neo,Zwift - 3R & British Cycling South West - Series 2 (B),Garmin Vector 3 Pedals Dual Sided,Tacx Neo Gen 1,322,321,1
105176,109035,2021-01-29 17:00:12,neo,Zwift - TDZ Stage 6: Longer Ride,FSA Powerbox,Neo 1,372,367,5
117766,109035,2021-02-17 18:29:43,neo,Zwift - NCF Vintercup 2021 - Runde 6 - Herrer (A),FSA Powerbox,Neo 1,373,364,9
36379,109392,2020-05-20 14:49:51,wahoo,Z PRO TRI Race series: Men&#039;s A Race 6 (A),Rotor 2inPower,Wahoo Kickr,362,366,-4
61144,110351,2020-10-12 09:50:21,wahoo,Zwift - KISS at Base Training Ride (B),4iiii,kickr,252,255,-3
78544,110351,2020-12-02 11:39:59,wahoo,Zwift - DIRT Watts Up Wednesday Ride (C),4iiii,kickr,287,287,0
119430,110351,2021-02-23 11:04:55,wahoo,Zwift - MGCC Ride & Race (B),4iiii,kickr,348,360,-12
126081,110351,2021-03-09 11:05:08,wahoo,Zwift - MGCC Ride & Race (B),4iiii,kickr,324,344,-20
129538,110351,2021-03-17 09:29:57,wahoo,Zwift - USA Cycling Coffee with Hot Espresso Presented by Team ODZ (C),4iiii,kickr,315,332,-17
99524,110979,2021-01-18 19:07:57,wahoo,Zwift - AHDR Bacon Rolls (B),Stages single sided,Kickr,325,332,-7
119158,110979,2021-02-22 19:20:02,wahoo,Zwift - ZSUN Chain Gang (B),Stages single sided,Kickr,289,292,-3
128671,110979,2021-03-15 12:48:14,wahoo,40/20s,Stages single sided,Kickr,364,350,14
129685,110979,2021-03-17 17:00:02,wahoo,Zwift - EVO CC Mini Vamos! 90 Min Ride Cat C [~2.8-3.2w/kg avg] (C),Stages single sided,Kickr,332,327,5
53199,111338,2020-09-03 10:40:17,wahoo,Zwift - DIRT Doozy Race (A),4ii Power Meter,Wahoo Kickr Core,415,416,-1
55137,111338,2020-09-14 17:59:54,wahoo,Zwift - Invitational League // Qualifying Race #1,4ii Power Meter,Wahoo Kickr Core,440,432,8
55439,111338,2020-09-15 20:15:16,wahoo,Zwift - JETT ZWIFT Morning Race (A),4iii Power Meter,Wahoo Kickr Core,311,322,-11
55942,111338,2020-09-17 18:30:12,wahoo,Zwift - Invitational League // Qualifying Race #2 (Men) ,4iii Power Meter,Wahoo Kickr Core,382,412,-30
59229,111338,2020-10-03 12:17:53,wahoo,Zwift - London,4iii Power Meter,Wahoo Kickr Core,204,211,-7
59250,111338,2020-10-03 13:18:51,wahoo,Zwift - Watopia,4iii Power Meter,Wahoo Kickr Core,419,437,-18
61340,111338,2020-10-12 18:49:01,wahoo,Zwift - Premier Division // Zwift Racing League (men) ,4iii Power Meter,Wahoo Kickr Core,434,458,-24
117348,111338,2021-02-18 19:00:21,wahoo,Zwift - FLANDERS The BZR Ronde Watopian League (A),4iii Power Meter,Wahoo Kickr Core,409,409,0
119455,111338,2021-02-23 13:29:57,wahoo,Zwift - ZHQ FutureWorks Circuit Race - Anti-sandbagging (A),4iii Power Meter,Wahoo Kickr Core,287,286,1
119880,111338,2021-02-23 18:14:58,wahoo,Zwift - Zwift Racing League | WTRL - Men&#039;s/Mixed EMEA E1 DIVISION 1 (A),4iii Power Meter,Wahoo Kickr Core,414,413,1
121888,111338,2021-02-27 21:09:58,wahoo,Zwift - 3R Gotham Grind Flat Race - 3 Laps (27.8km/17.4mi 87m) (A),4iii Power Meter,Wahoo Kickr Core,401,395,6
123198,111338,2021-03-02 18:18:28,wahoo,Zwift - Zwift Racing League | WTRL - Men&#039;s/Mixed EMEA E1 DIVISION 1 (A),4iii Power Meter,Wahoo Kickr Core,417,403,14
125851,111338,2021-03-08 19:19:54,wahoo,Zwift - Team TFC Mad Monday Race Series (high-end categories) (A),4iii Power Meter,Wahoo Kickr Core,442,422,20
127095,111338,2021-03-11 18:15:55,wahoo,Zwift - 03/11/2021,4iii Power Meter,Wahoo Kickr Core,406,406,0
128796,111338,2021-03-15 19:19:57,wahoo,Zwift - Team TFC Mad Monday Race Series (high-end categories) (A),4iii Power Meter,Wahoo Kickr Core,428,431,-3
102050,113057,2021-01-23 19:54:07,wahoo,Initial Kickr/Stages dual record test,Stages,Kickr,140,143,-3
58177,113401,2020-09-29 09:39:06,wahoo,Zwift - France,Quarq Elsa,Wahoo Kickr Core,219,223,-4
59772,113401,2020-10-06 11:24:35,wahoo,ODZ Covfefe,Quarq Elsa,Wahoo Kickr 5.0,290,291,-1
60100,113401,2020-10-07 17:42:48,wahoo,Zwift - DCU powered by Feltet.dk (A),Quarq Elsa,Wahoo Kickr 5.0,340,341,-1
60257,113401,2020-10-08 09:33:11,wahoo,ZADA Three sisters test,Quarq Elsa,Wahoo Kickr 5.0,372,373,-1
60308,113401,2020-10-08 16:00:18,wahoo,Zwift - OH MY CRIT! - The Double Race 2/2 (A),Quarq Elsa,Wahoo Kickr 5.0,374,374,0
60368,113401,2020-10-08 17:27:42,wahoo,Zwift - FUSION ECT BEUNSTOPPABLE Racing Series (A),Quarq Elsa,Wahoo Kickr 5.0,320,329,-9
61027,113401,2020-10-11 17:19:42,wahoo,Zwift - 3R Greater London 8 Hilly Race - 1 Lap (23.8km/14.8mi 238m) (A),Quarq Elsa,Wahoo Kickr 5.0,400,408,-8
61180,113401,2020-10-12 17:14:30,wahoo,Zwift - DBR Ride´N´Roll League (A),Quarq Elsa,Wahoo Kickr 5.0,331,332,-1
61866,113401,2020-10-14 16:57:42,wahoo,Zwift - MIDWEEK Autumn Series by SZR (A),Quarq Elsa,Wahoo Kickr 5.0,382,381,1
61899,113401,2020-10-14 17:59:55,wahoo,DBR HEINO CUP III,Quarq Elsa,Wahoo Kickr 5.0,324,324,0
62120,113401,2020-10-15 16:04:47,wahoo,Zwift - OH MY CRIT! - The Double Race 2/2 (A),Quarq Elsa,Wahoo Kickr 5.0,369,376,-7
62217,113401,2020-10-15 17:29:46,wahoo,Zwift - FUSION ECT BEUNSTOPPABLE Racing Series (A),Quarq Elsa,Wahoo Kickr 5.0,369,374,-5
62375,113401,2020-10-16 09:25:22,wahoo,Zwift - DIRT Friday Morning Sprintapalooza (C),Quarq Elsa,Wahoo Kickr 5.0,236,237,-1
62626,113401,2020-10-17 14:11:12,wahoo,Zwift - OH MY CRIT - Saturday Smash Race (A),Quarq Elsa,Wahoo Kickr 5.0,363,368,-5
62874,113401,2020-10-18 13:14:47,wahoo,Zwift - KISS at Race 100 - Americas (A),Quarq Elsa,Wahoo Kickr 5.0,338,339,-1
62893,113401,2020-10-18 16:05:13,wahoo,Zwift - 3R Tick Tock Flat Race - 1 Lap (19km/11.8mi 50m) (A),Quarq Elsa,Wahoo Kickr 5.0,313,315,-2
63422,113401,2020-10-20 17:30:22,wahoo,WTRL Racing,Quarq Elsa,Wahoo Kickr 5.0,384,388,-4
63818,113401,2020-10-21 16:57:01,wahoo,Zwift - MIDWEEK Autumn Series by SZR (A),Quarq Elsa,Wahoo Kickr 5.0,365,370,-5
63898,113401,2020-10-21 18:03:16,wahoo,DBR HEINO CUP III,Quarq Elsa,Wahoo Kickr 5.0,321,320,1
64157,113401,2020-10-22 16:04:14,wahoo,Zwift - OH MY CRIT! - The Double Race 2/2 (A),Quarq Elsa,Wahoo Kickr 5.0,351,354,-3
64332,113401,2020-10-23 09:32:07,wahoo,Zwift - DIRT Friday Morning Sprintapalooza (C),Quarq Elsa,Wahoo Kickr 5.0,242,244,-2
64648,113401,2020-10-24 14:13:20,wahoo,Zwift - OH MY CRIT - Saturday Smash Race (A),Quarq Elsa,Wahoo Kickr 5.0,344,345,-1
65211,113401,2020-10-26 19:54:52,wahoo,Dropout on secondary Zwift - Premier Division // Zwift Racing League (men) (A),Quarq Elsa,Wahoo Kickr 5.0,373,378,-5
65797,113401,2020-10-28 17:58:46,wahoo,Zwift - MIDWEEK Autumn Series by SZR (A),Quarq Elsa,Wahoo Kickr 5.0,343,343,0
66104,113401,2020-10-29 17:02:45,wahoo,Zwift - OH MY CRIT! - The Double Race 2/2 (A),Quarq Elsa,Wahoo Kickr 5.0,360,358,2
66179,113401,2020-10-29 18:27:34,wahoo,FUSION ECT BEUNSTOPPABLE Racing Series,Quarq Elsa,Wahoo Kickr 5.0,369,371,-2
66411,113401,2020-10-30 12:25:03,wahoo,Zwift - DIRT Friday Pacific Sprintapalooza  (C),Quarq Elsa,Wahoo Kickr 5.0,247,248,-1
66708,113401,2020-10-31 15:15:05,wahoo,Zwift - OH MY CRIT - Saturday Smash Race (A),Quarq Elsa,Wahoo Kickr 5.0,346,341,5
66963,113401,2020-11-01 13:15:16,wahoo,Zwift - KISS at Race 100 - Americas (A),Quarq Elsa,Wahoo Kickr 5.0,350,349,1
66987,113401,2020-11-01 16:05:14,wahoo,Zwift - 3R Tick Tock Flat Race - 1 Lap (19km/11.8mi 50m) (A),Quarq Elsa,Wahoo Kickr 5.0,325,328,-3
67527,113401,2020-11-03 12:14:51,wahoo,Zwift - ODZ Covfefe (C),Quarq Elsa,Wahoo Kickr 5.0,339,341,-2
68016,113401,2020-11-04 17:59:51,wahoo,Zwift - MIDWEEK Autumn Series by SZR (A),Quarq Elsa,Wahoo Kickr 5.0,328,330,-2
68178,113401,2020-11-05 17:03:18,wahoo,Zwift - OH MY CRIT! - The Double Race 2/2 (A),Quarq Elsa,Wahoo Kickr 5.0,360,360,0
68806,113401,2020-11-07 15:14:41,wahoo,Zwift - OH MY CRIT - Saturday Smash Race (A),Quarq Elsa,Wahoo Kickr 5.0,361,363,-2
68992,113401,2020-11-08 08:57:26,wahoo,Zwift - Zwift Fondo Series 2020/21: Gran Fondo ,Quarq Elsa,Wahoo Kickr 5.0,358,363,-5
69623,113401,2020-11-10 10:57:58,wahoo,Small dropouts on primary Zwift - KISS at Race - Americas AM (A),Quarq Elsa,Wahoo Kickr 5.0,375,387,-12
69648,113401,2020-11-10 12:14:54,wahoo,Zwift - ODZ Covfefe (C),Quarq Elsa,Wahoo Kickr 5.0,343,346,-3
70281,113401,2020-11-11 17:55:41,wahoo,Zwift - MIDWEEK Autumn Series by SZR (A),Quarq Elsa,Wahoo Kickr 5.0,348,355,-7
70306,113401,2020-11-11 18:49:29,wahoo,Zwift - DCU – Feltet.dk November series (A),Quarq Elsa,Wahoo Kickr 5.0,362,363,-1
70653,113401,2020-11-12 17:04:43,wahoo,Zwift - OH MY CRIT! - The Double Race 2/2 (A),Quarq Elsa,Wahoo Kickr 5.0,328,320,8
70815,113401,2020-11-12 18:29:37,wahoo,Zwift - FUSION ECT BEUNSTOPPABLE Racing Series (A),Quarq Elsa,Wahoo Kickr 5.0,292,298,-6
71409,113401,2020-11-14 15:15:12,wahoo,Zwift - OH MY CRIT - Saturday Smash Race (A),Quarq Elsa,Wahoo Kickr 5.0,337,334,3
72645,113401,2020-11-18 18:58:10,wahoo,Zwift - DCU – Feltet.dk November series (A),Quarq Elsa,Wahoo Kickr 5.0,352,353,-1
73150,113401,2020-11-19 19:13:49,wahoo,Zwift - World Championships Experience // Danish Cycling Federation,Quarq Elsa,Wahoo Kickr 5.0,360,359,1
73408,113401,2020-11-20 10:25:07,wahoo,Zwift - DIRT Friday Morning Sprintapalooza (C),Quarq Elsa,Wahoo Kickr 5.0,236,238,-2
74691,113401,2020-11-23 19:44:48,wahoo,Dropout on secondary in sprint. Zwift - Premier Division // Zwift Racing League (men) (A),Quarq Elsa,Wahoo Kickr 5.0,410,414,-4
75521,113401,2020-11-25 17:52:59,wahoo,Dropout on secondary Zwift - MIDWEEK Autumn Series by SZR (A),Quarq Elsa,Wahoo Kickr 5.0,360,370,-10
75591,113401,2020-11-25 18:56:51,wahoo,Zwift - DCU – Feltet.dk November series (A),Quarq Elsa,Wahoo Kickr 5.0,354,359,-5
75918,113401,2020-11-26 16:10:46,wahoo,Zwift - OH MY CRIT! - The Double Race 1/2 (A),Quarq Elsa,Wahoo Kickr 5.0,345,348,-3
75941,113401,2020-11-26 17:02:40,wahoo,OH MY CRIT! - The Double Race 2/2,Quarq Elsa,Wahoo Kickr 5.0,326,327,-1
76996,113401,2020-11-28 15:13:30,wahoo,Zwift - OH MY CRIT - Saturday Smash Race (A),Quarq Elsa,Wahoo Kickr 5.0,351,350,1
77307,113401,2020-11-29 14:13:50,wahoo,Zwift - KISS 100 Race Series - Americas (A),Quarq Elsa,Wahoo Kickr 5.0,325,318,7
77642,113401,2020-11-30 18:29:44,wahoo,Zwift - Frenchy Fuzion Watopia Tour - Etape 1 (E),Quarq Elsa,Wahoo Kickr 5.0,348,355,-7
78569,113401,2020-12-02 17:55:34,wahoo,Zwift - MIDWEEK Winter Series by SZR (A),Quarq Elsa,Wahoo Kickr 5.0,346,350,-4
78900,113401,2020-12-03 16:10:38,wahoo,Zwift - OH MY CRIT! - The Double Race 1/2 (A),Quarq Elsa,Wahoo Kickr 5.0,368,368,0
78924,113401,2020-12-03 16:53:57,wahoo,Zwift - OH MY CRIT! - The Double Race 2/2 (A),Quarq Elsa,Wahoo Kickr 5.0,358,361,-3
79003,113401,2020-12-03 18:25:05,wahoo,Zwift - FUSION DECEMBER CUP (A),Quarq Elsa,Wahoo Kickr 5.0,306,309,-3
79802,113401,2020-12-05 15:12:18,wahoo,Zwift - OH MY CRIT - Saturday Smash Race (A),Quarq Elsa,Wahoo Kickr 5.0,367,369,-2
80486,113401,2020-12-07 18:14:21,wahoo,Dropout on secondary in sprint - Zwift -  DBR Monday Race (A),Quarq Elsa,Wahoo Kickr 5.0,332,333,-1
80526,113401,2020-12-07 19:16:17,wahoo,Zwift - Team TFC Mad Monday Races (A),Quarq Elsa,Wahoo Kickr 5.0,346,346,0
81089,113401,2020-12-09 17:59:48,wahoo,Zwift - MIDWEEK Winter Series by SZR (A),Quarq Elsa,Wahoo Kickr 5.0,375,379,-4
81515,113401,2020-12-10 17:02:46,wahoo,Zwift - OH MY CRIT! - The Double Race 2/2 (A),Quarq Elsa,Wahoo Kickr 5.0,362,362,0
81624,113401,2020-12-10 18:29:36,wahoo,Dropout on secondary in sprint. Zwift - FUSION DECEMBER CUP (A),Quarq Elsa,Wahoo Kickr 5.0,357,362,-5
81883,113401,2020-12-11 10:24:43,wahoo,Zwift - DIRT Friday Morning Sprintapalooza (C),Quarq Elsa,Wahoo Kickr 5.0,228,228,0
82397,113401,2020-12-12 15:12:59,wahoo,Zwift - OH MY CRIT - Saturday Smash Race (A),Quarq Elsa,Wahoo Kickr 5.0,405,414,-9
82829,113401,2020-12-13 17:18:34,wahoo,Zwift - 3R Racing (A),Quarq Elsa,Wahoo Kickr 5.0,378,377,1
83195,113401,2020-12-14 19:17:40,wahoo,Zwift - Team TFC Mad Monday Winter Series (A),Quarq Elsa,Wahoo Kickr 5.0,338,339,-1
83996,113401,2020-12-16 17:55:23,wahoo,Zwift - MIDWEEK Winter Series by SZR (A),Quarq Elsa,Wahoo Kickr 5.0,360,362,-2
84290,113401,2020-12-17 16:11:46,wahoo,Zwift - OH MY CRIT! - The Double Race 1/2 (A),Quarq Elsa,Wahoo Kickr 5.0,393,393,0
84317,113401,2020-12-17 17:01:26,wahoo,Zwift - OH MY CRIT! - The Double Race 2/2 (A),Quarq Elsa,Wahoo Kickr 5.0,372,376,-4
84408,113401,2020-12-17 18:21:30,wahoo,Zwift - FUSION DECEMBER CUP (A),Quarq Elsa,Wahoo Kickr 5.0,332,337,-5
85110,113401,2020-12-19 15:12:22,wahoo,Zwift - OH MY CRIT - Saturday Smash Race (A),Quarq Elsa,Wahoo Kickr 5.0,412,416,-4
85456,113401,2020-12-20 14:14:26,wahoo,Dropout on secondary in sprint. Zwift - KISS 100 Race Series - Americas (A),Quarq Elsa,Wahoo Kickr 5.0,315,318,-3
86049,113401,2020-12-22 11:10:14,wahoo,Zwift - Japan Zwift Tuesday Race (A),Quarq Elsa,Wahoo Kickr 5.0,376,378,-2
86073,113401,2020-12-22 12:24:01,wahoo,Zwift - Team ODZ Tuesday Coffee and Espresso Ride (C),Quarq Elsa,Wahoo Kickr 5.0,340,343,-3
86402,113401,2020-12-23 10:44:54,wahoo,Zwift - USA Cycling Race League by Indoor Specialist (A),Quarq Elsa,Wahoo Kickr 5.0,334,338,-4
86422,113401,2020-12-23 12:30:13,wahoo,Forget to start garmin. Only recorded last 5 min. Zwift - 3R LaGuardia Loop Flat Race - 10 Laps (28.3km/17.6mi 270m) (A),Quarq Elsa,Wahoo Kickr 5.0,315,315,0
86874,113401,2020-12-24 10:59:59,wahoo,Still having dropout problems. Zwift - KISS Race Series - Americas AM (A),Quarq Elsa,Wahoo Kickr 5.0,350,355,-5
87465,113401,2020-12-26 15:14:51,wahoo,OH MY CRIT - Saturday Smash Race,Quarq Elsa,Wahoo Kickr 5.0,359,362,-3
87903,113401,2020-12-27 14:14:01,wahoo,Zwift - KISS 100 Race Series - Americas (A),Quarq Elsa,Wahoo Kickr 5.0,356,359,-3
88487,113401,2020-12-29 10:58:50,wahoo,Zwift - KISS Race Series - Americas AM (A),Quarq Elsa,Wahoo Kickr 5.0,339,340,-1
88926,113401,2020-12-30 09:59:46,wahoo,Zwift - EVR Definitely Not the WTNC (A),Quarq Elsa,Wahoo Kickr 5.0,349,353,-4
88977,113401,2020-12-30 12:27:27,wahoo,Zwift - 3R LaGuardia Loop Flat Race - 10 Laps (28.3km/17.6mi 270m) (A),Quarq Elsa,Wahoo Kickr 5.0,336,341,-5
89507,113401,2020-12-31 16:13:05,wahoo,New trainer firmware - Zwift - OH MY CRIT! - The Double Race 1/2 (A),Quarq Elsa,Wahoo Kickr 5.0,337,342,-5
90260,113401,2021-01-02 15:13:20,wahoo,Zwift - OH MY CRIT - Saturday Smash Race (A),Quarq Elsa,Wahoo Kickr 5.0,360,366,-6
90861,113401,2021-01-03 14:14:44,wahoo,Zwift - KISS 100 Race Series - Americas (A),Quarq Elsa,Wahoo Kickr 5.0,313,320,-7
91601,113401,2021-01-05 10:58:12,wahoo,Zwift - KISS Race Series - Americas AM (A),Quarq Elsa,Wahoo Kickr 5.0,381,387,-6
92304,113401,2021-01-06 17:56:52,wahoo,Zwift - MIDWEEK Winter Series by SZR (A),Quarq Elsa,Wahoo Kickr 5.0,341,347,-6
92774,113401,2021-01-07 17:03:18,wahoo,Zwift - OH MY CRIT! - The Double Race 2/2 (A),Quarq Elsa,Wahoo Kickr 5.0,361,367,-6
92926,113401,2021-01-07 18:29:52,wahoo,Secondary fckup in sprint. Zwift - FUSION WINTER CUP (A),Quarq Elsa,Wahoo Kickr 5.0,333,343,-10
93260,113401,2021-01-08 10:25:13,wahoo,Zwift - DIRT Friday Morning Sprintapalooza (C),Quarq Elsa,Wahoo Kickr 5.0,231,228,3
93262,113401,2021-01-08 12:16:15,wahoo,Small test of dzero and kickr,Quarq dzero,Wahoo Kickr 5.0,244,239,5
93902,113401,2021-01-09 15:12:42,wahoo,Zwift - OH MY CRIT - Saturday Smash Race (A),Quarq Elsa,Wahoo Kickr 5.0,355,362,-7
94992,113401,2021-01-11 19:09:40,wahoo,Zwift - Premier Division // Zwift Racing League (men) (A),Quarq Elsa,Wahoo Kickr 5.0,349,357,-8
95430,113401,2021-01-12 11:00:16,wahoo,Kickr test vs Dzero Zwift - TDZ Stage 2: Longer Ride,Quarq dzero,Wahoo Kickr 5.0,270,268,2
96144,113401,2021-01-13 09:55:09,wahoo,Zwift - Innsbruck,Quarq Elsa,Wahoo Kickr 5.0,264,265,-1
96429,113401,2021-01-13 18:44:30,wahoo,Zwift - Danmarks Cykle Union & Partners 1/6 (A),Quarq Elsa,Wahoo Kickr 5.0,360,358,2
96870,113401,2021-01-14 16:12:24,wahoo,Small dropout on secondary in last minute. Zwift - OH MY CRIT! - The Double Race 1/2 (A),Quarq Elsa,Wahoo Kickr 5.0,351,350,1
96889,113401,2021-01-14 17:03:33,wahoo,Zwift - OH MY CRIT! - The Double Race 2/2 (A),Quarq Elsa,Wahoo Kickr 5.0,350,351,-1
97360,113401,2021-01-15 10:25:22,wahoo,Zwift - DIRT Friday Morning Sprintapalooza (C),Quarq Elsa,Wahoo Kickr 5.0,229,228,1
98027,113401,2021-01-16 15:11:12,wahoo,Zwift - OH MY CRIT - Saturday Smash Race (A),Quarq Elsa,Wahoo Kickr 5.0,343,337,6
98104,113401,2021-01-16 16:29:21,wahoo,Zwift - TEAM VEGAN Tofu Tornado (A),Quarq Elsa,Wahoo Kickr 5.0,372,366,6
98562,113401,2021-01-17 14:14:09,wahoo,Zwift - KISS 100 Race Series - Americas (A),Quarq Elsa,Wahoo Kickr 5.0,338,330,8
99514,113401,2021-01-19 11:00:13,wahoo,Zwift - KISS Race Series - Americas AM (A),Quarq Elsa,Wahoo Kickr 5.0,377,380,-3
100323,113401,2021-01-20 18:44:50,wahoo,Zwift - Danmarks Cykle Union & Partners 2/6 (A),Quarq Elsa,Wahoo Kickr 5.0,374,371,3
100810,113401,2021-01-21 16:13:21,wahoo,Zwift - OH MY CRIT! - The Double Race 1/2 (A),Quarq Elsa,Wahoo Kickr 5.0,361,357,4
101912,113401,2021-01-23 15:12:24,wahoo,Zwift - OH MY CRIT!! - Saturday Smash Race (A),Quarq Elsa,Wahoo Kickr 5.0,361,363,-2
103003,113401,2021-01-25 18:59:05,wahoo,Zwift - Premier Division // Zwift Racing League (men) (A),Quarq Elsa,Wahoo Kickr 5.0,355,361,-6
104167,113401,2021-01-27 18:43:56,wahoo,Zwift - Danmarks Cykle Union & Partners 3/6 (A),Quarq Elsa,Wahoo Kickr 5.0,369,368,1
104596,113401,2021-01-28 17:04:03,wahoo,Zwift - OH MY CRIT!! - The Double Race 2/2 (A),Quarq Elsa,Wahoo Kickr 5.0,343,346,-3
104725,113401,2021-01-28 18:27:52,wahoo,Zwift - FUSION WINTER CUP (A),Quarq Elsa,Wahoo Kickr 5.0,385,383,2
105640,113401,2021-01-30 15:13:31,wahoo,Zwift - OH MY CRIT!! - Saturday Smash Race (A),Quarq Elsa,Wahoo Kickr 5.0,356,353,3
105689,113401,2021-01-30 16:36:16,wahoo,Crit City Race,Quarq Elsa,Wahoo Kickr 5.0,360,362,-2
106920,113401,2021-02-01 20:06:15,wahoo,Zwift - Premier Division // Zwift Racing League (men) (A),Quarq Elsa,Wahoo Kickr 5.0,347,357,-10
107951,113401,2021-02-03 10:40:32,wahoo,Zwift - The Morning Grind by STPC (A),Quarq Elsa,Wahoo Kickr 5.0,326,332,-6
108231,113401,2021-02-03 18:44:03,wahoo,Zwift - Danmarks Cykle Union & Partners 4/6 (A),Quarq Elsa,Wahoo Kickr 5.0,361,364,-3
108771,113401,2021-02-04 17:04:33,wahoo,Zwift - OH MY CRIT!! - The Double Race 2/2 (A),Quarq Elsa,Wahoo Kickr 5.0,373,375,-2
109912,113401,2021-02-06 15:13:02,wahoo,Zwift - OH MY CRIT!! - Saturday Smash Race (A),Quarq Elsa,Wahoo Kickr 5.0,389,390,-1
110518,113401,2021-02-07 14:13:18,wahoo,Zwift - KISS 100 Race Series - Americas (A),Quarq Elsa,Wahoo Kickr 5.0,384,384,0
111657,113401,2021-02-09 18:49:55,wahoo,Small dropout on secondary in last minute. Zwift - Team Italy & Frenchy Fuzion League (A),Quarq Elsa,Wahoo Kickr 5.0,339,344,-5
112306,113401,2021-02-10 18:41:08,wahoo,Zwift - Danmarks Cykle Union & Partners 5/6 (A),Quarq Elsa,Wahoo Kickr 5.0,370,369,1
112850,113401,2021-02-11 17:01:52,wahoo,Zwift - OH MY CRIT!! - The Double Race 2/2 (A),Quarq Elsa,Wahoo Kickr 5.0,366,369,-3
113026,113401,2021-02-11 18:28:46,wahoo,Zwift - FUSION WINTER CUP (A),Quarq Elsa,Wahoo Kickr 5.0,352,353,-1
114144,113401,2021-02-13 15:12:51,wahoo,Zwift - OH MY CRIT!! - Saturday Smash Race (A),Quarq Elsa,Wahoo Kickr 5.0,382,383,-1
114316,113401,2021-02-13 18:02:47,wahoo,Zwift - 3R Three Sisters Hilly Race (47km/29.2mi 879m) (A),Quarq Elsa,Wahoo Kickr 5.0,383,382,1
115650,113401,2021-02-16 10:57:33,wahoo,Zwift - KISS Race Series - Americas AM (A),Quarq Elsa,Wahoo Kickr 5.0,327,321,6
116422,113401,2021-02-17 10:43:26,wahoo,Zwift - The Morning Grind by STPC (A),Quarq Elsa,Wahoo Kickr 5.0,373,370,3
116685,113401,2021-02-17 18:43:24,wahoo,Zwift - Danmarks Cykle Union & Partners 6/6 (A),Quarq Elsa,Wahoo Kickr 5.0,348,342,6
117188,113401,2021-02-18 17:04:21,wahoo,Zwift - OH MY CRIT!! - The Double Race 2/2 (A),Quarq Elsa,Wahoo Kickr 5.0,379,376,3
117262,113401,2021-02-18 18:37:03,wahoo,Zwift - The Breaks Indoor Racing Tour (A),Quarq Elsa,Wahoo Kickr 5.0,334,331,3
117647,113401,2021-02-19 10:24:56,wahoo,Zwift - DIRT Friday Morning Sprintapalooza (C),Quarq Elsa,Wahoo Kickr 5.0,229,230,-1
118049,113401,2021-02-20 08:04:00,wahoo,Zwift - 3R Weekend Race Club - Race 1 (A),Quarq Elsa,Wahoo Kickr 5.0,331,333,-2
119125,113401,2021-02-22 19:07:25,wahoo,Zwift - Premier Division // Zwift Racing League (men) (A),Quarq Elsa,Wahoo Kickr 5.0,348,354,-6
120333,113401,2021-02-24 18:44:30,wahoo,Zwift - Scandinavian Cup 2021 - Round 1 - Men (A),Quarq Elsa,Wahoo Kickr 5.0,329,338,-9
120713,113401,2021-02-25 17:02:36,wahoo,Zwift - OH MY CRIT!! - The Double Race 2/2 (A),Quarq Elsa,Wahoo Kickr 5.0,364,362,2
120826,113401,2021-02-25 18:28:24,wahoo,Zwift - FUSION WINTER CUP (A),Quarq Elsa,Wahoo Kickr 5.0,371,370,1
121633,113401,2021-02-27 15:14:30,wahoo,Zwift - OH MY CRIT!! - Saturday Smash Race (A),Quarq Elsa,Wahoo Kickr 5.0,347,347,0
122612,113401,2021-03-01 20:16:45,wahoo,Zwift - Premier Division // Zwift Racing League (men) (A),Quarq Elsa,Wahoo Kickr 5.0,358,359,-1
123645,113401,2021-03-03 18:43:11,wahoo,Zwift - Scandinavian Cup 2021 - Round 2 - Men (A),Quarq Elsa,Wahoo Kickr 5.0,357,359,-2
123963,113401,2021-03-04 16:12:23,wahoo,Zwift - OH MY CRIT!! - The Double Race 1/2 (A),Quarq Elsa,Wahoo Kickr 5.0,362,364,-2
123980,113401,2021-03-04 17:02:04,wahoo,Zwift - OH MY CRIT!! - The Double Race 2/2 (A),Quarq Elsa,Wahoo Kickr 5.0,357,355,2
125005,113401,2021-03-06 15:10:31,wahoo,Zwift - OH MY CRIT!! - Saturday Smash Race (A),Quarq Elsa,Wahoo Kickr 5.0,348,345,3
125320,113401,2021-03-07 09:04:53,wahoo,Zwift - Newbury Velo Road Race (A),Quarq Elsa,Wahoo Kickr 5.0,352,351,1
126032,113401,2021-03-09 10:57:44,wahoo,Zwift - KISS Race Series - Americas AM (A),Quarq Elsa,Wahoo Kickr 5.0,339,342,-3
126599,113401,2021-03-10 18:43:01,wahoo,Zwift - Scandinavian Cup 2021 - Round 3 - Men (A),Quarq Elsa,Wahoo Kickr 5.0,370,369,1
126997,113401,2021-03-11 17:03:04,wahoo,Zwift - OH MY CRIT!! - The Double Race 2/2 (A),Quarq Elsa,Wahoo Kickr 5.0,350,347,3
127137,113401,2021-03-11 18:27:03,wahoo,Zwift - FUSION SPRING CUP (A),Quarq Elsa,Wahoo Kickr 5.0,354,354,0
127444,113401,2021-03-12 13:24:41,wahoo,Zwift - DIRT Friday Pacific Sprintapalooza  (C),Quarq Elsa,Wahoo Kickr 5.0,244,239,5
127782,113401,2021-03-13 09:54:18,wahoo,Zwift - Cycling Ireland eRacing Spring League Rd 3 (A),Quarq Elsa,Wahoo Kickr 5.0,375,377,-2
128424,113401,2021-03-14 14:14:51,wahoo,Zwift - KISS 100 Race Series (Americas) (A),Quarq Elsa,Wahoo Kickr 5.0,348,346,2
129161,113401,2021-03-16 18:28:52,wahoo,Zwift - CeramicSpeed Race Series: Open Race (A),Quarq Elsa,Wahoo Kickr 5.0,378,379,-1
129759,113401,2021-03-17 18:44:42,wahoo,Zwift - Scandinavian Cup 2021 - Round 4 - Men (A),Quarq Elsa,Wahoo Kickr 5.0,344,339,5
106288,114291,2021-01-31 14:12:23,wahoo,Zwift - KISS 100 Race Series - Americas (A),Garmin Vector 3 Dual,Wahoo Kickr Core,469,467,2
107783,114291,2021-02-03 02:57:54,wahoo,Zwift - Zwift Racing League | WTRL - Men&#039;s/Mixed AMERICAS W DIVISION 1 (A),Garmin Vector 3 Dual,Wahoo Kickr Core,447,442,5
109969,114291,2021-02-06 15:13:05,wahoo,Zwift - OH MY CRIT!! - Saturday Smash Race (A),Garmin Vector 3 Dual,Wahoo Kickr Core,485,484,1
110531,114291,2021-02-07 14:12:52,wahoo,Zwift - KISS 100 Race Series - Americas (A),Garmin Vector 3 Dual,Wahoo Kickr Core,473,471,2
111946,114291,2021-02-10 03:06:30,wahoo,Zwift - Zwift Racing League | WTRL - Men&#039;s/Mixed AMERICAS W DIVISION 1 (A),Garmin Vector 3 Dual,Wahoo Kickr Core,438,444,-6
114225,114291,2021-02-13 15:12:49,wahoo,Zwift - OH MY CRIT!! - Saturday Smash Race (A),Garmin Vector 3 Dual,Wahoo Kickr Core,448,452,-4
114777,114291,2021-02-14 14:14:28,wahoo,Zwift - KISS 100 Race Series - Americas (A),Garmin Vector 3 Dual,Wahoo Kickr Core,404,412,-8
120014,114291,2021-02-24 02:59:00,wahoo,Zwift - Zwift Racing League | WTRL - Men&#039;s/Mixed AMERICAS W DIVISION 1 (A),Garmin Vector 3 Dual,Wahoo Kickr Core,381,382,-1
123314,114291,2021-03-03 03:06:07,wahoo,Zwift - Zwift Racing League | WTRL - Men&#039;s/Mixed AMERICAS W DIVISION 1 (A),Garmin Vector 3 Dual,Wahoo Kickr Core,404,387,17
124602,114291,2021-03-05 19:03:07,wahoo,Zwift - Zwift Racing League | WTRL Battle Royale Playoff - Men&#039;s Points Race (A),Garmin Vector 3 Dual,Wahoo Kickr Core,432,432,0
9554,115080,2020-01-15 18:59:57,wahoo,Zwift - FIETS Magazine Race Series (A),Power2max,Kickr Gen1,376,395,-19
10474,115080,2020-01-22 18:59:57,wahoo,Zwift - FIETS Magazine Race Series (A),Power2max,Kickr Gen1,377,369,8
10646,115080,2020-01-23 19:14:59,wahoo,"Zwift - Tour de Zwift // Pro-Am Invitational 2nd big group, PR on first climb, popped too early on final climb unfortunately!",Power2max,Kickr Gen1,439,446,-7
11493,115080,2020-01-28 16:59:58,wahoo,Zwift - Crank it Up Fiets (E),Power2max,Kickr,397,395,2
53297,115080,2020-09-03 18:44:58,wahoo,Zwift - XRS - ZTR Thursday Night Race (A),Power2max,Kickr Gen1,410,417,-7
54155,115080,2020-09-09 17:49:58,wahoo,Zwift - Team CLS TT Rollup (A),Power2max,Kickr Gen1,377,375,2
55844,115080,2020-09-17 18:29:59,wahoo,Zwift - Invitational League // Qualifying Race #2 (Men) ,Power2max,Kickr Gen1,382,376,6
64210,115080,2020-10-22 18:00:01,wahoo,Zwift -  Flanders The BZR Ronde  (A),Power2max,Kickr Gen1,362,376,-14
66203,115080,2020-10-29 18:59:33,wahoo,Zwift -  Flanders The BZR Ronde  (A) Three Sisters ain&#039;t to no walk in the park :s ,Power2max,Kickr Gen1,379,387,-8
67593,115080,2020-10-29 18:59:33,wahoo,Zwift - Zwift Racing League | WTRL - Men&#039;s EMEA E1 DIVISION 1 (A),Power2max,Kickr Gen1,374,387,-13
67616,115080,2020-11-03 18:32:15,wahoo,Zwift - Zwift Racing League | WTRL - Men&#039;s EMEA E1 DIVISION 1 (A),Power2max,Kickr Gen1,374,392,-18
75537,115080,2020-11-25 17:59:02,wahoo,"Zwift - MIDWEEK Autumn Series by SZR (A) dropped in descent of 2nd KOM, too bad but the level was a bit too high!",Power2max,Kickr Gen1,385,385,0
78177,115080,2020-12-01 18:20:34,wahoo,Zwift - Zwift Racing League | WTRL - Men&#039;s EMEA E1 DIVISION 1 (A),Power2max,Kickr Gen1,371,394,-23
81030,115080,2020-12-08 18:14:44,wahoo,Zwift - Zwift Racing League | WTRL - Men&#039;s EMEA E1 DIVISION 1 (A) WIFI DROPOUT :(:(:(,Power2max,Kickr Gen1,367,378,-11
81734,115080,2020-12-10 18:59:55,wahoo,"Zwift - BENELIGA 2020-2021 (E) 25th place, very happy with first good race in a long time!",Power2max,Kickr Gen1,378,389,-11
82470,115080,2020-12-10 18:59:55,wahoo,Zwift - 3R Three Sisters Hilly Race (47km/29.2mi 879m) (A),Power2max,Kickr Gen1,378,408,-30
82475,115080,2020-12-12 18:04:56,wahoo,Zwift - 3R Three Sisters Hilly Race (47km/29.2mi 879m) (A),Power2max,Kickr Gen1,382,408,-26
83550,115080,2020-12-15 18:20:49,wahoo,Zwift - Zwift Racing League | WTRL - Men&#039;s EMEA E1 DIVISION 1 (A),Power2max,Kickr Gen1,373,383,-10
84422,115080,2020-12-17 18:59:53,wahoo,"Zwift -  Flanders The BZR Ronde  (A) MAX effort on Ventoux, I absolutely love long climbs, endorphin fes ++ NEW FTP !!!",Power2max,Kickr Gen1,389,402,-13
86250,115080,2020-12-22 19:59:50,wahoo,"Zwift - KISS Race Series - EU PM (A) 3 times volcano for late night snack, love it!",Power2max,Kickr Gen1,389,395,-6
86957,115080,2020-12-22 19:59:50,wahoo,Zwift - OH MY CRIT! - The Double Race 1/2 (A),Power2max,Kickr Gen1,389,389,0
86959,115080,2020-12-24 16:14:55,wahoo,Zwift - OH MY CRIT! - The Double Race 1/2 (A),Power2max,Kickr Gen1,384,389,-5
87550,115080,2020-12-26 18:04:50,wahoo,Zwift - 3R Three Sisters Hilly Race (47km/29.2mi 879m) (A),Power2max,Kickr Gen1,385,389,-4
91819,115080,2021-01-05 18:54:57,wahoo,Zwift - Team Italy & Frenchy Fuzion League (A) boooooring zwift gameplay...Wait wait wait and then...it&#039;s over in 2�0sec,Power2max,Kickr Gen1,381,392,-11
93449,115080,2021-01-07 18:59:48,wahoo,Zwift - BENELIGA 2020-2021 (E) very early dropout so lonesome race...,Power2max,Kickr Gen1,379,383,-4
94590,115080,2021-01-10 18:59:49,wahoo,Zwift - BRT Iron Goat Racing League (A),Power2max,Kickr Gen1,418,440,-22
95589,115080,2021-01-12 18:15:17,wahoo,Zwift - Zwift Racing League | WTRL - Men&#039;s/Mixed EMEA E1 DIVISION 1 (A),Power2max,Kickr Gen1,347,376,-29
97282,115080,2021-01-14 18:59:58,wahoo,"Zwift - BENELIGA 2020-2021 (E) bad legs today so got dropped pretty early on...Pushed trough till line, 50th!",Power2max,Kickr Gen1,387,387,0
98566,115080,2021-01-17 14:14:50,wahoo,Zwift - 01/17/2021,Power2max,Kickr Gen1,335,340,-5
103492,115080,2021-01-26 18:14:49,wahoo,Zwift - Zwift Racing League | WTRL - Men&#039;s/Mixed EMEA E1 DIVISION 1 (A),Power2max,Kickr Gen1,381,386,-5
105236,115080,2021-01-29 19:11:53,wahoo,Zwift - Team IRL Without Borders Chase (A) KICKOFF HOLIDAY !! 1min effort at finish ,Power2max,Kickr Gen1,344,344,0
106005,115080,2021-01-31 06:29:55,wahoo,Zwift - XRS Races: a Longer and Hard race (A),Power2max,Kickr Gen1,392,407,-15
107296,115080,2021-02-02 18:14:51,wahoo,Zwift - Zwift Racing League | WTRL - Men&#039;s/Mixed EMEA E1 DIVISION 1 (A),Power2max,Kickr Gen1,375,364,11
107965,115080,2021-02-03 10:44:49,wahoo,Zwift - The Morning Grind by STPC (A) Attack to improve! Little left for finish but NICE race,Power2max,Kickr Gen1,401,417,-16
109711,115080,2021-02-06 08:32:53,wahoo,Zwift - Zwift Fondo Series: Ultima Fondo LOOOOOOOOOVING longgggggg efforts like this,Power2max,Kickr Gen1,374,382,-8
111571,115080,2021-02-09 18:24:30,wahoo,Zwift - Zwift Racing League | WTRL - Men&#039;s/Mixed EMEA E1 DIVISION 1 (A),Power2max,Kickr Gen1,396,424,-28
113010,115080,2021-02-11 19:00:04,wahoo,Zwift - FLANDERS The BZR Ronde Watopian League (A),Rotor INPower,Kickr Gen1,341,357,-16
124050,115080,2021-03-04 18:19:55,wahoo,Zwift - III Liga ZESP - Etapa 4 (A) 2times Innsbruck KOM for dinner!,Power2max,Kickr Gen1,375,395,-20
126608,115080,2021-03-10 18:59:28,wahoo,Zwift - Zwift NL Race Day (A) tough day in the office after yesterday&#039;s VO2 session :s ,Power2max,Kickr Gen1,369,383,-14
127615,115080,2021-03-11 18:59:45,wahoo,"Zwift - Flanders The BZR Ronde Spring Classics League (A) dropped halfway, not paying attention...Sweetspotted half of the race home",Power2max,Kickr Gen1,401,410,-9
127750,115080,2021-03-13 08:59:59,wahoo,Zwift - Three Sisters ZADA test,Power2max,Kickr Gen1,397,393,4
129167,115080,2021-03-16 18:29:49,wahoo,Zwift - CeramicSpeed Race Series: Open Race (A),Power2max,Kickr Gen1,392,402,-10
129677,115080,2021-03-17 18:00:03,wahoo,Zwift - 03/17/2021,Power2max,Kickr Gen1,377,373,4
128198,115704,2021-03-14 02:05:18,wahoo,2021/03/14 3R Innsbruckring Flat Race - 2 Laps (17.6km/10.9m 154m) (B),STAGES POWER Gen2,Wahoo KICKR 2016,238,235,3
128723,116554,2021-03-11 18:00:01,wahoo,Zwift - Peter Danger&#039;s Meetup - Tick Tock,Vector 3,Kickr 2020,339,342,-3
129500,121526,2021-03-16 19:29:59,neo,Zwift - ZHR Masters (C),Evening_Ride,Neo,289,275,14
6140,121681,2019-12-12 21:39:59,wahoo,Zwift - KOA Sports Warrior Race (A),SRM,KICKR 2018,312,315,-3
6142,121681,2019-12-12 21:39:59,wahoo,Zwift - 3R Alpe Du Zwift KOM Race (20km 1444m) (A),SRM,KICKR 2018,335,338,-3
6181,121681,2019-12-13 14:32:21,wahoo,Zwift - SMART - Lucy in the Sky with Diamonds - 100 - Xert,SRM,KICKR 2018,237,235,2
6264,121681,2019-12-14 14:56:13,wahoo,Zwift - OH CRIT!! - Saturday Smash Series (A),SRM,KICKR 2018,323,325,-2
6381,121681,2019-12-15 23:21:48,wahoo,Zwift - HOP - 140% and 75% - Xert,SRM,KICKR 2018,291,303,-12
9280,121681,2020-01-14 14:05:10,wahoo,Tour de Zwift: Stage 1 Race,VECTOR 3,KICKR 2018,312,317,-5
9523,121681,2020-01-15 18:52:15,wahoo,Zwift - Tour de Zwift // Pro-Am Invitational (A),VECTOR 3,KICKR 2018,362,361,1
11861,121681,2020-01-31 18:30:08,wahoo,Zwift - Tour de Zwift // Pro-Am Invitational (A),VECTOR 3,KICKR 2018,385,377,8
12478,121681,2020-02-04 18:55:46,wahoo,Zwift - Tour de Zwift // Pro-Am Invitational (A) ,VECTOR 3,KICKR 2018,369,368,1
12789,121681,2020-02-06 18:34:24,wahoo,Zwift - KALAS Cup - Round 2 (A),VECTOR 3,KICKR 2018,330,337,-7
13740,121681,2020-02-13 18:46:17,wahoo,KALAS Cup - Round 3,VECTOR 3,KICKR 2018,343,348,-5
14304,121681,2020-02-16 22:20:19,wahoo,Zwift - 30/15 - Xert,VECTOR 3,KICKR 2018,348,343,5
14574,121681,2020-02-18 19:28:02,wahoo,3R SuperCRITical Race Series - Round 1of4,VECTOR 3,KICKR 2018,336,336,0
14991,121681,2020-02-20 18:39:39,wahoo,Zwift - KALAS Cup - Round 4 (A),VECTOR 3,KICKR 2018,350,352,-2
15194,121681,2020-02-22 14:54:15,wahoo,OH CRIT!! - Saturday Smash Series,VECTOR 3,KICKR 2018,323,319,4
15896,121681,2020-02-27 18:50:02,wahoo,Zwift - KALAS Cup - Round 5 (A),VECTOR 3,KICKR 2018,343,350,-7
16142,121681,2020-02-29 15:01:24,wahoo,Zwift - OH CRIT!! - Saturday Smash Series (A),VECTOR 3,KICKR 2018,333,342,-9
16815,121681,2020-03-04 19:12:24,wahoo,Zwift - Zwift Beta Race (A),VECTOR 3,KICKR 2018,349,343,6
17170,121681,2020-03-07 15:03:35,wahoo,Zwift - OH CRIT!! - Saturday Smash Series (A),VECTOR 3,KICKR 2018,345,346,-1
17840,121681,2020-03-12 18:51:29,wahoo,Zwift - KALAS Cup - Round 7 (A),VECTOR 3,KICKR 2018,329,333,-4
19062,121681,2020-03-21 15:04:30,wahoo,Zwift - OH CRIT!! - Saturday Smash Series (A),VECTOR 3,KICKR 2018,360,364,-4
19804,121681,2020-03-26 18:59:30,wahoo,Zwift - KALAS Cup - Round 9 (A),VECTOR 3,KICKR 2018,344,348,-4
19808,121681,2020-03-24 18:14:43,wahoo,Zwift - Flanders De Ronde Race (A),VECTOR 3,KICKR 2018,371,373,-2
20174,121681,2020-03-28 14:56:15,wahoo,Zwift - OH CRIT!! - Saturday Smash Series (A),VECTOR 3,KICKR 2018,347,346,1
21498,121681,2020-04-02 17:48:43,wahoo,Zwift - KALAS Cup - Round 10 (A),VECTOR 3,KICKR 2018,349,345,4
22086,121681,2020-04-04 13:58:15,wahoo,Zwift - OH CRIT!! - Saturday Smash Series (A),VECTOR 3,KICKR 2018,325,326,-1
23324,121681,2020-04-09 17:52:54,wahoo,Zwift - London International // Zwift Classic (A),VECTOR 3,KICKR 2018,369,365,4
24634,121681,2020-04-14 18:26:48,wahoo,Zwift - 3R Spring Loaded Race Series - Round 3of6 (A),VECTOR 3,KICKR 2018,365,367,-2
25613,121681,2020-04-17 17:55:55,wahoo,Zwift - Richmond Challenge // Zwift Classic (A),VECTOR 3,KICKR 2018,374,365,9
30617,121681,2020-05-02 15:40:58,wahoo,Zwift - YANA Pro/AM Invitiational (A),VECTOR 3,KICKR 2018,342,336,6
34712,121681,2020-05-14 14:46:31,wahoo,ZADA Three Sisters Test,VECTOR 3,KICKR 2018,344,342,2
36688,121681,2020-05-21 17:58:08,wahoo,Zwift - Tour for All Invitational Race // Men (A),VECTOR 3,KICKR 2018,369,366,3
37126,121681,2020-05-23 13:35:59,wahoo,Zwift - XRS Races: Saturday Climbing Series (A),VECTOR 3,KICKR 2018,344,343,1
38376,121681,2020-05-28 17:48:03,wahoo,Zwift - Tour for All Invitational Race // Men (A),VECTOR 3,KICKR 2018,395,400,-5
38595,121681,2020-05-29 23:14:05,wahoo,Zwift - Tour for All 2020: Stage 3 Longer Ride,VECTOR 3,KICKR 2018,328,329,-1
41322,121681,2020-06-13 01:17:26,wahoo,Zwift - 3R LaGuardia Loop Reverse Flat Race - 6 Laps (19.1km/11.9 162m) (A),VECTOR 3,KICKR 2018,341,338,3
43598,121681,2020-06-25 18:23:30,wahoo,Zwift - ZHR Up & Down Race (A),VECTOR 3,KICKR 2018,354,354,0
44484,121681,2020-07-02 01:00:56,wahoo,welp ok,VECTOR 3,KICKR 2018,341,339,2
44585,121681,2020-07-02 18:36:44,wahoo,Zwift - Mocha,VECTOR 3,KICKR 2018,339,336,3
45512,121681,2020-07-08 23:21:13,wahoo,Zwift - Austin Driveway Series Criterium (A),VECTOR 3,KICKR 2018,344,347,-3
45774,121681,2020-07-09 18:37:13,wahoo,Zwift - Mocha,VECTOR 3,KICKR 2018,334,333,1
46515,121681,2020-07-15 23:24:57,wahoo,Zwift - Austin Driveway Series Criterium (A),VECTOR 3,KICKR 2018,328,330,-2
46629,121681,2020-07-16 17:08:06,wahoo,Zwift - Espresso,VECTOR 3,KICKR 2018,343,349,-6
46770,121681,2020-07-17 22:51:52,wahoo,Zwift - Virtual Tour de France - Open - Stage 4 Discovery Ride,VECTOR 3,KICKR 2018,357,355,2
47591,121681,2020-07-25 01:15:19,wahoo,Zwift - 3R LaGuardia Loop Reverse Flat Race - 6 Laps (19.1km/11.9 162m) (A),VECTOR 3,KICKR 2018,357,352,5
47691,121681,2020-07-25 22:56:29,wahoo,Zwift - The - GO  TBR / BDCC / SMCC Combine (A),VECTOR 3,KICKR 2018,314,302,12
47800,121681,2020-07-26 23:03:10,wahoo,Zwift - 3R Achterbahn Climbing Race (47.4km/29.5mi 988m) (A),VECTOR 3,KICKR 2018,337,333,4
48378,121681,2020-07-30 23:38:13,wahoo,Zwift - WTRL Team Time Trial (B),VECTOR 3,KICKR 2018,323,307,16
49104,121681,2020-08-06 18:30:20,wahoo,Zwift - Mocha,VECTOR 3,KICKR 2018,337,333,4
49297,121681,2020-08-08 13:57:15,wahoo,Zwift - OH MY CRIT - Saturday Smash Race (A),VECTOR 3,KICKR 2018,356,350,6
49893,121681,2020-08-14 01:04:24,wahoo,Quick 30min of good work,VECTOR 3,KICKR 2018,325,326,-1
50044,121681,2020-08-14 17:40:15,wahoo,Zwift - RHYS HOWELL [CANYON]&#039;s Meetup - Tour Of Tewit Well,VECTOR 3,KICKR 2018,351,347,4
50387,121681,2020-08-17 09:29:39,wahoo,Zwift - Off the MAAP Invitational Race // Stage 2 (Men) (A),VECTOR 3,KICKR 2018,332,327,5
51004,121681,2020-08-20 23:08:48,wahoo,Zwift - Espresso,VECTOR 3,KICKR 2018,351,338,13
51148,121681,2020-08-22 00:58:03,wahoo,Zwift - Off The MAAP Stage 3 - Longer Ride,VECTOR 3,KICKR 2018,362,361,1
51882,121681,2020-08-25 17:42:17,wahoo,Zwift - RHYS HOWELL [CANYON]&#039;s Meetup - Big Foot Hills,VECTOR 3,KICKR 2018,359,354,5
52284,121681,2020-08-27 23:13:21,wahoo,Zwift - WTRL Team Time Trial (C),VECTOR 3,KICKR 2018,343,347,-4
55063,121681,2020-09-14 17:33:46,wahoo,Zwift - Invitational League // Qualifying Race #1,VECTOR 3,KICKR 2018,340,347,-7
55455,121681,2020-09-15 23:17:37,wahoo,Zwift - Midweek Criterium Race (A),VECTOR 3,KICKR 2018,359,356,3
55858,121681,2020-09-17 17:36:04,wahoo,Zwift - Invitational League // Qualifying Race #2 (Men) ,VECTOR 3,KICKR 2018,339,336,3
56443,121681,2020-09-20 12:34:28,wahoo,Zwift - Invitational League // Qualifying Race #3 (Men) (A),VECTOR 3,KICKR 2018,356,359,-3
57371,121681,2020-09-24 23:26:58,wahoo,Zwift - Espresso,VECTOR 3,KICKR 2018,334,334,0
58631,121681,2020-09-29 17:44:45,wahoo,Zwift - RHYS HOWELL [CANYON]&#039;s Meetup - Cobbled Climbs,VECTOR 3,KICKR 2018,356,355,1
61264,121681,2020-10-12 18:31:03,wahoo,Zwift - Premier Division // Zwift Racing League (men) ,VECTOR 3,KICKR 2018,344,348,-4
63157,121681,2020-10-19 17:28:11,wahoo,Zwift - Premier Division // Zwift Racing League (men) ,VECTOR 3,KICKR 2018,337,344,-7
76026,121681,2020-11-26 18:13:37,wahoo,Zwift - WTRL NOPINZ WORLD TTT CHAMPIONSHIPS - Zone 6 (C),VECTOR 3,KICKR 2018,347,348,-1
77707,121681,2020-11-30 18:24:10,wahoo,Zwift - Premier Division // Zwift Racing League (men) (A),VECTOR 3,KICKR 2018,349,347,2
82574,121681,2020-12-13 00:02:02,wahoo,Zwift - 3R & ZID Merdeka Classique Flat Race Series - Round 4 of 4 (A),VECTOR 3,KICKR 2018,316,310,6
84551,121681,2020-12-17 18:17:52,wahoo,Zwift - WTRL Team Time Trial - Zone 6 (C),VECTOR 3,KICKR 2018,320,312,8
84558,121681,2020-12-17 01:47:22,wahoo,Zwift - ZHQ FutureWorks Circuit Race - Anti-sandbagging (A),VECTOR 3,KICKR 2018,312,301,11
86102,121681,2020-12-22 14:45:10,wahoo,Zwift - Watopia,VECTOR 3,KICKR 2018,296,284,12
86465,121681,2020-12-23 13:51:17,wahoo,Endurance,VECTOR 3,KICKR 2018,228,215,13
87412,121681,2020-12-25 23:44:16,wahoo,Legs feeling like jello from yesterday ,VECTOR 3,KICKR 2018,338,329,9
87456,121681,2020-12-26 14:51:24,wahoo,Zwift - 3R Endurance Steady Ride [~3.0//2.5w/kg avg] (B),VECTOR 3,KICKR 2018,196,191,5
87648,121681,2020-12-26 23:56:41,wahoo,2nd roll,VECTOR 3,KICKR 2018,311,300,11
87880,121681,2020-12-27 16:00:54,wahoo,Knocking out some more kjs,VECTOR 3,KICKR 2018,220,213,7
88015,121681,2020-12-27 23:39:16,wahoo,"Eat to ride, ride to eat.",VECTOR 3,KICKR 2018,311,302,9
88236,121681,2020-12-28 14:59:18,wahoo,ZADA 3 Sisters Test,VECTOR 3,KICKR 2018,348,349,-1
92879,121681,2021-01-07 18:10:04,wahoo,Zwift - WTRL Team Time Trial - Zone 6 (C),VECTOR 3,KICKR 2018,328,334,-6
94969,121681,2021-01-11 18:43:14,wahoo,Zwift - Premier Division // Zwift Racing League (men) (A),VECTOR 3,KICKR 2018,296,297,-1
96948,121681,2021-01-14 18:03:02,wahoo,Zwift - Vienna,VECTOR 3,KICKR 2018,313,311,2
97667,121681,2021-01-16 00:02:11,wahoo,3R & ZID Merdeka La Reine Hilly Race - Round 3 of 4,VECTOR 3,KICKR 2018,311,311,0
100549,121681,2021-01-20 23:34:48,wahoo,Zwift - EVR Definitely Not the WTNC (A),VECTOR 3,KICKR 2018,348,352,-4
100903,121681,2021-01-21 18:02:55,wahoo,Zwift - Vienna,VECTOR 3,KICKR 2018,319,317,2
103139,121681,2021-01-25 23:09:30,wahoo,Zwift - ZHQ FutureWorks Circuit Race - Anti-sandbagging (A),VECTOR 3,KICKR 2018,291,289,2
103772,121681,2021-01-26 22:49:25,wahoo,Zwift - TDZ Stage 5: Longer Ride,VECTOR 3,KICKR 2018,347,343,4
104357,121681,2021-01-27 23:43:27,wahoo,Zwift - EVR Definitely Not the WTNC (A),VECTOR 3,KICKR 2018,329,326,3
104650,121681,2021-01-28 17:56:29,wahoo,Zwift - Vienna,VECTOR 3,KICKR 2018,338,336,2
108902,121681,2021-02-04 18:04:42,wahoo,Zwift - Vienna,VECTOR 3,KICKR 2018,339,338,1
111017,121681,2021-02-08 18:38:32,wahoo,Zwift - Premier Division // Zwift Racing League (men) (A),VECTOR 3,KICKR 2018,343,342,1
112947,121681,2021-02-11 17:47:57,wahoo,Zwift - Vienna,VECTOR 3,KICKR 2018,334,333,1
115363,121681,2021-02-15 19:25:14,wahoo,Zwift - Premier Division // Zwift Racing League (men) (A),VECTOR 3,KICKR 2018,379,376,3
117248,121681,2021-02-18 17:50:29,wahoo,Zwift - Vienna,VECTOR 3,KICKR 2018,327,324,3
119110,121681,2021-02-22 18:41:02,wahoo,Zwift - Premier Division // Zwift Racing League (men) (A),VECTOR 3,KICKR 2018,333,331,2
122570,121681,2021-03-01 19:38:23,wahoo,Zwift - Premier Division // Zwift Racing League (men) (A),VECTOR 3,KICKR 2018,336,331,5
129443,121681,2021-03-17 00:53:02,wahoo,Zwift - Mayhem Racing p/b Ridley&#039;s Cycle (A),VECTOR 3,KICKR 2018,325,317,8
16602,122744,2020-03-03 17:35:19,neo,Zwift - Watopia 129-139,Quarq Riken,Tacx Neo,279,276,3
24844,122744,2020-04-14 16:01:51,neo,Zwift - Watopia - Recovery,Power2Max Type S,Tacx Neo,277,290,-13
41606,122744,2020-06-14 09:28:25,neo,Zwift - London,FSA Powerbox,Tacx Neo,222,227,-5
45873,122849,2020-07-11 05:01:12,wahoo,Zwift - L&#039;Etape du Tour Stage 2 - Open,VerveCycling Infocrank M30,Wahoo KICKR 2018,227,222,5
47406,122849,2020-07-23 07:14:41,wahoo,Zwift - Japan Club Team Enduro ,VerveCycling Infocrank M30,Wahoo KICKR 2018,202,199,3
51432,122849,2020-08-24 01:04:51,wahoo,Zwift - 3R Watopia Flat Route Race - 2 Laps (20.5km/12.7mi 108m) (B),VerveCycling Infocrank M30,Wahoo KICKR 2018,224,221,3
51433,122849,2020-08-22 07:30:10,wahoo,Zwift - TEAM VEGAN Tofu Tornado XL (B),VerveCycling Infocrank M30,Wahoo KICKR 2018,223,218,5
112462,123405,2021-02-10 19:00:01,wahoo,Zwift - Movistar Team Challenge // Round 1 (A),Stages Power L - Shimano 105,Wahoo Kickr 2018,388,368,20
113581,123405,2021-02-12 19:00:10,wahoo,Movistar Team Challenge // Round 1,Stages Power L - Shimano 105,Wahoo Kickr 2018,380,388,-8
115388,123405,2021-02-15 20:02:00,wahoo,Zwift - Premier Division // Zwift Racing League (men) (A),Stages Power L - Shimano 105,Wahoo Kickr 2018,385,404,-19
17846,123836,2020-03-12 19:15:31,neo,Zwift - Tour of Watopia Pro-Am Men&#039;s Race #1 (A),Stages,NEO,328,298,30
18931,123836,2020-03-20 19:15:21,neo,Zwift - Tour of Watopia Pro-Am Men&#039;s Race #2 (A),Stages,NEO,312,311,1
98554,124057,2021-01-16 12:35:26,wahoo,kickr18 vs vector3,v3,kickr18,208,199,9
102586,124057,2021-01-24 19:41:20,wahoo,Kickr 2018 / Garmin V3,Garmin V3,Kickr 2018,274,281,-7
111356,124057,2021-02-08 19:16:48,wahoo,Zwift - Team TFC Mad Monday Winter Series (B),Garmin V3,Kickr 2018,340,353,-13
114387,124057,2021-02-13 17:32:58,wahoo,Zwift - London,Garmin V3,Kickr 2018,281,289,-8
122704,124057,2021-03-01 19:56:02,wahoo,Zwift - SMART - Takin&#039; Care of Business - 60 - Xert,assioma,Kickr 2018,311,301,10
62520,124775,2020-10-13 23:44:51,neo,Zwift - Zwift Racing League | WTRL (A),Quarq,Tacx Neo,369,362,7
62521,124775,2020-10-16 19:16:56,neo,Zwift - Crit City Race (A),Quarq,Tacx Neo,352,348,4
62522,124775,2020-10-11 12:16:40,neo,Zwift - ZHQ Beta Circuit Race  (B),Quarq,Tacx Neo,337,334,3
62523,124775,2020-10-12 13:24:35,neo,Zwift - Crit City Race (A),Quarq,Tacx Neo,344,341,3
62684,124775,2020-10-17 15:53:19,neo,Zwift - 3R Classique Flat Race - 4 Laps (26.9km/16.7mi 76m) (A),Quarq,Tacx Neo,379,372,7
76305,124775,2020-11-26 21:46:19,neo,Zwift - SST (Med),Quarq,Tacx Neo,381,379,2
52182,127561,2020-08-27 16:45:34,wahoo,Zwift - WTRL Team Time Trial (C),Assioma,Wahoo kickr core,403,406,-3
52327,127561,2020-08-28 09:32:30,wahoo,Zwift - TBR Burrito Race (A),Assioma,Wahoo kickr core,396,394,2
52622,127561,2020-08-30 11:39:10,wahoo,Crit City Race,Assioma,Wahoo kickr core,418,407,11
52770,127561,2020-08-31 18:09:43,wahoo,Zwift - TFC Mad Monday Summer Series (9 of 10) (A),Assioma,Wahoo kickr core,406,396,10
53067,127561,2020-09-02 14:36:35,wahoo,Zwift - Crit City Race (A),Assioma Duo,Wahoo kickr core,430,419,11
53255,127561,2020-09-03 18:26:40,wahoo,WTRL Team Time Trial - Zone6,Assioma Duo,Wahoo kickr core,396,388,8
53953,127561,2020-09-08 17:03:36,wahoo,SZR iTT Autumn Racing league,Assioma Duo,Wahoo kickr core,388,390,-2
54437,127561,2020-09-10 18:23:04,wahoo,Zwift - Espresso,Assioma Duo,Wahoo kickr core,413,413,0
54724,127561,2020-09-12 14:07:45,wahoo,Zwift - OH MY CRIT - Saturday Smash Race (A),Assioma Duo,Wahoo kickr core,421,423,-2
55554,127561,2020-09-16 16:55:52,wahoo,Zwift - MIDWEEK Autumn Series by SZR (A),Assioma Duo (Zwift),Wahoo kickr core,410,407,3
55857,127561,2020-09-17 18:34:20,wahoo,Zwift - Espresso,Assioma Duo (Zwift),Wahoo kickr core,399,387,12
56215,127561,2020-09-19 07:53:50,wahoo,Zwift - 3R Flat Race (A),Assioma Duo (Zwift),Wahoo kickr core,397,391,6
56266,127561,2020-09-19 14:11:51,wahoo,Zwift - OH MY CRIT - Saturday Smash Race (A),Assioma Duo (Zwift),Wahoo kickr core,367,364,3
57015,127561,2020-09-23 16:50:03,wahoo,Zwift - MIDWEEK Autumn Series by SZR (A),Assioma Duo (Zwift),Wahoo kickr core,407,412,-5
57715,127561,2020-09-26 13:34:27,wahoo,DIRT Dadurday Chase Race ,Assioma Duo (Zwift),Wahoo kickr core,401,397,4
57934,127561,2020-09-27 15:16:03,wahoo,3R Watopia 65km Race - 6 laps (40mi 324m),Assioma Duo (Zwift),Wahoo kickr core,396,388,8
58088,127561,2020-09-28 17:54:45,wahoo,Zwift - TFC Mad Monday Autumn Series (A),Assioma Duo (Zwift),Wahoo kickr core,400,390,10
58630,127561,2020-09-30 20:17:04,wahoo,3R Classique Flat Race - 5 Laps (32.3km/20.1mi 95m),Assioma Duo (Zwift),Wahoo kickr core,429,413,16
59622,127561,2020-10-05 17:52:53,wahoo,Zwift - TFC Mad Monday Autumn Series (A),Assioma Duo (Zwift),Wahoo kickr core,412,412,0
60432,127561,2020-10-08 18:50:00,wahoo,Zwift - KISS at Race - EU PM (A),Assioma Duo (Zwift),Wahoo kickr core,427,427,0
60807,127561,2020-10-10 14:11:05,wahoo,Zwift - OH MY CRIT - Saturday Smash Race (A),Assioma Duo (Zwift),Wahoo kickr core,411,402,9
62211,127561,2020-10-15 18:09:26,wahoo,Zwift - Pre Event Ride // Swedish Cycling Federation,Assioma Duo (Zwift),Wahoo kickr core,408,402,6
62230,127561,2020-10-15 18:09:26,wahoo,Pre Event Ride // Swedish Cycling Federation,Assioma Duo (Zwift),Wahoo kickr core,408,402,6
62644,127561,2020-10-17 15:24:16,wahoo,ZHQ Beta Crit City Race,Assioma Duo (Zwift),Wahoo kickr core,392,394,-2
62765,127561,2020-10-18 05:00:18,wahoo,KISS at Race 100 - EU,Assioma Duo (Zwift),Wahoo kickr core,401,387,14
64227,127561,2020-10-22 18:33:48,wahoo,Zwift - Espresso,Assioma Duo (Zwift),Wahoo kickr core,399,403,-4
64533,127561,2020-10-24 06:05:03,wahoo,Zwift - 3R Road To Ruins Hilly Race - 1 Lap (29..2km/18.1mi 275m) (A),Assioma Duo (Zwift),Wahoo kickr core,419,417,2
64859,127561,2020-10-25 13:03:25,wahoo,Zwift - 3R Watopia Flat Route Race - 4 Laps (40.5km/25.1mi 216m) (A),Assioma Duo (Zwift),Wahoo kickr core,411,397,14
65120,127561,2020-10-26 18:48:47,wahoo,TFC Mad Monday Autumn Series,Assioma Duo (Zwift),Wahoo kickr core,387,383,4
65431,127561,2020-10-27 17:45:49,wahoo,Zwift Racing League | WTRL - Mens EMEA E1 DIVISION 1,Assioma Duo (Zwift),Wahoo kickr core,423,421,2
66220,127561,2020-10-29 20:14:43,wahoo,3R LaGuardia Loop Flat Race - 6 Laps (17.5km/10.9 162m),Assioma Duo (Zwift),Wahoo kickr core,423,418,5
66518,127561,2020-10-30 22:01:13,wahoo,3R Volcano Flat 50k Race - 4 Laps (48.8km/30.7mi 184m),Assioma Duo (Zwift),Wahoo kickr core,408,400,8
67261,127561,2020-11-02 19:13:36,wahoo,TFC Mad Monday Autumn Series,Assioma Duo (Zwift),Wahoo kickr core,438,439,-1
68557,127561,2020-11-06 18:52:58,wahoo,Zwift -  Tour De Spartacus  (A),Assioma Duo (Zwift),Wahoo kickr core,433,428,5
68851,127561,2020-11-07 18:50:23,wahoo,Zwift -  Tour De Spartacus  (A),Assioma Duo (Zwift),Wahoo kickr core,378,376,2
69115,127561,2020-11-08 18:50:42,wahoo,Zwift -  Tour De Spartacus  (A),Assioma Duo (Zwift),Wahoo kickr core,433,428,5
69770,127561,2020-11-10 18:07:50,wahoo,Zwift - Zwift Racing League | WTRL - EMEA E1 (MEN) -  Division 1 (A),Assioma Duo (Zwift),Wahoo kickr core,429,423,6
70769,127561,2020-11-12 19:33:20,wahoo,Zwift - Espresso,Assioma Duo (Zwift),Wahoo kickr core,392,384,8
73874,127561,2020-11-21 16:03:11,wahoo,3R Classique Flat Race - 4 Laps (26.9km/16.7mi 76m),Assioma Duo (Zwift),Wahoo kickr core,423,411,12
74244,127561,2020-11-22 15:23:57,wahoo,3R Watopia 65km Race - 6 laps (40mi 324m),Assioma Duo (Zwift),Wahoo kickr core,409,394,15
76507,127561,2020-11-27 16:40:34,wahoo,Crit City Race,Assioma Duo (Zwift),Wahoo kickr core,424,415,9
78030,127561,2020-12-01 18:04:02,wahoo,Zwift - Zwift Racing League | WTRL - Men&#039;s EMEA E1 DIVISION 1 (A),Assioma Duo (Zwift),Wahoo kickr core,401,400,1
79788,127561,2020-12-05 15:03:21,wahoo,Zwift - OH MY CRIT - Saturday Smash Race (A),Assioma Duo (Zwift),Wahoo kickr core,423,416,7
80205,127561,2020-12-06 16:55:16,wahoo,Zwift - Nations Challenge // Sweden (E),Assioma Duo (Zwift),Wahoo kickr core,387,371,16
80778,127561,2020-12-08 18:07:16,wahoo,Zwift - Zwift Racing League | WTRL - Men&#039;s EMEA E1 DIVISION 1 (A),Assioma Duo (Zwift),Wahoo kickr core,395,390,5
82257,127561,2020-12-12 09:26:38,wahoo,Zwift - DBR Saturday Race (A),Assioma Duo (Zwift),Wahoo kickr core,375,351,24
83182,127561,2020-12-14 19:12:45,wahoo,Zwift - Team TFC Mad Monday Winter Series (A),Assioma Duo (Zwift),Wahoo kickr core,397,391,6
86348,127561,2020-12-23 06:09:18,wahoo,Zwift - 3R Racing (A),Assioma Duo (Zwift),Wahoo kickr core,399,394,5
86743,127561,2020-12-24 06:06:23,wahoo,Zwift - 3R Racing (A),Assioma Duo (Zwift),Wahoo kickr core,400,396,4
87678,127561,2020-12-27 06:11:56,wahoo,Mtri Race,Assioma Duo (Zwift),Wahoo kickr core,334,332,2
88473,127561,2020-12-29 10:45:41,wahoo,Zwift - SZR Lunch Race (A),Assioma Duo (Zwift),Wahoo kickr core,395,393,2
89005,127561,2020-12-30 13:56:05,wahoo,Zwift - KISS Race Series - Pacific AM (A),Assioma Duo (Zwift),Wahoo kickr core,381,370,11
89825,127561,2021-01-01 15:53:51,wahoo,Zwift - 3R Volcano Flat Race - 3 Laps (36.6km/22.7mi 138m) (A),Assioma Duo (Zwift),Wahoo kickr core,425,414,11
93053,127561,2021-01-07 19:29:33,wahoo,Zwift - WTRL Team Time Trial - Zone 9 (C),Assioma Duo (Zwift),Wahoo kickr core,391,390,1
94919,127561,2021-01-11 17:36:52,wahoo,Zwift - SCF SWE Cup (A),Assioma Duo (Zwift),Wahoo kickr core,398,389,9
95772,127561,2021-01-12 19:44:25,wahoo,Zwift - Zwift Racing League | WTRL - Men&#039;s/Mixed EMEA W2 DIVISION 1 (A),Assioma Duo (Zwift),Wahoo kickr core,369,360,9
97460,127561,2021-01-15 16:24:06,wahoo,ZHQ FutureWorks Crit City Race - Anti-sandbagging,Assioma Duo (Zwift),Wahoo kickr core,395,389,6
99822,127561,2021-01-19 19:54:17,wahoo,Zwift - Zwift Racing League | WTRL - Men&#039;s/Mixed EMEA W2 DIVISION 1 (A),Assioma Duo (Zwift),Wahoo kickr core,398,394,4
100229,127561,2021-01-20 16:08:32,wahoo,Zwift - 3R Tick Tock Flat Race - 2 Lap (36km/22.4mi 100m) (A),Assioma Duo (Zwift),Wahoo kickr core,392,379,13
109345,127561,2021-02-05 16:27:53,wahoo,Zwift - SZ AW Party by SZR (A),Assioma Duo (Zwift),Wahoo kickr core,404,405,-1
113041,127561,2021-02-11 19:35:51,wahoo,Zwift - WTRL Team Time Trial - Zone 11 (C),Assioma Duo (Zwift),Wahoo kickr core,410,410,0
118340,127561,2021-02-20 13:50:59,wahoo, Zwift Insider Badge Hunters - The Uber Pretzel Edition (E),Assioma Duo (Zwift),Wahoo kickr core,369,367,2
121677,127561,2021-02-27 16:26:28,wahoo,Zwift - TEAM VEGAN Tofu Tornado (A),Assioma Duo (Zwift),Wahoo kickr core,417,418,-1
121956,127561,2021-02-28 06:26:11,wahoo,XRS Races: a Longer and Hard race,Assioma Duo (Zwift),Wahoo kickr core,384,387,-3
127184,127561,2021-03-11 19:42:14,wahoo,Zwift - WTRL Team Time Trial - Zone 12 (C),Assioma Duo (Zwift),Wahoo kickr core,393,395,-2
37374,127717,2020-05-21 09:31:47,wahoo,Zwift - Watopia,rotor in spider,kickr,336,342,-6
37388,127717,2020-05-24 11:24:09,wahoo,Zwift - Crit City Race (A),rotor in spider,kickr,368,374,-6
69046,127717,2020-10-28 11:18:27,wahoo,rotor in spider / kickr,rotor in spider,kickr,321,353,-32
70141,127717,2020-11-11 10:45:07,wahoo,kickr / rotor in spider,rotor in spider,kickr,358,353,5
71262,127717,2020-11-14 10:00:03,wahoo,Cycling ireland race 1 ,rotor in spider,kickr,385,397,-12
76832,127717,2020-11-28 10:30:17,wahoo,Zwift - 3R Volcano Climb Race - 1 Lap (22.4km/14mi 204m) (A),rotor in spider,kickr,392,382,10
35344,128232,2020-05-16 14:00:01,wahoo,Zwift - Watopia,Powertap,Zwift Kickr,320,310,10
37609,128232,2020-05-25 13:40:01,wahoo,Zwift - Tour for All 2020: Stage 5 3R&#039;s Choice,Powertap,Zwift Kickr,325,302,23
59278,128232,2020-10-03 14:16:19,wahoo,Zwift - OH MY CRIT - Saturday Smash Race (B),Morning_Ride-4,Zwift Kickr,342,334,8
60323,128232,2020-10-08 16:29:58,wahoo,Zwift - EVO CC Sprint Race Series  (B),Quarq,Zwift Kickr,319,309,10
90476,128232,2021-01-02 16:30:19,wahoo,Zwift - TEAM VEGAN Tofu Tornado (A),Quarq,Zwift Kickr,333,340,-7
52329,128441,2020-08-24 08:02:08,wahoo,off the Maap Stage 4 Race (C) Internet crashed! :S,Favero Assioma,KICKR,194,209,-15
19226,130137,2020-03-22 22:00:02,wahoo,Zwift - Stage 4 - Longer Ride - Tour of Watopia 2020,Favero Assioma Duo,Kickr 18 Ant,319,309,10
19912,130137,2020-03-27 08:00:00,wahoo,Zwift - Stage 5 - Longer Ride - Tour of Watopia 2020,Favero Assioma Duo,Kickr 18 Ant,342,327,15
20039,130137,2020-03-27 23:11:02,wahoo,Zwift - ASIA 120km Endurance Ride (A),Favero Assioma Duo,Kickr 18 Ant,307,292,15
29442,130137,2020-04-30 09:19:03,wahoo,Zwift - Cycling Australia&#039;s The Chop by AHDR (A),Favero Assioma Duo,Kickr 18 Ant,364,350,14
32361,130137,2020-05-07 09:20:04,wahoo,Zwift - Cycling Australia&#039;s The Chop by AHDR (A),Favero Assioma Duo,Kickr 18 Ant,323,326,-3
33805,130137,2020-05-12 09:10:00,wahoo,Zwift - SRAM Send it Series - Race 1 - Men&#039;s (E),Favero Assioma Duo,Kickr 18 Ant,366,365,1
34566,130137,2020-05-14 09:19:02,wahoo,Zwift - Cycling Australia&#039;s The Chop by AHDR (A),Favero Assioma Duo,Kickr 18 Ant,334,331,3
35989,130137,2020-05-19 09:10:02,wahoo,SRAM Send it Series  - Race 2 - Men&#039;s ,Favero Assioma Duo,Kickr 18 Ant,365,351,14
36555,130137,2020-05-21 09:19:01,wahoo,Zwift - 05/21/2020,Favero Assioma Duo,Kickr 18,333,328,5
38233,130137,2020-05-28 09:20:02,wahoo,Zwift - Cycling Australia&#039;s The Chop by AHDR (A),Favero Assioma Duo,Kickr 18,359,349,10
38439,130137,2020-05-28 23:00:02,wahoo,Zwift - Koa Sports League Warrior Race (A),Favero Assioma Duo,Kickr 18,351,325,26
40459,130137,2020-06-09 09:10:04,wahoo,Zwift - SRAM Send it Series - Race 5 - Men&#039;s (E),Favero Assioma Duo,Kickr 18,377,366,11
40706,130137,2020-06-10 09:45:00,wahoo,Zwift - USA Cycling Race League by Indoor Specialist (A),Favero Assioma Duo,Kickr 18,387,387,0
40953,130137,2020-06-11 09:20:01,wahoo,Zwift - Cycling Australia&#039;s The Chop by AHDR (A),Favero Assioma Duo,Kickr 18,350,337,13
41891,130137,2020-06-16 09:10:01,wahoo,Zwift - SRAM Send it Series - Race 6 - Men&#039;s (E),Favero Assioma Duo,Kickr 18,402,388,14
42351,130137,2020-06-18 09:20:01,wahoo,Zwift - Cycling Australia&#039;s The Chop by AHDR (A),Favero Assioma Duo,Kickr 18,355,349,6
43085,130137,2020-06-22 10:00:00,wahoo,Zwift - EVR Asia Race (A),Favero Assioma Duo,Kickr 18,268,274,-6
43339,130137,2020-06-24 09:45:00,wahoo,Zwift - USA Cycling Race League by Indoor Specialist A Nother AHDR win..,Favero Assioma Duo,Kickr 18,370,350,20
43501,130137,2020-06-25 09:19:02,wahoo,Zwift - Cycling Australia&#039;s The Chop by AHDR (A),Favero Assioma Duo,Kickr 18,374,344,30
44156,130137,2020-06-30 09:10:02,wahoo,Zwift - SRAM Send it Series - Race 8 - Men&#039;s (E),Favero Assioma Duo,Kickr 18,354,344,10
44365,130137,2020-07-01 09:45:00,wahoo,Zwift - USA Cycling Race League by Indoor Specialist (A),Favero Assioma Duo,Kickr 18,342,352,-10
45194,130137,2020-07-07 08:01:03,wahoo,Zwift - Virtual Tour de France - Open - Stage 1 Discovery Ride,Favero Assioma Duo,Kickr 18,337,339,-2
45393,130137,2020-07-08 09:45:01,wahoo,Zwift - USA Cycling Race League by Indoor Specialist (A),Favero Assioma Duo,Kickr 18,321,315,6
46223,130137,2020-07-14 08:01:02,wahoo,Zwift - Virtual Tour de France - Open - Stage 4 Discovery Ride,Favero Assioma Duo,Kickr 18,380,367,13
46236,130137,2020-07-14 09:20:00,wahoo,Zwift - The After Party Race (A),Favero Assioma Duo,Kickr 18,366,358,8
46415,130137,2020-07-15 09:45:00,wahoo,Zwift - USA Cycling Race League by Indoor Specialist (A),Favero Assioma Duo,Kickr 18,376,352,24
46548,130137,2020-07-16 09:16:01,wahoo,Zwift - The Lamb Chop p/b Black Sheep (A),Favero Assioma Duo,Kickr 18,366,360,6
46930,130137,2020-07-19 10:01:02,wahoo,Zwift - L&#039;Etape du Tour Stage 3 - Open,Favero Assioma Duo,Kickr 18,345,342,3
47131,130137,2020-07-21 08:01:02,wahoo,Zwift - Virtual Tour de France - A - Stage 6 Discovery Ride,Favero Assioma Duo,Kickr 18,373,350,23
47271,130137,2020-07-22 09:45:01,wahoo,Zwift - USA Cycling Race League by Indoor Specialist (A),Favero Assioma Duo,Kickr 18,348,355,-7
47410,130137,2020-07-23 09:17:01,wahoo,Zwift - The Lamb Chop p/b Black Sheep (A),Favero Assioma Duo,Kickr 18,359,365,-6
47411,130137,2020-07-23 09:59:59,wahoo,Zwift - Koa Sports League Race (A),Favero Assioma Duo,Kickr 18,342,323,19
47745,130137,2020-07-26 08:00:01,wahoo,Zwift -  Alpecin Cycling Series,Favero Assioma Duo,Kickr 18,354,358,-4
47948,130137,2020-07-28 09:05:00,wahoo,Zwift - 3R Turbocharged Team Race Series - Round 3 (A),Favero Assioma Duo,Kickr 18,356,357,-1
48252,130137,2020-07-30 09:17:00,wahoo,Zwift - The Lamb Chop p/b Black Sheep (A),Favero Assioma Duo,Kickr 18,358,343,15
48456,130137,2020-07-31 22:00:03,wahoo,Zwift - Zwift Fondo 2020 Series (Southern Hemisphere) (A),Favero Assioma Duo,Kickr 18,354,339,15
48732,130137,2020-08-04 09:05:00,wahoo,Zwift - 3R Turbocharged Team Race Series - Round 4 (A),Favero Assioma Duo,Kickr 18,333,306,27
48883,130137,2020-08-05 09:45:01,wahoo,Zwift - USA Cycling Race League by Indoor Specialist (A),Favero Assioma Duo,Kickr 18,344,332,12
49136,130137,2020-08-06 09:17:00,wahoo,Zwift - The Lamb Chop p/b Black Sheep (A),Favero Assioma Duo,Kickr 18,364,362,2
49422,130137,2020-08-10 08:30:02,wahoo,Zwift - Longer Ride - 7 Days of Tarmac SL7: Stage 1 with Mark O&#039;Brien,Favero Assioma Duo,Kickr 18,349,337,12
49424,130137,2020-08-10 09:15:06,wahoo,Zwift - 3R Watopia Flat Route Race - 4 Laps (41km/25.5mi 216m) (A),Favero Assioma Duo,Kickr 18,295,289,6
51446,130137,2020-08-24 07:52:24,wahoo,ZADA TEST 3 SISTERS,Favero Assioma Duo,Kickr 18,347,343,4
53725,130137,2020-09-07 08:21:19,wahoo,Zwift - DCrainmaker 30 x 30 ERG,Favero Assioma Duo Static Weight Test 22kg,Kickr 20,313,305,8
54077,130137,2020-09-09 09:45:01,wahoo,Zwift - USA Cycling Race League by Indoor Specialist (A),Favero Assioma Duo,Kickr 20,334,314,20
54309,130137,2020-09-10 09:27:18,wahoo,Zwift - Espresso,Favero Assioma Duo,Kickr 20,365,346,19
55029,130137,2020-09-14 18:00:02,wahoo,Zwift - Invitational League // Qualifying Race #1,Favero Assioma Duo,Kickr 20,367,340,27
55288,130137,2020-09-15 09:09:01,wahoo,Zwift - 3R Sundown Race Series  (E),Favero Assioma Duo,Kickr 20,346,336,10
55303,130137,2020-09-15 10:00:02,wahoo,Zwift - KISS at Race - Americas AM (A),Favero Assioma Duo,Kickr 20,345,332,13
56961,130137,2020-09-23 09:45:01,wahoo,Zwift - USA Cycling Race League by Indoor Specialist (A),Favero Assioma Duo,Kickr 20,346,330,16
58994,130137,2020-10-02 07:06:01,wahoo,3R Innsbruckring Race - 33.2km,Favero Assioma Duo,Kickr 20,301,284,17
60934,130137,2020-10-10 22:00:48,wahoo,2nd ZADA TEST 3 SISTERS,Favero Assioma Duo,Kickr 20,338,353,-15
61254,130137,2020-10-12 18:50:11,wahoo,Premier Division // Zwift Racing League (men),Favero Assioma Duo,Kickr 20,359,341,18
61255,130137,2020-10-12 18:50:11,wahoo,Kickr 20 / Favero Assioma Duo,Favero Assioma Duo,Kickr 20,359,341,18
65209,130137,2020-10-26 20:00:01,wahoo,Kickr 20 / Favero Assioma Duo,Favero Assioma Duo,Kickr 20,325,332,-7
128189,131978,2021-03-13 23:31:24,wahoo,Zwift - TEAM VEGAN Tofu Tornado (B),Stages,Wahoo Kickr,319,319,0
128190,131978,2021-03-13 23:30:59,wahoo,Zwift - TEAM VEGAN Tofu Tornado (B),Stages,Wahoo Kickr,324,319,5
129532,131978,2021-03-17 09:05:02,wahoo,Zwift - ZSUN Endurance Social Ride (C),Assioma,Wahoo Kickr,241,247,-6
58400,134235,2020-09-30 07:45:28,wahoo,Zwift - Giant Crit Crushers Race 1 (A),Shimano,Kickr,456,457,-1
58401,134235,2020-09-30 08:10:55,wahoo,Zwift - Giant Crit Crushers Race 2 (A),Shimano,Kickr,415,413,2
58698,134235,2020-10-01 09:00:33,wahoo,Zwift - Espresso,Shimano,Kickr,379,383,-4
94727,134235,2021-01-11 01:14:27,wahoo,Zwift - Watopia - After calibration,Shimano,Kickr,293,289,4
109412,134257,2021-02-05 17:51:54,wahoo,Zwift - Chill on Trainer III,PowerTap Pedals Dual,Kickr Gen 1,245,246,-1
54846,135104,2020-09-13 10:29:56,wahoo,Zwift - Stages of DIRT (A),Powertap C1 ,kicker v5,339,318,21
55308,135104,2020-09-15 10:22:17,wahoo,Powertap C1  / kicker v5,Powertap C1 ,kicker v5,314,313,1
55739,135104,2020-09-17 09:59:48,wahoo,Zwift - KISS at Race - Americas AM (A),Powertap C1 ,kicker v5,370,358,12
57183,135104,2020-09-24 09:44:45,wahoo,Zwift - TBR Kettle and Boil (C),Powertap C1 ,kicker v5,310,289,21
57448,135104,2020-09-25 09:50:24,wahoo,Powertap C1  / kicker v5,Powertap C1 ,kicker v5,283,280,3
57685,135104,2020-09-26 10:45:13,wahoo,Into the Red by RELENTLESS,Powertap C1 ,kicker v5,344,316,28
60752,135104,2020-10-10 10:45:07,wahoo,Into the Red by RELENTLESS,2020-10-10-104507-FITNESS 8111-17-0,kicker v5,323,319,4
61348,135104,2020-10-12 20:29:51,wahoo,Zwift - The Kraken by TeamODZ (B),2020-10-12-202951-FITNESS 8111-19-0,kicker v5,298,273,25
62591,135104,2020-10-17 10:45:05,wahoo,Into the Red by RELENTLESS,2020-10-17-104505-FITNESS 8111-22-0,kicker v5,320,338,-18
64999,135104,2020-10-26 09:13:56,wahoo,kicker v5 / Powertap C1 ,Powertap C1 ,kicker v5,347,336,11
76841,135104,2020-11-28 10:44:32,wahoo,Zwift - Into the Red by RELENTLESS (A),powermeter,kicker v5,367,344,23
86044,135104,2020-12-22 12:03:33,wahoo,Zwift n&#039;,powermeter,kicker v5,313,311,2
87592,135104,2020-12-26 18:01:57,wahoo,Frenchy Fuzion Race,Powertap C1 ,kicker v5,373,353,20
87891,135104,2020-12-27 16:29:25,wahoo,Zwift - Duathlon Race Series (A),Powertap C1 ,kicker v5,350,326,24
89083,135104,2020-12-30 17:28:13,wahoo,Zwift - 3R & British Cycling South West - Series 2 (A),Powertap C1 ,kicker v5,348,327,21
89598,135104,2020-12-31 18:10:56,wahoo,Zwift - British Triathlon Winter Series: Handicap Race (A),Powertap C1 ,kicker v5,371,346,25
92632,135104,2021-01-07 11:52:57,wahoo,Zwift - DIRT Doozy Race (A),2021-01-07-115257-FITNESS 8111-65-0,kicker v5,338,316,22
98245,135104,2021-01-16 18:58:00,wahoo,Zwift - EVR Winter Series (A),2021-01-16-185800-FITNESS 8111-66-0,kicker v5,342,320,22
100698,135104,2021-01-21 10:21:39,wahoo,Zwift - WTRL Team Time Trial - Zone 2 (C),2021-01-21-102139-FITNESS 8111-67-0,kicker v5,365,333,32
101864,135104,2021-01-23 10:43:15,wahoo,Zwift - Into the Red by RELENTLESS (A),2021-01-23-104315-FITNESS 8111-68-0,kicker v5,328,333,-5
105500,135104,2021-01-30 10:41:50,wahoo,Zwift - Into the Red by RELENTLESS (A),Powertap C1 ,kicker v5,343,359,-16
108530,135104,2021-02-04 00:59:48,wahoo,Zwift - Americas HDR p/b GIANT (B),Powertap C1 ,kicker v5,380,350,30
118178,135104,2021-02-20 10:45:26,wahoo,Zwift - Into the Red by RELENTLESS (A),Powertap C1 ,kicker v5,367,345,22
118928,135104,2021-02-22 10:19:15,wahoo,Zwift - 3R Volcano Flat Race - 3 Laps (36.6km/22.7mi 138m) (A),Powertap C1 ,kicker v5,374,345,29
121559,135104,2021-02-27 10:42:23,wahoo,Zwift - Into the Red by RELENTLESS (A),Powertap C1 ,kicker v5,336,323,13
124897,135104,2021-03-06 10:45:15,wahoo,Zwift - Into the Red by RELENTLESS (A),2021-03-06-104651-FITNESS 8111-82-0,kicker v5,382,367,15
127853,135104,2021-03-13 11:13:58,wahoo,Zwift - 3R Tick Tock Flat Race - 2 Lap (36km/22.4mi 100m) (A),Powertap C1 ,kicker v5,378,364,14
128898,135104,2021-03-16 00:44:12,wahoo,Zwift - Team TFC Mad Monday Races (A),Powertap C1 ,kicker v5,377,371,6
47807,135363,2020-07-23 17:18:54,wahoo,Zwift - Espresso (C),Rotor inPower (Single Sided),Wahoo Kickr Gen1,338,364,-26
48054,135363,2020-07-28 18:39:58,wahoo,Zwift - 3R Turbocharged Team Race Series - Round 3 (A),Rotor inPower (Single Sided),Wahoo Kickr Gen1,328,359,-31
51146,135363,2020-08-21 22:50:58,wahoo,Zwift - Herd Summer Racing League Race 1 (A),Rotor inPower (Single Sided),Wahoo Kickr Gen1,320,324,-4
51413,135363,2020-08-22 18:00:37,wahoo,Zwift - Off The MAAP Stage 3 Race (A),Rotor inPower (Single Sided),Wahoo Kickr Gen1,325,317,8
52252,135363,2020-08-27 17:23:55,wahoo,Zwift - Espresso,Rotor inPower (Single Sided),Wahoo Kickr Gen1,319,342,-23
52422,135363,2020-08-28 23:04:59,wahoo,Zwift - Herd Summer Racing League Race 2 (A),Rotor inPower (Single Sided),Wahoo Kickr Gen1,314,293,21
92559,135635,2021-01-07 07:04:50,wahoo,Zwift - 3R Innsbruckring Flat Race - 5 Laps (44km/27.3mi 385m),Quarq_DZero to Garmin,Kickr17 to Zwift,308,314,-6
99235,135635,2021-01-18 19:29:43,wahoo,Zwift - Premier Division // Zwift Racing League (men) (A),Quarq_DZero to Garmin,Kickr17 to Zwift,388,370,18
102973,135635,2021-01-25 18:41:07,wahoo,Premier Division // Zwift Racing League (men) - R#3 Innsbruck after party!,Quarq_DZero to Garmin,Kickr17 to Zwift,373,377,-4
106954,135635,2021-02-01 19:49:09,wahoo,Premier Division // Zwift Racing League (men),Quarq_DZero to Garmin,Kickr17 to Zwift,388,381,7
115420,135635,2021-02-15 19:59:00,wahoo,Zwift - Premier Division // Zwift Racing League (men) (A),Quarq_DZero to Garmin,Kickr17 to Zwift,411,414,-3
119130,135635,2021-02-22 18:45:15,wahoo,Premier Division 😑 game freeze at 24km ,Quarq_DZero to Garmin,Kickr17 to Zwift,348,354,-6
122577,135635,2021-03-01 19:29:42,wahoo,Zwift - Premier Division // Zwift Racing League (men) (A),Quarq_DZero to Garmin,Kickr17 to Zwift,400,402,-2
55576,136598,2020-09-10 17:03:32,neo,Espresso,Dura Ace Stages,Tacx Neo,362,340,22
55991,136598,2020-09-17 18:29:51,neo,Zwift - Invitational League // Qualifying Race #2 (Men) ,"Dura Ace Stages (Secondary, to Garmin)","Tacx Neo (Primary, to Zwift)",367,357,10
56476,136598,2020-09-20 12:59:55,neo,Zwift - Invitational League // Qualifying Race #3 (Men) (A),"Dura Ace Stages (Secondary, to Garmin)","Tacx Neo (Primary, to Zwift)",378,366,12
6547,136809,2019-12-17 18:56:18,wahoo,Zwift - WORLDOFFUSION Racing Series (A),Quarq DZero PM,Wahoo Kickr,427,420,7
22930,136809,2020-04-07 18:30:11,wahoo,Zwift - 3R Spring Loaded Race Series - Round 2of6 (A) - 3rd I think...,Quarq DZero PM to Zwift,Wahoo Kickr to Bolt,410,411,-1
27167,136809,2020-04-23 04:56:58,wahoo,Zwift - Ramp Test - dual power test,Quarq DZero PM,Wahoo Kickr 18 ,462,459,3
27322,136809,2020-04-23 16:02:48,wahoo,Zwift - OH CRIT!! - The Double Race - Race 2/2 (A),Quarq DZero PM to Zwift,Wahoo Kickr 18 to Wahoo Bolt,424,408,16
28374,136809,2020-04-25 17:54:59,wahoo,Crit City Slam // Zwift Classic,Quarq DZero PM to Zwift,Wahoo Kickr 18 to Wahoo Bolt,456,433,23
28460,136809,2020-04-27 16:59:24,wahoo,Zwift - DBR Wahoo League (A) - 3rd,Quarq DZero PM to Zwift,Wahoo Kickr 18 to Wahoo Bolt,416,405,11
28975,136809,2020-04-29 09:41:58,wahoo,Zwift - USA Cycling Race League by Indoor Specialist  (A) - 1st :),Quarq DZero PM to Zwift,Wahoo Kickr 18 to Wahoo Bolt,440,425,15
29336,136809,2020-04-30 05:14:58,wahoo,Zwift - Christopher MCGLINCHEY [VIT] &#039;s Meetup - Three Sisters,Quarq DZero PM to Bolt ANT+,Wahoo Kickr 18 to Zwift ANT+,401,403,-2
30406,136809,2020-05-02 08:39:47,wahoo,Zwift - Cycling Ireland Zwift League Rd 6 Road to Ruins (A) - 1st :) ,Quarq DZero PM to Bolt ANT+,Wahoo Kickr 18 to Zwift ANT+,456,448,8
30638,136809,2020-05-02 15:47:21,wahoo,Zwift - YANA Pro/AM Invitiational (A) -2nd :),Quarq DZero PM to Bolt ANT+,Wahoo Kickr 18 to Zwift ANT+,478,473,5
31873,136809,2020-05-05 18:24:20,wahoo,3R Spring Loaded Race Series - Round 6of6,Quarq DZero PM to Zwift,Wahoo Kickr 18 to Wahoo Bolt,481,468,13
32664,136809,2020-05-07 18:38:17,wahoo,Zwift - WTRL Team Time Trial (C),Quarq DZero PM to Zwift,Wahoo Kickr 18 to Wahoo Bolt,437,423,14
32907,136809,2020-05-09 08:36:40,wahoo,Zwift - CIZL Rd 7 – Sean Lynch Memorial (A)2nd- 1st CIZL :) ,Quarq DZero PM to Zwift,Wahoo Kickr 18 to Wahoo Bolt,468,451,17
34041,136809,2020-05-12 18:31:30,wahoo,3R & Wahoo Ride Real Race Series - Round 1 of 7,Quarq DZero PM to Zwift,Wahoo Kickr 18 to Wahoo Bolt,428,425,3
34240,136809,2020-05-13 09:41:28,wahoo,Zwift - USA Cycling Race League by Indoor Specialist (A) - 5th,Quarq DZero PM to Zwift,Wahoo Kickr 18 to Wahoo Bolt,445,442,3
34739,136809,2020-05-14 17:06:13,wahoo,Zwift - WTRL Team Time Trial Premier League (C) - 2nd,Quarq DZero PM to Bolt ANT+,Wahoo Kickr 18 to Wahoo Bolt,442,440,2
35239,136809,2020-05-16 08:41:28,wahoo,Zwift - Cycling Ireland Zwift League Rd 8 (A) - 1st :),Quarq DZero PM to Zwift,Wahoo Kickr 18 to Wahoo Bolt,455,468,-13
36110,136809,2020-05-19 18:23:33,wahoo,Zwift - 3R & Wahoo Ride Real Race Series - Round 2 of 7 (A) 2nd - BRUTAL! New 20min power PB ,Quarq DZero PM to Zwift,Wahoo Kickr 18 to Wahoo Bolt,468,471,-3
36682,136809,2020-05-21 18:00:32,wahoo,Zwift - Tour for All Invitational Race // Men (A),Quarq DZero PM to Zwift,Wahoo Kickr 18 to Wahoo Bolt,505,506,-1
36951,136809,2020-05-23 01:05:03,wahoo,Mens Tour of the Gila - Stage 1 - WTRL Team Time Trial,Quarq DZero PM to Zwift,Wahoo Kickr 18 to Wahoo Bolt,455,457,-2
37175,136809,2020-05-23 15:46:15,wahoo,Zwift - MEN&#039;S TOUR OF THE GILA STAGE 2 CIRCUIT RACE (A) - 2nd,Quarq DZero PM to Zwift,Wahoo Kickr 18 to Wahoo Bolt,481,477,4
37427,136809,2020-05-24 15:47:02,wahoo,"Zwift - MEN&#039;S TOUR OF THE GILA STAGE 3 EPIC KOM QUEEN STAGE (A) - 2nd, 3rd GC & KOM comp :)",Quarq DZero PM to Zwift,Wahoo Kickr 18 to Wahoo Bolt,459,462,-3
37852,136809,2020-05-26 18:34:18,wahoo,Zwift - 3R & Wahoo Ride Real Race Series - Round 3 of 7 (A) Forgot TT bike for the TT.... new 20 min power though haha! ,Quarq DZero PM to Zwift,Wahoo Kickr 18 to Wahoo Bolt,469,468,1
38348,136809,2020-05-28 18:08:40,wahoo,Zwift - Tour for All Invitational Race // Men (A) - 3rd,Quarq DZero PM to Zwift,Wahoo Kickr 18 to Wahoo Bolt,468,468,0
38647,136809,2020-05-30 08:56:41,wahoo,Zwift - Cycling Ireland Zwift League Rd 10 (A) - 1st :) overall wrapped up! :),Quarq DZero PM to Zwift,Wahoo Kickr 18 to Wahoo Bolt,488,489,-1
39117,136809,2020-06-02 18:05:06,wahoo,Zwift - UNO X CUP powered by DCU & Feltet.dk (A),Quarq DZero PM to Zwift,Wahoo Kickr 18 to Wahoo Bolt,440,441,-1
40547,136809,2020-06-09 18:00:30,wahoo,Zwift - UNO X CUP powered by DCU & Feltet.dk (A),Quarq DZero PM to Zwift,Wahoo Kickr 18 to Wahoo Bolt,421,421,0
41360,136809,2020-06-13 08:57:42,wahoo,Zwift - Cycling Ireland Zwift League Rd 12 (A) - 1st :) Thanks CI for a great series ,Quarq DZero PM to Zwift,Wahoo Kickr 18 to Wahoo Bolt,446,437,9
42010,136809,2020-06-16 18:36:48,wahoo,Zwift - 3R & Wahoo Ride Real Race Series - Round 5 of 7 (A) - 2nd,Quarq DZero PM to Zwift,Wahoo Kickr 18 to Wahoo Bolt,397,384,13
42661,136809,2020-06-19 23:18:31,wahoo,Zwift - VIRTUAL JOE MARTIN STAGE RACE ITT,Quarq DZero PM to Zwift,Wahoo Kickr 18 to Wahoo Bolt,463,473,-10
42865,136809,2020-06-20 15:53:49,wahoo,Zwift - VIRTUAL JOE MARTIN STAGE RACE - 3rd,Quarq DZero PM to Zwift,Wahoo Kickr 18 to Wahoo Bolt,450,433,17
42981,136809,2020-06-21 15:45:07,wahoo,Zwift - VIRTUAL JOE MARTIN STAGE RACE (A),Quarq DZero PM to Zwift,Wahoo Kickr 18 to Wahoo Bolt,436,430,6
43247,136809,2020-06-23 18:36:47,wahoo,Zwift - 3R & Wahoo Ride Real Race Series - Round 6 of 7 (A),Quarq DZero PM to Zwift,Wahoo Kickr 18 to Wahoo Bolt,478,476,2
44270,136809,2020-06-30 18:33:58,wahoo,Zwift - 3R & Wahoo Ride Real Race Series - Round 7 of 7 (A) boom :) 1st win in a while!,Quarq DZero PM to Zwift,Wahoo Kickr to Bolt,431,432,-1
46468,136809,2020-07-15 17:49:14,wahoo,Zwift - USA Cycling Race League by Indoor Specialist (A),Quarq DZero PM to Zwift,Wahoo Kickr 18 to Wahoo Bolt,425,424,1
49948,136809,2020-08-14 08:32:08,wahoo,Zwift - Off the MAAP Invitational Race // Stage 1 (Men) (A),Quarq DZero PM to Bolt ANT+,Wahoo Kickr 18 to Zwift ANT+,410,423,-13
50863,136809,2020-08-20 08:41:18,wahoo,Zwift - Off the MAAP Invitational Race // Stage 3 (men) ,Quarq DZero PM to Bolt ANT+,Wahoo Kickr 18 to Zwift ANT+,424,422,2
51698,136809,2020-08-25 17:57:11,wahoo,Zwift - RHYS HOWELL [CANYON]&#039;s Meetup - Big Foot Hills,Quarq DZero PM to Zwift,Wahoo Kickr 18 to Wahoo Bolt,437,427,10
58195,136809,2020-09-29 09:02:21,wahoo,Zwift - KISS at Race - Americas AM (A),Quarq DZero PM to Zwift,Wahoo Kickr 18 to Wahoo Bolt,396,383,13
61279,136809,2020-10-12 18:31:25,wahoo,Zwift - Premier Division // Zwift Racing League (men) ,Quarq DZero PM to Bolt ANT+,Wahoo Kickr 18 to Zwift ANT+,452,444,8
63076,136809,2020-10-19 17:45:32,wahoo,Zwift - Premier Division // Zwift Racing League (men) ,Quarq DZero PM to Bolt ANT+,Wahoo Kickr 18 to Zwift ANT+,427,421,6
65173,136809,2020-10-26 19:44:33,wahoo,Zwift - Premier Division // Zwift Racing League (men) (A),Quarq DZero PM to Bolt ANT+,Wahoo Kickr 18 to Zwift ANT+,428,422,6
67265,136809,2020-11-02 18:48:46,wahoo,Zwift - Premier Division // Zwift Racing League (men) (A),Quarq DZero PM to Bolt ANT+,Wahoo Kickr 18 to Zwift ANT+,435,427,8
69411,136809,2020-11-09 19:43:39,wahoo,Zwift - Premier Division // Zwift Racing League (men) (A),Quarq DZero PM to Bolt ANT+,Wahoo Kickr 18 to Zwift ANT+,470,468,2
72030,136809,2020-11-16 18:46:26,wahoo,Zwift - Premier Division // Zwift Racing League (men) (A),Quarq DZero PM to Bolt ANT+,Wahoo Kickr 18 to Zwift ANT+,433,426,7
74687,136809,2020-11-23 19:44:04,wahoo,Zwift - Premier Division // Zwift Racing League (men) (A),Quarq DZero PM to Bolt ANT+,Wahoo Kickr 18 to Zwift ANT+,482,473,9
76774,136809,2020-11-28 10:00:02,wahoo,Zwift - Cycling Ireland Zwift League Rd 3 (A),Quarq DZero PM to Zwift,Wahoo Kickr 18 to Wahoo Bolt,440,445,-5
77669,136809,2020-11-30 18:48:58,wahoo,Zwift - Premier Division // Zwift Racing League (men) (A),Quarq DZero PM to Bolt ANT+,Wahoo Kickr 18 to Zwift ANT+,436,432,4
82216,136809,2020-12-12 09:59:08,wahoo,Zwift - Cycling Ireland Zwift League Rd 5 (A) - 1st,Quarq DZero PM to Zwift,Wahoo Kickr 18 to Wahoo Bolt,461,469,-8
83146,136809,2020-12-14 17:54:08,wahoo,Zwift - 3R Bologna Race - 2 Laps (A),Quarq DZero PM to Zwift,Wahoo Kickr 18 to Wahoo Bolt,456,464,-8
84323,136809,2020-12-17 16:59:31,wahoo,Zwift - OH MY CRIT! - The Double Race 2/2 (A),Quarq DZero PM to Zwift,Wahoo Kickr 18 to Wahoo Bolt,395,364,31
85863,136809,2020-12-21 19:17:56,wahoo,Zwift - Team TFC Mad Monday Winter Series (A) - 1st :),Quarq DZero PM to Zwift,Wahoo Kickr 18 to Wahoo Bolt,432,421,11
86145,136809,2020-12-22 17:08:35,wahoo,Zwift - 3R Volcano KOM After Party Race - 2 laps + climb (40.2km/25mi 286m) (A) - 1st :) ,Quarq DZero PM to Zwift,Wahoo Kickr 18 to Wahoo Bolt,436,439,-3
86361,136809,2020-12-23 06:48:28,wahoo,Zwift - Christopher McGlinchey&#039;s Meetup - Three Sisters - ZADA Test,Quarq AXS DZero to Bolt,Wahoo Kickr 18 to Zwift ANT+,439,444,-5
87474,136809,2020-12-26 15:10:30,wahoo,Zwift - OH MY CRIT - Saturday Smash Race (A),Quarq DZero PM to Zwift,Wahoo Kickr 18 to Wahoo Bolt,408,408,0
87695,136809,2020-12-27 05:58:36,wahoo,Zwift - KISS 100 Race Series - EU (A) - 1st :),Quarq DZero PM to Zwift,Wahoo Kickr 18 to Wahoo Bolt,408,412,-4
88489,136809,2020-12-29 10:58:34,wahoo,Zwift - KISS Race Series - Americas AM (A),Quarq DZero PM to Zwift,Wahoo Kickr 18 to Wahoo Bolt,373,380,-7
89100,136809,2020-12-30 17:50:07,wahoo,Zwift - MIDWEEK Winter Series by SZR (A),Quarq DZero PM to Zwift,Wahoo Kickr 18 to Wahoo Bolt,392,399,-7
89520,136809,2020-12-31 16:02:46,wahoo,Zwift - OH MY CRIT! - The Double Race 1/2 (A),Quarq DZero PM to Zwift,Wahoo Kickr 18 to Wahoo Bolt,443,432,11
89543,136809,2020-12-31 17:01:46,wahoo,Zwift - OH MY CRIT! - The Double Race 2/2 (A),Quarq DZero PM to Zwift,Wahoo Kickr 18 to Wahoo Bolt,382,382,0
89701,136809,2021-01-01 07:04:36,wahoo,Zwift - 3R Innsbruckring Race - 33.2km (A),Quarq DZero PM to Bolt ANT+,Wahoo Kickr 18 to Zwift ANT+,390,398,-8
91395,136809,2021-01-04 19:55:29,wahoo,Zwift - Emily&#039;s Short Mix,Quarq AXS DZero to Bolt,Wahoo Kickr 18 to Zwift ANT+,363,360,3
91788,136809,2021-01-05 18:28:27,wahoo,Zwift - TDZ Stage 1: Standard Ride,Quarq AXS DZero to Bolt,Wahoo Kickr 18 to Zwift ANT+,332,327,5
92313,136809,2021-01-06 17:53:41,wahoo,Zwift - MIDWEEK Winter Series by SZR (A),Quarq AXS DZero to Bolt,Wahoo Kickr 18 to Zwift ANT+,399,397,2
92777,136809,2021-01-07 16:54:39,wahoo,Zwift - OH MY CRIT! - The Double Race 2/2 (A),Quarq AXS DZero to Bolt,Wahoo Kickr 18 to Zwift ANT+,408,404,4
93221,136809,2021-01-08 06:52:40,wahoo,Zwift - TDZ Stage 1: Longer Ride,Quarq AXS DZero to Bolt,Wahoo Kickr 18 to Zwift ANT+,324,319,5
93679,136809,2021-01-09 09:00:17,wahoo,Zwift - KRT/KISS 80 km Endurance Ride (B),Quarq AXS DZero to Bolt,Wahoo Kickr 18 to Zwift ANT+,291,300,-9
93696,136809,2021-01-09 09:54:04,wahoo,Zwift - Cycling Ireland Zwift League Rd 7 (A) - 1st :),Quarq AXS DZero to Bolt,Wahoo Kickr 18 to Zwift ANT+,376,372,4
94981,136809,2021-01-11 18:46:34,wahoo,Zwift - Premier Division // Zwift Racing League (men) (A),Quarq AXS DZero to Bolt,Wahoo Kickr 18 to Zwift ANT+,380,378,2
96869,136809,2021-01-14 16:13:05,wahoo,Zwift - OH MY CRIT! - The Double Race 1/2 (A),Quarq AXS DZero to Bolt,Wahoo Kickr 18 to Zwift ANT+,419,425,-6
96891,136809,2021-01-14 16:52:43,wahoo,Zwift - OH MY CRIT! - The Double Race 2/2 (A),Quarq AXS DZero to Bolt,Wahoo Kickr 18 to Zwift ANT+,385,382,3
97704,136809,2021-01-16 06:25:56,wahoo,Zwift - XRS Races - The Saturday Classic (A),Quarq AXS DZero to Bolt,Wahoo Kickr 18 to Zwift ANT+,432,432,0
99188,136809,2021-01-18 19:18:07,wahoo,Zwift - Premier Division // Zwift Racing League (men) (A),Quarq AXS DZero to Bolt,Wahoo Kickr 18 to Zwift ANT+,413,417,-4
100697,136809,2021-01-21 10:56:37,wahoo,Zwift - KISS Race Series - Americas AM (A),Quarq AXS DZero to Bolt,Wahoo Kickr 18 to Zwift ANT+,392,399,-7
102890,136809,2021-01-25 18:45:22,wahoo,Zwift - Premier Division // Zwift Racing League (men) (A),Quarq AXS DZero to Bolt,Wahoo Kickr 18 to Zwift ANT+,438,438,0
106888,136809,2021-02-01 19:42:51,wahoo,Zwift - Premier Division // Zwift Racing League (men) (A),Quarq AXS DZero to Bolt,Wahoo Kickr 18 to Zwift ANT+,405,405,0
110252,136809,2021-02-07 05:55:52,wahoo,Zwift - KISS 100 Race Series - EU (A),Quarq AXS DZero to Bolt,Wahoo Kickr 18 to Zwift ANT+,439,440,-1
111021,136809,2021-02-08 18:55:28,wahoo,Zwift - Premier Division // Zwift Racing League (men) (A),Quarq AXS DZero to Bolt,Wahoo Kickr 18 to Zwift ANT+,440,438,2
112857,136809,2021-02-11 17:01:17,wahoo,Zwift - OH MY CRIT!! - The Double Race 2/2 (A),Quarq AXS DZero to Bolt,Wahoo Kickr 18 to Zwift ANT+,418,417,1
113279,136809,2021-02-12 06:51:15,wahoo,Zwift - 3R Innsbruckring Race - 33.2km (A),Quarq AXS DZero to Bolt,Wahoo Kickr 18 to Zwift ANT+,375,372,3
115353,136809,2021-02-15 19:47:34,wahoo,Zwift - Premier Division // Zwift Racing League (men) (A),Quarq AXS DZero to Bolt,Wahoo Kickr 18 to Zwift ANT+,450,449,1
117187,136809,2021-02-18 16:58:42,wahoo,Zwift - OH MY CRIT!! - The Double Race 2/2 (A),Quarq AXS DZero to Bolt,Wahoo Kickr 18 to Zwift ANT+,437,433,4
119100,136809,2021-02-22 18:55:04,wahoo,Zwift - Premier Division // Zwift Racing League (men) (A),Quarq AXS DZero to Bolt,Wahoo Kickr 18 to Zwift ANT+,406,406,0
120705,136809,2021-02-25 17:01:15,wahoo,Zwift - OH MY CRIT!! - The Double Race 2/2 (A),Quarq AXS DZero to Bolt,Wahoo Kickr 18 to Zwift ANT+,402,397,5
121394,136809,2021-02-27 06:26:33,wahoo,Zwift - XRS Races - The Saturday Classic (A),Quarq AXS DZero to Bolt,Wahoo Kickr 18 to Zwift ANT+,433,432,1
122571,136809,2021-03-01 20:01:51,wahoo,Zwift - Premier Division // Zwift Racing League (men) (A),Quarq AXS DZero to Bolt,Wahoo Kickr 18 to Zwift ANT+,447,454,-7
123962,136809,2021-03-04 16:07:56,wahoo,OH MY CRIT!! - The Double Race 1/2,Quarq AXS DZero to Bolt,Wahoo Kickr 18 to Zwift ANT+,413,416,-3
123986,136809,2021-03-04 16:49:38,wahoo,Zwift - OH MY CRIT!! - The Double Race 2/2 (A),Quarq AXS DZero to Bolt,Wahoo Kickr 18 to Zwift ANT+,405,403,2
127001,136809,2021-03-11 16:46:18,wahoo,Zwift - OH MY CRIT!! - The Double Race 2/2 (A),Quarq AXS DZero to Bolt,Wahoo Kickr 18 to Zwift ANT+,410,408,2
129129,136809,2021-03-16 18:26:36,wahoo,Zwift - CeramicSpeed Race Series: Open Race (A),Quarq AXS DZero to Bolt,Wahoo Kickr 18 to Zwift ANT+,438,435,3
9549,137795,2020-01-15 19:14:48,wahoo,Zwift - Tour de Zwift // Pro-Am Invitational (A),FSA Powerbox,Kickr 18,457,455,2
11601,137795,2020-01-30 07:29:34,wahoo,Zwift - AHDR The Chop 30/01/2020,FSA Powerbox,Kickr 18,411,407,4
11867,137795,2020-01-30 07:29:34,wahoo,Zwift - Tour de Zwift // Pro-Am Invitational (A) - Richmond UCI,FSA Powerbox,Kickr 18,458,456,2
12633,137795,2020-02-04 19:04:25,wahoo,Zwift - Tour de Zwift // Pro-Am Invitational (A) - Shit dual recording caused from dropouts,FSA Powerbox,Kickr 18 (Primary),491,466,25
12871,137795,2020-02-06 18:58:18,wahoo,Zwift - KALAS Cup - Round 2 (A),Quarq D0,Kickr 18 (breaking),483,473,10
14944,137795,2020-02-20 18:59:59,wahoo,Zwift - KALAS Cup - Round 4 (A),FSA Powerbox (Primary),Kickr 18 (Secondary),440,440,0
15953,137795,2020-02-27 18:58:07,wahoo,Zwift - KALAS Cup - Round 5 (A),FSA Powerbox (Primary),Kickr 18 (Secondary),427,416,11
16943,137795,2020-03-05 18:56:48,wahoo,Zwift - KALAS Cup - Round 6 (A),FSA Powerbox (Primary),Kickr 18 (Secondary),410,414,-4
17836,137795,2020-03-12 18:52:03,wahoo,Zwift - Tour of Watopia Pro-Am Men&#039;s Race #1 (A),FSA Powerbox (Primary),Kickr 18 (Secondary),445,447,-2
18897,137795,2020-03-20 18:53:17,wahoo,Zwift - Tour of Watopia Pro-Am Men&#039;s Race #2 (A),FSA Powerbox (Primary),Kickr 18 (Secondary),477,478,-1
19667,137795,2020-03-24 19:11:46,wahoo,Zwift - Tour of Watopia Pro-Am Men&#039;s Race #3 (A),FSA Powerbox (Primary),Kickr 18 (Secondary),419,418,1
19695,137795,2020-03-24 19:11:46,wahoo,Zwift - Cervelo Jungle Rush Series Rd 1 - Cervelo Aspero (B),FSA Powerbox (Primary),Kickr 18 (Secondary),460,455,5
20243,137795,2020-03-28 22:43:43,wahoo,Zwift - EVR Americas West Weekend (A),FSA Powerbox (Primary),Kickr 18 (Secondary),395,391,4
22165,137795,2020-04-05 08:39:57,wahoo,Zwift - Ronde van Zwift (A),FSA Powerbox (Primary),Kickr 18 (Secondary),430,426,4
23145,137795,2020-04-09 04:40:00,wahoo,Infocrank first ride comparison to Wahoo Kickr &#039;18,Infocrank (Primary),Kickr 18 (Secondary),415,408,7
23307,137795,2020-04-09 17:49:59,wahoo,Zwift - London International // Zwift Classic (A),Infocrank (Primary),Kickr 18 (Secondary),509,499,10
23601,137795,2020-04-10 19:40:15,wahoo,Zwift -  Triathlon NZ Saturday Race League (A),Infocrank (Primary),Kickr 18 (Secondary),412,399,13
23919,137795,2020-04-12 03:41:39,wahoo,Training: SE -&gt; Sprints,Infocrank (Primary),Kickr 18 (Secondary),357,353,4
25608,137795,2020-04-17 17:50:55,wahoo,Zwift - Richmond Challenge // Zwift Classic (A) - No legs,Infocrank (Primary),Kickr 18 (Secondary),466,450,16
28028,137795,2020-04-25 17:46:35,wahoo,Zwift - Crit City Slam // Zwift Classic (A),Infocrank (Primary),Kickr 18 (Secondary),460,451,9
30633,137795,2020-05-02 15:39:12,wahoo,Zwift - YANA Pro/AM Invitiational (A) -Training block + 4am /= good legs,Infocrank (Primary),Kickr 18 (Secondary),422,411,11
33821,137795,2020-05-12 09:03:08,wahoo,Zwift - SRAM Send it Series - Race 1 - Men&#039;s (E),Infocrank (Primary),Kickr 18 (Secondary),480,469,11
34580,137795,2020-05-14 09:33:05,wahoo,Zwift - Koa Sports League Race (A) - Awful legs = restday tomorrow,Infocrank (Primary),Kickr 18 (Secondary),426,413,13
36684,137795,2020-05-21 18:13:02,wahoo,Zwift - Tour for All Invitational Race // Men (A),Infocrank (Primary),Kickr 18 (Secondary),435,427,8
37735,137795,2020-05-26 08:16:33,wahoo,Zwift - SRAM Send it Series - Race 3 - Men&#039;s (E),Infocrank (Primary),Kickr 18 (Secondary),468,458,10
37736,137795,2020-05-19 09:05:19,wahoo,Zwift - SRAM Send it Series - Race 2 - Men&#039;s (E),Infocrank (Primary),Kickr 18 (Secondary),493,476,17
38390,137795,2020-05-28 18:08:38,wahoo,Zwift - Tour for All Invitational Race // Men (A),Infocrank (Primary),Kickr 18 (Secondary),487,483,4
38884,137795,2020-06-01 04:38:06,wahoo,Zwift - practice ramp test @90% -&gt; Z2,Infocrank (Secondary),Kickr 18 (Primary),479,476,3
39025,137795,2020-06-02 08:58:58,wahoo,Zwift - SRAM Send it Series - Race 4 - Men&#039;s (E),Infocrank (Primary),Kickr 18 (Secondary),493,490,3
39205,137795,2020-06-02 22:54:49,wahoo,Zwift - Watopia,Infocrank (Secondary),Kickr 18 (Primary),507,487,20
39499,137795,2020-06-04 09:48:14,wahoo,Zwift - Koa Sports League Race (A),Infocrank (Primary),Kickr 18 (Secondary),432,435,-3
40466,137795,2020-06-09 08:53:23,wahoo,Zwift - SRAM Send it Series - Race 5 - Men&#039;s (E),Infocrank (Primary),Kickr 18 (Secondary),504,487,17
41894,137795,2020-06-16 08:58:41,wahoo,Zwift - SRAM Send it Series - Race 6 - Men&#039;s (E),Infocrank (Primary),Kickr 18 (Secondary),438,459,-21
43202,137795,2020-06-23 08:57:17,wahoo,Zwift - SRAM Send it Series - Race 7 - Men&#039;s (E),Infocrank (Primary),Kickr 18 (Secondary),529,528,1
43649,137795,2020-06-25 09:42:04,wahoo,Koa Sports League Race (A) - double day ,Infocrank (Primary),Kickr 18 (Secondary),438,437,1
44157,137795,2020-06-30 08:35:55,wahoo,Zwift - SRAM Send it Series - Race 8 - Men&#039;s (E),Infocrank (Primary),Kickr 18 (Secondary),438,442,-4
45084,137795,2020-07-06 09:56:24,wahoo,Zwift - 30s efforts (10pm),Infocrank (Primary),Kickr 18 (Secondary),214,222,-8
46110,137795,2020-07-13 04:58:53,wahoo,Zwift - Virtual Tour de France - Open - Stage 4 Discovery Ride,Infocrank (Primary),Kickr 18 (Secondary),523,525,-2
47277,137795,2020-07-22 09:38:08,wahoo,Zwift - USA Cycling Race League by Indoor Specialist (A),Infocrank (Primary),Kickr 18 (Secondary),457,458,-1
47488,137795,2020-07-23 09:13:17,wahoo,Zwift - The Lamb Chop p/b Black Sheep (A),Infocrank (Primary),Kickr 18 (Secondary),453,455,-2
47489,137795,2020-07-23 09:53:34,wahoo,Zwift - Koa Sports League Race (A),Infocrank (Primary),Kickr 18 (Secondary),399,394,5
49502,137795,2020-08-10 23:41:29,wahoo,Zwift - 675/370 Over unders,Infocrank (Primary),Kickr 18 (Secondary),469,461,8
49593,137795,2020-08-11 18:40:10,wahoo,Zwift - 3R Turbocharged Team Race Series - Round 5 (A),Infocrank (Primary),Kickr 18 (Secondary),447,444,3
49880,137795,2020-08-13 21:24:53,wahoo,Zwift - Paris,Infocrank (Secondary),Kickr 18 (Primary),362,363,-1
49939,137795,2020-08-14 08:37:33,wahoo,Zwift - Off the MAAP Invitational Race // Stage 1 (Men) (A),Infocrank (Secondary),Kickr 18 (Primary),495,501,-6
50362,137795,2020-08-17 09:35:12,wahoo,Zwift - Off the MAAP Invitational Race // Stage 2 (Men) (A),Infocrank (Secondary),Kickr 18 (Primary),502,505,-3
50857,137795,2020-08-20 08:37:43,wahoo,Zwift - Off the MAAP Invitational Race // Stage 3 (men) ,Infocrank (Secondary),Kickr 18 (Primary),452,456,-4
51469,137795,2020-08-24 09:24:20,wahoo,Zwift - Off the MAAP Invitational Race // Stage 4 (men) ,Infocrank (Secondary),Kickr 18 (Primary),441,443,-2
51852,137795,2020-08-25 17:59:25,wahoo,Zwift - RHYS HOWELL [CANYON]&#039;s Meetup - Big Foot Hills,Infocrank (Primary),Kickr 18 (Secondary),469,477,-8
53979,137795,2020-09-08 17:59:06,wahoo,Zwift - RHYS HOWELL [CANYON]&#039;s Meetup - Muir And The Mountain,Infocrank (Primary),Kickr 18 (Secondary),488,490,-2
54295,137795,2020-09-10 09:00:36,wahoo,Zwift - Cycling Australia&#039;s The Chop by AHDR (A),Infocrank (Primary),Kickr 18 (Secondary),459,457,2
54545,137795,2020-09-11 08:35:43,wahoo,Zwift - 15s big gear seated (mostly),Infocrank (Primary),Kickr 18 (Secondary),250,243,7
54959,137795,2020-09-14 08:54:30,wahoo,Zwift - SE // sprints,Infocrank (Secondary),Kickr 18 (Primary),399,400,-1
55065,137795,2020-09-14 17:45:58,wahoo,Zwift - Invitational League // Qualifying Race #1,Infocrank (Secondary),Kickr 18 (Primary),432,431,1
56090,137795,2020-09-18 07:59:37,wahoo,Zwift -  Stage 1 // Virtual Haute Route Ventoux  (A),Infocrank (Primary),Kickr 18 (Secondary),468,449,19
56354,137795,2020-09-20 05:00:03,wahoo,Zwift -  Stage 3 // Virtual Haute Route Ventoux  (A),Infocrank (Secondary),Kickr 18 (Primary),408,413,-5
56423,137795,2020-09-20 12:53:33,wahoo,Zwift - Invitational League // Qualifying Race #3 (Men) (A) - shit 1am legs,Infocrank (Secondary),Kickr 18 (Primary),480,484,-4
60665,137795,2020-10-09 21:48:16,wahoo,ZA Road - Race #1,Infocrank (Secondary),Kickr 18 (Primary),503,507,-4
61295,137795,2020-10-12 18:35:07,wahoo,Zwift - Premier Division // Zwift Racing League (men) ,Infocrank (Secondary),Kickr 18 (Primary),479,481,-2
62054,137795,2020-10-15 08:20:15,wahoo,Zwift - Espresso,Infocrank (Primary),Wahoo Kickr v5.0,414,416,-2
62348,137795,2020-10-16 04:10:21,wahoo,Zwift Academy Road: Workout 2 | Sprint Profile,Infocrank (Primary),Kickr 18 (Secondary),371,369,2
63149,137795,2020-10-19 17:58:49,wahoo,Zwift - Premier Division // Zwift Racing League (men) ,Infocrank (Secondary),Kickr 18 (Primary),464,462,2
64287,137795,2020-10-23 00:40:36,wahoo,Zwift Academy Road: Workout 3 | VO2 Capacity,Infocrank (Primary),Kickr 18 (Secondary),516,508,8
64963,137795,2020-10-26 00:25:19,wahoo,Zwift Academy Road: Workout 4 | Anaerobic Resilience,Infocrank (Primary),Kickr 18 (Secondary),427,426,1
65165,137795,2020-10-26 19:48:23,wahoo,Zwift - Premier Division // Zwift Racing League (men) (A),Infocrank (Secondary),Kickr 18 (Primary),445,436,9
69196,137795,2020-11-09 02:32:32,wahoo,Zwift - Alex West &#039;s Meetup - Greater London Flat,Infocrank (Secondary),Kickr 18 (Primary),400,404,-4
69428,137795,2020-11-09 19:41:24,wahoo,Zwift - Premier Division // Zwift Racing League (men) (A),Infocrank (Secondary),Kickr 18 (Primary),498,497,1
71958,137795,2020-11-16 19:01:55,wahoo,Zwift - Premier Division // Zwift Racing League (men) (A),Infocrank (Secondary),Kickr 18 (Primary),446,452,-6
72429,137795,2020-11-18 01:50:47,wahoo,Zwift - ZA Road 2020 - Segment Ride #1: Three Sisters Course,Infocrank (Primary),Kickr 18 (Secondary),527,523,4
74585,137795,2020-11-23 08:06:18,wahoo,Zwift Academy Road: Workout 8 | Anaerobic Depletion,Infocrank (Primary),Kickr 18 (Secondary),370,363,7
74698,137795,2020-11-23 19:46:09,wahoo,Zwift - Premier Division // Zwift Racing League (men) (A),Infocrank (Secondary),Kickr 18 (Primary),462,461,1
76021,137795,2020-11-26 17:51:15,wahoo,Zwift - WTRL NOPINZ WORLD TTT CHAMPIONSHIPS - Zone 4 (C),Infocrank (Secondary),Kickr 18 (Primary),422,416,6
77681,137795,2020-11-30 19:02:59,wahoo,Zwift - Premier Division // Zwift Racing League (men) (A),Infocrank (Secondary),Kickr 18 (Primary),454,446,8
86740,137795,2020-12-24 05:29:45,wahoo,Zwift - Kiwi Crew Ride (D),Infocrank (Primary),Kickr 18 (Secondary),500,496,4
91119,137795,2021-01-04 09:54:23,wahoo,Zwift - Reco Intense,Infocrank (Secondary),Kickr v5,442,438,4
94638,137795,2021-01-10 20:14:01,wahoo,Zwift - 660/375 Over unders,Infocrank (Primary),Kickr 18 (Secondary),467,464,3
99185,137795,2021-01-18 19:35:44,wahoo,Zwift - Premier Division // Zwift Racing League (men) (A),Infocrank (Secondary),Kickr 18 (Primary),447,442,5
102916,137795,2021-01-25 18:51:23,wahoo,Zwift - Premier Division // Zwift Racing League (men) (A),Infocrank (Secondary),Kickr 18 (Primary),460,457,3
106518,137795,2021-01-30 23:36:12,wahoo,Zwift - Watopia,Infocrank (Primary),Kickr 18 (Secondary),411,405,6
106907,137795,2021-02-01 19:53:11,wahoo,Zwift - Premier Division // Zwift Racing League (men) (A),Infocrank (Secondary),Kickr 18 (Primary),485,475,10
111035,137795,2021-02-08 19:11:38,wahoo,Zwift - Premier Division // Zwift Racing League (men) (A),Infocrank (Secondary),Kickr 18 (Primary),472,473,-1
115374,137795,2021-02-15 19:40:12,wahoo,Zwift - Premier Division // Zwift Racing League (men) (A),Infocrank (Secondary),Kickr 18 (Primary),452,447,5
119097,137795,2021-02-22 18:56:47,wahoo,Zwift - Premier Division // Zwift Racing League (men) (A),Infocrank (Secondary),Kickr 18 (Primary),432,431,1
121029,137795,2021-02-26 00:05:40,wahoo,Zwift - SE,Infocrank (Secondary),Kickr 18 (Primary),390,384,6
122598,137795,2021-03-01 20:05:29,wahoo,Zwift - Premier Division // Zwift Racing League (men) (A),Infocrank (Secondary),Kickr 18 (Primary),456,463,-7
73933,138652,2020-11-21 01:35:07,neo,Zwift - Watopia,assioma,tacx neo,279,260,19
80935,138652,2020-12-08 17:22:12,neo,Zwift - Hunter&#039;s Challenge Week 2 Day 2 - Peaks Pedal Drills,assioma,tacx neo,259,259,0
84303,138652,2020-12-17 16:13:16,neo,Zwift - Test FTP Progressif,assioma,tacx neo,289,274,15
95195,139821,2021-01-11 20:00:11,wahoo,Crit City,Favero Assioma DUO,Wahoo KICKR,233,229,4
95835,139821,2021-01-12 19:15:07,wahoo,WTRL - Richmond Rev,Favero Assioma DUO,Wahoo KICKR,242,237,5
97176,139821,2021-01-14 18:51:44,wahoo,Espresso,Favero Assioma DUO,Wahoo KICKR,242,244,-2
99359,139821,2021-01-18 20:00:15,wahoo,Crit City,Favero Assioma DUO,Wahoo KICKR,241,241,0
117439,139821,2021-02-18 18:48:29,wahoo,Espresso,Favero Assioma DUO,Wahoo KICKR,236,237,-1
117446,139821,2021-01-26 19:14:30,wahoo,Zwift Racing League | WTRL - Women&#039;s EMEA W1 DIVISION 1,Favero Assioma DUO,Wahoo KICKR,233,234,-1
123177,139821,2021-03-02 19:19:24,wahoo,Zwift Racing League | WTRL - Women’s EMEA W1 Division 1,Favero Assioma DUO,Wahoo KICKR,237,234,3
127292,139821,2021-03-11 18:54:42,wahoo,Espresso,Favero Assioma DUO,Wahoo KICKR,228,230,-2
118579,140937,2021-02-21 05:44:12,wahoo,Zwift - KISS 100 Race Series - EU (A),Favero Assioma Duo,Wahoo KICKR v5,315,314,1
120013,140937,2021-02-24 02:38:30,wahoo,Zwift - Zwift Racing League | WTRL - Men&#039;s/Mixed AMERICAS W DIVISION 1 (A),Favero Assioma Duo,Wahoo KICKR v5,315,315,0
8750,141896,2020-01-10 16:27:16,wahoo,Zwift - Richmond,Assioma via Wahoo app,Kickr ANT FE-C to PC post-adv cal,160,157,3
8996,141896,2020-01-12 13:59:57,wahoo,Zwift - Tour de Zwift: Stage 1 Long Distance,Assioma via Wahoo app,Kickr ANT FE-C to PC post-adv cal,263,261,2
9004,141896,2020-01-12 15:10:27,wahoo,Zwift - Watopia,Assioma via Wahoo app,Kickr ANT FE-C to PC post-adv cal,108,111,-3
9094,141896,2020-01-12 16:12:28,wahoo,Zwift - Tour de Zwift: Stage 1 Race (C),Assioma via Wahoo app,Kickr ANT FE-C to PC post-adv cal,242,246,-4
9151,141896,2020-01-13 16:15:11,wahoo,Zwift - Yorkshire Recovery,Assioma via Wahoo app,Kickr ANT FE-C to PC,235,236,-1
9279,141896,2020-01-14 14:10:55,wahoo,Zwift - Tour de Zwift: Stage 1 Race (B),Assioma via Wahoo app,Kickr ANT FE-C to PC post-adv cal,295,303,-8
9288,141896,2020-01-14 15:00:14,wahoo,Zwift - Dubai Roadsters Club ride (C),Assioma via Wahoo app,Kickr ANT FE-C to PC post-adv cal,199,201,-2
10309,141896,2020-01-21 17:01:24,wahoo,Zwift - Tour de Zwift: Stage 3 Group Ride - Short Distance,Assioma,Kickr ANT FE-C to PC post-adv cal,248,248,0
10565,141896,2020-01-22 13:59:51,wahoo,Zwift - Tour de Zwift: Stage 3 Group Ride - Long Distance,Assioma via Wahoo app,Kickr ANT FE-C to PC post-adv cal,259,275,-16
11109,141896,2020-01-26 16:59:52,wahoo,Zwift - Tour de Zwift: Stage 4 Group Ride - Long Distance,Assioma,Kickr ANT FE-C to PC post-adv cal,217,221,-4
11295,141896,2020-01-28 15:09:34,wahoo,Zwift - NYC Cooldown,Assioma via Wahoo app,Kickr ANT FE-C to PC post-adv cal,134,133,1
13495,141896,2020-02-12 02:00:28,wahoo,Zwift - Tour de Zwift: Stage 1 Race (B),Assioma via Wahoo app,Kickr BTLE to PC post-cal,273,282,-9
105979,141896,2021-01-30 23:00:17,wahoo,Zwift - Ascenders Team [AsC 3.0] Ride (B),Assioma via Wahoo app,Kickr ANT FE-C to PC post-adv cal,294,288,6
106400,141896,2021-01-31 20:00:30,wahoo,Zwift - TEAM Zwift Tri Oz - Monday Recovery Ride (C),Assioma via Wahoo app,Kickr ANT FE-C to PC post-adv cal,164,159,5
108518,141896,2021-02-04 01:03:40,wahoo,Zwift - Watopia,Assioma via Wahoo app,Kickr ANT FE-C to PC post-adv cal,143,143,0
110123,141896,2021-02-06 18:32:25,wahoo,Zwift - Zwift Fondo Series: Bambino Fondo,Assioma via Wahoo app,Kickr ANT FE-C to PC post-adv cal,299,290,9
110705,141896,2021-02-07 21:32:02,wahoo,Zwift - Zwift Fondo Series: Bambino Fondo,Assioma via Wahoo app,Kickr ANT FE-C to PC post-cal,306,302,4
112539,141896,2021-02-10 23:59:59,wahoo,TDZ Stage 8: Group Ride,Assioma via Wahoo app,Kickr ANT FE-C to PC post-adv cal,285,309,-24
115554,141896,2021-02-14 19:40:05,wahoo,Zwift - Watopia,Assioma via Wahoo app,Kickr ANT FE-C to PC post-adv cal,232,212,20
115566,141896,2021-02-15 14:48:51,wahoo,Virtual Mauna Kea/Half Everest,Assioma via Wahoo app,Kickr ANT FE-C to PC post-adv cal,232,224,8
122160,141896,2021-02-28 17:01:57,wahoo,Zwift - Haute Route Watopia 2021 Stage 3 (B),Assioma via Wahoo app,Kickr ANT FE-C to PC post-adv cal,287,286,1
123774,141896,2021-03-04 01:04:51,wahoo,Zwift - Cycling Canada Wednesday Night Race Series (A),Assioma via Wahoo app,Kickr ANT FE-C to PC post-adv cal,289,293,-4
126773,141896,2021-03-11 00:42:36,wahoo,Zwift - ZHR Hare & Hounds (A),Assioma via Wahoo app,Kickr ANT FE-C to PC post-adv cal,282,282,0
127979,141896,2021-03-13 15:01:36,wahoo,Zwift - 3R Endurance Steady Ride [~3.0//2.5//2w/kg avg] (C),Assioma via Wahoo app,Kickr ANT FE-C to PC post-adv cal,205,196,9
128466,141896,2021-03-14 15:00:26,wahoo,Zwift - 3R Endurance Steady Ride [~3.0//2.5w/kg avg] (B),Assioma via Wahoo app,Kickr ANT FE-C to PC post-adv cal,275,270,5
106175,142744,2021-01-31 12:15:47,wahoo,Zwift - 2020 build 1,Quarq Elsa (to Garmin),Kickr 2021,239,251,-12
106179,142744,2021-01-31 11:47:35,wahoo,Zwift - spun down via app and game but....,Quarq Elsa (to Garmin),Kickr 2021,182,194,-12
106368,142744,2021-01-31 17:09:10,wahoo,Zwift - Watopia,Quarq Elsa (to Garmin),Kickr 2021,189,202,-13
106790,142744,2021-02-01 18:47:19,wahoo,Zwift - post factory calibration,Quarq Elsa (to Garmin),Kickr 2021,188,198,-10
107542,142744,2021-02-02 18:22:55,wahoo,Zwift - w&#039;up pre spin down,Quarq Elsa (to Garmin),Kickr 2021,209,219,-10
107548,142744,2021-02-02 18:56:25,wahoo,Zwift - post spindown tester,Quarq Elsa (to Garmin),Kickr 2021,179,183,-4
107564,142744,2021-02-02 20:00:15,wahoo,Zwift - OK turbo what say ye?,Quarq Elsa (to Garmin),Kickr 2021,162,169,-7
108376,142744,2021-02-03 18:29:37,wahoo,Zwift - Watopia,Quarq Elsa (to Garmin),Kickr 2021,181,187,-6
108989,142744,2021-02-04 18:09:18,wahoo,Zwift - Under overs sweetspot,Quarq Elsa (to Garmin),Kickr 2021,219,225,-6
110052,142744,2021-02-06 15:19:29,wahoo,Zwift - Watopia ZADA 3 SISTERS,Quarq Elsa (to Garmin),Kickr 2021,260,265,-5
110055,142744,2021-02-06 14:39:28,wahoo,Zwift - Watopia 3 sisters w&#039;up (pre spindown),Quarq Elsa (to Garmin),Kickr 2021,217,222,-5
112457,142744,2021-02-10 18:29:30,wahoo,Zwift - Movistar Team Challenge // Round 1 (B),Quarq Elsa (to Garmin),Kickr 2021,274,272,2
113672,142744,2021-02-12 18:32:07,wahoo,Zwift - Movistar Team Challenge // Round 1 (women),Quarq Elsa (to Garmin),Kickr 2021,265,271,-6
116813,142744,2021-02-17 18:15:42,wahoo,Zwift - Movistar Team Challenge // Round 2 (women) - Race 3/4,Quarq Elsa (to Garmin),Kickr 2021,243,250,-7
116894,142744,2021-02-17 17:42:36,wahoo,Zwift - Watopia,Quarq Elsa (to Garmin),Kickr 2021,148,153,-5
117948,142744,2021-02-19 18:20:59,wahoo,Zwift - Movistar Team Challenge // Round 2 (women),Quarq Elsa (to Garmin),Kickr 2021,279,277,2
123393,142744,2021-03-02 18:49:07,wahoo,Zwift - Zwift Racing League | WTRL - Women&#039;s EMEA W1 DIVISION 1 (A),Quarq Elsa (to Garmin),Kickr 2021,240,243,-3
124658,142744,2021-03-05 19:32:23,wahoo,Zwift - Movistar Team Challenge // Points Race (women) ,Quarq Elsa (to Garmin),Kickr 2021,255,258,-3
124663,142744,2021-03-05 18:46:54,wahoo,Zwift - Ramp Test,Quarq Elsa (to Garmin),Kickr 2021,274,286,-12
125157,142744,2021-03-06 18:59:26,wahoo,Zwift - Zwift Racing League | WTRL Battle Royale Playoff - Women&#039;s TTT (A),Quarq Elsa (to Garmin),Kickr 2021,238,245,-7
125162,142744,2021-03-06 18:28:05,wahoo,Zwift - London pre spindown,Quarq Elsa (to Garmin),Kickr 2021,209,214,-5
50873,142883,2020-08-20 08:49:50,wahoo,Zwift - Off the MAAP Invitational Race // Stage 3 (men) ,2020-08-20-084950-ELEMNT ROAM EBA5-53-0,Kickr ,399,417,-18
15802,143413,2020-02-27 04:03:27,wahoo,Zwift - 3R Park Perimeter Loop Flat Race - 3 Laps (29.1km/18mi 378m) (B),Garmin Vector 3,Kickr,292,293,-1
39039,143413,2020-06-02 08:01:24,wahoo,Zwift - Emily&#039;s Short Mix,Vector 3,KickR,287,293,-6
39260,143413,2020-06-03 07:48:59,wahoo,Zwift - SAS - Out & Back (C),Vector 3,KickR,294,314,-20
40647,143413,2020-06-09 09:51:38,wahoo,Zwift - Zwift 09/06,Vector 3,KickR,219,213,6
40896,143413,2020-06-10 09:23:28,wahoo,Zwift - ZHR Hare & Hounds Race,Vector 3,KickR,314,305,9
41707,143413,2020-06-14 05:24:34,wahoo,Zwift - XRS Races: a Longer and Hard race (B),Vector 3,KickR,311,304,7
42076,143413,2020-06-16 09:43:10,wahoo,Zwift - All American Bikes Group Ride (B),Vector 3,KickR,320,322,-2
42656,143413,2020-06-17 07:40:58,wahoo,Zwift - SAS - Out & Back (C),Vector 3,KickR,311,308,3
42657,143413,2020-06-19 05:46:43,wahoo,Zwift - SAS - Fush & Chups (C),Vector 3,KickR,335,329,6
42930,143413,2020-06-20 06:26:33,wahoo,Zwift - 3R 160 Steady Ride [~3.0w/kg avg] (B),Vector 3,KickR,231,228,3
43672,143413,2020-06-26 05:59:39,wahoo,Zwift - SAS - Fush & Chups (C),Vector 3,KickR,338,323,15
46111,143413,2020-07-12 05:08:38,wahoo,Zwift - L&#039;Etape du Tour Stage 2 - Open,Vector 3,KickR,290,274,16
46672,143413,2020-07-16 10:32:19,wahoo,Zwift - Roll with Castelli (C),Vector 3,KickR,205,212,-7
46675,143413,2020-07-15 09:09:48,wahoo,Zwift - JETT Enjoy Home Japan Ride (C),Vector 3,KickR,251,259,-8
47216,143413,2020-07-21 06:59:39,wahoo,Zwift - SAS - EYUP! (C),Vector 3,KickR,294,287,7
47749,143413,2020-07-22 07:31:26,wahoo,Zwift - SAS - Out & Back (C),Vector 3,KickR,299,303,-4
76332,143413,2020-11-26 06:39:51,wahoo,Zwift - SZR Sunrise Ride (C),Vector 3,KickR,315,306,9
52232,143629,2020-08-27 17:24:15,neo,SRM / Tacx Neo ,SRM,Tacx Neo ,409,414,-5
52491,143629,2020-08-29 08:49:32,neo,Tacx Neo  / SRM,SRM,Tacx Neo ,300,303,-3
52885,143629,2020-09-01 13:14:51,neo,Tacx Neo  / SRM,SRM,Tacx Neo ,421,418,3
53626,143629,2020-09-06 09:00:01,neo,Tacx Neo  / SRM,SRM,Tacx Neo ,391,405,-14
55066,143629,2020-09-14 17:59:51,neo,Tacx Neo  / SRM,SRM,Tacx Neo ,418,409,9
56070,143629,2020-09-17 18:29:57,neo,Tacx Neo  / SRM,SRM,Tacx Neo ,387,392,-5
56457,143629,2020-09-20 13:00:14,neo,Tacx Neo  / SRM,SRM,Tacx Neo ,396,408,-12
57288,143629,2020-09-24 18:03:57,neo,Zwift - Espresso,SRM,Tacx Neo ,396,400,-4
57633,143629,2020-09-26 08:30:00,neo,Zwift - DBR SufferDay League II (A),SRM,Tacx Neo ,410,417,-7
58827,143629,2020-10-01 17:26:14,neo,Zwift - Espresso,SRM,Tacx Neo ,392,394,-2
59172,143629,2020-10-03 08:29:54,neo,Zwift - DBR SufferDay League II (A),SRM,Tacx Neo ,410,417,-7
60254,143629,2020-10-08 09:59:45,neo,Zwift - KISS at Race - Americas AM (A),SRM,Tacx Neo ,426,425,1
61515,143629,2020-10-13 17:14:35,neo,Zwift - Zwift Racing League | WTRL,SRM,Tacx Neo ,413,412,1
62652,143629,2020-10-17 12:06:22,neo,Zwift - The BMTR Fundo (A),SRM,Tacx Neo ,372,373,-1
63401,143629,2020-10-20 17:18:56,neo,Zwift Racing League | WTRL - EMEA E (MEN) - TTT Grp 1,SRM,Tacx Neo ,400,402,-2
64377,143629,2020-10-23 13:02:01,neo,Zwift - Zwift Fast Fridays: Tempus Fugit Time Trial (E),SRM,Tacx Neo ,432,434,-2
64654,143629,2020-10-24 12:08:51,neo,The BMTR Fundo,SRM,Tacx Neo ,371,368,3
65430,143629,2020-10-27 18:13:52,neo,Zwift Racing League | WTRL - Mens EMEA E1 DIVISION 1,SRM,Tacx Neo ,426,427,-1
66693,143629,2020-10-31 12:09:31,neo,Zwift - The BMTR Fundo (A),SRM,Tacx Neo ,374,370,4
66900,143629,2020-11-01 09:59:44,neo,Zwift - Climbers Day p/b dPAC.fit & Precision Hydration (A),SRM,Tacx Neo ,382,390,-8
67580,143629,2020-11-03 18:34:19,neo,Zwift - Zwift Racing League | WTRL - Men&#039;s EMEA E1 DIVISION 1 (A),SRM,Tacx Neo ,390,394,-4
68987,143629,2020-11-08 08:59:18,neo,Zwift - Zwift Fondo Series 2020/21: Gran Fondo ,SRM,Tacx Neo ,397,400,-3
69752,143629,2020-11-10 18:14:25,neo,Zwift - Zwift Racing League | WTRL - EMEA E1 (MEN) -  Division 1 (A),SRM,Tacx Neo ,427,438,-11
70633,143629,2020-11-12 15:39:30,neo,Zwift - ZA Tri: TT Race - 40k,SRM,Tacx Neo ,452,453,-1
73092,143629,2020-11-19 18:54:11,neo,Zwift - Espresso,SRM,Tacx Neo ,399,401,-2
73832,143629,2020-11-21 11:58:50,neo,Zwift - WKG Winter League 2020 / 2021  (A),SRM,Tacx Neo ,393,397,-4
75025,143629,2020-11-24 18:13:50,neo,Zwift - Zwift Racing League | WTRL - Men&#039;s EMEA E1 DIVISION 1,SRM,Tacx Neo ,423,423,0
76039,143629,2020-11-26 18:52:25,neo,Zwift - WTRL NOPINZ WORLD TTT CHAMPIONSHIPS - Zone 7 (C),SRM,Tacx Neo ,402,404,-2
78040,143629,2020-12-01 18:23:25,neo,Zwift - Zwift Racing League | WTRL - Men&#039;s EMEA E1 DIVISION 1 (A),SRM,Tacx Neo ,396,394,2
79435,143629,2020-12-04 17:01:33,neo,Zwift - Zwift Fast Fridays: Bologna Time Trial (E),SRM,Tacx Neo ,392,401,-9
79779,143629,2020-12-05 13:59:06,neo,Zwift - XRS Races: Saturday Climbing Series (A),SRM,Tacx Neo ,422,429,-7
80767,143629,2020-12-08 18:13:56,neo,Zwift - Zwift Racing League | WTRL - Men&#039;s EMEA E1 DIVISION 1 (A),SRM,Tacx Neo ,412,408,4
62991,146249,2020-10-19 10:19:40,neo,Zwift - 3R Volcano Flat Race - 3 Laps (36.6km/22.7mi 138m) (A),Powertap P1,Tacx NEO,308,309,-1
63780,146249,2020-10-21 09:57:29,neo,Zwift - EVR Definitely Not the WTNC (A),Powertap P1,Tacx NEO,294,306,-12
65090,146249,2020-10-26 17:56:58,neo,Zwift - 3R Bologna Race - 2 Laps (A),Powertap P1,Tacx NEO,349,353,-4
65954,146249,2020-10-28 17:12:15,neo,Zwift - 3R iTT Race - Watopia Tick Tock - 1 Lap (A),Powertap P1,Tacx NEO,339,346,-7
66422,146249,2020-10-30 14:02:47,neo,Zwift - 3R Innsbruckring Flat Race - 2 Laps (17.6km/10.9m 154m) (A),Powertap P1,Tacx NEO,322,322,0
67152,146249,2020-11-02 11:29:32,neo,Zwift - 3R Innsbruckring Flat Race - 3 Laps (26.4km/16.4mi 231m) (A),Powertap P1,Tacx NEO,332,334,-2
68042,146249,2020-11-05 09:29:54,neo,Zwift - KISS at Race - Down Under (A),Powertap P1,Tacx NEO,310,317,-7
69334,146249,2020-11-09 16:58:04,neo,Zwift - ZHQ Steering Race // FutureWorks (A),Powertap P1,Tacx NEO,302,313,-11
72728,146249,2020-11-18 11:19:08,neo,Zwift - 3R Volcano Circuit Flat Race - 6 Laps (27km/16.8mi 120m) (A),Powertap P1,Tacx NEO,336,329,7
73552,146249,2020-11-20 16:04:24,neo,Zwift - 3R Volcano Flat Race - 3 Laps (36.6km/22.7mi 138m) (A),Powertap P1,Tacx NEO,334,337,-3
74583,146249,2020-11-23 17:31:16,neo,Zwift - Kiss Racing Team / FastFitnessTips iTT series (E),Powertap P1,Tacx NEO,319,317,2
75005,146249,2020-11-24 18:09:51,neo,Zwift - SZR iTT Autumn Racing league (A),Powertap P1,Tacx NEO,349,353,-4
76019,146249,2020-11-26 18:16:34,neo,Zwift - ,Powertap P1,Tacx NEO,328,325,3
83403,146249,2020-12-15 11:27:51,neo,Zwift - 3R Volcano Circuit Flat Race - 8 Laps (35.2km/21.9mi 160m) (A),Powertap P1,Tacx NEO,306,311,-5
86179,146249,2020-12-22 18:10:15,neo,Zwift - SZR iTT Winter Racing League (A),Powertap P1,Tacx NEO,342,336,6
88192,146249,2020-12-28 14:12:41,neo,Zwift - 3R Classique Reverse Flat Race - 5 Laps (32km/20.1mi 76m) (A),Powertap P1,Tacx NEO,324,313,11
88685,146249,2020-12-29 18:08:11,neo,Zwift - SZR iTT Winter Racing League (A),Powertap P1,Tacx NEO,341,331,10
95685,146249,2021-01-12 18:28:39,neo,Zwift - Zwift Racing League | WTRL - Men&#039;s/Mixed EMEA E2 DIVISION 6 (A),Powertap P1,Tacx NEO,352,365,-13
101521,146249,2021-01-22 18:37:27,neo,Zwift - TFC Xmas Smash Fest (E),Powertap P1,Tacx NEO,350,338,12
103498,146249,2021-01-26 18:10:07,neo,Zwift - Zwift Racing League | WTRL - Men&#039;s/Mixed EMEA E2 DIVISION 6 (A),Powertap P1,Tacx NEO,335,327,8
104654,146249,2021-01-28 17:46:52,neo,Zwift - Hudik Triathlon Time Trial,Powertap P1,Tacx NEO,323,324,-1
8654,146672,2020-01-09 15:45:14,wahoo,Zwift - Crit City Race (A),Favero assioma duo,Wahoo kickr smart 2018,351,351,0
8657,146672,2020-01-09 15:43:43,wahoo,Zwift - Crit City Race (A),Favero assioma duo,Wahoo kickr smart 2018,351,331,20
9112,146672,2020-01-13 10:19:19,wahoo,Zwift - 3R Volcano Flat Reverse Race - 3 Laps (36.6km/22.7mi 138m) (A),Favero assioma duo,Wahoo kickr smart 2018,360,338,22
9252,146672,2020-01-14 11:09:54,wahoo,Zwift - Tour de Zwift: Stage 1 Race (A),Favero assioma duo,Wahoo kickr smart 2018,341,313,28
9533,146672,2020-01-15 19:13:51,wahoo,Zwift - Tour de Zwift // Pro-Am Invitational (A),Favero assioma duo,Wahoo kickr smart 2018,379,362,17
9665,146672,2020-01-16 15:44:14,wahoo,Zwift - Crit City Race (A),Favero assioma duo,Wahoo kickr smart 2018,347,321,26
9667,146672,2020-01-16 16:09:38,wahoo,Zwift - OH CRIT!! - The Double Race - Race 1/2 (A),Favero assioma duo,Wahoo kickr smart 2018,328,300,28
9985,146672,2020-01-19 10:43:43,wahoo,Zwift - The Season - Richmond Cup (A),Favero assioma duo,Wahoo kickr smart 2018,375,354,21
9986,146672,2020-01-19 11:45:03,wahoo,Zwift - Crit City Race (A),Favero assioma duo,Wahoo kickr smart 2018,323,309,14
10113,146672,2020-01-20 10:27:58,wahoo,Zwift - DIRTy Dozen Sprint League (A),Favero assioma duo,Wahoo kickr smart 2018,373,351,22
10114,146672,2020-01-20 11:09:31,wahoo,Zwift - Tour de Zwift: Stage 3 Race (A),Favero assioma duo,Wahoo kickr smart 2018,359,341,18
10231,146672,2020-01-21 09:52:42,wahoo,Zwift - Peel Cycling - Morning Chase (A),Favero assioma duo,Wahoo kickr smart 2018,344,327,17
10232,146672,2020-01-21 11:00:08,wahoo,Zwift - Tour de Zwift: Stage 3 Group Ride - Short Distance,Favero assioma duo,Wahoo kickr smart 2018,333,323,10
10658,146672,2020-01-23 19:13:57,wahoo,Zwift - Tour de Zwift // Pro-Am Invitational,Favero assioma duo,Wahoo kickr smart 2018,385,375,10
10841,146672,2020-01-25 08:09:00,wahoo,Zwift - Tour de Zwift: Stage 4 Race (A),Favero assioma duo,Wahoo kickr smart 2018,398,380,18
11154,146672,2020-01-27 10:29:19,wahoo,Zwift - DIRTy Dozen Sprint League (A),Favero assioma duo,Wahoo kickr smart 2018,348,341,7
11263,146672,2020-01-28 11:09:22,wahoo,Zwift - Tour de Zwift: Stage 5 Race (A),Favero assioma duo,Wahoo kickr smart 2018,355,342,13
11264,146672,2020-01-28 09:52:50,wahoo,Zwift - Peel Cycling - Morning Chase (A),Favero assioma duo,Wahoo kickr smart 2018,346,330,16
11475,146672,2020-01-29 10:44:07,wahoo,Zwift - DIRT & IS: Baker&#039;s Dozen (A),Favero assioma duo,Wahoo kickr smart 2018,354,341,13
11718,146672,2020-01-30 15:44:14,wahoo,Zwift - Crit City Race (A),Favero assioma duo,Wahoo kickr smart 2018,335,325,10
11719,146672,2020-01-30 16:13:40,wahoo,Zwift - OH CRIT!! - The Double Race - Race 1/2 (A),Favero assioma duo,Wahoo kickr smart 2018,330,318,12
11938,146672,2020-02-01 08:09:08,wahoo,Zwift - Tour de Zwift: Stage 6 Race (A),Favero assioma duo,Wahoo kickr smart 2018,378,360,18
12230,146672,2020-02-03 10:28:56,wahoo,Zwift - DIRTy Dozen Sprint League (A),Favero assioma duo,Wahoo kickr smart 2018,354,342,12
12415,146672,2020-02-04 19:13:21,wahoo,Zwift - Tour de Zwift // Pro-Am Invitational (A),Favero assioma duo,Wahoo kickr smart 2018,387,374,13
12539,146672,2020-02-05 10:44:39,wahoo,Zwift - DIRT & IS: Baker&#039;s Dozen (A),Favero assioma duo,Wahoo kickr smart 2018,372,352,20
12742,146672,2020-02-06 15:43:53,wahoo,Zwift - Crit City Race (A),Favero assioma duo,Wahoo kickr smart 2018,350,331,19
12743,146672,2020-02-06 16:14:02,wahoo,Zwift - OH CRIT!! - The Double Race - Race 1/2 (A),Favero assioma duo,Wahoo kickr smart 2018,348,334,14
12744,146672,2020-02-06 17:10:00,wahoo,Zwift - Tour de Zwift: Stage 7 Race (A),Favero assioma duo,Wahoo kickr smart 2018,326,301,25
12967,146672,2020-02-08 10:06:27,wahoo,Zwift - Watopia,Favero assioma duo,Wahoo kickr smart 2018,229,222,7
12988,146672,2020-02-08 10:29:05,wahoo,Zwift - 3R Volcano Climb Race - 1 Lap (22.4km/14mi 204m) (A),Favero assioma duo,Wahoo kickr smart 2018,360,334,26
12989,146672,2020-02-08 11:14:34,wahoo,Zwift - 3R Tick Tock Flat Race - 2 Lap (36km/22.4mi 100m) (A),Favero assioma duo,Wahoo kickr smart 2018,335,324,11
12990,146672,2020-02-08 12:29:49,wahoo,Zwift - Watopia,Favero assioma duo,Wahoo kickr smart 2018,179,173,6
13244,146672,2020-02-10 09:59:22,wahoo,Zwift - MET-5 Race (A),Favero assioma duo,Wahoo kickr smart 2018,346,326,20
13538,146672,2020-02-12 10:43:02,wahoo,Zwift - DIRT & IS: Baker&#039;s Dozen (A),Favero assioma duo,Wahoo kickr smart 2018,377,364,13
13688,146672,2020-02-13 15:43:14,wahoo,Zwift - Crit City Race (A),Favero assioma duo,Wahoo kickr smart 2018,340,327,13
14166,146672,2020-02-16 08:04:10,wahoo,Zwift - 3R Watopia Flat Route Race - 4 Laps (40.5km/25.1mi 216m) (A),Favero assioma duo,Wahoo kickr smart 2018,347,331,16
14351,146672,2020-02-17 13:34:09,wahoo,Zwift - Crit City Race (A),Favero assioma duo,Wahoo kickr smart 2018,331,315,16
14352,146672,2020-02-17 14:14:10,wahoo,Zwift - 3R Classique Reverse Flat Race - 5 Laps (32km/20.1mi 76m) (A),Favero assioma duo,Wahoo kickr smart 2018,329,313,16
14667,146672,2020-02-19 10:44:09,wahoo,Zwift - DIRT & IS: Baker&#039;s Dozen (A),Favero assioma duo,Wahoo kickr smart 2018,357,348,9
14848,146672,2020-02-20 10:44:42,wahoo,Zwift - Crit City Race (A),Favero assioma duo,Wahoo kickr smart 2018,355,337,18
14849,146672,2020-02-20 11:14:11,wahoo,Zwift - 3R Classique Flat Race - 4 Laps (26.9km/16.7mi 76m) (A),Favero assioma duo,Wahoo kickr smart 2018,356,346,10
15157,146672,2020-02-22 10:29:13,wahoo,Zwift - 3R Volcano Climb Race - 1 Lap (22.4km/14mi 204m) (A),Favero assioma duo,Wahoo kickr smart 2018,380,365,15
15158,146672,2020-02-22 11:14:37,wahoo,Zwift - 3R Tick Tock Flat Race - 2 Lap (36km/22.4mi 100m) (A),Favero assioma duo,Wahoo kickr smart 2018,327,319,8
15420,146672,2020-02-24 10:29:28,wahoo,Zwift - DIRTy Dozen Sprint League (A),Favero assioma duo,Wahoo kickr smart 2018,358,343,15
15692,146672,2020-02-26 10:44:07,wahoo,Zwift - DIRT & IS: Baker&#039;s Dozen (A),Favero assioma duo,Wahoo kickr smart 2018,409,391,18
15863,146672,2020-02-27 15:44:03,wahoo,Zwift - Crit City Race (A),Favero assioma duo,Wahoo kickr smart 2018,353,332,21
16440,146672,2020-03-02 10:19:05,wahoo,Zwift - 3R Volcano Flat Race - 3 Laps (36.6km/22.7mi 138m) (A),Favero assioma duo,Wahoo kickr smart 2018,357,336,21
16753,146672,2020-03-04 10:04:04,wahoo,Zwift - 3R Road To Ruins Hilly Race - 1 Lap (29..2km/18.1mi 275m) (A),Favero assioma duo,Wahoo kickr smart 2018,385,368,17
16913,146672,2020-03-05 15:44:04,wahoo,Zwift - Crit City Race (A),Favero assioma duo,Wahoo kickr smart 2018,331,320,11
17346,146672,2020-03-09 09:49:41,wahoo,Zwift - KISS at Base Training Ride (B),Favero assioma duo,Wahoo kickr smart 2018,298,287,11
17439,146672,2020-03-10 10:09:02,wahoo,Zwift - Stage 1 Race (A) - Tour of Watopia 2020,Favero assioma duo,Wahoo kickr smart 2018,370,353,17
17797,146672,2020-03-12 15:44:01,wahoo,Zwift - Crit City Race (A),Favero assioma duo,Wahoo kickr smart 2018,365,342,23
18247,146672,2020-03-16 09:13:59,wahoo,Zwift - 3R Watopia Flat Route Race - 4 Laps (41km/25.5mi 216m) (A),Favero assioma duo,Wahoo kickr smart 2018,372,353,19
18374,146672,2020-03-17 09:59:40,wahoo,Zwift - KISS at Race - Americas AM (A),Favero assioma duo,Wahoo kickr smart 2018,366,347,19
18690,146672,2020-03-19 15:43:58,wahoo,Zwift - Crit City Race (A),Favero assioma duo,Wahoo kickr smart 2018,371,354,17
18691,146672,2020-03-19 16:13:58,wahoo,Zwift - OH CRIT!! - The Double Race - Race 1/2 (A),Favero assioma duo,Wahoo kickr smart 2018,355,338,17
19011,146672,2020-03-21 11:07:59,wahoo,Zwift - DIRT DADurday Chase Race (A),Favero assioma duo,Wahoo kickr smart 2018,378,369,9
19247,146672,2020-03-23 10:18:58,wahoo,Zwift - 3R Volcano Flat Race - 3 Laps (36.6km/22.7mi 138m) (A),Favero assioma duo,Wahoo kickr smart 2018,358,345,13
19484,146672,2020-03-25 09:43:56,wahoo,Zwift - USA Cycling Race League by Indoor Specialist  (A),Favero assioma duo,Wahoo kickr smart 2018,346,323,23
20102,146672,2020-03-28 11:14:56,wahoo,Zwift - 3R Tick Tock Flat Race - 2 Lap (36km/22.4mi 100m) (A),Favero assioma duo,Wahoo kickr smart 2018,360,360,0
20536,146672,2020-03-30 09:15:16,wahoo,Zwift - 3R Watopia Flat Route Race - 4 Laps (41km/25.5mi 216m) (A),Favero assioma duo,Wahoo kickr smart 2018,355,340,15
21669,146672,2020-04-03 10:04:56,wahoo,Zwift - 3R Innsbruckring Flat Race - 4 Laps (35.2km/21.9mi 308m) (A),Favero assioma duo,Wahoo kickr smart 2018,378,365,13
21919,146672,2020-04-04 09:04:53,wahoo,Zwift - 3R Sand & Sequioas Race - 2 Laps (A),Favero assioma duo,Wahoo kickr smart 2018,356,354,2
22183,146672,2020-04-05 09:45:54,wahoo,Zwift - DIRTy Opposite Race (A),Favero assioma duo,Wahoo kickr smart 2018,351,336,15
22968,146672,2020-04-08 09:44:57,wahoo,Zwift - USA Cycling Race League by Indoor Specialist  (A),Favero assioma duo,Wahoo kickr smart 2018,386,377,9
23686,146672,2020-04-11 08:04:55,wahoo,Zwift - 3R London Classique Reverse - 6 Laps (A),Favero assioma duo,Wahoo kickr smart 2018,358,358,0
23948,146672,2020-04-12 07:59:57,wahoo,Zwift -  KALAS Indoor EFCT race series #Sprint (A),Favero assioma duo,Wahoo kickr smart 2018,330,310,20
24548,146672,2020-04-14 15:04:57,wahoo,Zwift - 3R Volcano Circuit Flat Race - 8 Laps (35.2km/21.9mi 160m) (A),Favero assioma duo,Wahoo kickr smart 2018,347,334,13
24813,146672,2020-04-15 09:44:57,wahoo,Zwift - USA Cycling Race League by Indoor Specialist  (A),Favero assioma duo,Wahoo kickr smart 2018,375,358,17
25153,146672,2020-04-16 09:18:55,wahoo,Zwift - Cycling Australia&#039;s The Chop by AHDR (A),Favero assioma duo,Wahoo kickr smart 2018,363,351,12
25791,146672,2020-04-18 10:30:23,wahoo,Zwift - 3R Volcano Climb Race - 1 Lap (22.4km/14mi 204m) (A),Favero assioma duo,Wahoo kickr smart 2018,387,369,18
26590,146672,2020-04-21 09:04:57,wahoo,Zwift - 3R Spring Loaded Race Series - Round 4of6 (A),Favero assioma duo,Wahoo kickr smart 2018,356,341,15
27227,146672,2020-04-23 09:44:54,wahoo,Zwift - Koa Sports League Race (A),Favero assioma duo,Wahoo kickr smart 2018,374,368,6
27228,146672,2020-04-23 10:39:56,wahoo,Zwift - DIRT Doozy Race (A),Favero assioma duo,Wahoo kickr smart 2018,338,323,15
28659,146672,2020-04-28 09:15:26,wahoo,Zwift - 3R Whole Lotta Lava Hilly Race - 2 Laps (28.9km/12.53mi 336m) (A),Favero assioma duo,Wahoo kickr smart 2018,368,355,13
28660,146672,2020-04-28 10:32:57,wahoo,Zwift - Crit City Slam Race // Zwift Classic,Favero assioma duo,Wahoo kickr smart 2018,337,328,9
30396,146672,2020-05-02 08:59:57,wahoo,Zwift - Cycling Ireland Zwift League Rd 6 Road to Ruins (A),Favero assioma duo,Wahoo kickr smart 2018,373,360,13
31521,146672,2020-05-05 09:20:01,wahoo,Zwift - 05/05/2020,Favero assioma duo,Wahoo kickr smart 2018,355,338,17
31522,146672,2020-05-05 10:10:22,wahoo,Zwift - Tour for All 2020: Stage 1 Longer Race A/B,Favero assioma duo,Wahoo kickr smart 2018,312,296,16
32340,146672,2020-05-07 09:44:54,wahoo,Zwift - Koa Sports League Race (A),Favero assioma duo,Wahoo kickr smart 2018,391,380,11
32890,146672,2020-05-09 08:59:57,wahoo,Zwift - CIZL Rd 7 – Sean Lynch Memorial (A),Favero assioma duo,Wahoo kickr smart 2018,380,364,16
33838,146672,2020-05-12 09:09:53,wahoo,Zwift - SRAM Send it Series - Race 1 - Men&#039;s (E),Favero assioma duo,Wahoo kickr smart 2018,380,375,5
34573,146672,2020-05-14 09:44:54,wahoo,Zwift - Koa Sports League Race (A),Favero assioma duo,Wahoo kickr smart 2018,381,364,17
34593,146672,2020-05-14 10:39:53,wahoo,Zwift - DIRT Doozy Race (A),Favero assioma duo,Wahoo kickr smart 2018,372,357,15
35251,146672,2020-05-16 08:59:55,wahoo,Zwift - Cycling Ireland Zwift League Rd 8 (A),Favero assioma duo,Wahoo kickr smart 2018,375,374,1
35964,146672,2020-05-19 09:09:53,wahoo,Zwift - SRAM Send it Series - Race 2 - Men&#039;s (E),Favero assioma duo,Wahoo kickr smart 2018,386,371,15
35982,146672,2020-05-19 09:59:57,wahoo,Zwift - KISS at Race - Americas AM (A),Favero assioma duo,Wahoo kickr smart 2018,335,321,14
36579,146672,2020-05-21 10:39:57,wahoo,Zwift - DIRT Doozy Race (A),Favero assioma duo,Wahoo kickr smart 2018,349,339,10
37728,146672,2020-05-26 09:09:55,wahoo,Zwift - SRAM Send it Series - Race 3 - Men&#039;s (E),Favero assioma duo,Wahoo kickr smart 2018,393,370,23
37743,146672,2020-05-26 09:59:57,wahoo,Zwift - KISS at Race - Americas AM (A),Favero assioma duo,Wahoo kickr smart 2018,339,328,11
38235,146672,2020-05-28 09:44:55,wahoo,Zwift - Koa Sports League Race (A),Wahoo kickr smart 2018,Wahoo kickr smart 2018,360,374,-14
38654,146672,2020-05-30 08:59:57,wahoo,Zwift - Cycling Ireland Zwift League Rd 10 (A),Favero assioma duo,Wahoo kickr smart 2018,395,378,17
39020,146672,2020-06-02 09:09:55,wahoo,Zwift - SRAM Send it Series - Race 4 - Men&#039;s (E),Favero assioma duo,Wahoo kickr smart 2018,370,379,-9
39261,146672,2020-06-03 09:44:58,wahoo,Zwift - USA Cycling Race League by Indoor Specialist (A),Favero assioma duo,Wahoo kickr smart 2018,368,356,12
39507,146672,2020-06-04 10:39:58,wahoo,Zwift - DIRT Doozy Race (A),Favero assioma duo,Wahoo kickr smart 2018,348,339,9
40141,146672,2020-06-07 10:09:56,wahoo,Zwift - 3R Sand & Sequoias - 1 Lap (20km/12.5mi 173m) (A),Favero assioma duo,Wahoo kickr smart 2018,367,358,9
40464,146672,2020-06-09 09:04:58,wahoo,Zwift - 3R & Wahoo Ride Real Race Series - Round 4 of 7 (A),Favero assioma duo,Wahoo kickr smart 2018,358,345,13
40969,146672,2020-06-11 09:59:55,wahoo,Zwift - Koa Sports League Race (A),Favero assioma duo,Wahoo kickr smart 2018,377,367,10
40970,146672,2020-06-11 10:39:58,wahoo,Zwift - DIRT Doozy Race (A),Favero assioma duo,Wahoo kickr smart 2018,335,325,10
41209,146672,2020-06-12 10:04:54,wahoo,Zwift - 3R Innsbruckring Flat Race - 4 Laps (35.2km/21.9mi 308m) (A),Favero assioma duo,Wahoo kickr smart 2018,349,340,9
41398,146672,2020-06-13 11:14:57,wahoo,Zwift - 3R Tick Tock Flat Race - 2 Lap (36km/22.4mi 100m) (A),Favero assioma duo,Wahoo kickr smart 2018,365,358,7
41902,146672,2020-06-16 09:04:54,wahoo,Zwift - 3R & Wahoo Ride Real Race Series - Round 5 of 7 (A),Favero assioma duo,Wahoo kickr smart 2018,348,338,10
42128,146672,2020-06-17 09:41:55,wahoo,Zwift - ZHR Hare & Hounds Race (A),Favero assioma duo,Wahoo kickr smart 2018,349,336,13
42353,146672,2020-06-18 09:59:52,wahoo,Zwift - Koa Sports League Race (A),Favero assioma duo,Wahoo kickr smart 2018,373,366,7
42364,146672,2020-06-18 10:44:54,wahoo,Zwift - Crit City Race (A),Favero assioma duo,Wahoo kickr smart 2018,342,335,7
42564,146672,2020-06-19 09:24:55,wahoo,Zwift - DIRT Friday Morning Sprintapalooza (C),Favero assioma duo,Wahoo kickr smart 2018,236,230,6
42796,146672,2020-06-20 10:29:53,wahoo,Zwift - 3R Volcano Climb Race - 1 Lap (22.4km/14mi 204m) (A),Favero assioma duo,Wahoo kickr smart 2018,367,353,14
43071,146672,2020-06-22 09:14:51,wahoo,Zwift - 3R Watopia Flat Route Race - 4 Laps (41km/25.5mi 216m) (A),Favero assioma duo,Wahoo kickr smart 2018,347,331,16
43205,146672,2020-06-23 10:39:51,wahoo,Zwift - Kinetic Group Ride (B),Favero assioma duo,Wahoo kickr smart 2018,245,237,8
43509,146672,2020-06-25 09:59:49,wahoo,Zwift - Koa Sports League Race (A),Favero assioma duo,Wahoo kickr smart 2018,371,354,17
43516,146672,2020-06-25 10:39:50,wahoo,Zwift - DIRT Doozy Race (A),Favero assioma duo,Wahoo kickr smart 2018,322,314,8
43767,146672,2020-06-27 08:59:48,wahoo,Zwift - Cycling Ireland Watopia Classic (A),Favero assioma duo,Wahoo kickr smart 2018,382,376,6
44185,146672,2020-06-30 09:34:53,wahoo,Zwift - MGCC Ride & Race (B),Favero assioma duo,Wahoo kickr smart 2018,364,353,11
44186,146672,2020-06-30 10:40:03,wahoo,Zwift - Kinetic Group Ride (B),Favero assioma duo,Wahoo kickr smart 2018,245,231,14
44523,146672,2020-07-02 09:59:47,wahoo,Zwift - Koa Sports League Race (A),Favero assioma duo,Wahoo kickr smart 2018,390,368,22
44524,146672,2020-07-02 10:39:47,wahoo,Zwift - DIRT Doozy Race (A),Favero assioma duo,Wahoo kickr smart 2018,320,306,14
44660,146672,2020-07-03 09:25:23,wahoo,Zwift - DIRT Friday Morning Sprintapalooza (C),Favero assioma duo,Wahoo kickr smart 2018,234,227,7
44820,146672,2020-07-04 10:04:52,wahoo,Zwift - Team EN Hang-On Ride (C),Favero assioma duo,Wahoo kickr smart 2018,361,349,12
45395,146672,2020-07-08 09:44:47,wahoo,Zwift - USA Cycling Race League by Indoor Specialist (A),Favero assioma duo,Wahoo kickr smart 2018,322,315,7
45560,146672,2020-07-09 09:15:43,wahoo,Zwift - The Lamb Chop p/b Black Sheep (A),Favero assioma duo,Wahoo kickr smart 2018,359,352,7
45561,146672,2020-07-09 10:39:48,wahoo,Zwift - DIRT Doozy Race (A),Favero assioma duo,Wahoo kickr smart 2018,354,343,11
46238,146672,2020-07-14 09:04:56,wahoo,Zwift - 3R Turbocharged Team Race Series - Round 1 (A),Favero assioma duo,Wahoo kickr smart 2018,355,345,10
46568,146672,2020-07-16 09:15:54,wahoo,Zwift - The Lamb Chop p/b Black Sheep (A),Favero assioma duo,Wahoo kickr smart 2018,389,380,9
46570,146672,2020-07-16 09:59:57,wahoo,Zwift - Koa Sports League Race (A),Favero assioma duo,Wahoo kickr smart 2018,347,329,18
46571,146672,2020-07-16 10:39:56,wahoo,Zwift - DIRT Doozy Race (A),Favero assioma duo,Wahoo kickr smart 2018,353,337,16
46806,146672,2020-07-18 09:00:55,wahoo,Zwift - L&#039;Etape du Tour Stage 3 - Open,Favero assioma duo,Wahoo kickr smart 2018,328,318,10
47134,146672,2020-07-21 09:04:56,wahoo,Zwift - 3R Turbocharged Team Race Series - Round 2 (A),Favero assioma duo,Wahoo kickr smart 2018,347,341,6
47409,146672,2020-07-23 09:59:55,wahoo,Zwift - Koa Sports League Race (A),Favero assioma duo,Wahoo kickr smart 2018,366,355,11
47415,146672,2020-07-23 10:44:55,wahoo,Zwift - Crit City Race (A),Favero assioma duo,Wahoo kickr smart 2018,364,356,8
47518,146672,2020-07-24 09:34:54,wahoo,Zwift - TBR Burrito Race (A),Favero assioma duo,Wahoo kickr smart 2018,339,331,8
47945,146672,2020-07-28 09:04:52,wahoo,Zwift - 3R Turbocharged Team Race Series - Round 3 (A),Favero assioma duo,Wahoo kickr smart 2018,376,363,13
48098,146672,2020-07-29 09:44:51,wahoo,Zwift - USA Cycling Race League by Indoor Specialist (A),Favero assioma duo,Wahoo kickr smart 2018,331,319,12
48263,146672,2020-07-30 09:16:51,wahoo,Zwift - The Lamb Chop p/b Black Sheep (A),Favero assioma duo,Wahoo kickr smart 2018,359,355,4
48266,146672,2020-07-30 09:59:51,wahoo,Zwift - Koa Sports League Race (A),Favero assioma duo,Wahoo kickr smart 2018,321,317,4
48562,146672,2020-08-02 09:45:51,wahoo,Zwift - Stages of DIRT (A),Favero assioma duo,Wahoo kickr smart 2018,348,340,8
48752,146672,2020-08-04 09:04:51,wahoo,Zwift - 3R Turbocharged Team Race Series - Round 4 (A),Favero assioma duo,Wahoo kickr smart 2018,338,329,9
48753,146672,2020-08-04 09:59:51,wahoo,Zwift - KISS at Race - Americas AM (A),Favero assioma duo,Wahoo kickr smart 2018,322,319,3
49038,146672,2020-08-06 09:59:51,wahoo,Zwift - Koa Sports League Race (A),Favero assioma duo,Wahoo kickr smart 2018,371,358,13
49039,146672,2020-08-06 10:39:49,wahoo,Zwift - DIRT Doozy Race (A),Favero assioma duo,Wahoo kickr smart 2018,318,312,6
49541,146672,2020-08-11 09:04:48,wahoo,Zwift - 3R Turbocharged Team Race Series - Round 5 (A),Favero assioma duo,Wahoo kickr smart 2018,374,364,10
49799,146672,2020-08-13 09:28:34,wahoo,Zwift - Espresso,Favero assioma duo,Wahoo kickr smart 2018,369,360,9
49975,146672,2020-08-14 09:34:47,wahoo,Zwift - TBR Burrito Race (A),Favero assioma duo,Wahoo kickr smart 2018,342,333,9
50497,146672,2020-08-18 09:04:45,wahoo,Zwift - 3R Turbocharged Team Race Series - Round 6 (A),Favero assioma duo,Wahoo kickr smart 2018,347,343,4
50887,146672,2020-08-20 09:25:39,wahoo,Zwift - Espresso,Favero assioma duo,Wahoo kickr smart 2018,369,353,16
51637,146672,2020-08-25 09:04:43,wahoo,Zwift - 3R Turbocharged Team Race Series - Bonus Round (A),Favero assioma duo,Wahoo kickr smart 2018,347,341,6
51638,146672,2020-08-25 09:59:45,wahoo,Zwift - KISS at Race - Americas AM (A),Favero assioma duo,Wahoo kickr smart 2018,333,319,14
52845,146672,2020-09-01 09:04:44,wahoo,Zwift - 3R Sundown Race Series - Round1 iTT,Favero assioma duo,Wahoo kickr smart 2018,362,354,8
52856,146672,2020-09-01 09:59:43,wahoo,Zwift - KISS at Race - Americas AM (A),Favero assioma duo,Wahoo kickr smart 2018,332,320,12
53903,146672,2020-09-08 09:08:40,wahoo,Zwift - 09/08/2020,Favero assioma duo,Wahoo kickr smart 2018,345,331,14
54320,146672,2020-09-10 09:19:37,wahoo,Zwift - Cycling Australia&#039;s The Chop by AHDR (A),Favero assioma duo,Wahoo kickr smart 2018,370,361,9
55290,146672,2020-09-15 09:08:36,wahoo,Zwift - 3R Sundown Race Series  (E),Favero assioma duo,Wahoo kickr smart 2018,359,341,18
55715,146672,2020-09-17 09:59:37,wahoo,Zwift - KISS at Race - Americas AM (A),Favero assioma duo,Wahoo kickr smart 2018,367,340,27
56245,146672,2020-09-19 10:05:29,wahoo,Zwift - Team EN Hang-On Ride (C),Favero assioma duo,Wahoo kickr smart 2018,351,328,23
56622,146672,2020-09-21 09:50:38,wahoo,Zwift - KISS at Base Training Ride (C),Favero assioma duo,Wahoo kickr smart 2018,209,195,14
56773,146672,2020-09-22 09:08:35,wahoo,Zwift - 3R Sundown Race Series  (E),Favero assioma duo,Wahoo kickr smart 2018,354,344,10
57669,146672,2020-09-26 10:44:34,wahoo,Zwift - Into the Red by RELENTLESS (A),Favero assioma duo,Wahoo kickr smart 2018,365,355,10
58179,146672,2020-09-29 09:08:31,wahoo,Zwift - 3R Sundown Race Series  (E),Favero assioma duo,Wahoo kickr smart 2018,357,343,14
58423,146672,2020-09-30 09:44:31,wahoo,Zwift - USA Cycling Race League by Indoor Specialist (A),Favero assioma duo,Wahoo kickr smart 2018,357,349,8
59212,146672,2020-10-03 10:44:29,wahoo,Zwift - Into the Red by RELENTLESS (A),Favero assioma duo,Wahoo kickr smart 2018,376,365,11
59746,146672,2020-10-06 09:59:33,wahoo,Zwift - KISS at Race - Americas AM (A),Favero assioma duo,Wahoo kickr smart 2018,356,349,7
60245,146672,2020-10-08 10:19:31,wahoo,Zwift - 3R Whole Lotta Lava Hilly Race - 1 Lap (16.9km/10.5mi 183m) (A),Favero assioma duo,Wahoo kickr smart 2018,363,355,8
60747,146672,2020-10-10 10:44:28,wahoo,Zwift - 10/10/2020,Favero assioma duo,Wahoo kickr smart 2018,372,361,11
61111,146672,2020-10-12 09:14:25,wahoo,Zwift - 3R Watopia Flat Route Race - 4 Laps (41km/25.5mi 216m) (A),Favero assioma duo,Wahoo kickr smart 2018,346,335,11
61451,146672,2020-10-13 09:35:23,wahoo,Zwift - MGCC Ride & Race (B),Favero assioma duo,Wahoo kickr smart 2018,358,348,10
61763,146672,2020-10-14 09:04:29,wahoo,Zwift - 3R Watopia Flat Route Race - 3 Laps (30.3km/18.8mi 162m) (A),Favero assioma duo,Wahoo kickr smart 2018,352,346,6
62378,146672,2020-10-16 10:04:25,wahoo,Zwift - 3R Innsbruckring Flat Race - 4 Laps (35.2km/21.9mi 308m) (A),Favero assioma duo,Wahoo kickr smart 2018,369,349,20
63316,146672,2020-10-20 08:51:53,wahoo,Zwift - Zwift Racing League | WTRL - APAC (MEN) - TTT (B),Favero assioma duo,Wahoo kickr smart 2018,357,349,8
64063,146672,2020-10-22 09:59:21,wahoo,Zwift - KISS at Race - Americas AM (A),Favero assioma duo,Wahoo kickr smart 2018,371,364,7
64586,146672,2020-10-24 10:44:22,wahoo,Zwift - Into the Red by RELENTLESS (A),Favero assioma duo,Wahoo kickr smart 2018,374,376,-2
65001,146672,2020-10-26 10:19:23,wahoo,Zwift - 3R Volcano Flat Race - 3 Laps (36.6km/22.7mi 138m) (A),Favero assioma duo,Wahoo kickr smart 2018,346,334,12
65325,146672,2020-10-27 08:44:18,wahoo,Zwift - WTRL Racing (A),Favero assioma duo,Wahoo kickr smart 2018,362,356,6
66607,146672,2020-10-31 10:44:23,wahoo,Zwift - Into the Red by RELENTLESS (A),Favero assioma duo,Wahoo kickr smart 2018,366,357,9
67469,146672,2020-11-03 09:04:12,wahoo,Zwift - Zwift Racing League | WTRL - Men&#039;s APAC DIVISION 1 (A),Favero assioma duo,Wahoo kickr smart 2018,381,370,11
67856,146672,2020-11-04 10:44:20,wahoo,Zwift - USA Cycling Race League by Indoor Specialist (A),Favero assioma duo,Wahoo kickr smart 2018,358,348,10
68735,146672,2020-11-07 10:44:21,wahoo,Zwift - Into the Red by RELENTLESS (A),Favero assioma duo,Wahoo kickr smart 2018,390,383,7
69622,146672,2020-11-10 10:59:17,wahoo,Zwift - KISS at Race - Americas AM (A),Favero assioma duo,Wahoo kickr smart 2018,385,378,7
70121,146672,2020-11-11 10:44:10,wahoo,Zwift - USA Cycling Race League by Indoor Specialist (A),Favero assioma duo,Wahoo kickr smart 2018,353,341,12
71304,146672,2020-11-14 10:44:13,wahoo,Zwift - Into the Red by RELENTLESS (A),Favero assioma duo,Wahoo kickr smart 2018,339,334,5
72525,146672,2020-11-18 10:44:14,wahoo,Zwift - USA Cycling Race League by Indoor Specialist (A),Favero assioma duo,Wahoo kickr smart 2018,358,350,8
72886,146672,2020-11-19 10:59:10,wahoo,Zwift - KISS Race Series - Americas AM (A),Favero assioma duo,Wahoo kickr smart 2018,362,353,9
73786,146672,2020-11-21 10:44:14,wahoo,Zwift - Into the Red by RELENTLESS (A),Favero assioma duo,Wahoo kickr smart 2018,385,379,6
74888,146672,2020-11-24 10:59:09,wahoo,Zwift - KISS Race Series - Americas AM (A),Favero assioma duo,Wahoo kickr smart 2018,333,329,4
76768,146672,2020-11-28 09:59:10,wahoo,Zwift - Cycling Ireland Zwift League Rd 3 (A),Favero assioma duo,Wahoo kickr smart 2018,383,379,4
77878,146672,2020-12-01 08:53:58,wahoo,Zwift - Zwift Racing League | WTRL - Men&#039;s APAC DIVISION 1 (A),Favero assioma duo,Wahoo kickr smart 2018,373,357,16
78427,146672,2020-12-02 10:50:12,wahoo,Zwift - KISS at Base Training Ride (C),Favero assioma duo,Wahoo kickr smart 2018,217,212,5
79290,146672,2020-12-04 10:11:04,wahoo,Zwift - Watopia,Favero assioma duo,Wahoo kickr smart 2018,242,243,-1
79683,146672,2020-12-05 10:44:26,wahoo,Zwift - Into the Red by RELENTLESS (A),Favero assioma duo,Wahoo kickr smart 2018,355,353,2
80691,146672,2020-12-08 11:09:08,wahoo,Zwift - Japan Zwift Tuesday Race (A),Favero assioma duo,Wahoo kickr smart 2018,355,341,14
81398,146672,2020-12-10 10:24:59,wahoo,Zwift - Espresso,Favero assioma duo,Wahoo kickr smart 2018,355,350,5
81887,146672,2020-12-11 11:19:05,wahoo,Zwift - 3R LaGuardia Loop Reverse Flat Race - 8 Laps (24.5km/15.2mi 216m) (A),Favero assioma duo,Wahoo kickr smart 2018,351,350,1
83357,146672,2020-12-15 08:55:14,wahoo,Zwift - Zwift Racing League | WTRL - Men&#039;s APAC DIVISION 1 (A),Favero assioma duo,Wahoo kickr smart 2018,367,361,6
84220,146672,2020-12-17 11:54:06,wahoo,Zwift - DIRT Doozy Race (A),Favero assioma duo,Wahoo kickr smart 2018,361,356,5
85009,146672,2020-12-19 10:44:04,wahoo,Zwift - Into the Red by RELENTLESS (A),Favero assioma duo,Wahoo kickr smart 2018,366,359,7
85371,146672,2020-12-20 11:29:02,wahoo,Zwift - Stages of DIRT (A),Favero assioma duo,Wahoo kickr smart 2018,331,324,7
86883,146672,2020-12-24 11:54:01,wahoo,Zwift - DIRT Doozy Race (A),Favero assioma duo,Wahoo kickr smart 2018,356,351,5
87425,146672,2020-12-26 10:14:44,wahoo,Zwift - Watopia,Favero assioma duo,Wahoo kickr smart 2018,218,216,2
87807,146672,2020-12-27 09:23:04,wahoo,Zwift - Watopia,Favero assioma duo,Wahoo kickr smart 2018,249,244,5
89343,146672,2020-12-31 10:58:55,wahoo,Zwift - KISS Race Series - Americas AM (A),Favero assioma duo,Wahoo kickr smart 2018,366,362,4
89344,146672,2020-12-31 11:54:01,wahoo,Zwift - DIRT Doozy Race (A),Favero assioma duo,Wahoo kickr smart 2018,315,313,2
90176,146672,2021-01-02 11:13:55,wahoo,Zwift - 3R Tick Tock Flat Race - 2 Lap (36km/22.4mi 100m) (A),Favero assioma duo,Wahoo kickr smart 2018,337,335,2
91603,146672,2021-01-05 10:58:56,wahoo,Zwift - KISS Race Series - Americas AM (A),Favero assioma duo,Wahoo kickr smart 2018,372,370,2
93750,146672,2021-01-09 10:43:52,wahoo,Zwift - Into the Red by RELENTLESS (A),Favero assioma duo,Wahoo kickr smart 2018,344,335,9
95426,146672,2021-01-12 10:58:53,wahoo,Zwift - KISS Race Series - Americas AM (A),Favero assioma duo,Wahoo kickr smart 2018,363,354,9
97847,146672,2021-01-16 10:44:07,wahoo,Zwift - Into the Red by RELENTLESS (A),Favero assioma duo,Wahoo kickr smart 2018,340,330,10
100670,146672,2021-01-21 10:23:45,wahoo,Zwift - WTRL Team Time Trial - Zone 2 (C),Favero assioma duo,Wahoo kickr smart 2018,346,339,7
101745,146672,2021-01-23 10:43:47,wahoo,Zwift - Into the Red by RELENTLESS (A),Favero assioma duo,Wahoo kickr smart 2018,329,319,10
103988,146672,2021-01-27 09:20:44,wahoo,Zwift - Your First Century Week 5 Day 5,Favero assioma duo,Wahoo kickr smart 2018,240,233,7
104481,146672,2021-01-28 09:37:44,wahoo,Zwift - Gran Fondo - Low-Cadence Intervals,Favero assioma duo,Wahoo kickr smart 2018,343,339,4
105565,146672,2021-01-30 09:10:01,wahoo,Zwift -  5hrs 3.1,Favero assioma duo,Wahoo kickr smart 2018,231,223,8
112685,146672,2021-02-11 10:27:30,wahoo,Zwift - WTRL Team Time Trial - Zone 2 (C),Favero assioma duo,Wahoo kickr smart 2018,364,348,16
1694,148135,2019-09-12 10:53:54,wahoo,Dzero Propel vs. Kickr 2018,Dzero Propel,Kickr 2018,272,266,6
6906,148135,2019-12-21 11:41:57,wahoo,Dzero Supersix vs KickrNr4,Dzero Supersix,KickrNr4,343,339,4
10451,148135,2020-01-22 17:59:54,wahoo,SZR Winter Race Series,Dzero SuperSix,KickrNr4,351,345,6
12756,148135,2020-02-06 17:59:43,wahoo,Zwift - SCF SWE Cup Racing League (A),Dzero SuperSix garmin,Kickr 2018  zwift,408,402,6
15786,148135,2018-04-24 11:04:46,neo,Neo1 or 2 vs Dzero,Quarq Dzero ,TACX Neo1,324,326,-2
18896,148135,2020-03-20 19:16:05,neo,Tour of Watopia Pro-Am Mens Race #2,dzero,neo,416,400,16
74964,148135,2020-01-27 19:14:01,wahoo,Dzero Kickr4,Quarq Dzero Propel,Wahoo Kickr4,274,274,0
92736,148135,2021-01-07 15:29:19,neo,neo / dzero,dzero,neo,262,258,4
93486,148135,2021-01-08 17:59:58,neo,neogar / dzwift,dzwift,neogar,359,347,12
26409,150067,2020-04-18 15:30:20,neo,Zwift - Richmond Challenge Race // Zwift Classic (A),power2max ng,Tacx Neo Smart,391,392,-1
27057,150067,2020-04-22 17:00:00,neo,Swedish Zwift Racing Cup by SZR (A),power2max ng,Tacx Neo Smart,423,425,-2
27683,150067,2020-04-24 17:05:04,neo,3R Classique Flat Race - 5 Laps (A),power2max ng to Bolt,Tacx Neo Smart to Zwift,403,399,4
28146,150067,2020-04-26 08:04:57,neo,Zwift - 3R Watopia Flat Route Race - 4 Laps (40.5km/25.1mi 216m) (A),power2max ng to Bolt,Tacx Neo Smart to Zwift,400,400,0
28839,150067,2020-04-28 17:55:03,neo,Team Italy & Frenchy Fuzion League (A),power2max ng to Bolt,Tacx Neo Smart to Zwift,403,402,1
30822,150067,2020-05-03 07:59:53,neo,ZTS x Paceheads | Etappe II Greatest London Loop (26.2km/360hm) (A),power2max ng to Bolt,Tacx Neo Smart to Zwift,408,418,-10
32066,150067,2020-05-06 16:59:59,neo,Swedish Zwift Racing Cup by SZR (A),power2max ng to Bolt,Tacx Neo Smart to Zwift,415,415,0
32955,150067,2020-05-09 08:30:05,neo,Zwift - DBR Sufferday League (A),power2max ng to Bolt,Tacx Neo Smart to Zwift,388,392,-4
33167,150067,2020-05-10 07:59:59,neo,ZTS x Paceheads | Etappe III 39.6km | 507hm (A),power2max ng to Bolt,Tacx Neo Smart to Zwift,396,397,-1
34401,150067,2020-05-13 17:55:08,neo,USA Cycling Race League p/b Saris+TheProsCloset,power2max ng to Bolt,Tacx Neo Smart to Zwift,426,426,0
38212,150067,2020-05-27 17:00:10,neo,Swedish Zwift Racing Cup by SZR (A),power2max ng to Bolt,Tacx Neo Smart to Zwift,414,415,-1
38799,150067,2020-05-31 08:00:01,neo,ZTS x Paceheads | Etappe VI 32.7km | 612hm (A),power2max ng to Bolt,Tacx Neo Smart to Zwift,414,419,-5
39914,150067,2020-06-03 17:00:05,neo,MIDWEEK Summer Series by SZR (A),power2max ng to Bolt,Tacx Neo Smart to Zwift,394,397,-3
39916,150067,2020-06-03 17:54:58,neo,USA Cycling Race League by Indoor Specialist (A),power2max ng to Bolt,Tacx Neo Smart to Zwift,399,396,3
40271,150067,2020-06-07 13:15:00,neo,Zwift - KISS at Race 100 - Americas (A),power2max ng to Bolt,Tacx Neo Smart to Zwift,374,373,1
40933,150067,2020-06-10 17:00:04,neo,MIDWEEK Summer Series by SZR (A),power2max ng to Bolt,Tacx Neo Smart to Zwift,399,395,4
40934,150067,2020-06-10 17:54:59,neo,USA Cycling Race League by Indoor Specialist (A),power2max ng to Bolt,Tacx Neo Smart to Zwift,427,426,1
41591,150067,2020-06-14 08:00:08,neo,ZTS x Paceheads FINAL (A),power2max ng to Bolt,Tacx Neo Smart to Zwift,425,421,4
97391,150173,2021-01-15 13:09:56,wahoo,Zwift - New Workout,4iiii left,Kickr 18,301,296,5
40992,150208,2020-06-11 09:57:53,wahoo,Zwift - ZADA - Three Sisters Test No. 1,Stages,Kickr,281,281,0
55167,150208,2020-09-14 18:29:59,wahoo,Zwift - Invitational League // Qualifying Race #1 Tactical Numpty!,InfoCrank PM,Kickr,285,277,8
55796,150208,2020-09-17 17:59:58,wahoo,Zwift - Invitational League // Qualifying Race #2 (Women) (A),InfoCrank PM Secondary,Kickr Zwift,273,265,8
57884,150208,2020-09-23 19:40:08,wahoo,Zwift - ZADA 3 Sisters,InfoCrank PM Secondary,Kickr Zwift,298,291,7
61225,150208,2020-10-12 17:44:57,wahoo,Zwift - Premier League #ouch,InfoCrank PM Secondary,Kickr Zwift Primary,300,296,4
69389,150208,2020-11-09 19:04:59,wahoo,Zwift - Premier Division // Zwift Racing League (women) (A),InfoCrank PM Secondary,Kickr Zwift Primary,291,285,6
72094,150208,2020-11-16 19:58:20,wahoo,Zwift - Premier Division // Zwift Racing League (women) (A),InfoCrank PM Secondary,Kickr Zwift Primary,268,263,5
77776,150208,2020-11-30 20:00:00,wahoo,Zwift - Premier Division // Zwift Racing League (women) (A),InfoCrank PM Secondary,Kickr Zwift Primary,272,267,5
94230,150208,2021-01-10 07:29:58,wahoo,CANYON ESPORTS LEQP BADGE HUNTER TAKEOVER,InfoCrank PM Secondary,Kickr Zwift Primary,214,203,11
95115,150208,2021-01-11 20:06:53,wahoo,Zwift - Premier Division // Zwift Racing League (women) (A),InfoCrank PM Secondary,Kickr Zwift Primary,298,291,7
97806,150208,2021-01-16 10:03:59,wahoo,Zwift - Cycling Ireland Points Race,InfoCrank PM Secondary,KickrC,274,274,0
101681,150208,2021-01-23 10:01:21,wahoo,Zwift - Tour de Zwift Stage 4 - Women&#039;s Ride,InfoCrank PM Secondary,KickrC,304,306,-2
103048,150208,2021-01-25 20:03:09,wahoo,Zwift - Premier Division // Zwift Racing League (women) (A),InfoCrank PM Secondary,Kickr Zwift Primary,305,300,5
106803,150208,2021-02-01 19:03:01,wahoo,Zwift - Premier League #HomeTurf,InfoCrank PM Secondary,Kickr Zwift Primary,301,296,5
110115,150208,2021-02-06 18:31:49,wahoo,Zwift - Bambino Fondo #illtakeitsteady...,InfoCrank PM Secondary,Kickr Zwift Primary,271,263,8
113369,150208,2021-02-12 12:04:30,wahoo,Zwift - 3R Greater London 8 Race,InfoCrank PM Secondary,Kickr Zwift Primary,306,308,-2
115273,150208,2021-02-15 19:03:59,wahoo,Zwift - Premier League Scratch Race 6,InfoCrank PM Secondary,Kickr Zwift Primary,291,290,1
119233,150208,2021-02-22 19:58:59,wahoo,Zwift - Premier League Libby Hill After Party,InfoCrank PM Secondary,Kickr Zwift Primary,287,286,1
122516,150208,2021-03-01 19:22:31,wahoo,Zwift - Zwift Premier League - TTT,InfoCrank PM Secondary,Kickr Zwift Primary,284,286,-2
127550,150208,2021-03-12 18:28:59,wahoo,Zwift - Kirchmier Race Series No. 2 (A) Volcano Circuit,InfoCrank PM Secondary,Kickr Zwift Primary,282,288,-6
127554,150208,2021-03-12 17:58:59,wahoo,Zwift - Kirchmir Race Series - Classique Rev. (A),InfoCrank PM Secondary,Kickr Zwift Primary,287,289,-2
15299,152992,2020-02-23 13:00:00,wahoo,Zwift - Tour of Innsbruck // Stage 3,Favero Assioma Uno,Wahoo Kickr Core,350,363,-13
58865,152992,2020-10-01 17:56:11,wahoo,Zwift - Team Italy Superveloce Race (B),Favero Assioma Uno,Wahoo Kickr Core,331,351,-20
17069,153054,2020-03-06 13:21:04,neo,Zwift - FTP Test5/20,Afternoon_Ride,Neo,456,453,3
25096,153054,2020-04-16 07:29:56,neo,Zwift - Trofeo Bologna Race (A),Quark2,Neo,447,448,-1
26964,153054,2020-04-22 14:46:53,neo,ZPR2,Quark2,Neo,433,416,17
27269,153054,2020-04-23 10:46:39,neo,Zwift - Watopia,Quark2,Neo,248,242,6
29068,153054,2020-04-29 14:44:55,neo,Zwift - Z PRO TRI Race Series / Men&#039;s Race B,Quark2,Neo,433,414,19
29529,153054,2020-04-30 10:05:11,neo,Zwift - 20200430,Quark2,Neo,348,343,5
42339,153054,2020-06-18 07:24:07,neo,Zwift - 20200618,Quark2,Neo,389,381,8
90064,153054,2021-01-02 08:59:43,neo,Zwift - ZTS Season II - Race 3 (A),Quark2,Neo,388,377,11
88414,153066,2020-12-27 07:17:22,wahoo,Zwift - ZHQ FutureWorks Crit City Race - Anti-sandbagging (C),Garmin Vector 3,Wahoo Kickr v5,266,264,2
89130,153066,2020-12-30 17:41:14,wahoo,Zwift - MIDWEEK Winter Series by SZR (C),Garmin Vector 3,Wahoo Kickr v5,268,261,7
92433,153066,2021-01-06 17:41:18,wahoo,Zwift - MIDWEEK Winter Series by SZR (C),Garmin Vector 3,Wahoo Kickr v5,272,271,1
116687,153066,2021-02-17 17:52:12,wahoo,Zwift - MIDWEEK Winter Series by SZR (B),Garmin Vector 3,Wahoo Kickr v5,272,271,1
129692,153066,2021-03-17 17:43:49,wahoo,Zwift - MIDWEEK Crit Race Series by SZR (B),Garmin Vector 3,Wahoo Kickr v5,304,296,8
95849,153370,2021-01-12 19:51:43,wahoo,Zwift - Zwift Racing League | WTRL - Men&#039;s/Mixed EMEA W2 DIVISION 1 (A),Assioma Duo,Wahoo Kicker V5,378,387,-9
97132,153370,2021-01-14 19:43:32,wahoo,Zwift - WTRL Team Time Trial - Zone 9 (C),Assioma Duo,Wahoo Kicker V5,383,378,5
99831,153370,2021-01-19 19:55:22,wahoo,Zwift - Zwift Racing League | WTRL - Men&#039;s/Mixed EMEA W2 DIVISION 1 (A),Assioma Duo,Wahoo Kicker V5,365,361,4
100454,153370,2021-01-20 18:58:51,wahoo,Zwift - TDZ Stage 4: Longer Ride,Assioma Duo,Wahoo Kickr V5,378,376,2
101053,153370,2021-01-21 19:48:43,wahoo,Zwift - WTRL Team Time Trial - Zone 9 (C),Assioma Duo,Wahoo Kickr V5,373,361,12
113076,153370,2021-02-11 19:46:05,wahoo,Zwift - WTRL Team Time Trial - Zone 11 (C),Assioma Duo,Wahoo Kickr V5,387,377,10
116829,153370,2021-02-17 18:30:21,wahoo,Zwift - NCF Vintercup 2021 - Runde 6 - Herrer (A),Assioma Duo,Wahoo Kickr V5,394,389,5
117415,153370,2021-02-18 19:48:00,wahoo,Zwift - WTRL Team Time Trial - Zone 12 (C),Assioma Duo,Wahoo Kickr V5,368,364,4
119798,153370,2021-02-23 19:52:18,wahoo,Zwift - Zwift Racing League | WTRL - Men&#039;s/Mixed EMEA W2 DIVISION 1 (A),Assioma Duo,Wahoo Kickr V5,396,396,0
120890,153370,2021-02-25 19:45:01,wahoo,Zwift - WTRL Team Time Trial - Zone 12 (C),Assioma Duo,Wahoo Kickr V5,389,389,0
120893,153370,2021-02-25 19:44:31,wahoo,Zwift - WTRL Team Time Trial - Zone 12 (C),Assioma Duo,Wahoo Kickr V5,397,389,8
123125,153370,2021-03-02 19:55:01,wahoo,Zwift - Zwift Racing League | WTRL - Men&#039;s/Mixed EMEA W2 DIVISION 1 (A),Assioma Duo,Wahoo Kickr V5,382,376,6
127205,153370,2021-03-11 19:47:01,wahoo,Zwift - WTRL Team Time Trial - Zone 12 (C),Assioma Duo,Wahoo Kickr V5,376,369,7
940,153374,2019-08-28 18:05:01,wahoo,DBR Wednesday Race (A),Power2max Typ S // Ant+,Wahoo Kickr 2018 // Bluetooth ,303,311,-8
989,153374,2019-08-29 16:05:02,wahoo,3R Watopia Hilly Reverse Race - 2 Laps (18.2km/11.4mi 200m),Power2max Typ S // Ant+,Wahoo Kickr 2018 // Bluetooth ,300,307,-7
1433,153374,2019-09-07 16:50:26,wahoo,3R Innsbruckring Flat Race - 3 Laps (26.4km/16.4mi 231m) (A),Power2max Typ S // Ant+,Wahoo Kickr 2018 // Ant+,294,301,-7
2154,153374,2019-09-18 18:05:16,wahoo,DBR Wednesday Race (A),Power2max Typ S // Ant+,Wahoo Kickr 2018 // Ant+,295,297,-2
2163,153374,2019-09-19 16:05:19,wahoo,3R Watopia Hilly Reverse Race - 2 Laps (18.2km/11.4mi 200m) (A),Power2max Typ S // Ant+,Wahoo Kickr 2018 // Ant+,289,291,-2
5854,153374,2019-12-09 19:00:42,wahoo,Tour of London // Stage 1 (Race Group-Men),Power2max Typ S // Ant+,Wahoo Kickr 2018 // Ant+,331,328,3
8842,153374,2020-01-11 13:45:17,wahoo,WTRL Winter Racing League (A),Power2max Typ S // Ant+,Wahoo Kickr 2018 // Ant+,295,304,-9
10432,153374,2020-01-22 16:30:27,wahoo,Zwift - Sydkysten Cycling - Carl Ras Race (A),Power2max Typ S // Ant+,Wahoo Kickr 2018 // Ant+,297,307,-10
12256,153374,2020-02-03 16:44:55,wahoo,Zwift - Crit City Race (A),Power2max Typ S // Ant+,Wahoo Kickr 2018 // Ant+,295,305,-10
13015,153374,2020-02-08 16:05:02,wahoo,Zwift - 3R Classique Flat Race - 4 Laps (26.9km/16.7mi 76m) (A),Power2max Typ S // Ant+,Wahoo Kickr 2018 // Ant+,278,280,-2
13942,153374,2020-02-14 16:45:05,wahoo,Crit City Race (A),Power2max Typ S // Ant+,Wahoo Kickr 2018 // Ant+,296,308,-12
17072,153374,2020-03-04 17:50:18,wahoo,Team Italy Gladiators Race (A),Power2max Typ S // Ant+,Wahoo Kickr 2018 // Ant+,310,322,-12
17081,153374,2020-03-06 16:44:48,wahoo,Crit City Race (A),Power2max Typ S // Ant+,Wahoo Kickr 2018 // Ant+,294,298,-4
21479,153374,2020-04-02 17:31:45,wahoo,WTRL Team Time Trial (D),Power2max Typ S // Ant+,Wahoo Kickr 2018 // Ant+,280,289,-9
22588,153374,2020-04-06 17:15:16,wahoo,Zwift - DBR Wahoo League (A),Power2max Typ S // Ant+,Wahoo Kickr 2018 // Ant+,306,317,-11
23295,153374,2020-04-09 17:25:20,wahoo,WTRL Team Time Trial (D),Power2max Typ S // Ant+,Wahoo Kickr 2018 // Ant+,291,297,-6
24282,153374,2020-04-13 17:15:04,wahoo,Zwift - DBR Wahoo League (A),Power2max Typ S // Ant+,Wahoo Kickr 2018 // Ant+,313,322,-9
25286,153374,2020-04-13 17:15:04,wahoo,WTRL Team Time Trial (E),Power2max Typ S // Ant+,Wahoo Kickr 2018 // Ant+,313,282,31
26463,153374,2020-04-20 17:15:05,wahoo,DBR Wahoo League (A),Power2max Typ S // Ant+,Wahoo Kickr 2018 // Ant+,322,327,-5
41065,153374,2020-06-11 17:55:02,wahoo,Team Italy Superveloce Race (A),Power2max Typ S // Ant+,Wahoo Kickr 2018 // Ant+,286,295,-9
41354,153374,2020-06-12 15:00:02,wahoo,Race with MVP #ZHQ Beta Crit City Race (A) ,Power2max Typ S // Ant+,Wahoo Kickr 2018 // Ant+,300,306,-6
44032,153374,2020-06-18 17:55:02,wahoo,Team Italy Superveloce Race (A),Power2max Typ S // Ant+,Wahoo Kickr 2018 // Ant+,297,297,0
44035,153374,2020-06-26 15:00:01,wahoo,ZHQ Beta Crit City Race (A),Power2max Typ S // Ant+,Wahoo Kickr 2018 // Ant+,306,310,-4
44251,153374,2020-06-30 17:00:15,wahoo,ZRG Hot & Wet Series (A),Power2max Typ S // Ant+,Wahoo Kickr 2018 // Ant+,288,293,-5
44408,153374,2020-07-01 16:10:15,wahoo,3R Tick Tock Flat Race - 2 Lap (36km/22.4mi 100m) (A),Power2max Typ S // Ant+,Wahoo Kickr 2018 // Ant+,270,281,-11
45107,153374,2020-07-04 09:01:04,wahoo,L&#039;Etape du Tour Stage 1 (E),Power2max Typ S // Ant+,Wahoo Kickr 2018 // Ant+,312,316,-4
45133,153374,2020-07-06 17:01:03,wahoo,Zwift - Virtual Tour de France - Open - Stage 1 Discovery Ride,Power2max Typ S // Ant+,Wahoo Kickr 2018 // Ant+,308,314,-6
45877,153374,2020-07-08 17:01:27,wahoo,Virtual Tour de France - Open - Stage 2 Discovery Ride,Power2max Typ S // Ant+,Wahoo Kickr 2018 // Ant+,303,300,3
48445,153374,2020-07-31 17:05:21,wahoo,World Elite Zwifters Friday&#039;s Race (A),Power2max Typ S // Ant+,Wahoo Kickr 2018 // Ant+,308,313,-5
49216,153374,2020-08-07 17:05:04,wahoo,Team WEZ Friday Race (A),Power2max Typ S // Ant+,Wahoo Kickr 2018 // Ant+,298,302,-4
50040,153374,2020-08-14 17:05:15,wahoo,Team WEZ Friday Race (A),Power2max Typ S // Ant+,Wahoo Kickr 2018 // Ant+,322,324,-2
50158,153374,2020-08-15 16:50:27,wahoo,3R Innsbruckring Flat Race - 3 Laps (26.4km/16.4mi 231m) (A),Power2max Typ S // Ant+,Wahoo Kickr 2018 // Ant+,290,292,-2
68549,153374,2020-11-06 18:02:07,wahoo,ZRG-CC Falling Leaves Tour (B),Power2max Typ S // Ant+,Wahoo Kickr 2018 // Ant+,299,292,7
71138,153374,2020-11-13 18:02:27,wahoo,ZRG-CC Falling Leaves Tour (B),Power2max Typ S // Ant+,Wahoo Kickr 2018 // Ant+,296,291,5
73600,153374,2020-11-20 18:02:23,wahoo,Zwift - ZRG-CC Falling Leaves Tour (B),Power2max Typ S // Ant+,Wahoo Kickr 2018 // Ant+,295,288,7
76568,153374,2020-11-27 18:02:15,wahoo,ZRG-CC Falling Leaves Tour (B),Power2max Typ S // Ant+,Wahoo Kickr 2018 // Ant+,294,289,5
79471,153374,2020-12-04 18:02:20,wahoo,ZRG-CC Falling Leaves Tour (B),Power2max Typ S // Ant+,Wahoo Kickr 2018 // Ant+,293,294,-1
83539,153374,2020-12-15 18:23:20,wahoo,Zwift Racing League | WTRL - Men&#039;s EMEA E1 DIVISION 2 (A),Power2max Typ S // Ant+,Wahoo Kickr 2018 // Ant+,280,270,10
84781,153374,2020-12-18 18:01:56,wahoo,ZRG-CC Falling Leaves Tour (B),Power2max Typ S // Ant+,Wahoo Kickr 2018 // Ant+,302,302,0
91841,153374,2020-12-18 18:01:56,wahoo,Zwift - British Cycling Race Series (B),Power2max Typ S // Ant+,Wahoo Kickr 2018 // Ant+,302,300,2
92931,153374,2021-01-07 18:31:26,wahoo,FUSION WINTER CUP (B),Power2max Typ S // Ant+,Wahoo Kickr 2018 // Ant+,274,301,-27
95726,153374,2021-01-12 19:30:04,wahoo,Zwift - British Cycling Race Series (A),Power2max Typ S // Ant+,Wahoo Kickr 2018 // Ant+,290,288,2
97076,153374,2021-01-14 18:30:56,wahoo,Zwift - FUSION WINTER CUP (B),Power2max Typ S // Ant+,Wahoo Kickr 2018 // Ant+,307,302,5
99727,153374,2021-01-19 19:29:55,wahoo,Zwift - British Cycling Race Series (A),Power2max Typ S // Ant+,Wahoo Kickr 2018 // Ant+,301,299,2
104731,153374,2021-01-28 18:30:10,wahoo,Zwift - FUSION WINTER CUP (A),Power2max Typ S // Ant+,Wahoo Kickr 2018 // Ant+,294,291,3
106759,153374,2021-02-01 19:10:13,wahoo,RuhrRiders Pott-Race,Power2max Typ S // Ant+,Wahoo Kickr 2018 // Ant+,292,288,4
111029,153374,2021-02-08 19:10:24,wahoo,Zwift - RuhrRiders Pott-Race (A),Power2max Typ S // Ant+,Wahoo Kickr 2018 // Ant+,320,316,4
115241,153374,2021-02-15 19:10:24,wahoo,Zwift - RuhrRiders Pott-Race (A),Power2max Typ S // Ant+,Wahoo Kickr 2018 // Ant+,303,304,-1
117904,153374,2021-02-19 19:35:01,wahoo,Zwift - 3R Watopia Hilly Race - 3 Laps (27km/16.8mi 300m) (A),Power2max Typ S // Ant+,Wahoo Kickr 2018 // Ant+,316,304,12
120823,153374,2021-02-25 19:44:57,wahoo,Crit City Race,Power2max Typ S // Ant+,Wahoo Kickr 2018 // Bluetooth ,307,299,8
125809,153374,2021-03-08 19:10:03,wahoo,Zwift - RuhrRiders Pott-Race (A),Power2max Typ S // Ant+,Wahoo Kickr 2018 // Bluetooth ,307,307,0
127138,153374,2021-03-11 19:00:01,wahoo,Zwift - Flanders The BZR Ronde Spring Classics League (A),Power2max Typ S // Ant+,Wahoo Kickr 2018 // Bluetooth ,303,298,5
43304,153793,2020-06-22 10:54:41,wahoo,Zwift - British Triathlon Group Ride (E),Assioma DUO,KICKR CORE,294,297,-3
43305,153793,2020-06-23 10:55:05,wahoo,Zwift - British Triathlon Group Ride (E),Assioma DUO,KICKR CORE,188,189,-1
44913,153793,2020-07-04 05:59:38,wahoo,Zwift - SZR  Endurance Ride (D),Assioma DUO,KICKR CORE,178,184,-6
46091,153793,2020-07-10 21:23:03,wahoo,Zwift - SAS - TEMPUS 50km (C),Assioma DUO,KICKR CORE,210,217,-7
46092,153793,2020-07-11 05:56:37,wahoo,Zwift - SZR  Endurance Ride (D),Assioma DUO,KICKR CORE,197,204,-7
46722,153793,2020-07-17 10:47:56,wahoo,Zwift - Best Buddies Challenge - TGIF Ride (E),Assioma DUO,KICKR CORE,255,262,-7
46798,153793,2020-07-18 05:55:53,wahoo,Zwift - SZR  Endurance Ride (D),Assioma DUO,KICKR CORE,169,177,-8
47083,153793,2020-07-20 10:54:54,wahoo,Zwift - British Triathlon Group Ride (E),Assioma DUO,KICKR CORE,215,224,-9
47225,153793,2020-07-21 11:10:13,wahoo,Zwift - ODZ Covfefe (C),Assioma DUO,KICKR CORE,245,234,11
47402,153793,2020-07-23 00:54:01,wahoo,Zwift - Japan Club Team Enduro ,Assioma DUO,KICKR CORE,238,245,-7
47582,153793,2020-07-24 08:38:40,wahoo,Zwift - SAS - TEMPUS 50km (C),Assioma DUO,KICKR CORE,205,209,-4
47624,153793,2020-07-25 05:51:56,wahoo,Zwift - SZR  Endurance Ride (D),Assioma DUO,KICKR CORE,180,186,-6
48454,153793,2020-07-31 20:04:17,wahoo,Zwift - JETT Hill Climb & Interval Ride (B),Assioma DUO,KICKR CORE,259,260,-1
48462,153793,2020-07-31 21:24:34,wahoo,Zwift - SAS - TEMPUS 50km (C),Assioma DUO,KICKR CORE,192,196,-4
48484,153793,2020-08-01 05:54:18,wahoo,Zwift - SZR  Endurance Ride (D),Assioma DUO,KICKR CORE,216,220,-4
48700,153793,2020-08-03 10:50:14,wahoo,Zwift - British Triathlon Group Ride (E),Assioma DUO,KICKR CORE,294,278,16
48873,153793,2020-08-04 10:52:12,wahoo,Zwift - DIRT Rolling Thunder Ride (C),Assioma DUO,KICKR CORE,183,186,-3
49237,153793,2020-08-06 21:11:13,wahoo,Zwift - The &#039;Grind&#039; Finale,Assioma DUO,KICKR CORE,188,193,-5
49238,153793,2020-08-07 20:04:20,wahoo,Zwift - JETT Hill Climb & Interval Ride (B),Assioma DUO,KICKR CORE,280,289,-9
49239,153793,2020-08-07 21:26:46,wahoo,Zwift - SAS - TEMPUS 50km (C),Assioma DUO,KICKR CORE,182,188,-6
49283,153793,2020-08-08 05:57:01,wahoo,Zwift - SZR  Endurance Ride (D),Assioma DUO,KICKR CORE,223,229,-6
49355,153793,2020-08-09 06:31:09,wahoo,Zwift - 3R 100 Steady Ride [~3.0/2.5w/kg avg] (C),Assioma DUO,KICKR CORE,171,177,-6
49495,153793,2020-08-10 11:34:06,wahoo,Zwift - JETT Base Ride (2.7~3.8w/kg)  (C),Assioma DUO,KICKR CORE,272,276,-4
49621,153793,2020-08-11 10:34:06,wahoo,Zwift - CyclingTips Tuesday Group Ride (C),Assioma DUO,KICKR CORE,157,161,-4
50074,153793,2020-08-14 21:23:39,wahoo,Zwift - SAS - France 50km (C),Assioma DUO,KICKR CORE,204,209,-5
50097,153793,2020-08-15 03:55:00,wahoo,Zwift - SAS -  Tempus 100km (C),Assioma DUO,KICKR CORE,257,260,-3
51013,153793,2020-08-20 10:54:15,wahoo,Zwift - Roll with Castelli  (C),Assioma DUO,KICKR CORE,204,199,5
51014,153793,2020-08-20 21:05:52,wahoo,Zwift - The &#039;Grind&#039; Finale,Assioma DUO,KICKR CORE,188,189,-1
51925,153793,2020-08-25 10:50:33,wahoo,Zwift - DIRT Rolling Thunder Ride (C),Assioma DUO,KICKR CORE,208,215,-7
52290,153793,2020-08-26 22:56:39,wahoo,Zwift - British Triathlon Group Ride (E),Assioma DUO,KICKR CORE,182,184,-2
52419,153793,2020-08-28 21:24:28,wahoo,Zwift - SAS - France 50km (C),Assioma DUO,KICKR CORE,202,207,-5
52575,153793,2020-08-29 03:53:44,wahoo,Zwift - SAS -  Tempus 100km (C),Assioma DUO,KICKR CORE,211,219,-8
52977,153793,2020-09-01 10:49:47,wahoo,Zwift - DIRT Rolling Thunder Ride (C),Assioma DUO,KICKR CORE,208,216,-8
53354,153793,2020-09-03 10:47:52,wahoo,Zwift - British Triathlon Group Ride (E),Assioma DUO,KICKR CORE,174,179,-5
54654,153793,2020-09-11 19:59:36,wahoo,Zwift - JETT Hill Climb & Interval Ride (B),Assioma DUO,KICKR CORE,273,274,-1
54655,153793,2020-09-11 21:19:03,wahoo,Zwift - SAS - France 50km (C),Assioma DUO,KICKR CORE,155,157,-2
54666,153793,2020-09-12 03:54:34,wahoo,Zwift - SAS -  Tempus 100km (C),Assioma DUO,KICKR CORE,237,247,-10
56192,153793,2020-09-18 19:55:34,wahoo,Zwift - JETT Hill Climb & Interval Ride (B),Assioma DUO,KICKR CORE,339,343,-4
56193,153793,2020-09-18 21:18:25,wahoo,Zwift - SAS - France 50km (C),Assioma DUO,KICKR CORE,210,206,4
56212,153793,2020-09-19 04:43:12,wahoo,Zwift - TOUR de TOHOKU Virtual Ride (E),Assioma DUO,KICKR CORE,266,267,-1
57383,153793,2020-09-24 10:15:29,wahoo,Zwift - inGamba Family Ride [2.5 - 3.19w/kg] (C),Assioma DUO,KICKR CORE,241,235,6
58127,153793,2020-09-25 19:58:35,wahoo,Zwift - JETT Hill Climb & Interval Ride (B),Assioma DUO,KICKR CORE,269,269,0
58128,153793,2020-09-28 10:32:13,wahoo,Zwift - British Triathlon Group Ride (E),Assioma DUO,KICKR CORE,321,318,3
58943,153793,2020-09-29 10:58:24,wahoo,Zwift - DIRT Rolling Thunder Ride,Assioma DUO,KICKR CORE,203,208,-5
58944,153793,2020-10-01 10:56:35,wahoo,Zwift - Roll with Castelli - After Party (C),Assioma DUO,KICKR CORE,210,208,2
59511,153793,2020-10-02 10:54:37,wahoo,Zwift - Best Buddies Challenge - TGIF Ride (E),Assioma DUO,KICKR CORE,192,195,-3
59512,153793,2020-10-02 21:23:48,wahoo,Zwift - SAS - France 50km (C),Assioma DUO,KICKR CORE,166,172,-6
59513,153793,2020-10-03 05:56:45,wahoo,Zwift - SZR  Endurance Ride (C),Assioma DUO,KICKR CORE,171,179,-8
59514,153793,2020-10-03 21:19:40,wahoo,Zwift - ZA Road Group Ride,Assioma DUO,KICKR CORE,132,135,-3
59515,153793,2020-10-02 20:00:09,wahoo,Zwift - JETT Hill Climb & Interval Ride (B),Assioma DUO,KICKR CORE,311,307,4
61364,153793,2020-10-12 21:15:16,wahoo,Zwift - Ascenders Team Steady States Training (B),Assioma DUO,KICKR CORE,194,197,-3
61366,153793,2020-10-09 19:56:06,wahoo,Zwift - JETT Hill Climb & Interval Ride (B),Assioma DUO,KICKR CORE,278,276,2
61367,153793,2020-10-09 10:44:26,wahoo,Zwift - Friday Ebb presented by Team ODZ (C),Assioma DUO,KICKR CORE,182,201,-19
61368,153793,2020-10-08 10:35:38,wahoo,Zwift - Roll with Castelli - Lets Climb,Assioma DUO,KICKR CORE,225,226,-1
61369,153793,2020-10-07 10:42:39,wahoo,Zwift Academy Road: Workout 1 | Aerobic Power,Assioma DUO,KICKR CORE,309,306,3
61370,153793,2020-10-06 10:54:02,wahoo,Zwift - DIRT Rolling Thunder Ride (C),Assioma DUO,KICKR CORE,241,247,-6
62747,153793,2020-10-13 10:45:55,wahoo,Zwift - DIRT Rolling Thunder Ride (C),Assioma DUO,KICKR CORE,182,187,-5
62748,153793,2020-10-14 10:46:44,wahoo,Zwift - Okinawa week2 10/14,Assioma DUO,KICKR CORE,284,282,2
62749,153793,2020-10-14 21:45:45,wahoo,Zwift - European Lunch Ride (E),Assioma DUO,KICKR CORE,312,313,-1
62750,153793,2020-10-16 19:57:21,wahoo,Zwift - JETT Hill Climb & Interval Ride (B),Assioma DUO,KICKR CORE,296,296,0
63287,153793,2020-10-19 21:18:23,wahoo,Zwift - Ascenders Team Steady States Training (B),Assioma DUO,KICKR CORE,187,189,-2
63609,153793,2020-10-20 10:38:33,wahoo,Zwift - DIRT Rolling Thunder Ride (C),Assioma DUO,KICKR CORE,204,208,-4
64951,153793,2020-10-23 10:43:38,wahoo,Zwift - DIRT FriYay Ride (C),Assioma DUO,KICKR CORE,164,165,-1
64952,153793,2020-10-23 20:03:55,wahoo,Zwift - JETT Hill Climb & Interval Ride (B),Assioma DUO,KICKR CORE,282,279,3
64953,153793,2020-10-23 21:14:07,wahoo,Zwift - JETT TT Race (E),Assioma DUO,KICKR CORE,296,296,0
65259,153793,2020-10-26 21:15:00,wahoo,Zwift - Ascenders Team Steady States Training (B),Assioma DUO,KICKR CORE,202,204,-2
65609,153793,2020-10-26 10:56:43,wahoo,Zwift - Workout 20min PR,Assioma DUO,KICKR CORE - Erg Mode,301,298,3
65951,153793,2020-10-28 10:52:50,wahoo,Zwift - Okinawa week4 10/28,Assioma DUO,KICKR CORE - Erg Mode,294,293,1
66533,153793,2020-10-30 19:59:05,wahoo,Zwift - JETT Hill Climb & Interval Ride (B),Assioma DUO,KICKR CORE,287,285,2
66534,153793,2020-10-30 21:18:45,wahoo,Zwift - JETT TT Race (E),Assioma DUO,KICKR CORE,331,331,0
70050,153793,2020-11-05 10:37:17,wahoo,Zwift - DIRTy USA Cycling Ride (C),Assioma DUO,KICKR CORE,190,186,4
70052,153793,2020-11-06 20:02:36,wahoo,Zwift - JETT Hill Climb & Interval Ride (B),Assioma DUO,KICKR CORE,277,273,4
70054,153793,2020-11-09 21:07:39,wahoo,Zwift - Ascenders Team Steady States Training (B),Assioma DUO,KICKR CORE,188,191,-3
70056,153793,2020-11-10 10:40:22,wahoo,Zwift - CRYO-GEN ZTGR (Zwift Tuesday Group Ride) (C),Assioma DUO,KICKR CORE,177,174,3
71853,153793,2020-11-12 10:46:36,wahoo,Zwift - DIRTy USA Cycling Ride (C),Assioma DUO,KICKR CORE,167,169,-2
71855,153793,2020-11-12 22:47:09,wahoo,Zwift - GRIT Group ride - Partytime (B),Assioma DUO,KICKR CORE,291,291,0
71856,153793,2020-11-13 19:57:05,wahoo,Zwift - JETT Hill Climb & Interval Ride (B),Assioma DUO,KICKR CORE,265,264,1
95324,153793,2021-01-09 20:52:25,wahoo,Zwift - TDZ Stage 2: Longer Ride,Assioma DUO,KICKR CORE,197,196,1
95326,153793,2021-01-08 19:52:12,wahoo,Zwift - TBR 101 - Endurance (C),Assioma DUO,KICKR CORE,154,157,-3
95329,153793,2021-01-07 20:52:24,wahoo,Zwift - GGCC Glasgow Green Cycle Club Thursday Training Ride (C),Assioma DUO,KICKR CORE,193,195,-2
95330,153793,2021-01-07 10:51:00,wahoo,Zwift - CRYO-GEN ZTGR,Assioma DUO,KICKR CORE,174,175,-1
95335,153793,2021-01-04 20:57:03,wahoo,Zwift - TDZ Stage 1: Longer Ride,Assioma DUO,KICKR CORE,150,149,1
95336,153793,2021-01-05 10:37:32,wahoo,Zwift - CRYO-GEN ZTGR (Zwift Tuesday Group Ride) (C),Assioma DUO,KICKR CORE,193,192,1
95337,153793,2021-01-03 10:26:32,wahoo,Zwift - ODZentury Sunday Endurance Ride (C),Assioma DUO,KICKR CORE,170,174,-4
95338,153793,2021-01-01 21:33:33,wahoo,Zwift - JETT TT Race (E),Assioma DUO,KICKR CORE,300,305,-5
95933,153793,2021-01-12 20:47:53,wahoo,Zwift - Crit City Race (A),Assioma DUO,KICKR CORE,301,306,-5
96631,153793,2021-01-13 06:53:01,wahoo,Zwift - 3R Volcano Circuit Flat Race - 4 Laps (18.9km/11.7mi 80m) (A),Assioma DUO,KICKR CORE,284,293,-9
97223,153793,2021-01-14 10:46:28,wahoo,Zwift - CRYO-GEN ZTGR (Zwift Thursday Group Ride) (C),Assioma DUO,KICKR CORE,225,229,-4
97224,153793,2021-01-14 20:52:00,wahoo,Zwift - TDZ Stage 3: Shorter Ride,Assioma DUO,KICKR CORE,239,239,0
97670,153793,2021-01-15 21:24:19,wahoo,Zwift - JETT TT Race (E),Assioma DUO,KICKR CORE,301,307,-6
97674,153793,2021-01-15 21:56:32,wahoo,Zwift - Tour de Oz - Men&#039;s Stage 1 ,Assioma DUO,KICKR CORE,309,315,-6
97675,153793,2021-01-15 19:51:00,wahoo,Zwift - JETT Hill Climb & Interval Ride (B),Assioma DUO,KICKR CORE,295,297,-2
97733,153793,2021-01-16 04:54:39,wahoo,Zwift - SZR Wakeup Endurance Ride (D),Assioma DUO,KICKR CORE,181,178,3
99960,153793,2021-01-19 10:30:20,wahoo,Zwift - TDZ Stage 4: Standard Ride,Assioma DUO,KICKR CORE,173,173,0
99961,153793,2021-01-19 20:39:43,wahoo,Zwift - 3R Volcano Flat Reverse Race - 3 Laps (36.6km/22.7mi 138m) (A),Assioma DUO,KICKR CORE,324,322,2
100544,153793,2021-01-20 10:20:15,wahoo,Zwift - USA Cycling Coffee with Hot Espresso Presented by Team ODZ (C),Assioma DUO,KICKR CORE,346,354,-8
102650,153793,2021-01-21 10:37:51,wahoo,Zwift - CRYO-GEN ZTGR (Zwift Thursday Group Ride) (C),Assioma DUO,KICKR CORE,231,233,-2
102651,153793,2021-01-22 10:45:43,wahoo,Zwift - TDZ Stage 4: Shorter Ride,Assioma DUO,KICKR CORE,241,240,1
102652,153793,2021-01-23 10:09:59,wahoo,Zwift - 3R Volcano Climb Race - 1 Lap (22.4km/14mi 204m) (A),Assioma DUO,KICKR CORE,334,341,-7
102653,153793,2021-01-24 07:48:06,wahoo,Zwift - TDZ Stage 5: Shorter Ride,Assioma DUO,KICKR CORE,184,185,-1
103141,153793,2021-01-25 20:54:08,wahoo,Zwift - TDZ Stage 5: Longer Ride,Assioma DUO,KICKR CORE,157,157,0
103762,153793,2021-01-26 10:33:13,wahoo,Zwift - CRYO-GEN ZTGR (Zwift Tuesday Group Ride) (C),Assioma DUO,KICKR CORE,171,172,-1
103765,153793,2021-01-26 20:39:19,wahoo,Zwift - 3R Volcano Flat Reverse Race - 3 Laps (36.6km/22.7mi 138m) (A),Assioma DUO,KICKR CORE,312,318,-6
107676,153793,2021-02-02 20:39:54,wahoo,Zwift - 3R Volcano Flat Reverse Race - 3 Laps (36.6km/22.7mi 138m) (A),Assioma DUO,KICKR CORE,309,309,0
108474,153793,2021-02-03 10:40:40,wahoo,Zwift - 3R Volcano Circuit Flat Race - 6 Laps (27km/16.8mi 120m) (A),Assioma DUO,KICKR CORE,327,324,3
115520,153793,2021-02-12 19:52:22,wahoo,Zwift - JETT Hill Climb & Interval Ride (B),Assioma DUO,KICKR CORE,339,327,12
116166,153793,2021-02-16 21:26:23,wahoo,Zwift - Crit City Race (A),Assioma DUO,KICKR CORE,313,304,9
116295,153793,2021-02-16 10:35:47,wahoo,Zwift - CRYO-GEN ZTGR (Zwift Tuesday Group Ride) (C),Assioma DUO,KICKR CORE,164,162,2
116296,153793,2021-02-13 04:53:25,wahoo,Zwift - SZR Wakeup Endurance Ride (D),Assioma DUO,KICKR CORE,141,144,-3
116298,153793,2021-02-09 10:44:11,wahoo,Zwift - CRYO-GEN ZTGR (Zwift Tuesday Group Ride) (C),Assioma DUO,KICKR CORE,171,171,0
116299,153793,2021-02-08 20:39:14,wahoo,Zwift - TDZ Stage 8: Group Ride,Assioma DUO,KICKR CORE,166,164,2
116300,153793,2021-02-06 06:59:03,wahoo,Zwift - 3R Mountain Madness Steady Ride [~3.0w/kg avg] (B),Assioma DUO,KICKR CORE,209,210,-1
116301,153793,2021-02-06 04:46:07,wahoo,Zwift - SZR Wakeup Endurance Ride (D),Assioma DUO,KICKR CORE,142,149,-7
116302,153793,2021-02-05 19:53:12,wahoo,Zwift - JETT Hill Climb & Interval Ride (B),Assioma DUO,KICKR CORE,289,292,-3
116304,153793,2021-02-04 20:40:33,wahoo,Zwift - GGCC Glasgow Green Cycle Club Thursday Training Ride (C),Assioma DUO,KICKR CORE,189,193,-4
116307,153793,2021-02-04 10:45:12,wahoo,Zwift - CRYO-GEN ZTGR (Zwift Thursday Group Ride) (C),Assioma DUO,KICKR CORE,191,194,-3
116910,153793,2021-02-17 21:37:40,wahoo,Zwift - TDZ Stage 8: Group Ride,Assioma DUO,KICKR CORE,173,176,-3
116911,153793,2021-02-17 20:37:18,wahoo,Zwift - TDZ Stage 4: Standard Ride,Assioma DUO,KICKR CORE,172,171,1
116912,153793,2021-02-17 10:34:16,wahoo,Zwift - Peak-PTY Midweek TT Climb Challenge (A),Assioma DUO,KICKR CORE,323,318,5
119900,153793,2021-02-23 20:35:05,wahoo,Zwift - 3R Volcano Flat Reverse Race - 3 Laps (36.6km/22.7mi 138m) (A),Assioma DUO,KICKR CORE,324,317,7
125636,153793,2021-03-05 19:54:07,wahoo,Zwift - JETT Hill Climb & Interval Ride (B),Favero Assioma DUO,Wahoo Kickr Core,307,291,16
125637,153793,2021-03-05 10:23:45,wahoo,Zwift - DIRT Friday Morning Sprintapalooza (C),Favero Assioma DUO,Wahoo Kickr Core,196,187,9
125640,153793,2021-03-04 10:47:53,wahoo,Zwift - DIRTy USA Cycling Ride (C),Favero Assioma DUO,Wahoo Kickr Core,168,169,-1
125642,153793,2021-03-01 21:24:27,wahoo,Zwift - Ascenders Team Steady States Training (B),Favero Assioma DUO,Wahoo Kickr Core,197,197,0
125643,153793,2021-02-26 19:55:05,wahoo,Zwift - TBR 101 - Endurance (C),Favero Assioma DUO,Wahoo Kickr Core,161,156,5
125909,153793,2021-03-08 21:25:51,wahoo,Zwift - Ascenders Team Steady States Training (B),Favero Assioma DUO,Wahoo Kickr Core,255,251,4
126323,153793,2021-03-09 10:35:29,wahoo,Zwift - CRYO-GEN ZTGR (Zwift Tuesday Group Ride) (C),Favero Assioma DUO,Wahoo Kickr Core,188,183,5
127278,153793,2021-03-11 10:54:50,wahoo,Zwift - DIRTy USA Cycling Ride (C),Favero Assioma DUO,Wahoo Kickr Core,172,175,-3
33303,153898,2020-05-10 12:28:49,wahoo,RCC Zwift Championships - Mens Final,Stages (secondary),Wahoo Kickr (primary),346,354,-8
67622,153898,2020-11-03 18:27:10,wahoo,Wahoo Kickr (primary) / Assioma Favero Duo,Assioma Favero Duo (secondary),Wahoo Kickr (primary),313,330,-17
69774,153898,2020-11-10 18:05:04,wahoo,Zwift Racing League | WTRL - EMEA E2 (MEN) - Division 1 (B),Assioma Favero Duo (secondary),Wahoo Kickr (primary),350,367,-17
83871,155607,2020-12-16 09:37:37,neo,powertap p1 left pedal to sgx-ca500 / tacx neo to Zwift,powertap p1 left pedal to sgx-ca500,tacx neo to Zwift,352,337,15
111361,155607,2021-02-09 08:34:04,neo,tacx neo to Zwift / powertap p1 left pedal to sgx-ca500,powertap p1 left pedal to sgx-ca500,tacx neo to Zwift,343,328,15
129239,156078,2021-03-16 18:29:55,wahoo,CeramicSpeed Series Qualifier Race,Favero,Wahoo Kickr,396,398,-2
71228,156090,2020-11-14 04:54:57,neo,Zwift - SZR Wakeup Endurance Ride (D),Favero Assoma Duo,Tacx Neo,198,199,-1
73085,156090,2020-11-19 18:12:57,neo,Zwift - Latte,Favero Assoma Duo,Tacx Neo,247,249,-2
77495,156090,2020-11-29 18:59:55,neo,Zwift - Focus: Colours of PARI - Shorter Ride,Favero Assoma Duo,Tacx Neo,241,235,6
78597,156090,2020-12-02 18:01:52,neo,MIDWEEK Winter Series by SZR,Favero Assoma Duo,Tacx Neo,257,250,7
50453,156409,2020-08-17 20:15:03,neo,Zwift - AHDR Bacon Rolls (B),vector3,Tacx neo,322,301,21
50593,156409,2020-08-18 19:49:59,neo,Zwift - AHDR Bacon Rolls with Caffeine  (B),vector3,Tacx neo,353,350,3
51445,156409,2020-08-23 19:50:02,neo,Zwift - AHDR Bacon Rolls (B),vector3,Tacx neo,289,299,-10
51553,156409,2020-08-24 18:19:58,neo,Zwift - TFC Mad Monday Summer Series (8 of 10) (A),vector3,Tacx neo,348,371,-23
52251,156409,2020-08-27 18:48:58,neo,Zwift - WTRL Team Time Trial (C),vector3,Tacx neo,341,345,-4
52781,156409,2020-08-31 18:19:59,neo,TFC Mad Monday Summer Series (9 of 10),vector3,Tacx neo,394,363,31
53521,156409,2020-09-05 11:10:00,neo,Zwift - Innsbruck,vector3 to Zwift,Tacx neo to edge520,336,354,-18
53722,156409,2020-09-06 19:50:02,neo,Zwift - AHDR Bacon Rolls (B),vector3 to edge520,Tacx neo to zwift,302,309,-7
56016,156409,2020-09-17 18:48:56,neo,Zwift - Frappe,vector3 to edge520,Tacx neo to zwift,343,341,2
56872,156409,2020-09-22 18:39:54,neo,Zwift - 3R Sundown Race Series  (A),vector3 to edge520,Tacx neo to zwift,342,334,8
57402,156409,2020-09-24 18:46:55,neo,Zwift - Frappe TTT,vector3 to edge520,Tacx neo to zwift,362,371,-9
65552,156409,2020-10-27 19:51:58,neo,Zwift - Zwift Racing League | WTRL - EMEA W (MEN) -  Division 8 (A),vector3 to edge520,Tacx neo to zwift,380,373,7
69966,156409,2020-11-10 19:51:56,neo,Zwift - Zwift Racing League | WTRL - EMEA W2 (MEN) -  Division 4 (A),vector3 to edge520,Tacx neo to zwift,350,368,-18
41528,156975,2020-06-13 00:00:04,wahoo,Zwift - NRS Invitational - Week 4 (B),PowerTap p2 power meter pedals,Kicker18,378,363,15
43753,156975,2020-06-26 23:07:17,wahoo,Zwift - NRS Invitational - Week 5: Men Only,PowerTap p2 power meter pedals,Kicker18,409,405,4
49164,156975,2020-08-07 04:55:21,wahoo,Zwift - 3R Flat Race - FRANCE - Casse-Pattes - 1 Lap (A),PowerTap p2 power meter pedals,Kicker18,390,382,8
49328,156975,2020-08-09 00:15:05,wahoo,Zwift - Herd Summer Racing League Race 9 (A),PowerTap p2 power meter pedals,Kicker18,390,391,-1
49970,156975,2020-08-14 08:18:17,wahoo,Zwift - Off the MAAP Invitational Race // Stage 1 (Men) (A),PowerTap p2 power meter pedals,Kicker18,381,375,6
50607,156975,2020-08-18 22:30:19,wahoo,Zwift - SweatFest in France p/b Fell Swoop (A),PowerTap p2 power meter pedals,Kicker18,329,322,7
50860,156975,2020-08-20 08:21:55,wahoo,Zwift - Off the MAAP Invitational Race // Stage 3 (men) ,PowerTap p2 power meter pedals,Kicker18,403,374,29
51420,156975,2020-08-23 05:54:54,wahoo,Zwift - Off the MAAP Stage 3  Race (A) ,PowerTap p2 power meter pedals,Kicker17,309,304,5
51476,156975,2020-08-24 09:03:52,wahoo,Zwift - Off the MAAP Invitational Race // Stage 4 (men) ,PowerTap p2 power meter pedals,Kicker17,421,411,10
54829,156975,2020-09-13 04:53:21,wahoo,Zwift - KISS at Race 100 - EU (A),PowerTap p2 power meter pedals,Kicker17,398,397,1
55016,156975,2020-09-14 17:42:34,wahoo,Zwift - Invitational League // Qualifying Race #1,PowerTap p2 power meter pedals,Kicker17,366,363,3
55826,156975,2020-09-17 18:07:58,wahoo,Zwift - Invitational League // Qualifying Race #2 (Men) ,PowerTap p2 power meter pedals,Kicker17,373,371,2
56429,156975,2020-09-20 12:40:59,wahoo,Zwift - Invitational League // Qualifying Race #3 (Men) (A),PowerTap p2 power meter pedals,Kicker17,389,384,5
60922,156975,2020-10-11 06:09:53,wahoo,Zwift - ZA Road Race #1: 4 - 5 w/kg,PowerTap p2 power meter pedals,Kicker17,327,339,-12
61314,156975,2020-10-12 18:30:58,wahoo,Zwift - Premier Division // Zwift Racing League (men) ,PowerTap p2 power meter pedals,Kicker17,422,419,3
63069,156975,2020-10-19 18:01:08,wahoo,Zwift - Premier Division // Zwift Racing League (men) ,PowerTap p2 power meter pedals,Kicker17,406,409,-3
64732,156975,2020-10-24 23:58:00,wahoo,Zwift - ZA Road 2020 - Segment Ride #1: Innsbruck Course,PowerTap p2 power meter pedals,Kicker17,401,384,17
65183,156975,2020-10-26 19:55:26,wahoo,Zwift - 10/27/2020,PowerTap p2 power meter pedals,Kicker17,389,387,2
65193,156975,2020-10-26 19:55:26,wahoo,Zwift - Premier Division // Zwift Racing League (men) (A),PowerTap p2 power meter pedals,Kicker17,389,387,2
67302,156975,2020-11-02 19:06:24,wahoo,Zwift - Premier Division // Zwift Racing League (men) (A),PowerTap p2 power meter pedals,Kicker17,396,397,-1
69442,156975,2020-11-09 19:44:14,wahoo,Zwift - Premier Division // Zwift Racing League (men) (A),PowerTap p2 power meter pedals,Kicker17,415,415,0
74673,156975,2020-11-23 19:51:58,wahoo,Zwift - Premier Division // Zwift Racing League (men) (A),PowerTap p2 power meter pedals,Kicker17,401,400,1
52795,158721,2020-08-31 17:16:07,wahoo,Zwift - DBR Monday Race  (B) Kristian Miller on fire !,Rotor InPower,Kickr 18,357,330,27
52796,158721,2020-08-01 23:13:20,wahoo,Zwift - The - GO  TBR / BDCC / SMCC Combine (A) - 7th. Really hard race,Rotor InPower,Kickr 18,379,379,0
31475,159227,2020-04-29 16:34:37,neo,Zwift - Swedish Zwift Racing Cup by SZR (A),Favero Assioma Duo,Tacx Neo,382,375,7
101365,159227,2021-01-14 18:06:38,wahoo,Zwift - BENELIGA 2020-2021 (E),Favero Assioma Duo,Wahoo Kickr,394,394,0
12288,159283,2020-02-03 17:09:23,wahoo,Zwift - Tour de Zwift: Stage 6 Race (A),Garmin Vector 1 sided,Wahoo KICKR Powertrainer 2017,388,399,-11
16295,159283,2020-03-01 14:04:50,wahoo,Zwift - Zwift Medio Fondo,Garmin Vector 1 sided,Wahoo KICKR Powertrainer 2017,318,314,4
32272,159707,2020-05-07 04:59:59,wahoo,Zwift - Tour for All 2020: Stage 1 Longer Ride,Garmin Vector Peddles,Wahoo Kicker,276,281,-5
32496,159707,2020-05-07 18:31:03,wahoo,Zwift -  Kiss Racing Team / FastFitnessTips iTT series (E),Garmin Vector Peddles,Wahoo Kicker,378,367,11
33339,159707,2020-05-10 13:15:00,wahoo,Zwift - KISS at Race 100 - Americas (A),Garmin Vector Peddles,Wahoo Kicker,332,322,10
33886,159707,2020-05-12 14:00:12,wahoo,Zwift - Zwift Time Trial Tuesday: Tempus Fugit (E),Garmin Vector Peddles,Wahoo Kicker,376,371,5
34728,159707,2020-05-14 17:11:53,wahoo,Zwift - ZHR Hare & Hounds Race (A),Garmin Vector Peddles,Wahoo Kicker,396,392,4
36057,159707,2020-05-19 16:10:00,wahoo,Zwift - Tour for All 2020: Stage 4 Longer Race A/B,Garmin Vector Peddles,Wahoo Kicker,385,381,4
96019,159746,2021-01-13 00:39:51,wahoo,Zwift Racing League | WTRL - Mens/Mixed AMERICAS E DIVISION 2,Quarq to Zwift,Kickr Secondary,398,395,3
99987,159746,2021-01-20 00:45:42,wahoo,Zwift Racing League | WTRL - Mens/Mixed AMERICAS E DIVISION 2,Quarq to Zwift,Kickr Secondary,387,376,11
103808,159746,2021-01-27 00:45:36,wahoo,Zwift Racing League | WTRL - Mens/Mixed AMERICAS E DIVISION 1,Quarq,Kickr ,402,393,9
107745,159746,2021-02-03 00:11:36,wahoo,Zwift Racing League | WTRL - Mens/Mixed AMERICAS E DIVISION 1,Quarq,Kickr ,385,384,1
111891,159746,2021-02-10 00:47:50,wahoo,Zwift Racing League | WTRL - Mens/Mixed AMERICAS E DIVISION 1,Quarq to Zwift,Kickr Secondary,366,369,-3
116217,159746,2021-02-17 00:43:39,wahoo,Zwift Racing League | WTRL - Mens/Mixed AMERICAS E DIVISION 1,Quarq,Kickr ,417,407,10
119948,159746,2021-02-24 00:45:45,wahoo,Zwift Racing League | WTRL - Mens/Mixed AMERICAS E DIVISION 1,Quarq,Kickr ,361,362,-1
123244,159746,2021-03-03 00:48:48,wahoo,Zwift Racing League | WTRL - Mens/Mixed AMERICAS E DIVISION 1,Quarq,Kickr ,360,362,-2
82914,160036,2020-12-13 15:06:48,wahoo,Zwift - Geiger +2,Stages XTR Gen2,Kickr V1,286,266,20
84729,160036,2020-12-18 14:32:40,wahoo,Zwift - Donner,P2M Type S,Kickr V1,279,281,-2
47740,160942,2020-07-26 07:05:57,wahoo,Zwift - Vikings Valhalla 100 series (D),Garmin vector 3,Wahoo kickr ,242,238,4
48229,160942,2020-07-28 08:29:57,wahoo,Zwift - Singletrack Slayer - Long Climbs,Garmin vector 3,Wahoo kickr ,228,228,0
53349,160942,2020-09-03 17:19:20,wahoo,Zwift - Latte,Garmin vector 3,Wahoo kickr ,369,366,3
56630,160942,2020-09-21 11:40:48,wahoo,Zwift - TT#3 Dynamic TT Course Work,Vector 3,Wahoo kickr ,285,271,14
57114,160942,2020-09-23 17:34:30,wahoo,Zwift - NCF Vinter Cup 2020 - Runde 1 - Herrer (B),Garmin vector 3,Wahoo kickr ,365,349,16
114871,160942,2021-02-14 08:29:59,wahoo,Zwift - Absa Cape Epic Workout 3,Garmin vector 3,Wahoo kickr ,241,246,-5
17206,161949,2020-03-07 15:37:10,wahoo,Zwift - Watopia,4iiii,Kickr,146,151,-5
18585,161949,2020-03-18 17:17:32,wahoo,Zwift - 03/18/2020,4iiii,Kickr,180,172,8
22066,161949,2020-04-04 16:12:10,wahoo,Zwift - NYC,4iiii,Kickr,189,174,15
42620,161949,2020-06-19 16:00:00,wahoo,Zwift - EVO CC Flux Ride [1.5 - 2.0w/kg avg] (D),4iiii,Kickr,207,194,13
73537,161949,2020-11-20 16:22:43,wahoo,Zwift - Ramp Test Lite,4iiii,Kickr,228,229,-1
94905,161949,2021-01-11 17:31:52,wahoo,Zwift - Watopia,4iiii,Kickr,183,180,3
92787,162054,2021-01-07 17:04:47,wahoo,Zwift - OH MY CRIT! - The Double Race 2/2 (A),Dura Ace,Kickr,367,367,0
92793,162054,2021-01-07 16:14:30,wahoo,Zwift - OH MY CRIT! - The Double Race 1/2 (A),Dura Ace,Kickr,374,375,-1
12407,162250,2020-02-04 18:58:04,neo,Zwift - ZwiftTeamPL League – Sprinters Series (A),Stages gen3,Tacx neo,277,278,-1
12960,162250,2020-02-07 17:21:40,neo,Zwift - 3R PedalPlay Interval Ride [~3.5-4+w/kg avg] (B),Stages gen3,Tacx neo,282,273,9
13192,162250,2020-02-09 16:43:35,neo,Zwift - Zwift Bambino Fondo,Stages gen3,Tacx neo,280,277,3
13444,162250,2020-02-11 18:36:55,neo,ZwiftTeamPL League � Climbers Series A,Stages gen3,Tacx neo,270,270,0
60098,162250,2020-10-07 15:30:48,neo,Zwift - TEAM VEGAN Mixed Salad (B),Stages gen3,Tacx neo,250,269,-19
60371,162250,2020-10-08 16:34:58,neo,Zwift - 3R PedalPlay Interval Ride [~3.5-4.0w/kg avg] (B),Stages gen3,Tacx neo,237,251,-14
69096,162250,2020-11-08 13:59:59,neo,Zwift - Zwift Fondo Series 2020/21: Bambino Fondo,assioma,Tacx neo,240,240,0
90972,162405,2021-01-03 13:59:59,wahoo,Zwift - Zwift Fondo Series 2020/21 (A),PTP1,Kickr18,376,372,4
91650,162405,2021-01-05 10:59:59,wahoo,Zwift - KISS Race Series - Americas AM (A),PTP1,Kickr18,388,380,8
91661,162405,2021-01-05 11:59:58,wahoo,Zwift - TDZ Stage 1: Longer Ride,PTP1,Kickr18,325,320,5
92658,162405,2021-01-07 10:59:59,wahoo,Zwift - KISS Race Series - Americas AM (A),PTP1,Kickr18,396,391,5
94007,162405,2021-01-09 15:15:00,wahoo,Zwift - OH MY CRIT - Saturday Smash Race (A),PTP1,Kickr18,354,350,4
94469,162405,2021-01-10 13:10:02,wahoo,Zwift - The BMTR Fundo (A),PTP1,Kickr18,377,370,7
94817,162405,2021-01-11 10:55:18,wahoo,Zwift - KISS at Base Training Ride (B),PTP1,Kickr18,217,212,5
95484,162405,2021-01-12 10:59:59,wahoo,Zwift - KISS Race Series - Americas AM (A),PTP1,Kickr18,353,345,8
96218,162405,2021-01-13 10:45:00,wahoo,Zwift - The Morning Grind by STPC (A),PTP1,Kickr18,383,375,8
96792,162405,2021-01-14 10:34:58,wahoo,Japan ZWIFT Hill Climb Race,PTP1,Kickr18,350,346,4
8357,162474,2020-01-07 18:54:37,neo,Zwift - Team Italy Gladiators Race (A),SRAM Red Quarq DZero,tacx neo 1,355,351,4
10356,162474,2020-01-21 19:39:52,neo,Zwift - 3R Ultimate Racing League - Round 3 (A),SRAM Red Quarq DZero,tacx neo 1,392,395,-3
11409,162474,2020-01-28 18:59:51,neo,Zwift - ZwiftTeamPL League – Classic Series (A),SRAM Red Quarq DZero,tacx neo 1,387,387,0
57045,162474,2020-09-23 17:45:15,neo,Zwift - DCU powered by Feltet.dk (A),Favero assioma duo,tacx neo 1,332,355,-23
58547,162474,2020-09-30 17:44:41,neo,Zwift - DCU powered by Feltet.dk (A),Favero assioma duo,tacx neo 1,336,350,-14
60891,162474,2020-10-07 17:44:25,neo,Zwift - DCU powered by Feltet.dk (A),Favero assioma duo,tacx neo 1,347,360,-13
60897,162474,2020-10-11 03:14:32,neo,Zwift - 3R Watopia Flat Route Race - 3 Laps (30.3km/18.8mi 162m) (A),Favero assioma duo,tacx neo 1,339,348,-9
60899,162474,2020-10-11 04:04:45,neo,Zwift - 3R Innsbruckring Flat Race - 2 Laps (17.6km/10.9m 154m) (A),Favero assioma duo,tacx neo 1,351,357,-6
62453,162474,2020-10-15 18:52:33,neo,Zwift - Espresso,Favero assioma duo,tacx neo 1,316,321,-5
64219,162474,2020-10-22 17:28:00,neo,Zwift - FUSION ECT BEUNSTOPPABLE Racing Series (A),Favero assioma duo,tacx neo 1,356,372,-16
68235,162474,2020-11-05 18:25:09,neo,Zwift - FUSION ECT BEUNSTOPPABLE Racing Series (A),Favero assioma duo,tacx neo 1,359,370,-11
72214,162474,2020-11-12 19:04:38,neo,Zwift - Espresso,Favero assioma duo,tacx neo 1,328,329,-1
73153,162474,2020-11-19 19:27:31,neo,Zwift - World Championships Experience // Danish Cycling Federation,Favero assioma duo,tacx neo 1,331,343,-12
76160,162474,2020-11-26 18:26:35,neo,Zwift - FUSION ECT BEUNSTOPPABLE Racing Series (A),Favero assioma duo,tacx neo 1,331,343,-12
78143,162474,2020-12-01 19:43:56,neo,Zwift - Zwift Racing League | WTRL - Men&#039;s EMEA W1 DIVISION 1 (A),Favero assioma duo,tacx neo 1,328,340,-12
79017,162474,2020-12-03 18:28:23,neo,Zwift - FUSION DECEMBER CUP (A),Favero assioma duo,tacx neo 1,332,343,-11
80901,162474,2020-12-08 19:42:23,neo,Zwift - Zwift Racing League | WTRL - Men&#039;s EMEA W1 DIVISION 1 (A),Favero assioma duo,tacx neo 1,344,360,-16
81648,162474,2020-12-10 18:27:51,neo,Zwift - FUSION DECEMBER CUP (A),Favero assioma duo,tacx neo 1,337,349,-12
83618,162474,2020-12-15 19:44:44,neo,Zwift - 12/15/2020,Favero assioma duo,tacx neo 1,323,338,-15
84431,162474,2020-12-17 18:26:15,neo,Zwift - FUSION DECEMBER CUP (A),Favero assioma duo,tacx neo 1,360,372,-12
93070,162474,2021-01-07 18:26:14,neo,Zwift - FUSION WINTER CUP (A),Favero assioma duo,tacx neo 1,363,379,-16
95844,162474,2021-01-12 19:49:06,neo,Zwift - Zwift Racing League | WTRL - Men&#039;s/Mixed EMEA W2 DIVISION 1 (A),Favero assioma duo,tacx neo 1,362,369,-7
97256,162474,2021-01-14 18:26:50,neo,Zwift - FUSION WINTER CUP (A),Favero assioma duo,tacx neo 1,364,377,-13
100829,162474,2021-01-19 19:52:17,neo,Zwift - Zwift Racing League | WTRL - Men&#039;s/Mixed EMEA W2 DIVISION 1 (A),Favero assioma duo,tacx neo 1,338,332,6
101203,162474,2021-01-21 18:27:31,neo,Zwift - FUSION WINTER CUP (A),Favero assioma duo,tacx neo 1,343,356,-13
103625,162474,2021-01-26 19:50:08,neo,Zwift - Zwift Racing League | WTRL - Men&#039;s/Mixed EMEA W2 DIVISION 1 (A),Favero assioma duo,tacx neo 1,334,346,-12
104777,162474,2021-01-28 18:27:49,neo,Zwift - FUSION WINTER CUP (A),Favero assioma duo,tacx neo 1,360,373,-13
107508,162474,2021-02-02 19:49:28,neo,Zwift - Zwift Racing League | WTRL - Men&#039;s/Mixed EMEA W2 DIVISION 1 (A),Favero assioma duo,tacx neo 1,349,358,-9
109041,162474,2021-02-04 18:26:11,neo,Zwift - FUSION WINTER CUP (A),Favero assioma duo,tacx neo 1,331,336,-5
111757,162474,2021-02-09 19:53:10,neo,Zwift - Zwift Racing League | WTRL - Men&#039;s/Mixed EMEA W2 DIVISION 1 (A),Favero assioma duo,tacx neo 1,356,361,-5
113295,162474,2021-02-11 18:27:08,neo,Zwift - FUSION WINTER CUP (A),Favero assioma duo,tacx neo 1,337,340,-3
116037,162474,2021-02-16 19:49:26,neo,Zwift - Zwift Racing League | WTRL - Men&#039;s/Mixed EMEA W2 DIVISION 1 (A),Favero assioma duo,tacx neo 1,356,363,-7
117567,162474,2021-02-18 18:27:34,neo,Zwift - FUSION WINTER CUP (A),Favero assioma duo,tacx neo 1,334,338,-4
119746,162474,2021-02-23 19:49:03,neo,Zwift - Zwift Racing League | WTRL - Men&#039;s/Mixed EMEA W2 DIVISION 1 (A),Favero assioma duo,tacx neo 1,350,356,-6
121024,162474,2021-02-25 18:26:40,neo,Zwift - FUSION WINTER CUP (A),Favero assioma duo,tacx neo 1,374,377,-3
124167,162474,2021-03-02 19:51:42,neo,Zwift - Zwift Racing League | WTRL - Men&#039;s/Mixed EMEA W2 DIVISION 1 (A),Favero assioma duo,tacx neo 1,336,337,-1
124173,162474,2021-03-04 18:28:42,neo,Zwift - FUSION SPRING CUP (A),Favero assioma duo,tacx neo 1,341,342,-1
127210,162474,2021-03-11 18:27:49,neo,Zwift - FUSION SPRING CUP (A),Favero assioma duo,tacx neo 1,349,345,4
54601,162824,2020-09-11 15:22:24,wahoo,Zwift - Watopia,4iiii Dual Power Meter,Wahoo Kickr,305,297,8
60593,162824,2020-10-09 16:00:22,wahoo,Zwift Academy Road: Workout 2 | Sprint Profile,4iiii Dual Power Meter,Wahoo Kickr,251,227,24
60824,162824,2020-10-10 14:11:21,wahoo,Zwift - ZA Road Race #1: 3.2 - 4 w/kg,4iiii Dual Power Meter0,Wahoo Kickr,306,302,4
66377,162824,2020-10-30 09:57:04,wahoo,Zwift - GPLAMA - ULTIMATE WARM UP,4iiii Dual Power Meter,Wahoo Kickr,262,254,8
66378,162824,2020-10-30 10:27:24,wahoo,Zwift - Watopia,4iiii Dual Power Meter,Wahoo Kickr,233,230,3
78970,162824,2020-12-03 16:50:14,wahoo,Zwift - Yorkshire,4iiii Dual Power Meter,Wahoo Kickr,290,289,1
93981,162824,2021-01-09 14:20:40,wahoo,Zwift - CCBoucherville-V2000 FUN Races (B),4iiii Dual Power Meter,Wahoo Kickr,289,291,-2
106121,162824,2021-01-31 10:04:13,wahoo,Zwift - Yorkshire,4iiii Dual Power Meter,Wahoo Kickr,301,298,3
117847,162824,2021-02-19 16:52:03,wahoo,Zwift - Richmond,4iiii Dual Power Meter,Wahoo Kickr,226,210,16
121281,162824,2021-02-26 16:56:10,wahoo,Zwift - Watopia,4iiii Dual Power Meter,John&#039;s Kickr,254,241,13
121284,162824,2021-02-26 17:26:43,wahoo,Zwift - Watopia,4iiii Dual Power Meter,John&#039;s Kickr,259,245,14
91868,164519,2021-01-05 15:00:00,neo,Zwift - TDZ Stage 1: Longer Ride,Stages Shimano Dura Ace Gen2,Tacx Neo Gen. 0,215,203,12
92362,164519,2021-01-06 18:02:00,neo,Zwift - MIDWEEK Winter Series by SZR (C),Stages Shimano Dura Ace Gen2,Tacx Neo Gen. 0,293,281,12
95918,164519,2021-01-12 19:58:59,neo,Zwift - Zwift Racing League | WTRL - Men&#039;s/Mixed EMEA W2 DIVISION 7 (B),Stages Shimano Dura Ace Gen2,Tacx Neo Gen. 0,319,327,-8
98949,164519,2021-01-16 18:00:00,neo,Zwift - TDZ Stage 3: Longer Ride,Stages Shimano Dura Ace Gen2,Tacx Neo Gen. 0,214,199,15
101302,164519,2021-01-21 18:13:46,neo,Zwift - WTRL Team Time Trial - Zone 4 (D),Stages Shimano Dura Ace Gen2,Tacx Neo Gen. 0,279,270,9
121215,164519,2021-02-26 16:37:20,neo,Zwift - SZ AW Party by SZR (B),Stages Shimano Dura Ace Gen2,Tacx Neo Gen. 0,302,302,0
121218,164519,2021-02-26 16:09:14,neo,Zwift - SZ AW Party by SZR (B),Stages Power Meter,Tacx Neo,302,299,3
115477,164763,2021-02-15 19:30:01,wahoo,Zwift - ZZRC Happy Hour (C),Quarq DZero,Wahoo Kickr 2016,219,222,-3
116059,164763,2021-02-16 19:14:16,wahoo,Zwift - The Gorby,Quarq DZero,Wahoo Kickr 2016,303,310,-7
117435,164763,2021-02-18 18:47:51,wahoo,Zwift - FLANDERS The BZR Ronde Watopian League (B),Quarq DZero,Wahoo Kickr 2016,306,300,6
119835,164763,2021-02-23 19:47:50,wahoo,Zwift - London,Quarq DZero,Wahoo Kickr v5,309,305,4
124223,164763,2021-03-04 19:52:25,wahoo,Zwift - The Gorby,Quarq DZero,Wahoo Kickr v5,311,307,4
125561,164763,2021-03-07 19:10:52,wahoo,Zwift - Watopia,Quarq DZero,Wahoo Kickr v5,309,304,5
125563,164763,2021-03-06 18:58:14,wahoo,Zwift - The Wringer,Quarq DZero,Wahoo Kickr v5,256,259,-3
126295,164763,2021-03-09 19:21:14,wahoo,Zwift - Watopia,Quarq DZero,Wahoo Kickr v5,296,299,-3
31744,164997,2020-05-05 17:10:13,wahoo,Zwift - Tour for All 2020: Stage 1 Longer Race A/B,Stages Dual Dura Ace,Wahoo KICKR 2018,387,402,-15
35396,164997,2020-05-16 14:44:55,wahoo,GCA Liga #5 (D) Men Only,Wahoo KICKR 2018 ANT via Garmin,Wahoo KICKR 2018 - BT via Zwift Companion,425,431,-6
41488,164997,2020-06-13 15:59:37,wahoo,GCA Klassiker #2 (A),Stages Dual Dura Ace (driveside shimano stages are low),Wahoo KICKR 2018,411,424,-13
106398,165736,2021-01-30 12:12:03,neo,Zwift - KOM-on Winter - Oflfine Final - Mighty Metropolitan,Assioma,Tacx Neo,358,377,-19
7656,165977,2019-12-30 16:10:05,neo,Zwift - 3R Classique Reverse Flat Race - 4 Laps,Quarq dZero,"Neo, gen. 1",309,299,10
8821,165977,2020-01-11 09:29:46,neo,Zwift - DBR Saturday Race (A),Quarq dZero,"Neo, gen. 1",370,371,-1
22746,165977,2020-04-07 16:20:39,wahoo,Zwift - Yorkshire Grand Prix Race (A),Quarq dZero,Kickr gen 4.,307,293,14
23057,165977,2020-04-08 17:42:39,wahoo,Zwift - DBR Sprinthooligan Cup (A),Quarq dZero,Kickr gen 4.,298,290,8
23262,165977,2020-04-09 14:59:17,neo,Zwift - DBR Base Endurance Ride (E),Quarq dZero,"Neo, gen. 1",279,277,2
23548,165977,2020-04-10 16:10:14,wahoo,Zwift - London International Race (A),Quarq dZero,Kickr gen 4.,309,299,10
23687,165977,2020-04-07 15:51:30,neo,DBR Sufferday League,Quarq dZero,"Neo, time and date adjusted",291,288,3
23945,165977,2020-04-12 07:54:35,neo,Zwift - DBR Social Ride  (D),Quarq dZero,"Neo, gen. 1",265,264,1
25199,165977,2020-04-16 14:46:51,wahoo,Zwift - DBR Base Endurance Ride (E),Quarq dZero,Kickr gen 4.,246,238,8
26115,165977,2020-04-19 07:55:03,wahoo,Zwift - DBR Social Ride  (D),Quarq dZero,Kickr gen 4.,223,220,3
26686,165977,2020-04-21 17:24:20,wahoo,Zwift - Ride it out with Castelli,Quarq dZero,Kickr gen 4.,301,295,6
27333,165977,2020-04-23 14:59:17,wahoo,Zwift - DBR Base Endurance Ride (E),Quarq dZero,Kickr gen 4.,256,259,-3
28229,165977,2020-04-26 13:30:01,wahoo,Zwift - Meetup - Big Loop,Quarq dZero,Kickr gen 4.,300,293,7
28728,165977,2020-04-28 14:46:55,wahoo,Zwift - ZHQ Beta Crit City Race (B),Quarq dZero,Kickr gen 4.,309,304,5
29635,165977,2020-04-30 15:00:02,wahoo,Zwift - DBR Base Endurance Ride (E),Quarq dZero,Kickr gen 4.,249,240,9
30192,165977,2020-05-01 15:59:36,wahoo,Zwift - Ride VS Covid-19 (E),Quarq dZero,Kickr gen 4.,305,295,10
30422,165977,2020-05-02 08:29:44,wahoo,Zwift - DBR Sufferday League (B),Quarq dZero,Kickr gen 4.,311,300,11
31251,165977,2020-05-04 14:36:31,wahoo,Zwift - Watopia,Quarq dZero,Kickr gen 4.,299,294,5
32429,165977,2020-05-07 14:57:57,wahoo,Zwift - DBR Base Endurance Ride (E),Quarq dZero,Kickr gen 4.,230,225,5
32938,165977,2020-05-09 08:21:34,wahoo,Zwift - DBR Sufferday League (B),Quarq dZero,Kickr gen 4.,301,296,5
33681,165977,2020-05-11 17:29:08,neo,Zwift - Fast &#039;n&#039; Furious Team CLS Racing S5 (B),Quarq dZero,"Neo, gen. 1",296,307,-11
33934,165977,2020-05-12 15:28:44,neo,Zwift - Innsbruck,Quarq dZero,"Neo, gen. 1",297,291,6
34703,165977,2020-05-14 15:00:04,neo,Zwift - DBR Base Endurance Ride (E),Quarq dZero,"Neo, gen. 1",235,232,3
35286,165977,2020-05-16 08:28:54,neo,Zwift - DBR Sufferday League (B),Quarq dZero,"Neo, gen. 1",289,289,0
35612,165977,2020-05-17 10:59:51,neo,Zwift - USA Cycling Xtra Long Ride by DIRT (C),Quarq dZero,"Neo, gen. 1",271,281,-10
35832,165977,2020-05-18 17:15:07,neo,Zwift - DBR Wahoo League (B),Quarq dZero,"Neo, gen. 1",291,291,0
36031,165977,2020-05-19 13:51:31,neo,Zwift - Zwift Time Trial Tuesday: Tempus Fugit (E),Quarq dZero,"Neo, gen. 1",295,297,-2
36633,165977,2020-05-21 15:00:02,neo,Zwift - DBR Base Endurance Ride (E),Quarq dZero,"Neo, gen. 1",234,239,-5
36870,165977,2020-05-22 15:00:16,wahoo,Zwift - ZHQ Beta Crit City Race (B),Quarq dZero,Kickr gen 4.,310,297,13
37043,165977,2020-05-23 08:29:40,wahoo,Zwift - DBR Sufferday League (B),Quarq dZero,Kickr gen 4.,333,307,26
37636,165977,2020-05-25 17:04:29,neo,Zwift - DBR Wahoo League (B),Quarq dZero,"Neo, gen. 1",312,310,2
37823,165977,2020-05-26 16:30:01,neo,Zwift - 3R PedalPlay EVOLVE Interval Ride [~2.9-3.2 w/kg avg] (C),Quarq dZero,"Neo, gen. 1",331,323,8
38129,165977,2020-05-27 17:50:32,neo,Zwift - DBR Boerkop Cykler Cup (B),Quarq dZero,"Neo, gen. 1",321,315,6
38305,165977,2020-05-28 15:00:02,neo,Zwift - DBR Base Endurance Ride (E),Quarq dZero,"Neo, gen. 1",243,240,3
38646,165977,2020-05-30 08:29:46,neo,Zwift - DBR Sufferday League (B),Quarq dZero,"Neo, gen. 1",322,320,2
38789,165977,2020-05-31 07:44:46,neo,Zwift - DBR Social Ride  (D),Quarq dZero,"Neo, gen. 1",336,329,7
38913,165977,2020-06-01 10:00:42,neo,Zwift - EVR Asia Race (B),Quarq dZero,"Neo, gen. 1",298,281,17
39089,165977,2020-06-02 15:05:46,neo,Zwift - 3R & Wahoo Ride Real Race Series - Round 4 of 7 (B),Quarq dZero,"Neo, gen. 1",308,308,0
39578,165977,2020-06-04 15:00:06,neo,Zwift - DBR Base Endurance Ride (E),Quarq dZero,"Neo, gen. 1",274,265,9
39793,165977,2020-06-05 14:04:26,neo,Zwift - 3R Innsbruckring Flat Race (B),Quarq dZero,"Neo, gen. 1",311,317,-6
39937,165977,2020-06-06 08:59:26,neo,Zwift - KRT/KISS 80 km Endurance Ride (B),Quarq dZero,"Neo, gen. 1",259,251,8
40131,165977,2020-06-07 07:49:42,neo,Zwift - DBR Social Ride  (D),Quarq dZero,"Neo, gen. 1",208,204,4
40369,165977,2020-06-08 17:10:37,neo,Zwift - DBR Wahoo League (B),Quarq dZero,"Neo, gen. 1",325,320,5
40521,165977,2020-06-09 15:00:07,neo,Zwift - ZHQ Beta Crit City Race (B),Quarq dZero,"Neo, gen. 1",316,312,4
41044,165977,2020-06-11 14:58:16,neo,Zwift - DBR Base Endurance Ride (E),Quarq dZero,"Neo, gen. 1",264,259,5
41366,165977,2020-06-13 08:28:27,neo,Zwift - DBR Saturday Race  (B),Quarq dZero,"Neo, gen. 1",309,295,14
41579,165977,2020-06-14 07:54:45,neo,Zwift - DBR Social Ride  (D),Quarq dZero,"Neo, gen. 1",238,230,8
41819,165977,2020-06-15 17:15:00,neo,Zwift - DBR Monday Race  (B),Quarq dZero,"Neo, gen. 1",360,346,14
42611,165977,2020-06-18 14:58:28,neo,Zwift - DBR Base Endurance Ride (E),Quarq dZero,"Neo, gen. 1",223,217,6
42612,165977,2020-06-19 14:56:44,neo,Zwift - ZHQ Beta Crit City Race (B),Quarq dZero,"Neo, gen. 1",322,311,11
42789,165977,2020-06-20 08:23:47,neo,Zwift - DBR Saturday Race  (B),Quarq dZero,"Neo, gen. 1",314,312,2
42945,165977,2020-06-21 07:55:06,neo,Zwift - DBR Social Ride  (D),Quarq dZero,"Neo, gen. 1",210,203,7
43121,165977,2020-06-22 17:14:19,neo,Zwift - DBR Monday Race  (B),Quarq dZero,"Neo, gen. 1",305,301,4
43564,165977,2020-06-25 14:59:36,neo,Zwift - DBR Base Endurance Ride (E),Quarq dZero,"Neo, gen. 1",253,251,2
43765,165977,2020-06-27 08:33:57,neo,Zwift - ZHR Audax (D),Quarq dZero,"Neo, gen. 1",295,291,4
44069,165977,2020-06-29 16:53:56,neo,Zwift - DBR Monday Race  (B),Quarq dZero,"Neo, gen. 1",307,297,10
44243,165977,2020-06-30 15:44:01,neo,Zwift - France - Casse-Pattes,Quarq dZero,"Neo, gen. 1",322,330,-8
44562,165977,2020-07-02 16:32:56,neo,"Zwift - Somewhere, going up.",Quarq dZero,"Neo, gen. 1",293,289,4
44818,165977,2020-07-04 08:29:26,neo,Zwift - DBR Saturday Race  (B),Quarq dZero,"Neo, gen. 1",322,321,1
44989,165977,2020-07-05 11:35:12,neo,Zwift - Afternoon Ride,Quarq dZero,"Neo, gen. 1",292,297,-5
45125,165977,2020-07-06 17:15:46,neo,Zwift - DBR Monday Race  (B),Quarq dZero,"Neo, gen. 1",329,328,1
45297,165977,2020-07-07 16:35:13,neo,Zwift - Afternoon Ride,Quarq dZero,"Neo, gen. 1",300,303,-3
45466,165977,2020-07-08 18:02:57,neo,Zwift - DBR Wednesday Race (B),Quarq dZero,"Neo, gen. 1",297,294,3
45897,165977,2020-07-11 09:01:42,neo,Zwift - L&#039;Etape du Tour Stage 2 - Open,Quarq dZero,"Neo, gen. 1",320,315,5
46173,165977,2020-07-13 17:15:28,neo,Zwift - DBR Monday Race  (B),Quarq dZero,"Neo, gen. 1",326,323,3
46305,165977,2020-07-14 15:04:28,neo,Zwift - 3R Turbocharged Team Race Series - Round 1 (B),Quarq dZero,"Neo, gen. 1",324,319,5
46972,165977,2020-07-19 10:58:48,wahoo,Zwift - France,Quarq dZero,Kickr gen 4.,304,297,7
47179,165977,2020-07-21 17:29:15,neo,Zwift - UK Armed Forces Cycling Community Race Night (B),Quarq dZero,"Neo, gen. 1",316,314,2
47440,165977,2020-07-23 14:27:09,neo,Zwift - Team Italy Specialissima Race (B),Quarq dZero,"Neo, gen. 1",297,292,5
47551,165977,2020-07-24 14:05:58,neo,Zwift - France,Quarq dZero,"Neo, gen. 1",269,269,0
47627,165977,2020-07-25 10:13:40,neo,Zwift - 3R Volcano Climb Race - 1 Lap (B),Quarq dZero,"Neo, gen. 1",306,305,1
47753,165977,2020-07-26 12:59:50,neo,Zwift - 3R Watopia Flat Route Race - 4 Laps (B),Quarq dZero,"Neo, gen. 1",324,322,2
47881,165977,2020-07-27 17:15:34,neo,Zwift - DBR Monday Race  (B),Quarq dZero,"Neo, gen. 1",304,300,4
48319,165977,2020-07-30 14:03:33,neo,Zwift - 3R Classique Flat Race - 6 Laps (37.7km/23.4mi 114m) (B),Quarq dZero,"Neo, gen. 1",307,303,4
48320,165977,2020-07-30 15:15:18,neo,Zwift - OH MY CRIT! (B),Quarq dZero,"Neo, gen. 1",262,254,8
48549,165977,2020-08-02 07:54:37,neo,Zwift - DBR Social Ride  (D),Quarq dZero,"Neo, gen. 1",279,282,-3
48784,165977,2020-08-04 16:34:26,wahoo,Zwift - Team Italy Specialissima Race (B),Quarq dZero,Kickr gen 4.,307,290,17
49072,165977,2020-08-06 14:59:18,wahoo,Zwift - DBR Base Endurance Ride (E),Quarq dZero,Kickr gen 4.,244,234,10
49208,165977,2020-08-07 16:29:24,wahoo,Zwift - EVO CC Sprint Race Series  (B),Quarq dZero,Kickr gen 4.,301,283,18
49278,165977,2020-08-08 08:29:54,neo,Zwift - DBR Saturday Race  (B),Quarq dZero,"Neo, gen. 1",303,301,2
49470,165977,2020-08-10 17:13:59,neo,Zwift - DBR Monday Race  (B),Quarq dZero,"Neo, gen. 1",286,281,5
49583,165977,2020-08-11 17:37:14,neo,Zwift - France,Quarq dZero,"Neo, gen. 1",289,277,12
49833,165977,2020-08-12 16:51:56,neo,Zwift - DBR Base Endurance Ride (E),Quarq dZero,"Neo, gen. 1",254,250,4
50043,165977,2020-08-14 16:50:14,neo,Zwift - 3R and Triathlon Ireland TT - Round 10 (B),Quarq dZero,"Neo, gen. 1",311,303,8
50222,165977,2020-08-16 07:52:12,neo,Zwift - DBR Social Ride  (D),Quarq dZero,"Neo, gen. 1",310,303,7
50422,165977,2020-08-17 17:13:55,neo,Zwift - DBR Monday Race  (B),Quarq dZero,"Neo, gen. 1",329,321,8
50756,165977,2020-08-19 18:03:16,neo,Zwift - DBR Wednesday Race (B),Quarq dZero,"Neo, gen. 1",330,329,1
50928,165977,2020-08-20 14:55:27,wahoo,Zwift - DBR Base Endurance Ride (E) - Kickr 5 first ride,Quarq dZero,Kickr 5,219,220,-1
51093,165977,2020-08-21 12:55:55,wahoo,Zwift - Off The MAAP Stage 3 Race (B),Quarq dZero,Kickr 5,315,308,7
51539,165977,2020-08-21 13:37:46,wahoo,Zwift - DBR Monday Race  (B),Quarq dZero,Kickr 5,318,304,14
51630,165977,2020-08-25 08:02:08,wahoo,Zwift - Off The MAAP Stage 4 - Longer Ride,Quarq dZero,Kickr 5,301,293,8
52046,165977,2020-08-26 18:03:08,wahoo,Zwift - DBR Wednesday Race (B),Quarq dZero,Kickr 5,321,314,7
52176,165977,2020-08-27 15:00:02,wahoo,Zwift - DBR Base Endurance Ride (E),Quarq dZero,Kickr 5,230,227,3
52357,165977,2020-08-28 14:47:47,wahoo,Zwift - Off The MAAP Stage 1 Race (B),Quarq dZero,Kickr 5,336,330,6
52462,165977,2020-08-29 08:08:11,wahoo,Zwift - DBR Saturday Race  (B),Quarq dZero,Kickr 5,308,300,8
52601,165977,2020-08-30 09:10:03,wahoo,Zwift - Off The MAAP Stage 2 Race (B),Quarq dZero,Kickr 5,307,296,11
52768,165977,2020-08-31 17:13:27,wahoo,Zwift - DBR Monday Race  (B),Quarq dZero,Kickr 5,316,315,1
52892,165977,2020-09-01 14:23:06,wahoo,Zwift - Sydkysten Cycling - Carl Ras Race (B),Quarq dZero,Kickr 5,315,304,11
53116,165977,2020-09-02 18:05:24,wahoo,Zwift - DBR Wednesday Race (B),Quarq dZero,Kickr 5,295,290,5
53221,165977,2020-09-03 15:00:03,wahoo,Zwift - DBR Base Endurance Ride (E),Quarq dZero,Kickr 5,249,243,6
53437,165977,2020-09-04 15:05:41,wahoo,Zwift - 3R Sand and Sequoias Race (B),Quarq dZero,Kickr 5,319,307,12
53763,165977,2020-09-07 17:15:27,wahoo,Zwift - DBR Ride´N´Roll League (B),Quarq dZero,Kickr 5,324,305,19
53937,165977,2020-09-08 15:04:37,wahoo,Zwift - 3R Sundown Race Series  (B),Quarq dZero,Kickr 5,294,280,14
54190,165977,2020-09-09 18:04:56,neo,Zwift - DBR Wednesday Race (B),Quarq dZero,"Neo, gen. 1",313,307,6
54380,165977,2020-09-10 15:00:03,neo,Zwift - DBR Base Endurance Ride (E),Quarq dZero,"Neo, gen. 1",259,254,5
54697,165977,2020-09-12 08:29:55,neo,Zwift - DBR SufferDay League II (B),Quarq dZero,"Neo, gen. 1",355,348,7
54994,165977,2020-09-14 14:59:34,neo,Zwift - ZHQ Beta Crit City Race (B),Quarq dZero,"Neo, gen. 1",309,301,8
55603,165977,2020-09-16 18:05:28,neo,Zwift - DBR Wednesday Race (B) - a rare WIN :D,Quarq dZero,"Neo, gen. 1",314,311,3
56234,165977,2020-09-19 08:28:16,neo,Zwift - DBR SufferDay League II (B),Quarq dZero,"Neo, gen. 1",330,326,4
56685,165977,2020-09-21 17:14:59,neo,Zwift - DBR Ride´N´Roll League (B),Quarq dZero,"Neo, gen. 1",327,318,9
58572,165977,2020-09-30 18:06:17,neo,Zwift - DBR Wednesday Race (B),Quarq dZero,"Neo, gen. 1",302,296,6
59189,165977,2020-10-02 15:14:08,neo,Zwift - 3R Sand and Sequoias Race (B),Quarq dZero,"Neo, gen. 1",309,305,4
59206,165977,2020-09-23 16:35:30,neo,Zwift - DBR SufferDay League II (B),Quarq dZero,"Neo, gen. 1",302,309,-7
60139,165977,2020-10-07 18:05:29,neo,Zwift - DBR HEINO CUP III (B),Quarq dZero,"Neo, gen. 1",317,310,7
61202,165977,2020-10-12 17:15:25,neo,DBR Ride´N´Roll League,Quarq dZero,"Neo, gen. 1",298,302,-4
61491,165977,2020-10-12 17:15:25,neo,Zwift - Zwift Time Trial Tuesday: Tempus Fugit (E),Quarq dZero,"Neo, gen. 1",303,296,7
61937,165977,2020-10-14 18:04:47,neo,Zwift - DBR HEINO CUP III (B),Quarq dZero,"Neo, gen. 1",285,286,-1
62614,165977,2020-10-17 12:00:44,neo,Zwift - ZA Road 2020 - Segment Ride #1: London Course,Quarq dZero,"Neo, gen. 1",270,262,8
62615,165977,2020-10-17 11:07:26,neo,Zwift - DIRT Dadurday Chase Race  (B),Quarq dZero,"Neo, gen. 1",316,307,9
62865,165977,2020-10-18 11:10:51,neo,Zwift - ZA Road Race #1: 3.2 - 4 w/kg,Quarq dZero,"Neo, gen. 1",312,306,6
63056,165977,2020-10-19 17:15:39,neo,Zwift - DBR Ride´N´Roll League (B),Quarq dZero,"Neo, gen. 1",296,296,0
64166,165977,2020-10-22 15:00:06,neo,Zwift - DBR Base Endurance Ride (E),Quarq dZero,"Neo, gen. 1",260,271,-11
64892,165977,2020-10-25 15:59:35,neo,Zwift - ZA Road Group Ride: 2.2 - 2.7 w/kg ,Quarq dZero,"Neo, gen. 1",282,276,6
65413,165977,2020-10-27 15:53:07,neo,Zwift Academy Road: Workout 5 | Primed FTP,Quarq dZero,"Neo, gen. 1",294,302,-8
68200,165977,2020-11-05 17:27:10,neo,Zwift Academy Road: Workout 6 | Alternative Sprints,Quarq dZero,"Neo, gen. 1",252,244,8
90177,165977,2021-01-02 09:16:32,wahoo,Zwift - DBR SufferDay League III (A),Quarq dZero,Kickr 5,322,336,-14
113928,165977,2021-02-13 09:18:02,wahoo,Zwift - DBR SufferDay League III (B),Quarq dZero,Kickr 5,338,334,4
114609,165977,2021-02-14 09:14:06,wahoo,Zwift - DBR Sunday Race (B),Quarq dZero,Kickr 5,353,345,8
117284,165977,2021-02-18 18:09:18,wahoo,Zwift - WTRL Platinum League Team Time Trial - 3rd place,Quarq dZero,Kickr 5,340,342,-2
55839,167541,2020-09-17 18:30:10,wahoo,Zwift - Invitational League // Qualifying Race #2 (Men) ,Quarq DFour PM,Wahoo Kickr V5,361,349,12
56372,167541,2020-09-20 10:30:11,wahoo,Stages of DIRT (A),Quarq DFour PM,Wahoo Kickr V5,324,323,1
56375,167541,2020-09-20 11:45:12,wahoo,Crit City Race (A),Quarq DFour PM,Wahoo Kickr V5,329,333,-4
57745,167541,2020-09-26 11:09:58,wahoo,Zwift - Jed Scott [DRFT]&#039;s Meetup - Three Sisters,Quarq DFour PM,Wahoo Kickr V5,395,379,16
60594,167541,2020-10-09 16:05:19,wahoo,Zwift - 3R Volcano Flat Race - 3 Laps (36.6km/22.7mi 138m) (A),Quarq DFour PM,Wahoo Kickr V5,376,388,-12
64840,167541,2020-10-25 11:20:13,wahoo,Zwift - Ottawa TopSpeed Race (A),Quarq DFour PM,Wahoo Kickr V5,381,371,10
65172,167541,2020-10-26 20:00:25,wahoo,Zwift - Premier Division // Zwift Racing League (men) (A),Quarq DFour PM,Wahoo Kickr V5,374,362,12
67267,167541,2020-11-02 19:11:11,wahoo,Zwift - Premier Division // Zwift Racing League (men) (A),Quarq DFour PM,Wahoo Kickr V5,355,349,6
69414,167541,2020-11-09 20:00:12,wahoo,Zwift - Premier Division // Zwift Racing League (men) (A),Quarq DFour PM,Wahoo Kickr V5,405,395,10
72160,167541,2020-11-16 19:05:43,wahoo,Zwift - Premier Division // Zwift Racing League (men) (A),Quarq DFour PM,Wahoo Kickr V5,364,353,11
74670,167541,2020-11-23 20:00:17,wahoo,Zwift - Premier Division // Zwift Racing League (men) (A),Quarq DFour PM,Wahoo Kickr V5,405,396,9
118860,167712,2019-07-29 03:46:19,wahoo,Zwift - 3R Gotham Grind Flat Race - 3 Laps (27.8km/17.4mi 87m) (A),Powertap P2,Wahoo Kickr,391,377,14
118861,167712,2019-07-21 15:21:12,wahoo,Zwift - 3R Gotham Grind Flat Race - 3 Laps (27.8km/17.4mi 87m) (A),2019-07-21-08-21-12,Wahoo Kickr,383,377,6
118867,167712,2021-02-21 21:05:13,wahoo,Zwift - 3R Gotham Grind Flat Race - 3 Laps (27.8km/17.4mi 87m) (A),Powertap P2,Wahoo Kickr,391,377,14
89845,167810,2021-01-01 09:32:48,wahoo,Zwift - Watopia,Rotor,Kickr,332,326,6
90159,167810,2021-01-02 08:24:19,wahoo,Zwift - London,Rotor,Kickr,192,188,4
91396,167810,2021-01-03 08:59:51,wahoo,Zwift - Zwift Fondo Series 2020/21 (A),Rotor,Kickr,326,325,1
70386,168192,2020-11-11 18:45:00,neo,Zwift - GCA Cup (A),Favero Assioma Duo,Tacx Neo 1,342,321,21
104414,169284,2021-01-23 16:19:57,neo,Rhian Neo test,Quarq,Rhian Neo,277,253,24
8528,169690,2020-01-08 18:26:06,wahoo,Zwift - DIRT & IS: Baker&#039;s Dozen (A),Garmin Vector 3,Kickr,324,322,2
9580,169690,2020-01-15 18:56:22,wahoo,Zwift - Tour de Zwift // Pro-Am Invitational (A),Garmin Vector 3,Kickr,343,338,5
10690,169690,2020-01-23 18:47:55,wahoo,Zwift - Tour de Zwift // Pro-Am Invitational,Garmin Vector 3,Kickr,343,347,-4
11908,169690,2020-01-31 18:36:44,wahoo,Zwift - Tour de Zwift // Pro-Am Invitational (A),Garmin Vector 3,Kickr,347,343,4
12656,169690,2020-02-04 18:35:12,wahoo,Zwift - Tour de Zwift // Pro-Am Invitational (A),Garmin Vector 3,Kickr,331,354,-23
96053,169690,2021-01-13 00:44:22,wahoo,Zwift - Zwift Racing League | WTRL - Men&#039;s/Mixed AMERICAS E DIVISION 1 (A),Garmin Vector 3,Kickr,320,316,4
119341,170222,2021-02-22 20:15:01,neo,デュアルレコードtest,assioma duo,tacx neo,183,183,0
119344,170222,2021-02-22 20:14:57,neo,Zwift - 3R True2 Steady Ride [2.0w/kg avg] (C),assioma duo,tacx neo,187,183,4
119808,170222,2021-02-23 08:45:55,neo,Zwift - Zwift Racing League | WTRL - Men&#039;s/Mixed APAC DIVISION 2 (A),assioma duo,tacx neo,279,284,-5
123287,170222,2021-03-02 08:49:03,neo,Zwift - Zwift Racing League | WTRL - Men&#039;s/Mixed APAC DIVISION 2 (A),assioma duo,tacx neo,331,327,4
27176,170567,2020-04-22 18:20:52,wahoo,Zwift - ZHR Hare & Hounds Race (B),Assioma Uno,Wahoo Kickr,345,329,16
27896,170567,2020-04-25 08:28:22,wahoo,Zwift -  3R Watopia Big Loop - 1 Lap (B),Assioma Uno,Wahoo Kickr,326,310,16
30645,170567,2020-05-02 08:22:13,wahoo,Zwift - Cycling Ireland Zwift League Rd 6 Road to Ruins (B),Assioma Uno,Wahoo Kickr,344,328,16
32275,170567,2020-05-06 18:39:51,wahoo,Zwift - ZHR Hare & Hounds Race (B),Assioma Uno,Wahoo Kickr,320,321,-1
32648,170567,2020-05-07 19:09:58,wahoo,Zwift - Alternate SFR X2,Assioma Uno,Wahoo Kickr,261,249,12
35260,170567,2020-05-16 09:00:54,wahoo,Zwift - Cycling Ireland Zwift League Rd 8 (B),Assioma Uno,Wahoo Kickr,335,322,13
37035,170567,2020-05-23 09:01:23,wahoo,Zwift - Cycling Ireland Zwift League Rd 9 (B),Assioma Uno,Wahoo Kickr,318,314,4
38736,170567,2020-05-30 08:36:39,wahoo,Zwift - Cycling Ireland Zwift League Rd 10 (B),Assioma Uno,Wahoo Kickr,311,313,-2
60631,170567,2020-10-09 18:00:49,wahoo,Zwift - Team IRL Without Borders Race (B),Assioma Uno,Wahoo Kickr,320,323,-3
79108,170567,2020-12-03 19:08:22,wahoo,FTP Test- 20min (SHORT),Assioma Uno,Wahoo Kickr,317,315,2
85579,170567,2020-12-19 10:00:58,wahoo,Zwift - Cycling Ireland Zwift League Rd 6 (B),Assioma Uno,Wahoo Kickr,307,298,9
110673,170567,2021-02-06 09:57:27,wahoo,Zwift - Cycling Ireland Spring Australian Handicap Race (B),Assioma Uno,Wahoo Kickr,326,338,-12
115693,170567,2021-02-13 10:01:22,wahoo,Zwift - Cycling Ireland One Day Classic - Scratch Race (B),Assioma Uno,Wahoo Kickr,309,328,-19
121035,170567,2021-02-25 20:08:16,wahoo,Zwift - 3R LaGuardia Loop Flat Race - 6 Laps (17.5km/10.9 162m) (B),Assioma Uno,Wahoo Kickr,295,294,1
121445,170567,2021-02-27 09:39:41,wahoo,Zwift - Cycling Ireland Spring Zwift League Rd 1 (B),Assioma Uno,Wahoo Kickr,324,317,7
128122,170567,2021-03-13 09:37:47,wahoo,Zwift - Cycling Ireland eRacing Spring League Rd 3 (B),Assioma Uno,Wahoo Kickr,326,327,-1
91654,170911,2021-01-05 11:18:27,wahoo,Zwift - France,Zwift,2021-01-05-111917_2_KickrV5,197,197,0
91351,171762,2021-01-04 18:15:59,wahoo, DBR Monday Race,4iiii Precision L - Wahoo Roam,Wahoo Kickr V5,363,362,1
92424,171762,2021-01-06 19:05:59,wahoo,Zwift - DBR Wednesday Race (B),4iiii Precision L - Wahoo Roam,Wahoo Kickr V5  - Primary/ZWIFT,348,352,-4
94946,171762,2021-01-11 18:15:57,wahoo, DBR Monday Race,4iiii Precision L - Wahoo Roam,Wahoo Kickr V5  - Primary/ZWIFT,370,361,9
96470,171762,2021-01-13 19:05:58,wahoo,Zwift - DBR Wednesday Race (B),4iiii Precision L - Wahoo Roam,Wahoo Kickr V5  - Primary/ZWIFT,336,326,10
97763,171762,2021-01-16 07:29:59,wahoo,Zwift - 3R 100 Steady Ride [~2.5w/kg avg] (C),4iiii Precision L - Wahoo Roam,Wahoo Kickr V5  - Primary/ZWIFT,243,243,0
99042,171762,2021-01-18 18:16:01,wahoo,Zwift -  DBR Monday Race (B),4iiii Precision L - Wahoo Roam,Wahoo Kickr V5  - Primary/ZWIFT,363,362,1
101422,171762,2021-01-22 13:59:59,wahoo,Zwift - Friday Freight Train (C),4iiii Precision L - Wahoo Roam,Wahoo Kickr V5  - Primary/ZWIFT,270,263,7
101671,171762,2021-01-23 07:29:59,wahoo,Zwift - 3R 100 Steady Ride [~2.5w/kg avg] (C),4iiii Precision L - Wahoo Roam,Wahoo Kickr V5  - Primary/ZWIFT,289,280,9
102864,171762,2021-01-25 18:15:59,wahoo,Zwift -  DBR Monday Race (B),4iiii Precision L - Wahoo Roam,Wahoo Kickr V5  - Primary/ZWIFT,357,353,4
105122,171762,2021-01-29 14:00:00,wahoo,Zwift - Friday Freight Train (C),4iiii Precision L - Wahoo Roam,Wahoo Kickr V5  - Primary/ZWIFT,266,269,-3
105575,171762,2021-01-30 07:30:01,wahoo,Zwift - 3R 100 Steady Ride [~2.5w/kg avg] (C),4iiii Precision L - Wahoo Roam,Wahoo Kickr V5  - Primary/ZWIFT,248,257,-9
106756,171762,2021-02-01 18:15:51,wahoo,Zwift -  DBR Monday Race (B),4iiii Precision L - Wahoo Roam,Wahoo Kickr V5  - Primary/ZWIFT,336,332,4
109676,171762,2021-02-06 07:30:04,wahoo,Zwift - 3R 100 Steady Ride [~2.5w/kg avg] (C),4iiii Precision L - Wahoo Roam,Wahoo Kickr V5  - Primary/ZWIFT,251,250,1
111008,171762,2021-02-08 18:16:16,wahoo,Zwift -  DBR Monday Race (B),4iiii Precision L - Wahoo Roam,Wahoo Kickr V5  - Primary/ZWIFT,344,348,-4
112430,171762,2021-02-10 17:49:59,wahoo,"3R 100 Steady Ride [~3.0w/kg, ~2.5w/kg, ~2w/kg avg]",4iiii Precision L - Wahoo Roam,Wahoo Kickr V5  - Primary/ZWIFT,290,288,2
117724,171762,2021-02-19 13:59:59,wahoo,Zwift - Friday Freight Train (C),4iiii Precision L - Wahoo Roam,Wahoo Kickr V5  - Primary/ZWIFT,239,245,-6
119073,171762,2021-02-22 18:15:58,wahoo,Zwift -  DBR Monday Race (B),4iiii Precision L - Wahoo Roam,Wahoo Kickr V5  - Primary/ZWIFT,321,322,-1
120375,171762,2021-02-24 19:05:59,wahoo,Zwift - DBR Wednesday Race (B),4iiii Precision L - Wahoo Roam,Wahoo Kickr V5  - Primary/ZWIFT,348,342,6
123662,171762,2021-03-03 19:05:54,wahoo,Zwift - DBR Wednesday Race (B),4iiii Precision L - Wahoo Roam,Wahoo Kickr V5  - Primary/ZWIFT,344,339,5
125838,171762,2021-03-08 18:15:54,wahoo,Zwift -  DBR Monday Race (B),4iiii Precision L - Wahoo Roam,Wahoo Kickr V5  - Primary/ZWIFT,362,353,9
126674,171762,2021-03-10 19:05:53,wahoo,Zwift - DBR Wednesday Race (B),4iiii Precision L - Wahoo Roam,Wahoo Kickr V5  - Primary/ZWIFT,354,347,7
127461,171762,2021-03-12 14:00:02,wahoo,Zwift - Friday Freight Train (C),4iiii Precision L - Wahoo Roam,Wahoo Kickr V5  - Primary/ZWIFT,245,250,-5
128752,171762,2021-03-15 18:15:56,wahoo,Zwift -  DBR Monday Race (B),4iiii Precision L - Wahoo Roam,Wahoo Kickr V5  - Primary/ZWIFT,335,325,10
102781,171866,2021-01-21 18:29:04,neo,Zwift - FUSION WINTER CUP (A),Quarq,Tacx Neo,346,334,12
84982,172380,2020-12-19 08:01:12,neo,Zwift - Watopia,Quarq,NEO,327,327,0
85715,172380,2020-12-21 12:07:07,neo,Zwift - Karl Tiselius [SZ]&#039;s Meetup - Three Sisters,Quarq,NEO,386,372,14
95290,172787,2021-01-12 00:38:12,wahoo,kickr core & pioneer,Pioneer,wahoo kickr core,185,191,-6
95389,172787,2021-01-12 08:43:13,wahoo,ZRL APAC D2-1,Pioneer,wahoo kickr core,319,325,-6
96755,172787,2021-01-14 09:46:29,wahoo,jzhr,Pioneer,wahoo kickr core,305,314,-9
99452,172787,2021-01-19 07:53:58,wahoo,ZRL APAC DIV2-1,Pioneer,wahoo kickr core,342,347,-5
99978,172787,2021-01-20 00:10:58,wahoo,2021/01/20,Pioneer,wahoo kickr core,282,289,-7
100571,172787,2021-01-21 00:59:42,wahoo,canada,Pioneer,wahoo kickr core,310,314,-4
100597,172787,2021-01-21 02:42:04,wahoo,tdz,Pioneer,wahoo kickr core,289,295,-6
107764,172787,2021-02-03 00:11:10,wahoo,Midweek Crit,Pioneer,wahoo kickr core,309,312,-3
107766,172787,2021-02-03 01:25:28,wahoo,Mayhem Racing,Pioneer,wahoo kickr core,299,305,-6
108527,172787,2021-02-03 23:55:01,wahoo,Movistar Team Challenge,Pioneer,wahoo kickr core,327,336,-9
110200,172787,2021-02-06 22:09:58,wahoo,Zwift Fondo A,XCADEY XPOWER-S,wahoo kickr core,291,291,0
111259,172787,2021-02-08 23:02:13,wahoo,3r race,XCADEY XPOWER-S,wahoo kickr core,323,321,2
111958,172787,2021-02-10 03:33:19,wahoo,tdz,XCADEY XPOWER-S,wahoo kickr core,272,273,-1
111959,172787,2021-02-10 03:33:19,wahoo,tdz,XCADEY XPOWER-S,wahoo kickr core,293,294,-1
115614,172787,2021-02-16 08:40:17,wahoo,zrl,XCADEY XPOWER-S,wahoo kickr core,336,340,-4
116935,172787,2021-02-17 23:18:25,wahoo,tdz,XCADEY XPOWER-S,wahoo kickr core,309,311,-2
116936,172787,2021-02-18 00:38:30,wahoo,cycling canada,XCADEY XPOWER-S,wahoo kickr core,295,296,-1
119381,172787,2021-02-23 08:40:25,wahoo,zrl,XCADEY XPOWER-S,wahoo kickr core,278,282,-4
120522,172787,2021-02-24 23:57:29,wahoo,evr,XCADEY XPOWER-S,wahoo kickr core,283,278,5
120523,172787,2021-02-25 01:01:07,wahoo,cycling canada,XCADEY XPOWER-S,wahoo kickr core,308,307,1
122775,172787,2021-03-02 08:47:52,wahoo,Zwift - 03/02/2021,XCADEY XPOWER-S,wahoo kickr core,318,318,0
99159,172921,2021-01-18 18:45:24,neo,Zwift -  SCF SWE Cup Men (A),Power2Max NGeco,Tacx Neo,357,339,18
27515,173080,2020-04-24 07:08:06,wahoo,Garmin Vector 3 / Kickr,Garmin Vector 3,Kickr,239,253,-14
27765,173080,2020-04-24 22:05:27,wahoo,Zwift - 3R Volcano Flat 50k Race - 4 Laps (48.8km/30.7mi 184m) (A),Garmin Vector 3,Kickr,302,297,5
33718,173080,2020-05-09 00:00:18,wahoo,Zwift - Tour for All 2020: Stage 2 Longer Ride,Garmin Vector 3,Kickr,319,312,7
54225,173080,2020-09-09 20:12:14,wahoo,Zwift - London,Garmin Vector 3,Kickr,198,200,-2
29201,173190,2020-04-29 17:00:12,neo,Zwift - Swedish Zwift Racing Cup by SZR (A),4iii Crank Arm,Tacx Neo,369,369,0
39854,173190,2020-06-05 17:59:32,neo,Zwift - TeamPTz Friday&#039;s Race League (A),4iii Crank Arm,Tacx Neo,372,378,-6
43568,173190,2020-06-25 17:05:18,neo,Zwift - Espresso,4iii Crank Arm,Tacx Neo,346,350,-4
44169,173190,2020-06-30 08:53:46,neo,Zwift - SRAM Send it Series - Race 8 - Men&#039;s (E),4iii Crank Arm,Tacx Neo,394,403,-9
51956,173190,2020-08-26 09:46:10,neo,Zwift - USA Cycling Race League by Indoor Specialist (A),4iii Crank Arm,Tacx Neo,376,380,-4
53233,173190,2020-09-03 12:51:02,neo,Zwift - 3R Knickerbocker Climbing Race - 1 Lap (22.4km/13.9mi 365m) (A),4iii Crank Arm,Tacx Neo,367,377,-10
53879,173190,2020-09-08 06:46:38,neo,Zwift -  Kiwi Crew Riot Race (A),4iii Crank Arm,Tacx Neo,313,333,-20
54591,173190,2020-09-11 12:36:16,neo,Zwift - KISS at Race - Pacific AM (A),4iii Crank Arm,Tacx Neo,345,356,-11
57022,173190,2020-09-23 16:37:22,neo,Zwift - MIDWEEK Autumn Series by SZR (A),4iii Crank Arm,Tacx Neo,365,370,-5
62257,173190,2020-10-15 17:55:45,neo,Zwift - Pre Event Ride // Swedish Cycling Federation,4iii Crank Arm,Tacx Neo,354,358,-4
63667,173190,2020-10-20 17:15:38,neo,Zwift - Zwift Racing League | WTRL - EMEA E (MEN) - TTT Grp 1,4iii Crank Arm,Tacx Neo,356,361,-5
73193,173190,2020-11-19 19:29:20,neo,Zwift - World Championships Experience // Danish Cycling Federation,4iii Crank Arm,Tacx Neo,352,360,-8
76572,173190,2020-11-27 18:29:54,neo,Zwift - Team WEZ Friday Race (E),4iii Crank Arm,Tacx Neo,373,384,-11
77328,173190,2020-11-29 14:15:01,neo,Zwift - KISS 100 Race Series - Americas (A),4iii Crank Arm,Tacx Neo,338,343,-5
79508,173190,2020-12-04 18:29:54,neo,Zwift - Team WEZ Friday Race (E),4iii Crank Arm,Tacx Neo,335,345,-10
82041,173190,2020-12-11 18:30:00,neo,Zwift - Team WEZ Friday Race (E),4iii Crank Arm,Tacx Neo,384,395,-11
93943,173190,2021-01-09 14:34:15,wahoo,Zwift - Watopia,4iii Crank Arm,Wahoo Kickr,397,398,-1
94942,173190,2021-01-11 17:44:59,wahoo,Zwift - SCF SWE Cup (A),4iii Crank Arm,Wahoo Kickr,371,355,16
95662,173190,2021-01-12 18:15:00,wahoo,Zwift - Zwift Racing League | WTRL - Men&#039;s/Mixed EMEA E1 DIVISION 1 (A),4iii Crank Arm,Wahoo Kickr,383,369,14
99661,173190,2021-01-19 18:18:27,wahoo,Zwift - Zwift Racing League | WTRL - Men&#039;s/Mixed EMEA E1 DIVISION 1 (A),4iii Crank Arm,Wahoo Kickr,360,365,-5
103480,173190,2021-01-26 18:14:47,wahoo,Zwift - Zwift Racing League | WTRL - Men&#039;s/Mixed EMEA E1 DIVISION 1 (A),4iii Crank Arm,Wahoo Kickr,391,401,-10
107367,173190,2021-02-02 18:13:47,wahoo,Zwift - Zwift Racing League | WTRL - Men&#039;s/Mixed EMEA E1 DIVISION 1 (A),4iii Crank Arm,Wahoo Kickr,384,389,-5
108313,173190,2021-02-03 18:59:59,wahoo,Zwift - Open - Movistar Team Challenge Community Qualifier Race #1,4iii Crank Arm,Wahoo Kickr,405,412,-7
111548,173190,2021-02-09 18:18:29,wahoo,Zwift - Zwift Racing League | WTRL - Men&#039;s/Mixed EMEA E1 DIVISION 1 (A),4iii Crank Arm,Wahoo Kickr,386,388,-2
113971,173190,2021-02-13 09:00:03,wahoo,Zwift - Team WEz Race (E),4iii Crank Arm,Wahoo Kickr,386,383,3
119052,173190,2021-02-22 17:29:59,wahoo,Zwift -  SCF SWE Cup Men (A),Favero Assioma UNO,Wahoo Kickr,446,443,3
119622,173190,2021-02-23 18:15:00,wahoo,Zwift - Zwift Racing League | WTRL - Men&#039;s/Mixed EMEA E1 DIVISION 1 (A),Favero Assioma UNO,Wahoo Kickr,368,366,2
122966,173190,2021-03-02 18:22:06,wahoo,Zwift - Zwift Racing League | WTRL - Men&#039;s/Mixed EMEA E1 DIVISION 1 (A),Favero Assioma UNO,Wahoo Kickr,378,374,4
125792,173190,2021-03-08 17:29:59,wahoo,Zwift -  SCF SWE Cup Men (A),Favero Assioma UNO,Wahoo Kickr,385,381,4
128347,173190,2021-03-14 09:00:01,wahoo,Zwift - 03/14/2021,Favero Assioma UNO,Wahoo Kickr,390,387,3
128793,173190,2021-03-15 18:24:52,wahoo,Zwift -  SCF SWE Cup Men (A),Favero Assioma UNO,Wahoo Kickr,361,371,-10
129770,173190,2021-03-17 18:27:08,wahoo,Zwift - Scandinavian Cup 2021 - Round 4 - Men (A),Favero Assioma UNO,Wahoo Kickr,381,386,-5
84839,173438,2020-12-18 11:00:56,wahoo,Zwift - Tour of New York Stage 1 - Open Shorter,Assioma Duo,Kickr Core,296,294,2
122666,173438,2021-03-01 18:59:58,wahoo,Zwift -  SCF SWE Cup Men (A),Assioma Duo,Kickr Core,333,328,5
122890,173438,2021-03-02 16:04:55,wahoo,Zwift - 3R Volcano Circuit Flat Race - 8 Laps (35.2km/21.9mi 160m) (A),Assioma Duo,Kickr Core,322,316,6
43634,173595,2020-06-25 21:09:12,wahoo,Giant Power Pro Dual / Kickr Core,Giant Power Pro Dual,Kickr Core,169,171,-2
87647,173595,2020-05-01 03:04:23,wahoo,Kickr Core / Giant Power Pro Dual,Giant Power Pro Dual,Kickr Core,307,302,5
77851,173986,2020-11-30 19:00:05,wahoo,4!!!! Precision 105 / Kickr Core,4!!!! Precision 105,Kickr Core,267,284,-17
80131,174373,2020-12-04 16:43:21,neo,Zwift - Crit City Race (A),4iiii left power meter (control),Taxs Neo (1) (To Zwift),348,359,-11
96052,174641,2021-01-13 00:31:33,wahoo,Zwift - Zwift Racing League | WTRL - Men&#039;s/Mixed AMERICAS E DIVISION 1 (A),quarq *(correct day),Kickr,388,372,16
100004,174641,2021-01-20 00:51:43,wahoo,Zwift - Zwift Racing League | WTRL - Men&#039;s/Mixed AMERICAS E DIVISION 1 (A),Quarq,Kickr,372,373,-1
108385,174641,2021-02-03 18:56:06,wahoo,Zwift - Open - Movistar Team Challenge Community Qualifier Race #1,Quarq,Kickr,393,401,-8
112432,174641,2021-02-10 18:50:05,wahoo,Zwift - Movistar Team Challenge // Round 1 (A),Quarq,Kickr,372,355,17
113662,174641,2021-02-12 18:43:44,wahoo,Zwift - Movistar Team Challenge // Round 1 (men),Quarq,Kickr,395,393,2
116837,174641,2021-02-17 18:50:40,wahoo,Zwift - Movistar Team Challenge // Round 2 (men) - Race 3/4,Quarq,Kickr,369,378,-9
117921,174641,2021-02-19 18:44:42,wahoo,Zwift - Movistar Team Challenge // Round 2 (men),Quarq,Kickr,430,421,9
120007,174641,2021-02-24 00:40:10,wahoo,Zwift - Zwift Racing League | WTRL - Men&#039;s/Mixed AMERICAS E DIVISION 1 (A),Quarq,Kickr,356,358,-2
123790,174641,2021-03-03 00:42:19,wahoo,Zwift - Zwift Racing League | WTRL - Men&#039;s/Mixed AMERICAS E DIVISION 1 (A),Quarq,Kickr,360,363,-3
124157,174641,2021-03-04 19:00:37,wahoo,Zwift - Movistar Team Challenge // Points Race (men),Quarq,Kickr,405,381,24
124638,174641,2021-03-05 18:48:01,wahoo,Zwift - Zwift Racing League | WTRL Battle Royale Playoff - Men&#039;s Points Race (A),Quarq,Kickr,381,391,-10
125166,174641,2021-03-06 19:42:56,wahoo,Zwift - Zwift Racing League | WTRL Battle Royale Playoff - Men&#039;s TTT (A),Quarq,Kickr,395,395,0
4998,174884,2019-11-27 17:04:19,wahoo,Zwift - 2RR ITT Bologna (A),4iiii precision ,Wahoo KICKR,361,362,-1
5650,174884,2019-12-05 18:31:41,wahoo,Zwift - FUSION ECT BEUNSTOPPABLE Racing Series (A),4iiii precision ,Wahoo KICKR,353,351,2
27667,174884,2020-04-24 13:35:15,wahoo,Zwift - Crit City Race (A),4iiii precision ,Wahoo KICKR,351,378,-27
54680,175310,2020-09-12 08:14:57,wahoo,Zwift - ZHR Audax (E),Assioma Duo,Kickr,258,259,-1
54966,175310,2020-09-14 08:34:57,wahoo,Zwift - EVO CC Sweet Sirocco Interval Ride [~3.0-3.5w/kg avg] (B),Assioma Duo,Kickr,275,273,2
92905,175588,2021-01-07 18:38:42,neo,Zwift - WTRL Team Time Trial - Zone 6 (D),Assioma Duo,Tacx Neo Bike,293,309,-16
93818,175588,2021-01-09 07:30:37,neo,Zwift - 3R 100 Steady Ride [~2.5w/kg avg] (C),Assioma Duo,Tacx Neo Bike,280,285,-5
95734,175588,2021-01-12 18:23:56,neo,Zwift - Zwift Racing League | WTRL - Men&#039;s/Mixed EMEA E2 DIVISION 1 (A),Assioma Duo,Tacx Neo Bike,324,324,0
99459,175588,2021-01-19 08:49:04,neo,Zwift - Zwift Racing League | WTRL - Men&#039;s/Mixed APAC DIVISION 1 (A),Assioma Duo,Tacx Neo Bike,311,324,-13
103263,175588,2021-01-26 08:45:20,neo,Zwift - Zwift Racing League | WTRL - Men&#039;s/Mixed APAC DIVISION 1 (A),Assioma Duo,Tacx Neo Bike,304,314,-10
105112,175588,2021-01-28 18:28:14,neo,Zwift - WTRL Team Time Trial - Zone 5 (D),Assioma Duo,Tacx Neo Bike,298,306,-8
108965,175588,2021-02-04 18:41:05,neo,Zwift - WTRL Team Time Trial - Zone 6 (D),Assioma Duo,Tacx Neo Bike,288,297,-9
3301,175948,2019-10-26 18:05:02,wahoo,Zwift - 3R Three Sisters Hilly Race (47km/29.2mi 879m) (A),Stages gen2,Wahoo KICKR ,387,392,-5
3446,175948,2019-10-29 19:09:59,wahoo,Zwift - WORLDOFFUSION Racing League (A),Stages L gen2,Wahoo KICKR ,389,385,4
3582,175948,2019-10-31 19:09:58,wahoo,FUSION ECT BEUNSTOPPABLE Racing Series,Stages L gen2,Wahoo KICKR ,369,371,-2
3825,175948,2019-11-05 19:00:07,wahoo,Zwift - ZwiftTeamPL League – Climbers Series (A),Stages L gen2,Wahoo KICKR ,368,375,-7
3979,175948,2019-11-08 18:59:58,wahoo,The Friday Criterium Autumn  Series (14 mi / 22 km),Stages L gen2,Wahoo KICKR ,402,409,-7
4016,175948,2019-11-09 18:04:58,wahoo,Zwift - 3R Three Sisters Hilly Race (47km/29.2mi 879m) (A),Stages L gen2,Wahoo KICKR ,413,422,-9
4067,175948,2019-11-10 18:59:55,wahoo,BRT Iron Goat Racing League,Stages L gen2,Wahoo KICKR ,418,424,-6
4251,175948,2019-11-14 18:22:56,wahoo,Zwift - WTRL Team Time Trial (C),Stages L gen2,Wahoo KICKR ,383,379,4
4347,175948,2019-11-16 09:29:53,wahoo,Zwift - DBR Saturday Race (A),Stages L gen2,Wahoo KICKR ,369,365,4
4493,175948,2019-11-19 19:09:54,wahoo,Zwift - WORLDOFFUSION Racing Series (A),Stages L gen222,Wahoo KICKR ,394,410,-16
4803,175948,2019-11-24 14:14:34,wahoo,Zwift - KISS at Race 100 - Americas (A),Stages L gen2,Wahoo KICKR ,375,382,-7
4823,175948,2019-11-24 18:59:47,wahoo,Zwift - BRT Iron Goat Racing League (A),Stages L gen2,Wahoo KICKR ,374,386,-12
4941,175948,2019-11-26 19:00:19,wahoo,Zwift - ZwiftTeamPL League – Climbers Series (A),Stages L gen2,Wahoo KICKR ,400,404,-4
5215,175948,2019-11-30 13:44:44,wahoo,Zwift - WTRL Alpe du Zwift Series (E),Stages L gen2,Wahoo KICKR ,384,392,-8
5403,175948,2019-12-03 19:09:41,wahoo,Zwift - WORLDOFFUSION Racing Series (A),Stages L gen2,Wahoo KICKR ,432,443,-11
5710,175948,2019-12-07 13:44:40,wahoo,Zwift - WTRL Alpe du Zwift Series (E),Stages L gen2,Wahoo KICKR ,385,389,-4
5774,175948,2019-12-08 14:14:25,wahoo,Zwift - KISS at Race 100 - Americas (A),Stages L gen2,Wahoo KICKR 18,382,379,3
5928,175948,2019-12-10 19:09:37,wahoo,Zwift - WORLDOFFUSION Racing Series (A),Stages L gen2,Wahoo KICKR 18,387,378,9
6071,175948,2019-12-11 19:04:50,wahoo,Zwift - DBR HEINO CUP (A),Stages L gen2,Wahoo KICKR 18,398,400,-2
6436,175948,2019-12-16 19:40:00,wahoo,Zwift - Crit City Race (A),Stages L gen2,Wahoo KICKR 18,319,322,-3
6437,175948,2019-12-14 13:38:22,wahoo,Zwift - WTRL Alpe du Zwift Series (E),Stages L gen2,Wahoo KICKR 18,375,383,-8
6518,175948,2019-12-17 18:05:01,wahoo,ZwiftTeamPL League – Climbers Series,Stages L gen2,Wahoo KICKR 18,376,383,-7
6928,175948,2019-12-21 13:45:00,wahoo,Zwift - WTRL Alpe du Zwift Series (E),Stages L gen2,Wahoo KICKR 18,396,402,-6
8083,175948,2020-01-04 18:05:02,wahoo,Zwift - 3R Three Sisters Hilly Race (47km/29.2mi 879m) (A),Stages L gen2,Wahoo KICKR 18,433,436,-3
8161,175948,2020-01-05 14:08:47,wahoo,Zwift - KISS at Race 100 - Americas (A),Stages L gen2,Wahoo KICKR 18,378,383,-5
8318,175948,2020-01-07 19:00:11,wahoo,Zwift - ZTPL.CC League – Classic Series (A),Stages L gen2,Wahoo KICKR 1811,393,403,-10
8676,175948,2020-01-09 18:30:02,wahoo,Zwift - FUSION ECT BEUNSTOPPABLE Racing Series (A),Stages L gen2,Wahoo KICKR 18,410,409,1
9046,175948,2020-01-12 14:14:59,wahoo,Zwift - KISS at Race 100 - Americas (A),Stages L gen2,Wahoo KICKR 18,364,370,-6
9720,175948,2020-01-16 18:30:02,wahoo,Zwift - FUSION ECT BEUNSTOPPABLE Racing Series (A),Stages L gen2,Wahoo KICKR 18,458,465,-7
10190,175948,2020-01-19 14:15:04,wahoo,Zwift - KISS at Race 100 - Americas (A),Stages L gen2,Wahoo KICKR 18,372,372,0
10191,175948,2020-01-20 19:50:54,wahoo,Zwift - GGCC Glasgow Green Cycle Club Race Series (A),Stages L gen2,Wahoo KICKR 18,406,409,-3
10296,175948,2020-01-21 19:00:02,wahoo,Zwift - ZTPL.CC League – Climbers Series (A),Stages L gen2,Wahoo KICKR 18,415,423,-8
10686,175948,2020-01-23 19:14:57,wahoo,Zwift - Tour de Zwift // Pro-Am Invitational,Stages L gen2,Wahoo KICKR 18,418,426,-8
11573,175948,2020-01-29 20:45:39,wahoo,Zwift - Watopia,Stages L gen2,Wahoo KICKR 18,393,398,-5
11904,175948,2020-01-31 17:21:19,wahoo,Zwift - Watopia Abslolute wahoo,Stages L gen2,Wahoo KICKR 18,403,419,-16
12135,175948,2020-02-02 14:15:01,wahoo,Zwift - KISS at Race 100 - Americas (A),Stages L gen2,Wahoo KICKR 18,388,388,0
12382,175948,2020-02-04 19:15:02,wahoo,Zwift - Tour de Zwift // Pro-Am Invitational (A),Stages L gen2,Wahoo KICKR 18,394,403,-9
12602,175948,2020-02-05 18:00:02,wahoo,Zwift - SZR Winter Race Series (A),Stages L gen2,Wahoo KICKR 18,413,403,10
12777,175948,2020-02-06 19:00:01,wahoo,Zwift - KALAS Cup - Round 2 (A),Stages L gen2,Wahoo KICKR 18,426,433,-7
12937,175948,2020-02-07 19:00:02,wahoo,Zwift - The Friday Criterium Winter Race Series  (19 mi / 30 km) (A),Stages L gen2,Wahoo KICKR 18,408,415,-7
13174,175948,2020-02-09 14:14:59,wahoo,Zwift - KISS at Race 100 - Americas (A),Stages L gen2,Wahoo KICKR 18,353,352,1
13417,175948,2020-02-11 19:00:00,wahoo,Zwift - ZwiftTeamPL League – Climbers Series (A),Stages L gen2,Wahoo KICKR 18,396,394,2
13744,175948,2020-02-13 18:59:58,wahoo,Zwift - KALAS Cup - Round 3 (A),Stages L gen2,Wahoo KICKR 18,378,390,-12
18175,175948,2020-03-15 13:15:50,wahoo,Zwift - KISS at Race 100 - Americas (A),Stages L gen2,Wahoo KICKR 18,354,359,-5
19084,175948,2020-03-21 18:05:00,wahoo,Zwift - 3R Three Sisters Hilly Race (47km/29.2mi 879m) (A),Stages L gen2,Wahoo KICKR 18,418,427,-9
77465,175948,2020-11-29 17:57:02,wahoo,Zwift - The Alpe Dash by Herd Racing League (A),Stages L gen2,Wahoo KICKR 18,384,389,-5
79780,175948,2020-12-05 10:00:01,wahoo,Zwift - Nations Challenge // Poland (E),Stages L gen2,Wahoo KICKR 18,360,360,0
95648,175948,2021-01-12 18:27:30,wahoo,Zwift - Zwift Racing League | WTRL - Men&#039;s/Mixed EMEA E2 DIVISION 5 (A),Stages L gen2,Wahoo KICKR 18,380,384,-4
97006,175948,2021-01-14 18:39:47,wahoo,Zwift - XRS - ZTR Thursday Night Race (A),Stages L gen2,Wahoo KICKR 18,363,366,-3
99755,175948,2021-01-19 18:25:14,wahoo,Zwift - Zwift Racing League | WTRL - Men&#039;s/Mixed EMEA E1 DIVISION 6 (A),Stages L gen2,Wahoo KICKR 18,382,379,3
100432,175948,2021-01-20 19:00:32,wahoo,Zwift - The Carnival Group Ride | ZTPL.CC (A),Stages L gen2,Wahoo KICKR 18,383,392,-9
101073,175948,2021-01-21 18:52:01,wahoo,Zwift - S6 Sweet Spot + Burnout,Stages L gen2,Wahoo KICKR 18,375,385,-10
101874,175948,2021-01-16 08:59:30,wahoo,Zwift - ZTPL.CC Classic Race (A),Stages L gen2,Wahoo KICKR 18,397,397,0
101992,175948,2021-01-23 16:59:44,wahoo,Zwift - The Carnival Race League Stage 2 with ZTPL.CC (A),Stages L gen2,Wahoo KICKR 18,425,426,-1
102357,175948,2021-01-24 09:00:18,wahoo,Zwift - The Carnival | ZTPL.CC Challenge Ride (A),Stages L gen2,Wahoo KICKR 18,390,394,-4
103561,175948,2021-01-26 18:19:39,wahoo,Zwift - Zwift Racing League | WTRL - Men&#039;s/Mixed EMEA E1 DIVISION 6 (A),Stages L gen2,Wahoo KICKR 18,399,407,-8
105869,175948,2021-01-30 18:04:12,wahoo,Zwift - 3R Three Sisters Hilly Race (47km/29.2mi 879m) (A),Stages L gen2,Wahoo KICKR 18,399,398,1
106394,175948,2021-01-31 14:14:48,wahoo,Zwift - KISS 100 Race Series - Americas (A),Stages L gen2,Wahoo KICKR 18,401,399,2
107455,175948,2021-02-02 18:19:38,wahoo,Zwift - Zwift Racing League | WTRL - Men&#039;s/Mixed EMEA E1 DIVISION 6 (A),Stages L gen2,Wahoo KICKR 18,389,393,-4
110061,175948,2021-02-06 16:59:36,wahoo,Zwift - The Carnival Race League Stage 6 with ZTPL.CC (A),Stages L gen2,Wahoo KICKR 18,393,398,-5
111174,175948,2021-02-08 20:35:00,wahoo,Zwift - Kalibracja  Kickr + Stages L,Stages L gen2,Wahoo KICKR 18,339,342,-3
112505,175948,2021-02-10 20:10:36,wahoo,Zwift - P Moc pod górę S5 + sprint,Stages L gen2,Wahoo KICKR 18,359,359,0
113626,175948,2021-02-12 18:59:32,wahoo,Zwift - TFC Xmas Smash Fest (E),Stages L gen2,Wahoo KICKR 18,423,430,-7
114315,175948,2021-02-13 16:59:23,wahoo,Zwift - ZTPL.CC Winter League 2021 Stage 8 (A),Stages L gen2,Wahoo KICKR 18,394,387,7
114836,175948,2021-02-14 14:14:23,wahoo,Zwift - KISS 100 Race Series - Americas (A),Stages L gen2,Wahoo KICKR 18,361,364,-3
118381,175948,2020-12-29 09:24:30,wahoo,Zwift - ZTPL.CC Winter League 2021 Stage 10 (A),Stages L gen2,Wahoo KICKR 18,376,377,-1
118599,175948,2020-12-30 00:54:31,wahoo,Zwift - Flanders Endurance Race League (A),Stages L gen2,Wahoo KICKR 18,396,398,-2
119844,175948,2021-01-01 10:54:38,wahoo,Zwift - ZTPL.CC Winter League 2021 Stage 9 (A),Stages L gen2,Wahoo KICKR 18,377,382,-5
120452,175948,2021-01-02 11:32:33,wahoo,Zwift - EVR Definitely Not the WTNC (A),Stages L gen2,Wahoo KICKR 18,308,321,-13
120917,175948,2021-02-25 19:59:59,wahoo,Zwift - KISS Race Series - EU PM (A),Stages L gen2,Wahoo KICKR 18,395,397,-2
121573,175948,2021-02-27 09:00:18,wahoo,Zwift - Haute Route Watopia 2021 Stage 2 (A),Stages L gen2,Wahoo KICKR 18,402,411,-9
121829,175948,2021-02-27 16:59:28,wahoo,Zwift -  ZTPL.CC Winter League 2021 Stage 12 (A),Stages L gen2,Wahoo KICKR 18,376,377,-1
122151,175948,2021-02-28 16:59:41,wahoo,Zwift - Haute Route Watopia 2021 Stage 3 (A),Stages L gen2,Wahoo KICKR 18,376,388,-12
124214,175948,2021-03-04 19:59:57,wahoo,Zwift - KISS Race Series - EU PM (A),Stages L gen2,Wahoo KICKR 18,396,399,-3
125479,175948,2021-03-07 16:59:35,wahoo,Zwift - MISTRZOSTWA ZTPL.CC (E),Stages L gen2,Wahoo KICKR 18,405,403,2
127810,175948,2021-03-13 09:04:32,wahoo,Zwift - 3R Endurance Series p/b OTE Sports (E),Stages L gen2,Wahoo KICKR 18,424,428,-4
129384,175948,2021-03-16 18:29:37,wahoo,Zwift - CeramicSpeed Race Series: Open Race (A),Stages L gen2,Wahoo KICKR 18,409,409,0
107851,176383,2021-02-02 18:31:24,wahoo,Zwift - SMART - Lucy in the Sky with Diamonds - 45 - Xert,Garmin Vector 3,Wahoo Kickr,238,227,11
108604,176383,2021-02-03 18:29:57,wahoo,Zwift - NCF Vintercup 2021 - Runde 4 - Herrer (A) + Cooldown,Garmin Vector 3,Wahoo Kickr,336,328,8
30520,177035,2020-05-02 12:00:00,wahoo,Zwift - Hauke [TTHB] Heller&#039;s Meetup - Greatest London Loop,Quarq Powermeter to Roam (Sec.),Wahoo Kickr 4.0 to Zwift (Prim.),296,291,5
30825,177035,2020-05-03 07:59:52,wahoo,ZTS x Paceheads | Etappe II Greatest London Loop (26.2km/360hm) (A),Quarq Powermeter to Roam (Sec.),Wahoo Kickr 4.0 to Zwift (Prim.),406,381,25
32442,177035,2020-05-07 16:23:52,wahoo,easy spin tt,Quarq Aerium to Roam (Sec.) ,Wahoo Kickr 4.0 to Zwift (Prim.),223,218,5
35553,177035,2020-05-17 08:00:04,wahoo,Zwift - ZTS x Paceheads | Etappe IV 19.4km | 80hm (A),Quarq Powermeter to Roam (Sec.),Wahoo Kickr 4.0 to Zwift (Prim.),407,390,17
54000,177035,2020-09-08 17:34:26,wahoo,Zwift - 8x30s Vo2maxmax FatMax,Quarq Aerium to Zwift (Prim.),Wahoo Kickr 4.0 to Roam (Sec.),295,285,10
54153,177035,2020-09-09 16:35:22,wahoo,Zwift - 5 x 30/15 Vo2 Max Intervalle Rolle,Quarq Aerium to Zwift (Prim.),Wahoo Kickr 4.0 to Roam (Sec.),354,348,6
54616,177035,2020-09-11 16:15:38,wahoo,Zwift - unmittelbare Wettkampfvorbereitung/Aktivierung,Quarq Aeroad to Zwift (Prim.),Wahoo Kickr 4.0 to Roam (Sec.),281,265,16
54681,177035,2020-09-12 08:15:58,wahoo,Zwift - Test Tag 1 5 + 10 ,Quarq Aeroad to Zwift (Prim.),Wahoo Kickr 4.0 to Roam (Sec.),438,412,26
54685,177035,2020-08-19 17:06:14,wahoo,5&20,Quarq Aeroad to Zwift (Prim.),Wahoo Kickr 4.0 to Roam (Sec.),417,415,2
54898,177035,2020-09-13 11:18:59,wahoo,Zwift - Stufentest 95-5-35,Quarq Aeroad to Zwift (Prim.),Wahoo Kickr 4.0 to Roam (Sec.),370,357,13
54899,177035,2020-09-13 12:11:14,wahoo,Zwift - Rampentest 100-30-25 @ 340,Quarq Aeroad to Zwift (Prim.),Wahoo Kickr 4.0 to Roam (Sec.),414,395,19
54900,177035,2020-09-13 12:32:18,wahoo,Zwift - Senkentest 250 - 90 - 10,Quarq Aerium to Zwift (Prim.),Wahoo Kickr 4.0 to Roam (Sec.),368,349,19
55628,177035,2020-09-15 17:54:59,wahoo,Zwift - Fatmax Pyramide Rolle,Quarq Aeroad to Zwift (Prim.),Wahoo Kickr 4.0 to Roam (Sec.),275,259,16
56839,177035,2020-09-22 18:30:55,wahoo,spin,Quarq Aeroad to Zwift (Prim.),Wahoo Kickr 4.0 to Roam (Sec.),260,253,7
57274,177035,2020-09-24 15:53:40,wahoo,Zwift - Rolle TF Pyramide II 100-120 rpm,Quarq Aeroad to Zwift (Prim.),Wahoo Kickr 4.0 to Roam (Sec.),281,268,13
57691,177035,2020-09-26 12:44:49,wahoo,Zwift - WTRL Racing (A),Quarq Aeroad to Zwift (Prim.),Wahoo Kickr 4.0 to Roam (Sec.),380,373,7
58152,177035,2020-09-29 04:43:12,wahoo,Zwift - Fatmax Pyramide lang Rolle,Quarq Aerium to Zwift (Prim.),Wahoo Kickr 4.0 to Roam (Sec.),263,258,5
58679,177035,2020-09-30 16:22:34,wahoo,Zwift - 2 x 30/30 Vo2 Max Intervalle Rolle,Quarq Aerium to Zwift (Prim.),Wahoo Kickr 4.0 to Roam (Sec.),343,332,11
68155,177035,2020-11-03 18:33:55,wahoo,Zwift - 3 x 30/30 Vo2 Max Intervalle Rolle,Quarq Aeroad to Zwift (Prim.),Wahoo Kickr 4.0 to Roam (Sec.),354,336,18
70251,177035,2020-11-10 17:34:52,wahoo,lalala,Quarq Aeroad to Zwift (Prim.),Wahoo Kickr 4.0 to Roam (Sec.),342,324,18
71501,177035,2020-11-14 13:06:36,wahoo,Zwift - 4 x 30,Quarq Aerium to Zwift (Prim.),Wahoo Kickr 4.0 to Roam (Sec.),370,356,14
72396,177035,2020-11-17 19:13:14,wahoo,Zwift - 4 x 1min/1min Vo2 Max Intervalle Rolle kurz,Quarq Aeroad to Zwift (Prim.),Wahoo Kickr 4.0 to Roam (Sec.),343,330,13
73164,177035,2020-11-19 19:46:02,wahoo,Zwift - Rolle 8x30s Vo2max FatMax,Quarq Aeroad to Zwift (Prim.),Wahoo Kickr 4.0 to Roam (Sec.),291,280,11
73822,177035,2020-11-21 12:34:59,wahoo,Zwift - 4 x 40,Quarq Aeroad to Zwift (Prim.),Wahoo Kickr 4.0 to Roam (Sec.),409,394,15
74981,177035,2020-11-24 17:27:32,wahoo,Zwift - Rolle TF Pyramide II 100-120 rpm,Quarq Aeroad to Zwift (Prim.),Wahoo Kickr 4.0 to Roam (Sec.),280,279,1
75328,177035,2020-11-25 06:26:46,wahoo,easy,Quarq Aeroad to Roam (Sec.),Wahoo Kickr 4.0 to Zwift (Prim.),272,260,12
75538,177035,2020-11-25 17:50:13,wahoo,Zwift - 2 x 1min/30 Vo2 Max Intervalle Rolle,Quarq Aeroad to Roam (Sec.),Wahoo Kickr 4.0 to Zwift (Prim.),382,363,19
76520,177035,2020-11-27 17:01:14,wahoo,Zwift - Nachbereitung Rad,Quarq Aeroad to Roam (Sec.),Wahoo Kickr 4.0 to Zwift (Prim.),207,200,7
76735,177035,2020-11-28 08:59:44,wahoo,ZTS Season II - Race 1,Quarq Aeroad to Roam (Sec.),Wahoo Kickr 4.0 to Zwift (Prim.),407,384,23
76745,177035,2020-11-28 09:51:23,wahoo,Zwift - Innsbruck,Quarq Aeroad to Roam (Sec.),Wahoo Kickr 4.0 to Zwift (Prim.),181,176,5
78061,177035,2020-12-01 17:59:35,wahoo,Zwift - Fatmax Pyramide 1x24min,Quarq Aeroad to Roam (Sec.),Wahoo Kickr 4.0 to Zwift (Prim.),267,262,5
78363,177035,2020-12-02 06:16:20,wahoo,Zwift - Rolle Nüchtern Ride,Quarq Aeroad to Roam (Sec.),Wahoo Kickr 4.0 to Zwift (Prim.),260,254,6
78600,177035,2020-12-02 17:31:52,wahoo,Zwift - Rolle Nüchtern Ride,Quarq Aeroad to Roam (Sec.),Wahoo Kickr 4.0 to Zwift (Prim.),378,361,17
80505,177035,2020-12-07 17:39:32,wahoo,Zwift - Nachbereitung Rad,Quarq Aerium to Roam (Sec.) ,Wahoo Kickr 4.0 to Zwift (Prim.),218,220,-2
82147,177035,2020-12-11 18:36:15,wahoo,Zwift - Rolle TF Pyramide II 100-120 rpm,Quarq Aerium to Roam (Sec.) ,Wahoo Kickr 4.0 to Zwift (Prim.),279,281,-2
82175,177035,2020-12-12 08:59:43,wahoo,Zwift - ZTS Season II - Race 2 (A),Quarq Aeroad to Roam (Sec.),Wahoo Kickr 4.0 to Zwift (Prim.),431,404,27
82782,177035,2020-12-13 14:23:49,wahoo,Zwift - GA1 Ride mit Sprints,Quarq Aerium to Roam (Sec.) ,Wahoo Kickr 4.0 to Zwift (Prim.),244,244,0
85087,177035,2020-12-19 13:55:34,wahoo,Zwift - Fatmax Pyramide 2x24min,Quarq Aerium to Roam (Sec.) ,Wahoo Kickr 4.0 to Zwift (Prim.),264,263,1
92271,177035,2021-01-06 14:10:07,wahoo,Zwift - 2 x 1min/1min Vo2 Max Intervalle Rolle,Quarq Aerium to Roam (Sec.) ,Wahoo Kickr 4.0 to Zwift (Prim.),341,332,9
93078,177035,2021-01-07 16:28:22,wahoo,Zwift - Fatmax Pyramide 3x24min,Quarq Aerium to Roam (Sec.) ,Wahoo Kickr 4.0 to Zwift (Prim.),265,263,2
93831,177035,2021-01-09 08:22:47,wahoo,Zwift - Rolle 8x30s Vo2max FatMax lang,Quarq Aerium to Roam (Sec.) ,Wahoo Kickr 4.0 to Zwift (Prim.),293,283,10
97501,177035,2021-01-15 17:41:30,wahoo,Zwift - Rolle Nüchtern Ride,Quarq Aeroad to Roam (Sec.),Wahoo Kickr 4.0 to Zwift (Prim.),234,228,6
97768,177035,2021-01-16 08:59:53,wahoo,Zwift - ZTS Season II - Race 4 (A),Quarq Aeroad to Roam (Sec.),Wahoo Kickr 4.0 to Zwift (Prim.),408,399,9
100624,177035,2021-01-20 17:59:50,wahoo,Zwift - MIDWEEK Winter Series by SZR (A),Quarq Aerium to Roam (Sec.) ,Wahoo Kickr 4.0 to Zwift (Prim.),401,388,13
102295,177035,2021-01-24 08:59:53,wahoo,Pushing Limits TT-Race,Quarq Aeroad to Roam (Sec.),Wahoo Kickr 4.0 to Zwift (Prim.),372,383,-11
104244,177035,2021-01-26 18:16:05,wahoo,Zwift - Rolle TF Pyramide II 100-120 rpm,Quarq Aeroad to Roam (Sec.),Wahoo Kickr 4.0 to Zwift (Prim.),298,289,9
104415,177035,2021-01-28 06:55:07,wahoo,Zwift - Rolle Nüchtern Ride,Quarq Aeroad to Roam (Sec.),Wahoo Kickr 4.0 to Zwift (Prim.),241,233,8
105244,177035,2021-01-29 18:27:22,wahoo,Zwift - Rolle Nüchtern Ride,Quarq Aerium to Roam (Sec.) ,Wahoo Kickr 4.0 to Zwift (Prim.),387,384,3
113553,177035,2021-02-12 18:27:46,wahoo,Zwift - Fatmax Pyramide 1x24min,Quarq Aerium to Roam (Sec.) ,Wahoo Kickr 4.0 to Zwift (Prim.),263,262,1
127965,177035,2021-03-13 14:34:33,wahoo,Zwift - easy spin,Quarq Aerium to Roam (Sec.) ,Wahoo Kickr 4.0 to Zwift (Prim.),222,218,4
54310,177702,2020-09-10 09:07:56,neo,Zwift - Cycling Australia&#039;s The Chop by AHDR (B),Assioma Duo,Tacx Neo,372,367,5
65354,177702,2020-10-27 08:30:59,neo,Zwift - Zwift Racing League | WTRL - APAC (MEN) -  Division 1 (B),Assioma Duo,Tacx Neo,367,362,5
79588,177702,2020-12-05 05:43:06,neo,Zwift - AHDR Open 2020 Club Championships (B),Assioma Duo,Tacx Neo,362,355,7
1250,177885,2019-09-04 09:44:58,wahoo,Zwift - The Morning Grind (A),Powertap P1s,Wahoo Kickr 2018,392,390,2
2048,177885,2019-09-18 10:09:58,wahoo,Zwift - Yorkshire Power Up Tour: Climber Stage (A),Powertap P1s,Wahoo Kickr 2018,367,372,-5
2659,177885,2019-09-26 18:59:25,wahoo,Zwift - Yorkshire Gran Prix // Zwift Classic (A),Powertap P1s,Wahoo Kickr 2018,442,449,-7
26780,181004,2020-04-21 18:41:14,wahoo,Zwift - 3R Spring Loaded Race Series - Round 4of6 (B),Stages PM,Kickr Core,374,363,11
113969,181504,2021-02-13 09:55:58,neo,Tacx Neo / Specialized power cranks,Specialized power cranks,Tacx Neo,275,272,3
113980,181504,2021-02-13 10:28:20,neo,Tacx Neo / Specialized power cranks,Specialized power cranks,Tacx Neo,343,344,-1
113984,181504,2021-02-13 10:28:20,neo,Tacx Neo / Power Crank,Power Crank,Tacx Neo,343,344,-1
116661,181504,2021-02-17 17:02:46,neo,Tacx Neo / Specialized Power Crank,Specialized Power Crank,Tacx Neo,356,358,-2
118202,181504,2021-02-20 10:04:58,neo,Tacx Neo / Specialized Power Crank,Specialized Power Crank,Tacx Neo,276,272,4
118204,181504,2021-02-20 10:30:21,neo,Tacx Neo / Specialized Power Crank,Specialized Power Crank,Tacx Neo,327,332,-5
121605,181504,2021-02-27 10:01:04,neo,Specialized Power Crank / Tacx Neo,Specialized Power Crank,Tacx Neo,283,275,8
121613,181504,2021-02-27 10:27:33,neo,Specialized Power Crank / Tacx Neo,Specialized Power Crank,Tacx Neo,343,338,5
124913,181504,2021-03-06 09:58:58,neo,Specialized Power Crank / Tacx Neo,Specialized Power Crank,Tacx Neo,363,356,7
97958,182252,2021-01-16 09:00:19,neo,Zwift - ZTS Season II - Race 4 (A),Garmin Vector 3,Tacx Neo,397,408,-11
99885,182252,2021-01-19 08:52:16,neo,Zwift - Zwift Racing League | WTRL - Men&#039;s/Mixed APAC DIVISION 1 (A),Garmin Vector 3,Tacx Neo,405,411,-6
100308,182252,2021-01-20 17:29:58,neo,Zwift - Julia Schallau (Beastmode)&#039;s Meetup - Innsbruckring,Garmin Vector 3,Tacx Neo,340,333,7
115598,182252,2021-02-16 08:45:23,neo,Zwift Racing League | WTRL - Mens/Mixed APAC DIVISION 1,Garmin Vector 3,Tacx Neo,425,434,-9
122789,182252,2021-03-02 08:51:51,neo,Zwift - Zwift Racing League | WTRL - Men&#039;s/Mixed APAC DIVISION 1 (A),Garmin Vector 3,Tacx Neo,406,418,-12
124662,182252,2021-03-05 19:04:54,neo,Zwift - Zwift Racing League | WTRL Battle Royale Playoff - Men&#039;s Points Race (A),Garmin Vector 3,Tacx Neo,406,414,-8
128003,182252,2021-03-13 15:14:49,neo,Zwift - OH MY CRIT!! - Saturday Smash Race (A),Garmin Vector 3,Tacx Neo,426,437,-11
29822,182368,2020-04-26 19:10:49,wahoo,Zwift - Crit City Slam Race // Zwift Classic (B),Garmin vector 3,Kickr 2018,318,310,8
60984,182368,2020-10-11 13:41:58,wahoo,Zwift - Crit City Race (B),Garmin vector 3,Kickr 2018,312,310,2
61911,182368,2020-10-13 17:15:34,wahoo,Zwift - Zwift Racing League | WTRL,Garmin vector 3,Kickr 2018,307,306,1
63472,182368,2020-10-20 17:01:37,wahoo,Zwift racing League EMEA TTT Group 4 -LEQP,Garmin vector 3,Kickr 2018,296,298,-2
80069,182368,2020-12-05 10:43:52,wahoo,Zwift - Nations Challenge // Great Britain (E),Garmin vector 3,Kickr 2018 (Primary),320,323,-3
83717,182368,2020-12-08 17:50:02,wahoo,Zwift - Zwift Racing League | WTRL - Men&#039;s EMEA E2 DIVISION 1 (B),Garmin vector 3,Kickr 2018 (Primary),345,337,8
88342,182368,2020-12-22 18:44:32,wahoo,Zwift - Team Italy & Frenchy Fuzion League (B),Garmin vector 3,Kickr 2018,329,336,-7
88347,182368,2020-12-24 10:16:38,wahoo,Zwift - 3R Whole Lotta Lava Hilly Race - 1 Lap (16.9km/10.5mi 183m) (B),Garmin vector 3,Kickr 2018,336,333,3
89593,182368,2020-12-31 11:30:38,wahoo,Zwift - End of year FTP Test :(,Garmin vector 3,Kickr 2018 (Primary),314,315,-1
90538,182368,2021-01-01 10:13:30,wahoo,Zwift - TEAM VEGAN Tofu Tornado (B),Garmin vector 3,Kickr 2018 (Primary),322,324,-2
94301,182368,2021-01-09 16:11:11,wahoo,Zwift - TEAM VEGAN Tofu Tornado (B),Garmin vector 3,Kickr 2018 (Primary),325,327,-2
104873,182368,2021-01-28 18:35:17,wahoo,Zwift - WTRL Team Time Trial - Zone 6 (D),Garmin vector 3,Kickr 2018 (Primary),271,274,-3
129306,182368,2021-03-16 18:49:48,wahoo,Zwift - Team Italy & Frenchy Fuzion League (B),Garmin vector 3,Kickr 2018 (Primary),347,351,-4
47414,182684,2020-07-23 10:10:38,wahoo,Zwift - MAP Micro Intervals: 3 Sets 40/20,Garmin Vector 3,Kickr Core,268,287,-19
47754,182684,2020-07-26 13:39:54,wahoo,Zwift - Herd Summer Racing League Race 7 (B),Garmin Vector 3,Kickr Core,302,324,-22
118963,182684,2021-02-19 19:00:29,wahoo,Zwift - WKG Winter League 2020 / 2021  (B),Stages Ultegra R,Kickr Core,311,322,-11
122868,182684,2021-03-01 19:07:44,wahoo,Zwift - The Stampede (ITT) by Herd Racing League (B) 1st,Stages Ultegra R,Kickr Core,327,344,-17
125529,182684,2021-03-07 15:22:12,wahoo,Zwift - 3R Watopia 65km Race - 6 laps (40mi 324m) (B),Stages Ultegra R,Kickr Core,298,297,1
6999,182972,2019-12-22 08:59:15,wahoo,Zwift - Danmarks Cykle Union Racing League (A),Garmin Vector 2,Wahoo Kickr 2018,360,340,20
7260,182972,2019-12-25 18:44:17,wahoo,Zwift - Crit City Race (A),Garmin Vector 2,Wahoo Kickr 2018,345,329,16
7427,182972,2019-12-27 17:59:05,wahoo,Zwift - ZA Tri 2020 TT Race - Open A,Garmin Vector 2,Wahoo Kickr 2018,379,373,6
7589,182972,2019-12-29 18:29:10,wahoo,Zwift - XRS Races Crit (A),Garmin Vector 253,Wahoo Kickr 2018,364,352,12
7807,182972,2020-01-01 19:04:09,wahoo,Zwift - DBR Wednesday Race (A),Garmin Vector 2,Wahoo Kickr 2018,365,353,12
7893,182972,2020-01-02 18:29:14,wahoo,Zwift - FUSION ECT BEUNSTOPPABLE Racing Series (A),Garmin Vector 2,Wahoo Kickr 2018,315,305,10
8036,182972,2020-01-04 11:59:19,wahoo,Zwift - HBR17 by Herd Racing League (Europe) (E),Garmin Vector 2,Wahoo Kickr 2018,399,390,9
8219,182972,2020-01-06 18:14:04,wahoo,Zwift - DBR Caresport Crit Cup  (A),Garmin Vector 2,Wahoo Kickr 2018,369,359,10
8342,182972,2020-01-07 19:39:04,wahoo,Zwift - 3R Ultimate Racing League - Round 1 (A),Garmin Vector 2,Wahoo Kickr 2018,376,362,14
8613,182972,2020-01-09 17:25:03,wahoo,Zwift - Danmarks Cykle Union 2020 Cup (A),Garmin Vector 2,Wahoo Kickr 2018,394,384,10
8927,182972,2020-01-12 08:58:40,wahoo,Zwift - Danmarks Cykle Union 2020 Cup (A),Garmin Vector 2,Wahoo Kickr 2018,341,332,9
9159,182972,2020-01-13 18:14:18,wahoo,Zwift - DBR Caresport Crit Cup  (A),Garmin Vector 2,Wahoo Kickr 2018,382,372,10
9808,182972,2020-01-17 18:59:36,wahoo,Zwift - The Friday Criterium Winter Race Series  (32 mi / 51 km) (A),Garmin Vector 2,Wahoo Kickr 2018,345,356,-11
9888,182972,2020-01-18 12:08:40,wahoo,Zwift - DIRT DADurday Chase Race (A),Garmin Vector 2,Wahoo Kickr 2018,346,359,-13
10308,182972,2020-01-21 18:09:47,wahoo,Zwift - Tour de Zwift: Stage 3 Race (A),Garmin Vector 2,Wahoo Kickr 2018,366,374,-8
10472,182972,2020-01-22 19:04:20,wahoo,Zwift - DBR HEINO CUP (A),Garmin Vector 2,Wahoo Kickr 2018,365,369,-4
10859,182972,2020-01-24 18:09:52,wahoo,Zwift - 3R Lutscher CCW Climbing Race - 1 Lap (22.1km/13.9mi 827m) (A),Garmin Vector 2,Wahoo Kickr 2018,375,388,-13
11418,182972,2020-01-28 21:04:14,wahoo,Zwift - 3R Volcano Flat Reverse Race - 3 Laps (36.6km/22.7mi 138m) (A),Garmin Vector 2,Wahoo Kickr 2018,333,338,-5
11896,182972,2020-01-31 19:13:51,wahoo,Zwift - Tour de Zwift // Pro-Am Invitational (A),Garmin Vector 2,Wahoo Kickr 2018,403,424,-21
12038,182972,2020-02-01 18:09:52,wahoo,Zwift - Tour de Zwift: Stage 6 Race (A),Garmin Vector 2,Wahoo Kickr 2018,315,326,-11
12262,182972,2020-02-03 17:29:42,wahoo,Zwift - baby woke up,Garmin Vector 2,Wahoo Kickr 2018,363,382,-19
12621,182972,2020-02-05 19:02:14,wahoo,Zwift - DBR Wednesday Race (A),Garmin Vector 2,Wahoo Kickr 2018,326,339,-13
12799,182972,2020-02-06 19:45:44,wahoo,Zwift - WTRL Team Time Trial ,Garmin Vector 2,Wahoo Kickr 2018,354,369,-15
13288,182972,2020-02-10 18:51:42,wahoo,Zwift ,Garmin Vector 2,Wahoo Kickr 2018,367,375,-8
13576,182972,2020-02-12 19:04:32,wahoo,Zwift - DBR Wednesday Race (A),Garmin Vector 2,Wahoo Kickr 2018,371,368,3
13736,182972,2020-02-13 18:59:32,wahoo,Zwift - KALAS Cup - Round 3 (A),Garmin Vector 2,Wahoo Kickr 2018,351,365,-14
14210,182972,2020-02-16 12:19:36,wahoo,Zwift - Ottawa TopSpeed Race (A),Garmin Vector 2,Wahoo Kickr 2018,348,353,-5
14560,182972,2020-02-18 19:14:23,wahoo,Zwift - Feltet.dk Race Series,Garmin Vector 2,Wahoo Kickr 2018,358,360,-2
15218,182972,2020-02-22 18:59:21,wahoo,Zwift - Vatternrundan E-Sportive 6 (E),Garmin Vector 2,Wahoo Kickr 2018,378,386,-8
15610,182972,2020-02-25 19:14:17,wahoo,Zwift - Feltet.dk Race Series (A),Garmin Vector 2,Wahoo Kickr 2018,377,395,-18
15892,182972,2020-02-27 18:48:44,wahoo,Zwift ,Garmin Vector 2,Wahoo Kickr 2018,329,339,-10
16192,182972,2020-02-29 19:20:42,wahoo,Zwift - ZHR Weekend Group Ride (C),Garmin Vector 2,Wahoo Kickr 2018,327,332,-5
16193,182972,2020-02-29 19:21:29,wahoo,Zwift - sst,Garmin Vector 2,Wahoo Kickr 2018,328,332,-4
16381,182972,2020-03-01 19:03:23,wahoo,Zwift - SST,Garmin Vector 2,Wahoo Kickr 2018,307,309,-2
16650,182972,2020-03-03 19:13:59,wahoo,Zwift - Feltet.dk Race Series (A),Garmin Vector 2,Wahoo Kickr 2018,392,386,6
16841,182972,2020-03-04 20:39:26,wahoo,Zwift ,Garmin Vector 2,Wahoo Kickr 2018,243,243,0
16891,182972,2020-03-05 10:45:50,wahoo,Zwift - O/U FTP,Garmin Vector 2,Wahoo Kickr 2018,333,338,-5
17533,182972,2020-03-10 19:14:18,wahoo,Feltet.dk Race Series,Garmin Vector 2,Wahoo Kickr 2018,369,366,3
17859,182972,2020-03-12 19:14:12,wahoo,Zwift - Tour of Watopia Pro-Am Men&#039;s Race #1 (A),Garmin Vector 2,Wahoo Kickr 2018,397,392,5
18035,182972,2020-03-14 11:14:01,wahoo,Zwift - 3R Tick Tock Flat Race - 2 Lap (36km/22.4mi 100m) (A),Garmin Vector 2,Wahoo Kickr 2018,389,380,9
18137,182972,2020-03-15 11:17:12,wahoo,Zwift ,Garmin Vector 2,Wahoo Kickr 2018,257,253,4
18441,182972,2020-03-17 19:38:56,wahoo,Zwift ,Garmin Vector 2,Wahoo Kickr 2018,339,356,-17
18914,182972,2020-03-20 19:14:12,wahoo,Zwift - Tour of Watopia Pro-Am Men&#039;s Race #2 (A),Garmin Vector 2,Wahoo Kickr 2018,420,414,6
19035,182972,2020-03-21 13:59:09,wahoo,Zwift ,Garmin Vector 2,Wahoo Kickr 2018,344,341,3
19434,182972,2020-03-24 19:13:49,wahoo,Zwift - Feltet.dk Race Series (A),Garmin Vector 2,Kickr 2019,368,366,2
19842,182972,2020-03-26 19:28:33,wahoo,Zwift - VO2 ,Assioma duo,Wahoo Kickr 2018,325,317,8
20122,182972,2020-03-28 11:35:58,wahoo,Zwift ,Assioma duo,Wahoo Kickr 2018,343,331,12
20403,182972,2020-03-29 12:14:30,wahoo,Zwift - Stage 2 Race (A) - Tour of Watopia 2020,Assioma duo,Wahoo Kickr 2018,351,350,1
20412,182972,2020-03-29 13:05:14,wahoo,Zwift - 3R Watopia Flat Route Race - 4 Laps (40.5km/25.1mi 216m) (A),Assioma duo,Wahoo Kickr 2018,364,357,7
20864,182972,2020-03-31 18:15:09,wahoo,Zwift - Feltet.dk Race Series (A),Assioma duo,Wahoo Kickr 2018,384,374,10
21684,182972,2020-04-03 11:19:46,wahoo,Zwift - 3R LaGuardia Loop Reverse Flat Race - 8 Laps (24.5km/15.2mi 216m) (A),Assioma duo,Wahoo Kickr 2018,377,373,4
21688,182972,2020-04-03 12:04:44,wahoo,Zwift ,Assioma duo,Wahoo Kickr 2018,317,317,0
21970,182972,2020-04-04 08:59:26,wahoo,Zwift ,Assioma duo,Wahoo Kickr 2018,358,357,1
22378,182972,2020-04-05 18:43:04,wahoo,Zwift - The Alpe Dash by Herd Racing League (A),Assioma duo,Wahoo Kickr 2018,364,363,1
23053,182972,2020-04-08 18:05:03,wahoo,Zwift - DBR Sprinthooligan Cup (A),Assioma duo,Wahoo Kickr 2018,369,358,11
23526,182972,2020-04-10 14:59:07,wahoo,Zwift - ZHQ Beta Crit City Race (A),Assioma duo,Wahoo Kickr 2018,360,354,6
24324,182972,2020-04-13 18:19:35,wahoo,Zwift - TFC Mad Monday World Series (1 of 6) (A),Assioma duo,Wahoo Kickr 2018,392,381,11
25601,182972,2020-04-17 19:00:04,wahoo,Zwift - KIRCHMAIR April Series (A),Assioma duo,Wahoo Kickr 2018,347,342,5
25641,182972,2020-04-17 19:29:46,wahoo,Zwift - KIRCHMAIR April Series (A),Assioma duo,Wahoo Kickr 2018,371,363,8
27018,182972,2020-04-22 18:04:53,wahoo,Zwift - DBR Sprinthooligan Cup (A),Assioma duo,Wahoo Kickr 2018,388,378,10
27995,182972,2020-04-25 18:09:48,wahoo,Zwift ,Assioma duo,Wahoo Kickr 2018,389,384,5
28816,182972,2020-04-28 18:06:38,wahoo,Zwift - ZHR Masters (A),Assioma duo,Wahoo Kickr 2018,398,391,7
30891,182972,2020-05-03 10:10:04,wahoo,Zwift - 3R Innsbruckring Sprint Race - 1 Lap (8.8km/5.5mi 77m) (A),Assioma duo,Wahoo Kickr 2018,381,364,17
31727,182972,2020-05-05 18:15:06,wahoo,Zwift - UNO X CUP powered by DCU & Feltet.dk (A),Assioma duo,Wahoo Kickr 2018,406,396,10
34029,182972,2020-05-12 18:14:22,wahoo,Zwift - UNO X CUP powered by DCU & Feltet.dk (A),Assioma duo,Wahoo Kickr 2018,398,393,5
35301,182972,2020-05-16 11:14:58,wahoo,3R Tick Tock Flat Race - 2 Lap (36km/22.4mi 100m),Assioma duo,Wahoo Kickr 2018,385,373,12
35302,182972,2020-05-16 11:15:00,wahoo,Team ODZ RACE,Assioma duo,Wahoo Kickr 2018,357,349,8
35604,182972,2020-05-17 11:16:47,wahoo,Zwift - STPC Gravel Grinder (A),Assioma duo,Wahoo Kickr 2018,373,367,6
36100,182972,2020-05-19 18:14:31,wahoo,Zwift - UNO X CUP powered by DCU & Feltet.dk (A),Assioma duo,Wahoo Kickr 2018,422,405,17
36321,182972,2020-05-20 09:40:09,wahoo,Zwift - 05/20/2020,Assioma duo,Wahoo Kickr 2018,368,351,17
36586,182972,2020-05-21 09:38:25,wahoo,Zwift - Koa Sports League Race (A),Assioma duo,Wahoo Kickr 2018,397,383,14
37025,182972,2020-05-23 09:05:29,wahoo,Zwift - 3R Watopia Out and Back Again - 1 Lap (42k/26.1mi 334m) (A),Assioma duo,Wahoo Kickr 2018,409,400,9
37644,182972,2020-05-25 17:58:52,wahoo,Zwift - Team IRL Without Borders Race (A),Assioma duo,Wahoo Kickr 2018,373,364,9
40809,182972,2020-06-10 17:56:07,wahoo,Zwift - DBR Boerkop Cykler Cup (A),Assioma duo,Wahoo Kickr 2018,366,361,5
41414,182972,2020-06-13 11:07:07,wahoo,Zwift - 3R Tick Tock Flat Race - 2 Lap (36km/22.4mi 100m) (A),Assioma duo,Wahoo Kickr 2018,387,374,13
41999,182972,2020-06-16 17:50:01,wahoo,Zwift - UNO X CUP powered by DCU & Feltet.dk (A),Assioma duo,Wahoo Kickr 2018,391,376,15
42235,182972,2020-06-17 17:51:32,wahoo,Zwift - USA Cycling Race League by Indoor Specialist (A),Assioma duo,Wahoo Kickr 2018,367,353,14
43718,182972,2020-06-26 17:42:46,wahoo,Zwift - 06/26/2020,Assioma duo,Wahoo Kickr 2018,374,356,18
44435,182972,2020-07-01 17:43:41,wahoo,Zwift - USA Cycling Race League by Indoor Specialist (A),Assioma duo,Wahoo Kickr 2018,386,368,18
44438,182972,2020-07-01 17:43:41,wahoo,Zwift - 07/01/2020,Assioma duo,Wahoo Kickr 2018,349,331,18
44707,182972,2020-07-03 17:40:41,wahoo,Zwift - TeamPTz Friday&#039;s Race League (A),Assioma duo,Wahoo Kickr 2018,380,364,16
45312,182972,2020-07-07 18:20:48,wahoo,Zwift - 3R NYC Gotham Grind - 4 Laps (A),Assioma duo,Wahoo Kickr 2018,378,364,14
45471,182972,2020-07-08 17:48:48,wahoo,Zwift - USA Cycling Race League by Indoor Specialist (A),Assioma duo,Wahoo Kickr 2018,383,368,15
45562,182972,2020-07-09 09:06:36,wahoo,Zwift - 07/09/2020,Assioma duo,Wahoo Kickr 2018,372,354,18
45765,182972,2020-07-10 09:59:55,wahoo,Zwift - 3R Innsbruckring Flat Race - 4 Laps (35.2km/21.9mi 308m) (A),Assioma duo,Wahoo Kickr 2018,376,356,20
46834,182972,2020-07-18 14:00:39,wahoo,Zwift - OH MY CRIT!! - Saturday Smash Race (A),Assioma duo,Wahoo Kickr 2018,342,331,11
47157,182972,2020-07-21 14:57:09,wahoo,Zwift - 3R Turbocharged Team Race Series - Round 2 (A),Assioma duo,Wahoo Kickr 2018,345,336,9
47278,182972,2020-07-19 10:05:40,wahoo,Zwift - USA Cycling Race League by Indoor Specialist (A),Assioma duo,Wahoo Kickr 2018,369,362,7
47327,182972,2020-07-22 17:41:29,wahoo,Zwift - USA Cycling Race League by Indoor Specialist (A),Assioma duo,Wahoo Kickr 2018,381,365,16
47742,182972,2020-07-26 10:00:24,wahoo,Zwift - 3R Sand & Sequoias - 1 Lap (20km/12.5mi 173m) (A),Assioma duo,Wahoo Kickr 2018,376,365,11
47890,182972,2020-07-27 18:04:08,wahoo,Zwift - TFC Mad Monday Summer Series (4 of 10) (A),Assioma duo,Wahoo Kickr 2018,389,379,10
48104,182972,2020-07-29 09:33:02,wahoo,Zwift - USA Cycling Race League by Indoor Specialist (A),Assioma duo,Wahoo Kickr 2018,394,382,12
48171,182972,2020-07-29 17:46:17,wahoo,Zwift - USA Cycling Race League by Indoor Specialist (A),Assioma duo,Wahoo Kickr 2018,393,385,8
48400,182972,2020-07-30 15:05:51,wahoo,Zwift - OH MY CRIT! - The Double Race 1/2 (A),Assioma duo,Wahoo Kickr 2018,396,391,5
48401,182972,2020-07-30 15:05:51,wahoo,Zwift - OH MY CRIT! - The Double Race 2/2 (A),Assioma duo,Wahoo Kickr 2018,382,370,12
48678,182972,2020-08-03 18:05:59,wahoo,Zwift - TFC Mad Monday Summer Series (5 of 10) (A),Assioma duo,Wahoo Kickr 2018,391,370,21
48799,182972,2020-08-04 18:30:31,wahoo,Zwift - 3R Turbocharged Team Race Series - Round 4 (A),Assioma duo,Wahoo Kickr 2018,377,367,10
48942,182972,2020-08-05 17:54:31,wahoo,Zwift - DBR Wednesday Race (A),Assioma duo,Wahoo Kickr 2018,369,362,7
49362,182972,2020-08-09 10:03:10,wahoo,Zwift - 3R Sand & Sequoias - 1 Lap (20km/12.5mi 173m) (A),Assioma duo,Wahoo Kickr 2018,348,343,5
49592,182972,2020-08-11 18:29:51,wahoo,Zwift - 3R Turbocharged Team Race Series - Round 5 (A),Assioma duo,Wahoo Kickr 2018,397,390,7
50152,182972,2020-08-15 13:56:32,wahoo,Zwift - OH MY CRIT - Saturday Smash Race (A),Assioma duo,Wahoo Kickr 2018,427,418,9
51624,182972,2020-08-25 09:00:46,wahoo,Zwift - 3R Turbocharged Team Race Series - Bonus Round (A),Assioma duo,Wahoo Kickr 2018,364,349,15
51855,182972,2020-08-25 18:29:11,wahoo,Zwift - 3R Turbocharged Team Race Series - Bonus Round (A),Assioma duo,Wahoo Kickr 2018,369,356,13
52031,182972,2020-08-26 16:51:16,wahoo,Zwift - MIDWEEK Summer Series by SZR (A),Assioma duo,Wahoo Kickr 2018,400,376,24
52777,182972,2020-08-31 18:08:34,wahoo,Zwift - TFC Mad Monday Summer Series (9 of 10) (A),Assioma duo,Wahoo Kickr 2018,391,376,15
53208,182972,2020-09-03 15:13:59,wahoo,Zwift - OH MY CRIT! - The Double Race 1/2 (A),Assioma duo,Wahoo Kickr 2018,391,375,16
53210,182972,2020-09-03 15:13:59,wahoo,Zwift - OH MY CRIT! - The Double Race 2/2 (A),Assioma duo,Wahoo Kickr 2018,356,345,11
53778,182972,2020-09-07 18:04:08,wahoo,Zwift - TFC Mad Monday Summer Series (10 of 10) (A),Assioma duo,Wahoo Kickr 2018,375,354,21
53976,182972,2020-09-08 18:35:57,wahoo,Zwift - 3R Sundown Race Series  (E),Assioma duo,Wahoo Kickr 2018,385,370,15
54196,182972,2020-09-09 17:52:58,wahoo,Zwift - DBR Wednesday Race (A),Assioma duo,Wahoo Kickr 2018,373,364,9
54378,182972,2020-09-10 15:58:37,wahoo,Zwift - OH MY CRIT! - The Double Race 2/2 (A),Assioma duo,Wahoo Kickr 2018,376,361,15
54700,182972,2020-09-12 10:53:03,neo,Zwift - NYC,Assioma duo,Neo,251,248,3
54702,182972,2020-09-12 11:05:54,neo,Zwift - test,Assioma duo,Neo,333,338,-5
54703,182972,2020-09-12 11:43:01,wahoo,Zwift - kickr test 5 min,Assioma duo,Wahoo Kickr 2018,303,296,7
54844,182972,2020-09-13 10:12:33,neo,Zwift ,Assioma duo,Neo,199,205,-6
55019,182972,2020-09-14 17:45:58,neo,Zwift - Invitational League // Qualifying Race #1,Assioma duo,Neo,380,381,-1
55294,182972,2020-09-15 08:41:57,neo,Zwift ,Assioma duo,Neo,199,198,1
55395,182972,2020-09-15 18:35:52,neo,Zwift - 3R Sundown Race Series  (E),Assioma duo,Neo,379,388,-9
55926,182972,2020-09-17 18:28:33,neo,Zwift - Invitational League // Qualifying Race #2 (Men) ,Assioma duo,Neo,382,375,7
57684,182972,2020-09-26 10:39:49,neo,Zwift - Into the Red by RELENTLESS (A),Assioma duo,Neo,386,378,8
57883,182972,2020-09-27 11:46:04,neo,Zwift - Peel Cycling - Sunday Chase (A),Assioma duo,Neo,347,341,6
62121,182972,2020-10-15 15:54:34,wahoo,Zwift - OH MY CRIT! - The Double Race 2/2 (A),Assioma duo,Kickr V5,381,366,15
62808,182972,2020-10-18 09:00:14,wahoo,Zwift - Newbury Velo Road Race (A),Assioma duo,Kickr V5,386,371,15
63572,182972,2020-10-20 18:57:59,wahoo,Zwift - KISS at Race - EU PM (A),Assioma duo,Kickr V5,382,364,18
65666,182972,2020-10-27 17:53:02,wahoo,Zwift Racing League | WTRL - Mens EMEA E1 DIVISION 1,Assioma duo,Kickr V5,392,371,21
66927,182972,2020-11-01 10:39:36,wahoo,Zwift - Ottawa TopSpeed Race (A),Assioma duo,Kickr V5,379,370,9
66967,182972,2020-11-01 10:39:18,wahoo,Zwift - ZHR Audax (D),Assioma duo,Kickr V5,252,247,5
67251,182972,2020-11-02 18:45:48,wahoo,Zwift - 11/02/2020,Assioma duo,Kickr V5,409,397,12
69014,182972,2020-11-08 11:22:22,wahoo,Zwift - ZHQ FutureWorks Crit City Race - Anti-sandbagging (A),Assioma duo,Kickr V5,336,322,14
69035,182972,2020-11-08 11:22:22,wahoo,Zwift - Stages of DIRT (A),Assioma duo,Kickr V5,381,366,15
69576,182972,2020-11-10 07:52:55,wahoo,Zwift - 11/10/2020,Assioma duo,Kickr V5,381,367,14
71093,182972,2020-11-12 18:21:25,wahoo,Zwift - 11/12/2020,Assioma duo,Kickr V5,328,313,15
71426,182972,2020-11-14 14:51:53,wahoo,Zwift - OH MY CRIT - Saturday Smash Race (A),Assioma duo,Kickr V5,370,347,23
71427,182972,2020-11-14 14:51:53,wahoo,Zwift - ZHQ FutureWorks Crit City Race - Anti-sandbagging (A),Assioma duo,Kickr V5,345,319,26
72242,182972,2020-11-17 17:48:16,wahoo,Zwift - Zwift Racing League | WTRL - Men&#039;s EMEA E1 DIVISION 1 (A),Assioma duo,Kickr V5,385,370,15
73152,182972,2020-11-19 18:58:22,wahoo,Zwift - World Championships Experience // Danish Cycling Federation,Assioma duo,Kickr V5,383,363,20
74172,182972,2020-11-22 11:51:04,wahoo,Zwift - 3R Whole Lotta Lava Hilly Race - 1 Lap (16.9km/10.5mi 183m) (A),Assioma duo,Kickr V5,437,416,21
75033,182972,2020-11-24 17:59:51,wahoo,Zwift - Zwift Racing League | WTRL - Men&#039;s EMEA E1 DIVISION 1,Assioma duo,Kickr V5,441,429,12
75573,182972,2020-11-25 18:43:00,wahoo,Zwift - DCU – Feltet.dk November series (A),Assioma duo,Kickr V5,413,401,12
78049,182972,2020-12-01 17:58:41,wahoo,Zwift - Zwift Racing League | WTRL - Men&#039;s EMEA E1 DIVISION 1 (A),Assioma duo,Kickr V5,408,399,9
79013,182972,2020-12-03 18:14:02,wahoo,Zwift - FUSION DECEMBER CUP (A),Assioma duo,Kickr V5,366,357,9
79652,182972,2020-12-05 09:54:11,wahoo,Zwift - Nations Challenge // Denmark (E),Assioma duo,Kickr V5,351,345,6
80061,182972,2020-12-06 10:48:39,wahoo,Zwift - ODZentury Sunday Endurance Ride (B),Assioma duo,Kickr V5,282,282,0
80811,182972,2020-12-08 17:54:15,wahoo,Zwift - Zwift Racing League | WTRL - Men&#039;s EMEA E1 DIVISION 1 (A),Assioma duo,Kickr V5,398,383,15
81230,182972,2020-12-08 18:00:16,wahoo,Zwift - Zwift Racing League | WTRL - Men&#039;s EMEA E1 DIVISION 1 (A),Assioma duo,Kickr V5 to wahoo app,398,388,10
81885,182972,2020-12-11 10:35:04,wahoo,Zwift - 12/11/2020,Assioma duo,Kickr V5 to wahoo app,362,354,8
89009,182972,2020-12-30 13:46:58,wahoo,Zwift - KISS Race Series - Pacific AM (A),Assioma duo,Kickr V5 to wahoo app,345,334,11
89762,182972,2021-01-01 12:17:48,wahoo,Zwift - Peak-PTY Climb Challenge Fridays (A),Assioma duo,Kickr V5 to wahoo app,376,368,8
90680,182972,2021-01-03 11:56:36,wahoo,Zwift 7 x 10 min SST,Assioma duo,Kickr V5 to wahoo app,329,325,4
91369,182972,2021-01-04 19:08:33,wahoo,Zwift - Team TFC Mad Monday Winter Series (A),Assioma duo,Kickr V5 to wahoo app,382,369,13
92922,182972,2021-01-07 18:19:21,wahoo,Zwift - FUSION WINTER CUP (A),Assioma duo,Kickr V5 to wahoo app,413,405,8
94399,182972,2021-01-10 09:25:33,wahoo,Zwift - DBR Sunday Race (A),Assioma duo,Kickr V5 to wahoo app,349,335,14
95671,182972,2021-01-12 17:59:02,wahoo,Zwift - Zwift Racing League | WTRL - Men&#039;s/Mixed EMEA E1 DIVISION 1 (A),Assioma duo,Kickr V5 to wahoo app,383,381,2
97456,182972,2021-01-15 16:03:41,wahoo,Zwift - 01/15/2021,Assioma duo,Kickr V5 to wahoo app,364,357,7
98185,182972,2021-01-16 15:06:14,wahoo,Zwift - OH MY CRIT - Saturday Smash Race (A),Assioma duo,Kickr V5 to wahoo app,370,363,7
98851,182972,2021-01-17 12:18:45,wahoo,Zwift ,Assioma duo,Kickr V5 to wahoo app,358,355,3
99647,182972,2021-01-19 17:59:51,wahoo,Zwift Racing League | WTRL - Mens/Mixed EMEA E1 DIVISION 1,Assioma duo,Kickr V5 to wahoo app,382,374,8
103456,182972,2021-01-26 17:58:39,wahoo,Zwift - Zwift Racing League | WTRL - Men&#039;s/Mixed EMEA E1 DIVISION 1 (A),Assioma duo,Kickr V5 to wahoo app,395,381,14
108319,182972,2021-02-03 18:49:31,wahoo,Zwift - Open - Movistar Team Challenge Community Qualifier Race #1,Assioma duo,Kickr V5 to wahoo app,401,391,10
110902,182972,2021-02-08 08:42:22,wahoo,Zwift - Crit City Race (A),Assioma duo,Kickr V5 to wahoo app,412,396,16
111807,182972,2021-02-09 19:13:11,wahoo,Zwift - British Cycling Race Series (A),Assioma duo,Kickr V5 to wahoo app,393,374,19
113116,182972,2021-02-11 18:20:45,wahoo,Zwift - FUSION WINTER CUP (A),Assioma duo,Kickr V5 to wahoo app,398,381,17
114391,182972,2021-02-13 18:55:50,wahoo,Zwift - TBR Pancake Chase Race! (A),Assioma duo,Kickr V5 to wahoo app,362,354,8
116860,182972,2021-02-17 18:37:34,wahoo,Zwift - Danmarks Cykle Union & Partners 6/6 (A),Assioma duo,Kickr V5 to wahoo app,393,382,11
117056,182972,2021-02-18 07:31:54,wahoo,Zwift,Assioma duo,Kickr V5,253,243,10
118632,182972,2021-02-21 11:20:25,wahoo,Zwift - Watopia,Assioma duo,Kickr V5,210,212,-2
118634,182972,2021-02-21 11:29:54,wahoo,Zwift,Assioma duo,Kickr V5,269,265,4
119602,182972,2021-02-23 17:59:01,wahoo,Zwift - Zwift Racing League | WTRL - Men&#039;s/Mixed EMEA E1 DIVISION 1 (A),Assioma duo,Kickr V5,376,370,6
120329,182972,2021-02-24 18:35:40,wahoo,Zwift - Scandinavian Cup 2021 - Round 1 - Men (A),Assioma duo,Kickr V5,394,385,9
121594,182972,2021-02-27 12:59:39,wahoo,Zwift - 111 - Strongman racing series (A),Assioma duo,Kickr V5,404,395,9
123087,182972,2021-03-02 18:00:18,wahoo,Zwift - Zwift Racing League | WTRL - Men&#039;s/Mixed EMEA E1 DIVISION 1 (A),Assioma duo,Kickr V5,396,396,0
123625,182972,2021-03-03 19:08:31,wahoo,Zwift ,Assioma duo,Kickr V5,257,255,2
125217,182972,2021-03-06 19:41:16,wahoo,Zwift - Zwift Racing League | WTRL Battle Royale Playoff - Men&#039;s TTT (A),Assioma duo,Kickr V5,415,409,6
125833,182972,2021-03-08 19:10:36,wahoo,Zwift - Team TFC Mad Monday Race Series (high-end categories) (A),Assioma duo,Kickr V5,377,369,8
126633,182972,2021-03-10 18:39:09,wahoo,Zwift - Scandinavian Cup 2021 - Round 3 - Men (A),Assioma duo,Kickr V5,403,398,5
127836,182972,2021-03-13 08:46:59,wahoo,Zwift,Assioma duo,Kickr V5,379,384,-5
128307,182972,2021-03-14 11:36:49,wahoo,Zwift - Crit City Race (A),Assioma duo,Kickr V5,365,364,1
128792,182972,2021-03-15 19:07:41,wahoo,Zwift - Team TFC Mad Monday Race Series (high-end categories) (A),Assioma duo,Kickr V5,409,407,2
11732,183471,2020-01-30 18:59:48,wahoo,Zwift - KALAS Cup - Round 1 (A),Garmi Vector,kickr,403,396,7
13428,183471,2020-02-11 19:40:10,wahoo,Zwift - 3R Ultimate Racing League - Round 6 (A),Garmi Vector,kickr,396,389,7
15584,183471,2020-02-25 19:09:41,wahoo,Feltet.dk Race Series,Garmi Vector,kickr,365,370,-5
15758,183471,2020-02-26 18:47:35,wahoo,Zwift - DBR Winter Cup (A),Garmi Vector,kickr,419,411,8
15891,183471,2020-02-27 18:46:16,wahoo,Zwift - KALAS Cup - Round 5 (A),Garmi Vector,kickr,407,399,8
16955,183471,2020-03-05 18:48:09,wahoo,Zwift - KALAS Cup - Round 6 (A),Garmi Vector,kickr,399,394,5
17834,183471,2020-03-12 18:52:15,wahoo,Zwift - Tour of Watopia Pro-Am Men&#039;s Race #1 (A),Garmi Vector,kickr,424,422,2
18730,183471,2020-03-19 18:26:38,wahoo,Zwift - KALAS Cup - Round 8 (A),Garmi Vector S2,kickr 18,377,371,6
19889,183471,2020-03-26 18:57:55,wahoo,Zwift - KALAS Cup - Round 9 (A),Garmi Vector S2,kickr 18,405,406,-1
21485,183471,2020-04-02 17:42:43,wahoo,Zwift - KALAS Cup - Round 10 (A),Garmi Vector S2,kickr 18,401,408,-7
22162,183471,2020-04-05 08:37:11,wahoo,Zwift - Ronde van Zwift (A),Garmi Vector S2,kickr 18,414,403,11
23332,183471,2020-04-09 17:43:19,wahoo,Zwift - London International // Zwift Classic (A),Garmi Vector S2,kickr 18,443,434,9
24262,183471,2020-04-13 16:08:19,wahoo,Zwift - 3R Classique Reverse Flat Race - 4 Laps (26.9km/16.7mi 57m) (A),Garmi Vector S2,kickr 18,418,409,9
25226,183471,2020-04-14 17:55:09,wahoo,Zwift - NCF Spring Cup (A),Garmi Vector S2,kickr 18,393,397,-4
25609,183471,2020-04-17 17:45:59,wahoo,Zwift - Richmond Challenge // Zwift Classic (A),Garmi Vector S2,kickr 18,415,413,2
26851,183471,2020-04-21 17:59:20,wahoo,Zwift - NCF Spring Cup (A),Garmi Vector S2,kickr 18,409,410,-1
28288,183471,2020-04-25 17:54:23,wahoo,Zwift - Crit City Slam // Zwift Classic (A),Garmi Vector S2,kickr 18,402,393,9
31680,183471,2020-05-05 16:50:22,wahoo,Zwift - NCF Grand Prix 2020 - Runde 1 - Elite (A),Garmi Vector S2,kickr 18,415,410,5
36067,183471,2020-05-19 16:59:01,wahoo,Zwift - NCF Grand Prix 2020 - Runde 3 - Elite Herrer/Kvinner (A),Garmi Vector S2,kickr 18,420,413,7
37828,183471,2020-05-26 16:57:51,wahoo,Zwift - NCF Grand Prix 2020 - Runde 4 - Elite Herrer/Kvinner (A),Garmi Vector S2,kickr 18,405,406,-1
39927,183471,2020-06-06 08:22:47,wahoo,Zwift - Zada test - Three Sisters,Garmi Vector S2,kickr 18,425,423,2
54417,183471,2020-09-10 17:27:17,wahoo,Zwift - FUSION ECT BEUNSTOPPABLE Racing Series (A),Garmi Vector S2,Wahoo Kickr v5,407,385,22
55777,183471,2020-09-17 17:38:10,wahoo,Zwift - Yorkshire,Garmi Vector S2,Wahoo Kickr v5,281,270,11
55834,183471,2020-09-17 18:27:17,wahoo,Zwift - Invitational League // Qualifying Race #2 (Men) ,Garmi Vector S2,Wahoo Kickr v5,392,377,15
57003,183471,2020-09-22 18:00:05,wahoo,Zwift - France,Garmi Vector S2,Wahoo Kickr v5,244,244,0
57039,183471,2020-09-23 17:44:29,wahoo,Zwift - NCF Vinter Cup 2020 - Runde 1 - Herrer (A),Garmi Vector S2,Wahoo Kickr v5,381,365,16
57286,183471,2020-09-24 18:05:02,wahoo,Zwift - Espresso,Garmi Vector S2,Wahoo Kickr v5,392,372,20
58308,183471,2020-09-29 17:31:46,wahoo,Zwift - Zada- 3 sisters test ,Garmi Vector S2,Wahoo Kickr v5,411,396,15
58528,183471,2020-09-30 17:29:14,wahoo,Zwift - NCF Vinter Cup 2020 - Runde 2 - Herrer (A),Garmi Vector S2,Wahoo Kickr v5,379,363,16
58830,183471,2020-10-01 17:18:48,wahoo,Zwift - Espresso,Garmi Vector S2,Wahoo Kickr v5,374,361,13
60316,183471,2020-10-07 17:29:50,wahoo,Zwift - NCF Vinter Cup 2020 - Runde 3 - Herrer (A),Garmi Vector S2,Wahoo Kickr v5,385,370,15
60342,183471,2020-10-08 17:16:20,wahoo,Zwift - Espresso,Garmi Vector S2,Wahoo Kickr v5,372,361,11
61252,183471,2020-10-12 18:21:26,wahoo,Zwift - Premier Division // Zwift Racing League (men) ,Garmi Vector S2,Wahoo Kickr v5,415,391,24
61912,183471,2020-10-14 17:27:20,wahoo,Zwift - NCF Vinter Cup 2020 - Runde 4 - Herrer (A),Garmi Vector S2,Wahoo Kickr v5,399,380,19
62154,183471,2020-10-15 17:22:57,wahoo,Zwift - Espresso,Garmi Vector S2,Wahoo Kickr v5,359,349,10
63885,183471,2020-10-21 17:27:06,wahoo,Zwift - NCF Vinter Cup 2020 - Runde 5 - Herrer (A),Garmi Vector S2,Wahoo Kickr v5,409,397,12
64190,183471,2020-10-22 17:15:45,wahoo,Zwift - Espresso,Garmi Vector S2,Wahoo Kickr v5,386,374,12
65174,183471,2020-10-26 19:26:37,wahoo,Zwift - Premier Division // Zwift Racing League (men) (A),Garmi Vector S2,Wahoo Kickr v5,421,406,15
65852,183471,2020-10-28 18:28:05,wahoo,NCF Vinter Cup 2020 - Runde 6 - Herrer,Garmi Vector S2,Wahoo Kickr v5,413,396,17
67260,183471,2020-11-02 18:44:37,wahoo,Premier Division // Zwift Racing League (men),Garmi Vector S2,Wahoo Kickr v5,413,393,20
68571,183471,2020-11-04 18:29:57,wahoo,Zwift - NCF Vinter Cup 2020 - Runde 7 - Herrer (A),Garmi Vector S2,Wahoo Kickr v5,400,384,16
68572,183471,2020-11-06 18:36:43,wahoo,Zwift - 10min,Garmi Vector S2,Wahoo Kickr v5,335,329,6
69421,183471,2020-11-09 19:43:35,wahoo,Zwift - Premier Division // Zwift Racing League (men) (A),Garmi Vector S2,Wahoo Kickr v5,434,421,13
70235,183471,2020-11-11 18:10:08,wahoo,Zwift - NCF Vinter Cup 2020 - Runde 8 - Herrer (A),Garmi Vector S2,Wahoo Kickr v5,395,389,6
72143,183471,2020-11-16 18:35:06,wahoo,Zwift - Premier Division // Zwift Racing League (men) (A),Garmi Vector S2,Wahoo Kickr v5,407,388,19
72669,183471,2020-11-18 18:04:34,wahoo,Zwift - NCF Vinter Cup 2020 - Runde 9 - Herrer (A),Garmi Vector S2,Wahoo Kickr v5,392,376,16
73141,183471,2020-11-19 19:27:26,wahoo,Zwift - World Championships Experience // Danish Cycling Federation,Garmi Vector S2,Wahoo Kickr v5,389,380,9
74676,183471,2020-11-23 19:35:56,wahoo,Zwift - Premier Division // Zwift Racing League (men) (A),Garmi Vector S2,Wahoo Kickr v5,403,388,15
8069,184035,2020-01-04 16:54:08,neo,Zwift - Innsbruck,9100P Zwift,Tacx Neo1,279,288,-9
8356,184035,2020-01-07 20:10:11,neo,Zwift - Watopia,9100P,Tacx Neo1,271,283,-12
8665,184035,2020-01-09 19:26:40,neo,Zwift - Watopia,9100P Edge,Tacx Neo1,277,283,-6
11070,184035,2020-01-26 17:29:00,neo,9100P Edge / Tacx Neo1,9100P Edge,Tacx Neo1,182,181,1
11352,184035,2020-01-28 18:16:56,neo,Tacx Neo1 / 9100P Edge,9100P Edge,Tacx Neo1,305,305,0
263,185918,2019-08-14 18:02:27,neo,Zwift - Trofeo Bologna // Zwift Classic ,P1S,Neo,366,382,-16
416,185918,2019-08-18 08:58:20,neo,Zwift - dPAC.fit Climbers Day (A),P1S,Neo,339,339,0
628,185918,2019-08-21 17:53:18,neo,The Morning Grind,P1S,Neo,338,341,-3
1051,185918,2019-08-31 08:03:09,neo,Zwift - 3R Watopia Hilly  Race - 4 Laps (A),P1S,Neo,340,329,11
1091,185918,2019-09-01 08:03:09,neo,Zwift - 3R Watopia Flat Route Race - 4 Laps (40.5km/25.1mi 216m) (A),P1S,Neo,323,327,-4
1170,185918,2019-09-02 17:13:09,neo,Zwift - DBR Monday Race League (A),P1S,Neo,312,314,-2
1363,185918,2019-09-05 18:01:05,neo,Zwift - Watopia Cup // Zwift Classic ,P1S,Neo,383,381,2
1661,185918,2019-09-11 17:52:59,neo,Zwift - The Morning Grind (A),P1S,Neo,333,333,0
2200,185918,2019-09-19 18:07:52,neo,Zwift - Yorkshire Power Up Tour: All-rounder Stage (A),P1S,Neo,352,357,-5
2709,185918,2019-09-26 17:07:45,neo,Zwift - Yorkshire World Championships Week - Road Event #1 (A),P1S,Neo,345,351,-6
3090,185918,2019-10-02 17:52:41,neo,Zwift - DIRT Cup Series (A),P1S,Neo,348,351,-3
3154,185918,2019-10-03 17:27:41,neo,Zwift - XRS - ZTR Thursday Night Racex (A),P1S,Neo,326,335,-9
10017,185918,2020-01-19 14:56:26,neo,Zwift - ZHR Masters Weekender (B),P1S,Neo,324,330,-6
10677,185918,2020-01-23 19:11:24,neo,Zwift - Tour de Zwift // Pro-Am Invitational,P1S,Neo,350,364,-14
11082,185918,2020-01-26 08:31:23,neo,Zwift - ZHR Masters Weekender (B),P1S,Neo,306,304,2
12517,185918,2020-02-04 19:11:20,neo,Zwift - Tour de Zwift // Pro-Am Invitational (A),P1S,Neo,359,369,-10
12639,185918,2020-02-05 19:21:18,neo,Zwift - Deeside Thistle and Moray Firth Crit (Race) (A),P1S,Neo,316,324,-8
12794,185918,2020-02-06 18:31:51,neo,Zwift - SMART - Opener 5 - Xert,P1S,Neo,249,256,-7
13322,185918,2020-02-10 18:41:03,neo,Zwift - Pre-Training Plan,Vector 3,Neo,252,262,-10
13587,185918,2020-02-12 19:21:11,neo,Zwift - Deeside Thistle and Moray Firth Crit (Race) (A),Vector 3,Neo,329,330,-1
13750,185918,2020-02-13 18:56:11,neo,Zwift - KALAS Cup - Round 3 (A),Vector 3,Neo,361,346,15
14744,185918,2020-02-19 19:21:07,neo,Zwift - Deeside Thistle and Moray Firth Crit (Race) (A),Vector 3,Neo,353,347,6
19995,185918,2020-03-27 16:05:41,neo,Zwift - Stage 5 Race (A) - Tour of Watopia 2020,Vector 3,Neo,330,338,-8
20158,185918,2020-03-28 09:59:59,neo,Zwift - David Lines(espressocyclecoaching.com)&#039;s Meetup - Big Foot Hills,Vector 3,Neo,342,344,-2
22200,185918,2020-04-05 08:55:37,neo,Zwift - Ronde van Zwift (A),Vector 3,Neo,357,363,-6
23069,185918,2020-04-08 17:50:32,neo,Zwift - USA Cycling Race League by Indoor Specialist  (A),Vector 3,Neo,353,364,-11
23502,185918,2020-04-10 10:25:36,neo,Zwift - London International Race (A),Vector 3,Neo,355,362,-7
23969,185918,2020-04-12 09:05:33,neo,Zwift - 3R Tour of Fire and Ice Hilly Race (25km/15.6mi 1166m) (A),Vector 3,Neo,315,326,-11
26352,185918,2020-04-19 09:26:24,neo,Zwift - Richmond Challenge Race // Zwift Classic (B),Vector 3,Neo,366,362,4
27042,185918,2020-04-22 18:27:23,neo,Zwift - Deeside Thistle and Moray Firth Crit (Race) (A),Vector 3,Neo,341,330,11
28205,185918,2020-04-26 10:26:30,neo,Zwift - Ramp Test,Vector 3,Neo,353,366,-13
29208,185918,2020-04-29 18:26:18,neo,Zwift - Deeside Thistle and Moray Firth Crit (Race) (A),Vector 3,Neo,336,332,4
30681,185918,2020-05-02 15:55:15,neo,Zwift - YANA Pro/AM Invitiational (A),Vector 3,Neo,360,356,4
30892,185918,2020-05-03 08:55:14,neo,Zwift - Great Britain Cycling Team Endurance Group Ride  (E),Vector 3,Neo,261,258,3
31724,185918,2020-05-05 17:55:12,neo,Zwift -  RCC Zwift Mens Championships - EMEA Region (E),Vector 3,Neo,345,336,9
32522,185918,2020-05-07 17:55:10,neo,Zwift -  RCC Zwift Mens Championships - Semi Final 1 (EMEA) (E),Vector 3,Neo,357,345,12
32699,185918,2020-05-08 09:46:36,neo,Zwift - KISS at Base Training Ride (C),Vector 3,Neo,232,224,8
33297,185918,2020-05-10 12:25:09,neo,Zwift -  RCC Zwift Championships - Men&#039;s Final,Vector 3,Neo,348,342,6
34096,185918,2020-05-12 18:06:16,neo,ZADA Test - Three Sisters,Vector 3,Neo,357,352,5
35284,185918,2020-05-16 10:25:05,neo,Zwift - GGCC Glasgow Green CC Saturday Training ride (C),Vector 3,Neo,366,365,1
35599,185918,2020-05-17 10:07:04,neo,Zwift - Tour for All 2020: Stage 4 Shorter Race A/B,Vector 3,Neo,357,354,3
40841,185918,2020-06-10 18:19:42,neo,Zwift - Deeside Thistle and Moray Firth Time Trial Special (A),Vector 3,Neo,351,345,6
59378,185918,2020-10-04 09:09:57,neo,Zwift - 3R Watopia Road To Sky - 1 Lap (A),Vector 3,Neo,353,352,1
63917,185918,2020-10-21 17:54:59,neo,Zwift - USA Cycling Race League by Indoor Specialist (A),Vector 3,Neo,374,371,3
64244,185918,2020-10-22 18:29:58,neo,Zwift - ZHR Up & Down Race (A),Vector 3,Neo,365,359,6
64560,185918,2020-10-24 08:04:57,neo,Zwift - 3R Weekend Race Club - Race 2 (A),Vector 3,Neo,330,321,9
66889,185918,2020-11-01 08:59:52,neo,Zwift - ZA Road 2020 - Segment Ride #1: Three Sisters Course,Vector 3,Neo,370,365,5
67692,185918,2020-11-03 20:02:41,neo,Zwift - 2 By 2,Vector 3,Neo,312,327,-15
68621,185918,2020-11-06 19:00:48,neo, Tour De Spartacus ,Vector 3,Neo,374,378,-4
68878,185918,2020-11-07 19:03:48,neo,Zwift -  Tour De Spartacus  (E),Vector 3,Neo,339,338,1
69144,185918,2020-11-08 19:03:47,neo,Zwift -  Tour De Spartacus  (E),Vector 3,Neo,383,388,-5
70376,185918,2020-11-11 19:24:43,neo,Zwift - Deeside Thistle and Moray Firth Race (A),Vector 3,Neo,332,343,-11
72253,185918,2020-11-17 18:29:40,neo,Jenson Button & Leger Social Ride,Vector 3,Neo,246,252,-6
72714,185918,2020-11-18 19:24:38,neo,Zwift - Deeside Thistle and Moray Firth Race (A),Vector 3,Neo,374,370,4
94476,185918,2021-01-10 15:08:34,neo,Zwift - Richmond,Vector 3,Neo,328,321,7
95824,185918,2021-01-12 19:47:59,neo,Zwift - Zwift Racing League | WTRL - Men&#039;s/Mixed EMEA W1 DIVISION 4 (A),Vector 3,Neo,366,365,1
98147,185918,2021-01-16 15:11:57,neo,Zwift - DROPS UCI vs. Tindall & Co: Chase! In aid of Cure Parkinson&#039;s (A),Vector 3,Neo,356,353,3
100438,185918,2021-01-20 19:24:53,neo,Zwift - Deeside Thistle and Moray Firth Race (A),Vector 3,Neo,328,329,-1
105533,185918,2021-01-30 11:59:56,neo,Zwift - TDZ Stage 6: Longer Ride,Vector 3,Neo,350,348,2
107639,185918,2021-02-02 19:47:58,neo,Zwift - Zwift Racing League | WTRL - Men&#039;s/Mixed EMEA W1 DIVISION 4 (A),Vector 3,Neo,365,368,-3
111298,185918,2021-02-06 18:57:21,wahoo,power tap / KickrV5,power tap,KickrV5,410,412,-2
114582,185918,2021-02-14 09:59:51,neo,Zwift - TDZ Stage 1: Longer Ride,Vector 3,Neo,331,333,-2
115052,185918,2021-02-15 11:16:50,neo,Zwift - TDZ Stage 6: Standard Ride,Vector 3,Neo,367,367,0
116071,185918,2021-02-16 19:47:50,neo,Zwift - Zwift Racing League | WTRL - Men&#039;s/Mixed EMEA W1 DIVISION 4 (A),Vector 3,Neo,359,362,-3
119795,185918,2021-02-23 19:47:58,neo,Zwift - Zwift Racing League | WTRL - Men&#039;s/Mixed EMEA W1 DIVISION 4 (A),Vector 3,Neo,315,333,-18
120393,185918,2021-02-24 19:24:56,neo,Zwift - Deeside Thistle and Moray Firth Race (A),Vector 3,Neo,352,351,1
121544,185918,2021-02-27 09:36:50,neo,Zwift - Doog Carruthers [TRVL]&#039;s Meetup - Petit Boucle,Vector 3,Neo,393,386,7
29639,186608,2020-04-30 15:49:52,wahoo,Zwift - NYC Double Power Test,Assioma ,Wahoo Kickr 2018,288,281,7
29784,186608,2020-04-29 14:44:52,wahoo,Zwift - Z PRO TRI Race Series / Men&#039;s Race B,Assioma ,Wahoo Kickr to Zwift,410,399,11
30094,186608,2020-05-01 13:34:38,wahoo,Zwift - Crit City Race (A),Assioma ,Wahoo Kickr to Zwift,408,397,11
30113,186608,2020-05-01 14:27:10,wahoo,Zwift - Neues Workout,Assioma ,Wahoo Kickr to Zwift,316,322,-6
32156,186608,2020-05-06 18:08:54,wahoo,Zwift - Z PRO TRI Race Series (A),Assioma ,Wahoo Kickr to Zwift,467,441,26
33173,186608,2020-05-10 07:59:44,wahoo,Zwift - ZTS x Paceheads | Etappe III 39.6km | 507hm (A),Assioma ,Wahoo Kickr to Zwift,432,410,22
34530,186608,2020-05-13 14:36:57,wahoo,Z PRO TRI Race Series: Mens B Race 5,Assioma ,Wahoo Kickr to Zwift,460,442,18
35547,186608,2020-05-17 07:59:56,wahoo,Zwift - ZTS x Paceheads | Etappe IV 19.4km | 80hm (A),Assioma ,Wahoo Kickr to Zwift,424,414,10
36915,186608,2020-05-20 14:50:17,wahoo,Zwift - Z PRO TRI Race Series: Men&#039;s B Race 6,Assioma 2min late ,Wahoo Kickr to Zwift,399,394,5
40878,186608,2020-06-10 15:59:59,wahoo,Zwift - FTP Test,Assioma ,Wahoo Kickr to Zwift,416,409,7
76909,186608,2020-11-28 08:31:11,wahoo,Zwift - ZTS Season II - Race 1 (A),Assioma ,Wahoo Kickr 2018,436,418,18
82201,186608,2020-12-12 08:39:03,wahoo,Zwift - ZTS Season II - Race 2 (A),Assioma ,Wahoo Kickr 2018,419,404,15
13786,188434,2020-02-13 19:03:04,neo,Zwift - Warm up ,Favero Assioma,Neo,246,241,5
14960,188434,2020-02-20 19:02:48,neo,Zwift - Pre-race Warmup [360 VELO],Favero Assioma,Neo,257,258,-1
17303,188434,2020-03-08 19:12:59,neo,Zwift - Tour of Watopia Pro-Am Women&#039;s Race #1 (A),Favero Assioma,Neo,266,255,11
20942,188434,2020-03-31 17:59:04,neo,NCF Spring ,Favero Assioma,Neo,268,262,6
22860,188434,2020-04-07 18:03:03,neo,NCF Spring #3,Favero Assioma,Neo,286,284,2
33291,188434,2020-05-10 11:33:32,neo,ZADA 3 sisters test ,Favero Assioma,Neo,260,255,5
33963,188434,2020-05-12 16:58:43,neo,Zwift - NCF Grand Prix 2020 - Runde 2 - Elite Herrer/Kvinner (B),Favero Assioma,Neo,272,266,6
36125,188434,2020-05-19 18:15:47,neo,Zwift - Tour for All Invitational Race // Women (A),Favero Assioma,Neo,248,250,-2
47738,188434,2020-07-26 10:43:10,neo,Zwift - Watopia,Favero Assioma,Neo,124,121,3
47961,188434,2020-07-26 17:47:09,neo,Zwift - Tour De Boudicca (A),Favero Assioma,Neo,247,243,4
49973,188434,2020-08-14 09:41:41,neo,Zwift - Off the MAAP Invitational Race // Stage 1 (Women) (A),Favero Assioma,Neo,271,264,7
50324,188434,2020-08-17 08:43:52,neo,Off the MAAP Invitational Race // Stage 2 (Women),Morning_Ride,Neo,256,246,10
55158,188434,2020-09-14 18:26:06,neo,Zwift - Invitational League // Qualifying Race #1 (Women),Favero Assioma,Neo,266,262,4
55805,188434,2020-09-17 17:58:02,neo,Invitational League // Qualifying Race #2 (Women),Favero Assioma,Neo,263,259,4
72384,188434,2020-11-17 19:17:23,neo,Zwift - Zwift Racing League | WTRL - Women&#039;s EMEA W1 DIVISION 1 (A),Favero Assioma,Neo,251,245,6
5885,188632,2019-11-11 21:25:24,neo,Zwift - Gravel Grinder - 2x(4x2min) Threshold Fun,Favero BePro,Tacx Neo,245,238,7
15402,188632,2020-02-23 21:51:57,neo,Zwift - FTP Builder - Tempo,Power2Max MTB,Tacx Neo,229,225,4
16529,188632,2020-03-02 21:53:03,neo,Zwift - FTP Builder - Foundation,Favero BePro,Tacx Neo,187,188,-1
20506,188632,2020-03-29 20:22:00,neo,Zwift - Stage 3 - Longer Ride - Tour of Watopia 2020,Favero BePro,Tacx Neo,300,279,21
21830,188632,2020-04-03 17:57:19,neo,Zwift -  Haute Route Watopia Stage 1 (E),Favero BePro,Tacx Neo,275,271,4
22139,188632,2020-04-04 19:59:49,neo,Zwift -  Haute Route Watopia Stage 2 (E),Favero BePro (-3%),Tacx Neo,268,264,4
22455,188632,2020-04-05 17:59:48,neo,Zwift -  Haute Route Watopia Stage 3 (E),Favero BePro (-3%),Tacx Neo,246,249,-3
24776,188632,2020-04-14 20:16:20,neo,Zwift - Trofeo Bologna Race (B),Favero BePro (-3%),Tacx Neo,303,312,-9
29524,188632,2020-04-29 20:19:48,neo,Zwift - 3R Classique Flat Race - 5 Laps (32.3km/20.1mi 95m) (B),Favero BePro (-3%),Tacx Neo,293,286,7
85569,188632,2020-12-20 19:00:00,neo,Zwift - Tour of New York Stage 3 - Open Longer,Favero BePro (-3%),Tacx Neo,299,288,11
108477,188632,2021-02-03 22:00:39,neo,Zwift - TDZ Stage 7: Longer Ride,Favero BePro (-3%),Tacx Neo,306,296,10
110714,188632,2021-02-07 20:17:30,neo,Zwift - SST (Med),Favero BePro (-3%),Tacx Neo,273,273,0
117610,188632,2021-02-18 20:42:22,neo,Zwift - Step By Step,Favero BePro (-3%),Tacx Neo,297,294,3
120081,188632,2021-02-23 20:59:50,neo,Zwift - 3R Volcano Flat Reverse Race - 3 Laps (36.6km/22.7mi 138m) (B),Favero BePro (-3%),Tacx Neo,303,290,13
7684,190507,2019-12-30 18:14:17,neo,Zwift - DBR Monday Race (A),Vector 2s,Neo 1,294,269,25
7884,190507,2020-01-02 16:58:07,neo,Zwift - Jon&#039;s Mix,Assioma Duo,Neo 1,250,236,14
8037,190507,2020-01-04 09:29:03,neo,DBR Saturday Race,Assioma Duo,Neo 1,314,298,16
8224,190507,2020-01-06 18:13:58,neo,DBR Caresport Crit Cup ,Assioma Duo,Neo 1,295,281,14
8484,190507,2020-01-08 19:04:14,neo,DBR HEINO CUP,Assioma Duo,Neo 1,319,306,13
8817,190507,2020-01-11 09:29:01,neo,DBR Saturday Race,Assioma Duo,Neo 1,313,301,12
9160,190507,2020-01-13 18:13:55,neo,DBR Caresport Crit Cup ,Assioma Duo,Neo 1,304,286,18
9585,190507,2020-01-15 19:03:56,neo,DBR HEINO CUP,Assioma Duo,Neo 1,305,294,11
9973,190507,2020-01-19 08:45:46,neo,Zwift - Endurance Bike,Assioma Duo,Neo 1,192,182,10
10174,190507,2020-01-20 18:13:54,neo,DBR Caresport Crit Cup ,Assioma Duo,Neo 1,313,296,17
10477,190507,2020-01-22 19:03:53,neo,Zwift - DBR HEINO CUP (A),Assioma Duo,Neo 1,320,301,19
10619,190507,2020-01-23 17:28:54,neo,Danmarks Cykle Union 2020 Cup,Assioma Duo,Neo 1,301,285,16
10849,190507,2020-01-25 09:08:49,neo,Zwift - Tour de Zwift: Stage 4 Race (A),Assioma Duo,Neo 1,322,310,12
10984,190507,2020-01-26 08:59:27,neo,Zwift - Endurance Bike,Assioma Duo,Neo 1,192,186,6
11180,190507,2020-01-27 18:13:54,neo,Zwift - DBR Caresport Crit Cup  (A),Assioma Duo,Neo 1,312,293,19
11539,190507,2020-01-29 19:03:56,neo,Zwift - DBR Wednesday Race (A),Assioma Duo,Neo 1,322,307,15
12066,190507,2020-01-28 17:58:50,neo,Danmarks Cykle Union 2020 Cup,Assioma Duo,Neo 1,322,308,14
12068,190507,2020-01-28 17:58:50,neo,Neo 1 / Assioma Duo,Assioma Duo,Neo 1,322,308,14
12070,190507,2020-02-01 08:58:48,neo,Zwift - Danmarks Cykle Union 2020 Cup (A),Assioma Duo,Neo 1,317,301,16
12099,190507,2020-02-02 07:18:27,neo,Zwift - Endurance bike,Assioma Duo,Neo 1,192,182,10
12292,190507,2020-02-03 18:13:55,neo,Zwift - DBR Monday Race  (A),Assioma Duo,Neo 1,311,295,16
12644,190507,2020-02-05 19:03:49,neo,Zwift - DBR Wednesday Race (A),Assioma Duo,Neo 1,307,288,19
12767,190507,2020-02-06 17:28:52,neo,Zwift - Danmarks Cykle Union 2020 Cup (A),Assioma Duo,Neo 1,302,285,17
13011,190507,2020-02-08 09:28:51,neo,DBR Saturday Race (A),Assioma Duo,Neo 1,300,288,12
13299,190507,2020-02-10 18:13:47,neo,Zwift - DBR Winter Cup (A),Assioma Duo,Neo 1,316,302,14
13683,190507,2020-02-11 17:59:46,neo,Zwift - Danmarks Cykle Union 2020 Cup (A),Assioma Duo,Neo 1,319,296,23
13686,190507,2020-02-12 19:03:43,neo,Zwift - DBR Wednesday Race (A),Assioma Duo,Neo 1,315,297,18
14029,190507,2020-02-15 08:59:47,neo,Zwift - Danmarks Cykle Union 2020 Cup (A),Assioma Duo,Neo 1,303,288,15
14173,190507,2020-02-16 07:53:30,neo,Zwift - Endurance bike 3,Assioma Duo,Neo 1,200,192,8
14376,190507,2020-02-17 18:13:39,neo,Zwift - DBR Winter Cup (A),Assioma Duo,Neo 1,298,285,13
14609,190507,2020-02-18 19:13:40,neo,Zwift - Feltet.dk Race Series,Assioma Duo,Neo 1,309,294,15
14733,190507,2020-02-19 19:03:40,neo,Zwift - DBR Winter Cup (A),Assioma Duo,Neo 1,305,292,13
14926,190507,2020-02-20 17:29:40,neo,Zwift - Danmarks Cykle Union 2020 Cup (A),Assioma Duo,Neo 1,313,291,22
15456,190507,2020-02-24 18:13:35,neo,Zwift - DBR Winter Cup (A),Assioma Duo,Neo 1,326,309,17
15599,190507,2020-02-25 19:13:34,neo,Zwift - Feltet.dk Race Series (A),Assioma Duo,Neo 1,322,324,-2
15763,190507,2020-02-26 19:03:34,neo,Zwift - DBR Winter Cup (A),Assioma Duo,Neo 1,313,298,15
16175,190507,2020-02-29 08:59:33,neo,Zwift - Danmarks Cykle Union 2020 Cup (A),Assioma Duo,Neo 1,319,301,18
16486,190507,2020-03-02 17:29:34,neo,Zwift - Danmarks Cykle Union 2020 Cup (A),Assioma Duo,Neo 1,297,281,16
16489,190507,2020-03-02 18:13:37,neo,Zwift - DBR Winter Cup (A),Assioma Duo,Neo 1,302,283,19
16972,190507,2020-03-05 17:29:30,neo,Zwift - Danmarks Cykle Union 2020 Cup (A),Assioma Duo,Neo 1,328,313,15
17129,190507,2020-03-07 09:28:29,neo,Zwift - DBR Saturday Race (A),Assioma Duo,Neo 1,316,303,13
17382,190507,2020-03-09 18:13:27,neo,Zwift - DBR Winter Cup (A),Assioma Duo,Neo 1,320,307,13
17517,190507,2020-03-10 17:59:28,neo,Zwift - Danmarks Cykle Union 2020 Cup (A),Assioma Duo,Neo 1,306,305,1
17708,190507,2020-03-11 19:03:27,neo,Zwift - DBR Winter Cup (A),Assioma Duo,Neo 1,310,310,0
17764,190507,2020-03-12 08:08:25,neo,Zwift - Stage 1 Race (A) - Tour of Watopia 2020,Assioma Duo,Neo 1,306,289,17
17913,190507,2020-03-13 08:08:27,neo,Zwift - Stage 2 Race (A) - Tour of Watopia 2020,Assioma Duo,Neo 1,317,301,16
18020,190507,2020-03-14 08:59:26,neo,Zwift - Danmarks Cykle Union 2020 Cup (A),Assioma Duo,Neo 1,321,305,16
18311,190507,2020-03-16 17:29:25,neo,Zwift - Danmarks Cykle Union 2020 Cup (A),Assioma Duo,Neo 1,302,288,14
18348,190507,2020-03-17 08:08:24,neo,Zwift - Stage 3 Race (A) - Tour of Watopia 2020,Assioma Duo,Neo 1,309,297,12
18453,190507,2020-03-17 19:13:27,neo,Zwift - Feltet.dk Race Series (A),Assioma Duo,Neo 1,307,296,11
18750,190507,2020-03-19 17:29:24,neo,Zwift - Danmarks Cykle Union 2020 Cup (A),Assioma Duo,Neo 1,317,301,16
18881,190507,2020-03-20 14:28:51,neo,Zwift - Power bike 5,Assioma Duo,Neo 1,242,221,21
19118,190507,2020-03-22 08:59:23,neo,Zwift - Danmarks Cykle Union 2020 Cup (A),Assioma Duo,Neo 1,342,328,14
19265,190507,2020-03-23 07:13:40,neo,Zwift - 45min Riders Choice,Assioma Duo,Neo 1,161,152,9
19408,190507,2020-03-24 17:59:23,neo,Zwift - Danmarks Cykle Union 2020 Cup (A),Assioma Duo,Neo 1,314,297,17
19440,190507,2020-03-24 19:13:21,neo,Zwift - Feltet.dk Race Series (A),Assioma Duo,Neo 1,301,292,9
19702,190507,2020-03-26 08:10:50,neo,Zwift - Power bike 6,Assioma Duo,Neo 1,239,223,16
19915,190507,2020-03-27 07:46:29,neo,Zwift - Endurance bike 27/3,Assioma Duo,Neo 1,199,192,7
20074,190507,2020-03-28 08:59:20,neo,Zwift - Danmarks Cykle Union 2020 Cup (A),Assioma Duo,Neo 1,304,289,15
20605,190507,2020-03-30 16:29:21,neo,Zwift - Danmarks Cykle Union 2020 Cup (A),Assioma Duo,Neo 1,330,314,16
21520,190507,2020-04-02 17:58:19,neo,Zwift - KALAS Cup - Round 10 (A),Assioma Duo,Neo 1,318,316,2
21978,190507,2020-04-04 08:28:17,neo,Zwift - DBR Sufferday League (A),Assioma Duo,Neo 1,321,307,14
22584,190507,2020-04-06 17:13:15,neo,Zwift - DBR Wahoo League (A),Assioma Duo,Neo 1,321,303,18
23074,190507,2020-04-08 18:03:16,neo,Zwift - DBR Sprinthooligan Cup (A),Assioma Duo,Neo 1,315,298,17
23676,190507,2020-04-11 08:28:12,neo,Zwift - DBR Sufferday League (A),Assioma Duo,Neo 1,312,317,-5
23952,190507,2020-04-12 08:26:48,neo,Zwift - Short Intervals 12/4,Assioma Duo,Neo 1,267,255,12
24301,190507,2020-04-13 17:13:15,neo,Zwift - DBR Wahoo League (A),Assioma Duo,Neo 1,320,304,16
24970,190507,2020-04-15 18:03:13,neo,Zwift - DBR Sprinthooligan Cup (A),Assioma Duo,Neo 1,309,292,17
25785,190507,2020-04-18 08:28:11,neo,Zwift - DBR Sufferday League (A),Assioma Duo,Neo 1,319,300,19
26470,190507,2020-04-20 17:13:09,neo,Zwift - DBR Wahoo League (A),Assioma Duo,Neo 1,321,304,17
27056,190507,2020-04-22 18:03:09,neo,Zwift - DBR Sprinthooligan Cup (A),Assioma Duo,Neo 1,327,313,14
27721,190507,2020-04-24 06:51:29,neo,Zwift - Short Intervals 24/4,Assioma Duo,Neo 1,278,263,15
27825,190507,2020-04-25 08:28:07,neo,Zwift - DBR Sufferday League (A),Assioma Duo,Neo 1,321,304,17
28470,190507,2020-04-27 17:13:07,neo,Zwift - DBR Wahoo League (A),Assioma Duo,Neo 1,311,292,19
29162,190507,2020-04-29 17:28:04,neo,Zwift - Danmarks Cykle Union – mid-week racing  (A),Assioma Duo,Neo 1,331,313,18
30469,190507,2020-05-02 08:28:03,neo,Zwift - DBR Sufferday League (A),Assioma Duo,Neo 1,319,308,11
31344,190507,2020-05-04 17:13:02,neo,Zwift - DBR Wahoo League (A),Assioma Duo,Neo 1,310,291,19
31729,190507,2020-05-05 18:13:03,neo,Zwift - UNO X CUP powered by DCU & Feltet.dk (A),Assioma Duo,Neo 1,311,291,20
33087,190507,2020-05-07 07:44:55,neo,Zwift - Short Intervals 7/5,Assioma Duo,Neo 1,261,248,13
33089,190507,2020-05-09 08:08:00,neo,Zwift - Tour for All 2020: Stage 2 Longer Race A/B,Assioma Duo,Neo 1,307,309,-2
33683,190507,2020-05-11 17:12:59,neo,Zwift - DBR Wahoo League (A),Assioma Duo,Neo 1,310,288,22
34073,190507,2020-05-12 18:12:58,neo,Zwift - UNO X CUP powered by DCU & Feltet.dk (A),Assioma Duo,Neo 1,311,294,17
34599,190507,2020-05-14 08:47:56,neo,Zwift - Short Intervals 14/5,Assioma Duo,Neo 1,272,260,12
35129,190507,2020-05-15 07:14:36,neo,Zwift - Endurance bike 27/3,Assioma Duo,Neo 1,220,208,12
35844,190507,2020-05-18 17:12:54,neo,Zwift - DBR Wahoo League (A),Assioma Duo,Neo 1,315,291,24
36408,190507,2020-05-20 18:02:54,neo,DBR Boerkop Cykler Cup,Assioma Duo,Neo 1,314,293,21
36810,190507,2020-05-22 06:16:27,neo,Zwift - Long Intervals 21/5,Assioma Duo,Neo 1,266,257,9
37649,190507,2020-05-25 17:12:52,neo,Zwift - DBR Wahoo League (A),Assioma Duo,Neo 1,302,284,18
38123,190507,2020-05-27 18:02:50,neo,Zwift - DBR Boerkop Cykler Cup (A),Assioma Duo,Neo 1,316,296,20
38960,190507,2020-06-01 17:12:49,neo,Zwift - DBR Wahoo League (A),Assioma Duo,Neo 1,316,299,17
39423,190507,2020-06-03 18:02:46,neo,Zwift - DBR Boerkop Cykler Cup (A),Assioma Duo,Neo 1,310,290,20
39640,190507,2020-06-04 18:13:20,neo,Zwift - Frappe,Assioma Duo,Neo 1,303,290,13
40363,190507,2020-06-08 17:12:46,neo,Zwift - DBR Wahoo League (A),Assioma Duo,Neo 1,313,299,14
41096,190507,2020-06-11 17:17:48,neo,Assioma Duo / Neo 1,Assioma Duo,Neo 1,299,286,13
42250,190507,2020-06-17 18:02:41,neo,Zwift - DBR Boerkop Cykler Cup (A),Assioma Duo,Neo 1,286,265,21
42464,190507,2020-06-18 18:10:43,neo,Zwift - Frappe,Assioma Duo,Neo 1,297,287,10
43426,190507,2020-06-24 18:02:40,neo,Zwift - DBR Boerkop Cykler Cup (A),Assioma Duo,Neo 1,327,308,19
43599,190507,2020-06-25 17:19:45,neo,Zwift - WTRL Team Time Trial Premier League (D),Assioma Duo,Neo 1,299,285,14
44584,190507,2020-07-02 17:21:44,neo,Zwift - Frappe,Assioma Duo,Neo 1,312,305,7
46488,190507,2020-07-15 17:54:40,neo,Zwift - USA Cycling Race League by Indoor Specialist (A),Assioma Duo,Neo 1,294,279,15
50508,190507,2020-08-18 09:59:23,neo,Zwift - Off The MAAP Stage 2 Race (A),Assioma Duo,Neo 1,294,276,18
50727,190507,2020-08-19 16:29:22,neo,Zwift - DT Swiss & Alpecin Cycling Reborn Faster Festival - Race (A),Assioma Duo,Neo 1,314,297,17
50773,190507,2020-08-17 17:14:24,neo,Zwift - DBR Monday Race  (A),Assioma Duo,Neo 1,308,291,17
53531,190507,2020-09-05 11:14:13,neo,Zwift - 3R Tick Tock Flat Race - 2 Lap (36km/22.4mi 100m) (A),Assioma Duo,Neo 1,279,261,18
53620,190507,2020-09-06 07:09:12,neo,Zwift - 3R Figure 8 Hilly Race - 1 Lap (29.2km/18.1m 234m) (A),Assioma Duo,Neo 1,292,270,22
53791,190507,2020-09-07 17:14:12,neo,Zwift - DBR Ride´N´Roll League (A),Assioma Duo,Neo 1,299,284,15
54325,190507,2020-09-10 09:44:10,neo,Zwift - TBR Kettle and Boil (C),Assioma Duo,Neo 1,280,260,20
54574,190507,2020-09-11 08:44:07,neo,Zwift - Crit City Race (A),Assioma Duo,Neo 1,309,283,26
55229,190507,2020-09-14 17:14:07,neo,Zwift - DBR Ride´N´Roll League (A),Assioma Duo,Neo 1,300,280,20
55588,190507,2020-09-16 17:44:07,neo,Zwift - DCU powered by Feltet.dk (A),Assioma Duo,Neo 1,309,287,22
56133,190507,2020-09-18 07:59:06,neo,Zwift -  Stage 1 // Virtual Haute Route Ventoux  (A),Assioma Duo,Neo 1,294,278,16
56678,190507,2020-09-21 17:14:04,wahoo,Zwift - DBR Ride´N´Roll League (A),Assioma Duo,Wahoo Kickr v5.,315,304,11
56756,190507,2020-09-22 06:24:04,wahoo,Zwift - 3R Watopia Flat Route Race - 3 Laps (30.3km/18.8mi 162m) (A),Assioma Duo,Wahoo Kickr v5.,287,276,11
57078,190507,2020-09-23 17:44:08,wahoo,Zwift - DCU powered by Feltet.dk (A),Assioma Duo,Wahoo Kickr v5.,299,290,9
57296,190507,2020-09-24 17:29:04,wahoo,Zwift - FUSION ECT BEUNSTOPPABLE Racing Series (A),Assioma Duo,Wahoo Kickr v5.,298,289,9
57640,190507,2020-09-26 08:04:01,wahoo,Zwift - 3R Flat Race (A),Assioma Duo,Wahoo Kickr v5.,311,296,15
58087,190507,2020-09-28 17:14:01,wahoo,Zwift - DBR Ride´N´Roll League (A),Assioma Duo,Wahoo Kickr v5.,309,300,9
58574,190507,2020-09-30 17:43:59,wahoo,Zwift - DCU powered by Feltet.dk (A),Assioma Duo,Wahoo Kickr v5.,309,300,9
58886,190507,2020-10-01 18:11:51,wahoo,Zwift - Mocha,Assioma Duo,Wahoo Kickr v5.,281,273,8
59166,190507,2020-10-03 07:03:58,wahoo,Zwift - 3R Flat Race (A),Assioma Duo,Wahoo Kickr v5.,296,283,13
59638,190507,2020-10-05 17:13:53,wahoo,Zwift - DBR Ride´N´Roll League (A),Assioma Duo,Wahoo Kickr v5.,306,292,14
60140,190507,2020-10-07 17:44:48,wahoo,DCU Iagttagelseslob powered by Feltet.dk,Assioma Duo,Wahoo Kickr v5.,308,291,17
60419,190507,2020-10-08 18:13:44,wahoo,Zwift - WTRL Team Time Trial - Zone 5 (C),Assioma Duo,Wahoo Kickr v5.,298,288,10
60754,190507,2020-10-10 08:04:47,wahoo,Zwift - 3R Flat Race (A),Assioma Duo,Wahoo Kickr v5.,287,274,13
62565,190507,2020-10-17 07:04:48,wahoo,Zwift - 3R Weekend Race Club - Race 1 (A),Assioma Duo,Wahoo Kickr v5.,296,273,23
62566,190507,2020-10-17 08:04:49,wahoo,Zwift - 3R Weekend Race Club - Race 2 (A),Assioma Duo,Wahoo Kickr v5.,285,273,12
63488,190507,2020-10-20 17:19:46,wahoo,Zwift - Zwift Racing League | WTRL - EMEA E (MEN) - TTT Grp 2 (D),Assioma Duo,Wahoo Kickr v5.,300,291,9
63949,190507,2020-10-21 18:04:47,wahoo,Zwift - DBR HEINO CUP III (A),Assioma Duo,Wahoo Kickr v5.,308,291,17
64266,190507,2020-10-22 17:29:43,wahoo,Zwift - FUSION ECT BEUNSTOPPABLE Racing Series (A),Assioma Duo,Wahoo Kickr v5.,312,306,6
65518,190507,2020-10-27 18:19:44,wahoo,Zwift - Zwift Racing League | WTRL - EMEA E (MEN) -  Division 6 (A),Assioma Duo,Wahoo Kickr v5.,310,298,12
65892,190507,2020-10-24 07:05:23,wahoo,Zwift - 3R Tick Tock Flat Race - 2 Lap (36km/22.4mi 100m) (A),Assioma Duo,Wahoo Kickr v5.,304,299,5
65900,190507,2020-10-28 19:14:53,wahoo,3R Tick Tock Flat Race - 2 Lap (36km/22.4mi 100m),Assioma Duo,Wahoo Kickr v5.,304,296,8
66241,190507,2020-10-29 18:30:10,wahoo,Zwift - FUSION ECT BEUNSTOPPABLE Racing Series (A),Assioma Duo,Wahoo Kickr v5.,311,300,11
66901,190507,2020-11-01 07:52:56,wahoo,Zwift - Short intervals 2,Assioma Duo,Wahoo Kickr v5.,279,271,8
67627,190507,2020-11-03 18:23:01,wahoo,Zwift - Zwift Racing League | WTRL - Men&#039;s EMEA E2 DIVISION 2 (A),Assioma Duo,Wahoo Kickr v5.,312,300,12
67989,190507,2020-11-04 19:04:48,wahoo,Zwift - DBR HEINO CUP III (A),Assioma Duo,Wahoo Kickr v5.,313,298,15
68959,190507,2020-11-08 05:46:29,wahoo,Zwift - KISS at Race 100 - EU (A),Assioma Duo,Wahoo Kickr v5.,328,303,25
70368,190507,2020-11-11 19:04:47,wahoo,Zwift - DBR HEINO CUP III (A),Assioma Duo,Wahoo Kickr v5.,328,310,18
70580,190507,2020-11-12 11:06:16,wahoo,Accuracy Test,Assioma Duo,Wahoo Kickr v5.,269,262,7
71727,190507,2020-11-15 07:59:55,wahoo,Zwift - Endurance bike 3,Assioma Duo,Wahoo Kickr v5.,189,183,6
72705,190507,2020-11-18 19:04:48,wahoo,Zwift - DBR HEINO CUP III (A),Assioma Duo,Wahoo Kickr v5.,300,288,12
73219,190507,2020-11-19 19:29:47,wahoo,Zwift - World Championships Experience // Danish Cycling Federation,Assioma Duo,Wahoo Kickr v5.,325,297,28
73757,190507,2020-11-21 09:04:48,wahoo,Zwift - 3R Weekend Race Club - Race 2 (A),Assioma Duo,Wahoo Kickr v5.,319,305,14
75108,190507,2020-11-24 18:19:46,wahoo,Zwift - Zwift Racing League | WTRL - Men&#039;s EMEA E2 DIVISION 2,Assioma Duo,Wahoo Kickr v5.,339,316,23
75630,190507,2020-11-25 19:05:02,wahoo,Zwift - DBR HEINO CUP III (A),Assioma Duo,Wahoo Kickr v5.,306,288,18
77541,190507,2020-11-30 09:50:36,wahoo,Zwift - Jon&#039;s Short Mix,Assioma Duo,Wahoo Kickr v5.,257,256,1
78103,190507,2020-12-01 18:23:33,wahoo,,Assioma Duo,Wahoo Kickr v5,295,280,15
78550,190507,2020-12-02 16:10:12,wahoo,Zwift - 3R Tick Tock Flat Race - 2 Lap (36km/22.4mi 100m) (A),Assioma Duo,Wahoo Kickr v5,300,285,15
80496,190507,2020-12-07 17:55:22,wahoo,Zwift - Marcel Moesgaard[DZR]&#039;s Meetup - 2019 UCI Worlds Harrogate Circuit,Assioma Duo,Wahoo Kickr v5,264,261,3
80792,190507,2020-12-08 18:20:19,wahoo,Zwift - Zwift Racing League | WTRL - Men&#039;s EMEA E2 DIVISION 2 (A),Assioma Duo,Wahoo Kickr v5,321,301,20
80977,190507,2020-12-09 09:05:20,wahoo,Zwift - 3R Watopia Flat Route Race - 3 Laps (30.3km/18.8mi 162m) (A),Assioma Duo,Wahoo Kickr v5,297,286,11
81660,190507,2020-12-10 18:30:11,wahoo,Zwift - FUSION DECEMBER CUP (A),Assioma Duo,Wahoo Kickr v5,315,303,12
82177,190507,2020-12-12 08:05:22,wahoo,Zwift - 3R Weekend Race Club - Race 1 (A),Assioma Duo,Wahoo Kickr v5,292,285,7
83595,190507,2020-12-15 18:23:42,wahoo,Zwift - Zwift Racing League | WTRL - Men&#039;s EMEA E2 DIVISION 2 (A),Assioma Duo,Wahoo Kickr v5,294,284,10
84453,190507,2020-12-17 18:30:14,wahoo,Zwift - FUSION DECEMBER CUP (A),Assioma Duo,Wahoo Kickr v5,311,298,13
84636,190507,2020-12-18 10:28:05,wahoo,Zwift - Watopia,Assioma Duo,Wahoo Kickr v5,193,188,5
84974,190507,2020-12-19 09:05:18,wahoo,Zwift - 3R Weekend Race Club - Race 2 (A),Assioma Duo,Wahoo Kickr v5,289,287,2
85586,190507,2020-12-20 20:15:11,wahoo,Zwift - 3R Greater London Flat Race - 3 Laps (40.2km/25mi 135m) (A),Assioma Duo,Wahoo Kickr v5,306,302,4
86047,190507,2020-12-22 08:30:21,wahoo,Zwift - Endurance bike 3,Assioma Duo,Wahoo Kickr v5,190,186,4
88287,190507,2020-12-28 18:15:20,wahoo,Zwift -  DBR Monday Race (A),Assioma Duo,Wahoo Kickr v5,318,316,2
89172,190507,2020-12-30 18:40:18,wahoo,Zwift - Danmarks Cykle Union – December Fun  (A),Assioma Duo,Wahoo Kickr v5,272,268,4
89221,190507,2020-12-30 16:10:10,wahoo,Zwift - 3R Tick Tock Flat Race - 2 Lap (36km/22.4mi 100m) (A),Assioma Duo,Wahoo Kickr v5,297,295,2
90309,190507,2021-01-02 16:05:11,wahoo,Zwift - 3R Classique Flat Race - 4 Laps (26.9km/16.7mi 76m) (A),Assioma Duo,Wahoo Kickr v5,316,313,3
90862,190507,2021-01-03 15:25:12,wahoo,Zwift - 3R Watopia 65km Race - 6 laps (40mi 324m) (A),Assioma Duo,Wahoo Kickr v5,310,301,9
92420,190507,2021-01-06 19:05:12,wahoo,Zwift - DBR Wednesday Race (A),Assioma Duo,Wahoo Kickr v5,302,293,9
92978,190507,2021-01-07 18:30:11,wahoo,Zwift - FUSION WINTER CUP (A),Assioma Duo,Wahoo Kickr v5,303,294,9
93408,190507,2021-01-08 15:30:19,wahoo,Zwift - DBR Friday Race (A),Assioma Duo,Wahoo Kickr v5,293,283,10
97124,190507,2021-01-14 18:30:11,wahoo,Zwift - FUSION WINTER CUP (A),Assioma Duo,Wahoo Kickr v5,304,296,8
97810,190507,2021-01-16 09:05:18,wahoo,Zwift - 3R Weekend Race Club - Race 2 (A),Assioma Duo,Wahoo Kickr v5,300,293,7
98699,190507,2021-01-17 07:29:54,wahoo,Zwift - Endurance bike 27/3,Assioma Duo,Wahoo Kickr v5,269,263,6
99828,190507,2021-01-19 18:31:53,wahoo,Zwift - Zwift Racing League | WTRL - Men&#039;s/Mixed EMEA E2 DIVISION 6 (A),Assioma Duo,Wahoo Kickr v5,294,288,6
100407,190507,2021-01-20 19:05:25,wahoo,DBR Wednesday Race,Assioma Duo,Wahoo Kickr v5,288,282,6
101044,190507,2021-01-21 18:30:21,wahoo,Zwift - FUSION WINTER CUP (A),Assioma Duo,Wahoo Kickr v5,303,299,4
103630,190507,2021-01-26 18:29:17,wahoo,Zwift - Zwift Racing League | WTRL - Men&#039;s/Mixed EMEA E2 DIVISION 6 (A),Assioma Duo,Wahoo Kickr v5,327,300,27
104770,190507,2021-01-28 18:30:13,wahoo,Zwift - FUSION WINTER CUP (A),Assioma Duo,Wahoo Kickr v5,307,301,6
105725,190507,2021-01-30 16:05:10,wahoo,Zwift - 3R Classique Flat Race - 4 Laps (26.9km/16.7mi 76m) (A),Assioma Duo,Wahoo Kickr v5,309,302,7
65066,190665,2020-10-26 15:42:17,wahoo,Zwift - Watopia Kickr v5,4iiii,Kickr v5,211,207,4
69063,190665,2020-11-08 10:50:37,wahoo,Zwift - Yorkshire,4iiii,Kickr v5,272,280,-8
75981,190665,2020-11-26 16:27:22,wahoo,Zwift - Jon&#039;s Mix,4iiii,Kickr v5,289,296,-7
77431,190665,2020-11-29 17:00:01,wahoo,Zwift - Focus: Colours of PARI - Shorter Ride,4iiii,Kickr v5,320,336,-16
116598,190665,2021-02-17 17:09:48,wahoo,Zwift - Watopia,4iiii,Kickr v5,280,277,3
118307,190665,2021-02-20 16:07:12,wahoo,Zwift - 3R Endurance Series p/b OTE Sports- Stage 1 (B),4iiii,Kickr v5,308,318,-10
118745,190665,2021-02-21 15:25:16,wahoo,Zwift - 3R Watopia 65km Race - 6 laps (40mi 324m) (B),2021_02_21_15_26_50,Kickr v5,286,294,-8
119543,190665,2021-02-23 16:31:00,wahoo,Zwift - TEAM VEGAN Tofu Tornado (B),4iiii,Kickr v5,353,341,12
83964,191244,2020-12-16 16:48:20,wahoo,Assioma / Kickr,Assioma,Kickr,103,104,-1
84380,191244,2020-12-17 18:00:00,wahoo,Assioma / Kickr,Assioma,Kickr,227,208,19
84665,191244,2020-09-21 08:56:55,wahoo,Assioma morten sin Kickr / Kickr morten sin,Kickr morten sin,Assioma morten sin Kickr,245,256,-11
85008,191244,2020-12-19 11:42:27,wahoo,Assioma Truls / Kickr Truls,Assioma Truls,Kickr Truls,100,110,-10
85082,191244,2020-12-19 14:07:37,wahoo,Assioma / Kickr Truls,Assioma,Kickr Truls,180,175,5
85158,191244,2020-12-19 17:28:20,wahoo,Assioma / Kickr,Assioma,Kickr,100,101,-1
85659,191244,2020-12-20 18:29:58,wahoo,Assioma / Kickr,Assioma,Kickr,224,205,19
92660,191244,2021-01-07 13:05:01,wahoo,Assioma / Kickr 2,Assioma,Kickr 2,138,136,2
93006,191244,2021-01-07 18:10:00,wahoo,Assioma / Kickr 2,Assioma,Kickr 2,251,243,8
93270,191244,2021-01-08 10:51:59,wahoo,Assioma / Kickr 2,Assioma,Kickr 2,224,216,8
42194,191271,2020-06-17 16:00:19,wahoo,SSAT Ace Cycles Virtual Racing Series (A),4iiii Precision Power meter (Shimano 105),Wahoo KICKR Gen1,362,357,5
43428,191271,2020-06-24 16:00:19,wahoo,SSAT Ace Cycles Virtual Racing Series (A),4iiii Precision Power meter (Shimano 105),Wahoo KICKR 4,366,367,-1
46459,191271,2020-07-15 16:00:20,wahoo,Zwift - Support SA Talent Virtual Racing Series (A),4iiii Precision Power meter (Shimano 105),Wahoo KICKR Gen1,356,358,-2
47313,191271,2020-07-22 16:00:17,wahoo,Support SA Talent Virtual Racing Series (A),4iiii Precision Power meter (Shimano 105),Wahoo KICKR Gen1,382,387,-5
48162,191271,2020-07-29 16:00:18,wahoo,Support SA Talent Virtual Racing Series (A),4iiii Precision Power meter (Shimano 105),Wahoo KICKR Gen1,359,347,12
48939,191271,2020-08-05 16:00:16,wahoo,Support SA Talent Virtual Racing Series (A),4iiii Precision Power meter (Shimano 105),Wahoo KICKR 4,390,391,-1
53076,191271,2020-09-02 16:01:20,wahoo,Zwift - Support SA Talent Virtual Racing Series,4iiii Precision Power meter (Shimano 105),Wahoo KICKR Gen1,392,391,1
54145,191271,2020-09-09 16:00:03,wahoo,Support SA Talent Virtual Racing Series,4iiii Precision Power meter (Shimano 105),Wahoo KICKR Gen1,381,374,7
55629,191271,2020-09-16 15:59:59,wahoo,Support SA Talent Virtual Racing Series,4iiii Precision Power meter (Shimano 105),Wahoo KICKR 4,385,384,1
107048,191271,2021-02-02 03:29:54,wahoo,Zwift - THE PREMIER LEAGUE SA COMMUNITY SERIES (A),4iiii Precision Power meter (Shimano 105),Wahoo KICKR 4,358,360,-2
121890,193323,2021-02-27 08:21:47,neo,Zwift - Watopia,6421124195_ACTIVITY,TACX NEO,270,270,0
61625,195556,2020-10-13 18:46:02,neo,"Zwift - Zwift Racing League | WTRL - 6th out of 116, chuffed with that",Power2max Type S (Campagnolo),Tacx Neo v1,326,320,6
63573,195556,2020-10-20 18:52:01,neo,Zwift - Zwift Racing League | WTRL - EMEA (MEN) - TTT Grp 5 (E),Power2max Type S (Campagnolo),Tacx Neo v1,319,313,6
65584,195556,2020-10-27 19:46:02,neo,"Zwift - Zwift Racing League | WTRL - EMEA W (MEN) -  Division 1 (B)- absolutely brutal first lap, im too diesel for this stuff these days!!!",Power2max Type S (Campagnolo),Tacx Neo v1,341,341,0
67721,195556,2020-11-03 19:55:03,neo,Zwift - Zwift Racing League | WTRL - Men&#039;s EMEA W1 DIVISION 1 (B) rode really well as a team,Power2max Type S (Campagnolo),Tacx Neo v1,311,305,6
72342,195556,2020-11-17 19:55:31,wahoo,"Zwift - Zwift Racing League | WTRL - Men&#039;s EMEA W1 DIVISION 1 (B), great effort by all",Power2max Type S (Campagnolo),Wahoo Kickr V5,328,313,15
78222,195556,2020-12-01 19:56:01,neo,"Zwift - Zwift Racing League | WTRL - Men&#039;s EMEA W1 DIVISION 1 (B), great team ride",Power2max Type S (Campagnolo),Tacx Neo v1,327,318,9
96126,195556,2021-01-12 19:45:45,neo,"Zwift - Zwift Racing League | WTRL - Men&#039;s/Mixed EMEA W1 DIVISION 1 (B), 13th and some intermediate points, happy with that",Power2max Type S (Campagnolo),Tacx Neo v1,369,362,7
103745,195556,2021-01-26 19:15:34,neo,"Zwift - Zwift Racing League | WTRL - Men&#039;s/Mixed EMEA W1 DIVISION 1 - 6th place, not bad for a fat lad on that climb",Power2max Type S (Campagnolo),Tacx Neo v1,345,338,7
104214,195556,2021-01-27 17:30:03,neo,"Zwift - LEQP Provence Rose Ride (C), on the tt bike nice and steady",TT Bike Quarq dzero,Tacx Neo v1,279,272,7
107617,195556,2021-02-02 19:52:51,neo,"Zwift - Zwift Racing League | WTRL - Men&#039;s/Mixed EMEA W2 DIVISION 2 (A), got up the drag then dropped on descent ffs, 63rd out of 89",Power2max Type S (Campagnolo),Tacx Neo v1,359,345,14
111813,195556,2021-02-09 20:00:22,neo,Zwift - Zwift Racing League | WTRL - Men&#039;s/Mixed EMEA W2 DIVISION 2 (A),Power2max Type S (Campagnolo),Tacx Neo v1,341,341,0
116112,195556,2021-02-16 19:52:50,neo,Zwift - Zwift Racing League | WTRL - Men&#039;s/Mixed EMEA W2 DIVISION 2 (A),Power2max Type S (Campagnolo),Tacx Neo v1,345,343,2
110344,196088,2021-02-06 14:43:53,wahoo,Zwift - TDZ Stage 7: Longer Ride,stages,wahoo kickr v5,266,255,11
3287,196246,2019-10-26 13:58:27,neo,Zwift - 10/26/2019 P Race,Quarq dfour,Tacx Neo,331,323,8
3456,196246,2019-10-29 16:08:25,neo,Zwift - 3R WATOPIA-Watopia Flat Route Reverse Race - 4 Laps (41km/25.5mi 216m) (A),Quarq dfour,Tacx Neo,341,333,8
3574,196246,2019-10-31 17:03:23,neo,Zwift - OH CRIT!! - The Double Race - Race 2/2 (A),Quarq dfour,Tacx Neo,321,319,2
3736,196246,2019-11-03 14:13:26,neo,Zwift - KISS at Race 100 - Americas (A),Quarq dfour,Tacx Neo,350,340,10
3959,196246,2019-11-07 16:03:16,neo,Zwift - OH CRIT!! - The Double Race - Race 1/2 (A),Quarq dfour,Tacx Neo,371,361,10
4009,196246,2019-11-09 15:13:15,neo,Zwift - OH CRIT!! - Saturday Smash Series (A),Quarq dfour,Tacx Neo,314,305,9
4051,196246,2019-11-10 14:13:14,neo,Zwift - KISS at Race 100 - Americas (A),Quarq dfour,Tacx Neo,346,333,13
4398,196246,2019-11-17 14:13:09,neo,Zwift - KISS at Race 100 - Americas (A),Quarq dfour,Tacx Neo,331,321,10
120395,196430,2021-02-24 18:30:03,wahoo,Zwift - 3R Race - France Petit Boucle - 45KM (A),4iiii,Wahoo Kickr,336,316,20
93413,196512,2021-01-08 17:59:53,wahoo,Zwift - KIRCHMAIR Race Series (A),Power Tap,Kickr,408,444,-36
97668,196512,2021-01-15 23:59:57,wahoo,Zwift - EVR Americas (A),Quarq ,Kickr,344,349,-5
109549,196512,2021-02-05 22:59:54,wahoo,Zwift - TDZ Stage 7: Longer Ride,2021-02-05-17-59-54,Kickr Gen5,430,444,-14
110101,196512,2021-01-08 17:59:53,wahoo,Power Tap / Kickr Gen5,Power Tap,Kickr Gen5,408,412,-4
111633,196512,2021-01-04 22:41:46,wahoo,Zwift - TDZ Stage 8: Group Ride,Power Tap Pedals,Kickr Gen5,488,466,22
112528,196512,2021-02-10 22:16:21,wahoo,Zwift - Watopia,Kickr Gen5,Kickr Gen5,363,361,2
112532,196512,2021-02-10 23:14:23,wahoo,Zwift - Watopia,Power Tap Pedals,Kickr Gen5,420,423,-3
113225,196512,2021-02-12 00:27:53,wahoo,Zwift - Watopia,Power Tap Pedals,Kickr Gen5,488,506,-18
114450,196512,2021-02-13 19:14:56,wahoo,Zwift - TDZ Stage 6: Longer Ride,Power Tap Pedals,Kickr Gen5,407,420,-13
115449,196512,2021-02-15 20:01:54,wahoo,Zwift - Premier Division // Zwift Racing League (men) (A),Power Tap Pedals,Kickr Gen5,476,493,-17
116174,196512,2021-02-16 22:04:56,wahoo,Zwift - 3R Classique Flat Race - 5 Laps (32.3km/20.1mi 95m) (A),Garmin Vector 3,Kickr Gen5,367,377,-10
119219,196512,2021-02-22 19:09:53,wahoo,Zwift - Premier Division // Zwift Racing League (men) (A),2021-02-22-14-09-53,Kickr Gen5,393,418,-25
122670,196512,2021-03-01 20:16:20,wahoo,Zwift - Premier Division // Zwift Racing League (men) (A),Garmin Vector 3,Kickr Gen5,437,464,-27
115946,197209,2021-02-16 18:27:35,wahoo,Zwift - Zwift Racing League | WTRL - Men&#039;s/Mixed EMEA E2 DIVISION 5 (A),4iiii precision,Wahoo Kickr v2,368,363,5
123016,197209,2021-03-02 18:32:33,wahoo,Zwift - Zwift Racing League | WTRL - Men&#039;s/Mixed EMEA E2 DIVISION 5 (A),4iiii precision,Wahoo Kickr v2,352,369,-17
16805,197543,2020-03-04 18:00:44,neo,Zwift - SZR Spring Race Series (B) ,Quarq,Neo,294,284,10
17055,197543,2020-03-05 17:39:16,neo,Zwift - SCF SWE Cup Racing League (B),Quarq,Neo,351,350,1
18269,197543,2020-03-16 15:43:08,neo,Zwift - Stage 2 Race (B) - Tour of Watopia 2020,Quarq,Neo,365,362,3
18588,197543,2020-03-18 17:28:48,neo,Zwift - SZR Spring Race Series (B),Quarq,Neo,357,346,11
32395,197543,2020-05-06 16:19:16,neo,Zwift - Swedish Zwift Racing Cup by SZR (B),Quarq,Neo,362,347,15
34360,197543,2020-05-13 16:27:03,neo,Zwift - Swedish Zwift Racing Cup by SZR (B),Quarq,Neo,365,348,17
35229,197543,2020-05-16 08:32:34,neo,Zwift - 2RR ITT Bologna (A),Quarq,Neo,369,365,4
38090,197543,2020-05-27 16:38:50,neo,Zwift - Swedish Zwift Racing Cup by SZR (B),Quarq,Neo,352,328,24
125364,197861,2021-03-07 12:02:10,wahoo,Zwift - ZHQ FutureWorks Crit City Race - Anti-sandbagging (A),Favero Assioma Duo,Wahoo Kickr,366,345,21
9524,198214,2020-01-15 19:14:59,wahoo,Zwift - Tour de Zwift // Pro-Am Invitational (A),Stages 105 Left Power Meter,Wahoo Kickr Core,338,340,-2
10717,198214,2020-01-23 19:14:59,wahoo,Zwift - Tour de Zwift // Pro-Am Invitational,Stages 105 Left Power Meter,Wahoo Kickr Core,380,364,16
12080,198214,2020-01-31 18:42:03,wahoo,Zwift - Tour de Zwift // Pro-Am Invitational (A),Stages 105 Left Power Meter,Wahoo Kickr Core,335,350,-15
12524,198214,2020-02-04 07:24:27,wahoo,Zwift - Tour de Zwift // Pro-Am Invitational (A) Yorkshire,Stages 105 Left Power Meter,Wahoo Kickr Core,358,365,-7
25848,198214,2020-04-16 16:29:54,wahoo,Zwift - Trofeo Bologna Race (A),Favero Assioma DUO,Wahoo Kickr Core,383,360,23
25850,198214,2020-04-16 17:11:53,wahoo,Zwift - ZHR Hare & Hounds Race (A),Favero Assioma DUO,Wahoo Kickr Core,312,287,25
51483,198214,2020-08-24 09:34:59,wahoo,Zwift - Off the MAAP Invitational Race // Stage 4 (men) ,Favero Assioma DUO,Wahoo Kickr Core,373,364,9
56472,198214,2020-09-20 13:00:00,wahoo,Zwift - Invitational League // Qualifying Race #3 (Men) (A),Favero Assioma DUO,Wahoo Kickr Core,353,352,1
61409,198214,2020-10-12 18:49:58,wahoo,Zwift - Premier Division // Zwift Racing League (men) ,Favero Assioma DUO,Wahoo Kickr Core,382,377,5
63160,198214,2020-10-19 18:15:51,wahoo,Zwift - Premier Division // Zwift Racing League (men) ,Favero Assioma DUO,Wahoo Kickr Core,354,345,9
67437,198214,2020-11-02 19:13:57,wahoo,Zwift - Premier Division // Zwift Racing League (men) (A),Favero Assioma DUO,Wahoo Kickr Core,365,360,5
67438,198214,2020-10-26 20:00:00,wahoo,Zwift - Premier Division // Zwift Racing League (men) (A),Favero Assioma DUO,Wahoo Kickr Core,370,359,11
69460,198214,2020-11-09 19:59:59,wahoo,Zwift - Premier Division // Zwift Racing League (men) (A),Favero Assioma DUO,Wahoo Kickr Core,411,397,14
73621,198214,2020-11-20 18:29:59,wahoo,Zwift - Team WEZ Friday Race,Favero Assioma DUO,Wahoo Kickr Core,391,387,4
76596,198214,2020-11-27 18:21:14,wahoo,Zwift - Team WEZ Friday Race (E),Favero Assioma DUO,Wahoo Kickr Core,360,356,4
79520,198214,2020-12-04 18:30:00,wahoo,Zwift - Team WEZ Friday Race (E),Favero Assioma DUO,Wahoo Kickr Core,336,332,4
82072,198214,2020-12-11 18:30:00,wahoo,Zwift - Team WEZ Friday Race (E),Favero Assioma DUO,Wahoo Kickr Core,395,394,1
84838,198214,2020-12-18 18:29:58,wahoo,Zwift - Team WEZ Friday Race (E),Favero Assioma DUO,Wahoo Kickr Core,343,344,-1
95073,198214,2021-01-11 19:14:59,wahoo,Zwift - Premier Division // Zwift Racing League (men) (A),Favero Assioma DUO,Wahoo Kickr Core,355,336,19
102961,198214,2021-01-25 19:05:00,wahoo,Zwift - Premier Division // Zwift Racing League (men) (A),Favero Assioma DUO,Wahoo Kickr Core,373,367,6
106924,198214,2021-02-01 20:06:55,wahoo,Zwift - Premier Division // Zwift Racing League (men) (A),Favero Assioma DUO,Wahoo Kickr Core,334,338,-4
112422,198214,2021-02-10 18:59:56,wahoo,Zwift - Movistar Team Challenge // Round 1 (A),Favero Assioma DUO,Wahoo Kickr Core,331,331,0
113286,198214,2021-02-11 18:14:56,wahoo,Zwift - BRT TTT,Favero Assioma DUO,Wahoo Kickr Core,372,376,-4
113706,198214,2021-02-12 18:59:58,wahoo,Zwift - Movistar Team Challenge // Round 1 (men),Favero Assioma DUO,Wahoo Kickr Core,384,382,2
115457,198214,2021-02-15 20:01:59,wahoo,Zwift - Premier Division // Zwift Racing League (men) (A),Favero Assioma DUO,Wahoo Kickr Core,378,376,2
117926,198214,2021-02-19 18:59:59,wahoo,Zwift - Movistar Team Challenge // Round 2 (men),Favero Assioma DUO,Wahoo Kickr Core,387,389,-2
119173,198214,2021-02-22 19:09:59,wahoo,Zwift - Premier Division // Zwift Racing League (men) (A),Favero Assioma DUO,Wahoo Kickr Core,322,326,-4
122592,198214,2021-03-01 20:16:55,wahoo,Zwift - Premier Division // Zwift Racing League (men) (A),Favero Assioma DUO,Wahoo Kickr Core,368,369,-1
98473,198268,2021-01-17 08:44:59,neo,Zwift - ,Powercranks,Tacx Neo,343,340,3
102169,198268,2021-01-23 11:05:36,neo,Zwift - Team EN Hang-On Ride (C),Powercranks,Tacx Neo,345,341,4
105549,198268,2021-01-30 11:05:11,neo,Zwift - Team EN Hang-On Ride (C),Powercranks,Tacx Neo,369,359,10
109831,198268,2021-02-06 11:05:09,neo,Zwift - Team EN Hang-On Ride (C),Powercranks,Tacx Neo,348,344,4
112121,198268,2021-02-10 10:30:01,neo,Zwift - USA Cycling Coffee with Hot Espresso Presented by Team ODZ (C),Powercranks,Tacx Neo,375,365,10
114075,198268,2021-02-13 11:05:10,neo,Zwift - Team EN Hang-On Ride (C),Powercranks,Tacx Neo,353,346,7
115675,198268,2021-02-16 10:30:16,neo,Zwift - ZHR Masters (C),Powercranks,Tacx Neo,379,378,1
118379,198268,2021-02-20 11:05:32,neo,Zwift - Team EN Hang-On Ride (C),Powercranks,Tacx Neo,365,364,1
122827,198268,2021-03-02 10:29:58,neo,Zwift - ZHR Masters (C),Powercranks,Tacx Neo,408,403,5
15235,200563,2020-02-20 10:25:33,wahoo,Zwift - Japan ZWIFT Hillclimb Race (A),in Power,KICKR CORE,332,335,-3
98334,200563,2021-01-17 01:47:16,wahoo,TDZ3,in Power,KICKR CORE,296,314,-18
103830,200563,2021-01-27 02:29:52,wahoo,Zwift - MAAP In The Field: Lunchtime Crit Race (A),in Power,KICKR CORE,306,294,12
26086,201796,2020-04-18 05:30:19,neo,Zwift - Bikes for the Philippines Fun Race (A),Garmin Vector 3s,Tacx Neo,316,318,-2
26087,201796,2020-04-15 15:20:22,neo,Zwift - Dig the burn - 20x20s Vo2 max,Garmin Vector 3s,Tacx Neo,295,301,-6
26089,201796,2020-03-25 19:14:55,neo,Zwift - 3R Tick Tock Flat Race - 2 Lap (36km/22.4mi 100m) (A),Garmin Vector 3s,Tacx Neo,320,315,5
26091,201796,2020-03-22 15:24:55,neo,Zwift - 3R Watopia 65km Race - 6 laps (40mi 324m) (A),Garmin Vector 3s,Tacx Neo,321,316,5
26092,201796,2020-03-18 17:59:52,neo,Zwift - SZR Spring Race Series (A),Garmin Vector 3s,Tacx Neo,310,308,2
26094,201796,2020-03-09 18:00:13,neo,Zwift - 3R Gotham Grind Flat Race - 3 Laps (27.8km/17.4mi 87m) (A),Garmin Vector 3s,Tacx Neo,311,312,-1
67117,201796,2020-11-01 08:34:12,neo,Zwift - ZHR Masters Weekender (B),Garmin Vector 3s,Tacx Neo,325,311,14
67124,201796,2020-10-25 07:34:50,neo,Zwift - ZHR Masters Weekender (B),Garmin Vector 3s,Tacx Neo,316,312,4
67128,201796,2020-09-16 16:59:54,neo,Zwift - MIDWEEK Autumn Series by SZR (A),Garmin Vector 3s,Tacx Neo,343,341,2
33522,202131,2020-05-11 07:17:23,neo,Zwift - Watopia,Stages Crank,Tacx  Neo,335,322,13
34437,202131,2020-05-12 16:29:59,neo,Zwift - ZHR Masters Europe (B),Stages Crank,Tacx  Neo,371,352,19
102761,202549,2021-01-24 08:42:45,wahoo,Zwift - Pushing Limits TT-Race,Power2max NGeco,Kickr Core,315,311,4
102764,202549,2021-01-12 17:36:17,wahoo,Zwift - Zwift Racing League | WTRL - Men&#039;s/Mixed EMEA E1 DIVISION 5 (A),Power2max NGeco MTB,Kickr Core,338,345,-7
106627,202549,2021-01-19 17:28:34,wahoo,Zwift - Zwift Racing League | WTRL - Men&#039;s/Mixed EMEA E1 DIVISION 5 (A),Power2max NGeco MTB,Kickr Core,324,322,2
106628,202549,2021-01-19 17:28:34,wahoo,Zwift - Zwift Racing League | WTRL - Men&#039;s/Mixed EMEA E1 DIVISION 5 (A),Zwift,Kickr Core,324,322,2
112055,202549,2021-02-09 17:17:59,wahoo,Zwift - Zwift Racing League | WTRL - Men&#039;s/Mixed EMEA E1 DIVISION 5 (A),Power2max NGeco MTB,Kickr Core,334,331,3
116309,202549,2021-02-16 17:31:25,wahoo,Zwift - Zwift Racing League | WTRL - Men&#039;s/Mixed EMEA E1 DIVISION 5 (A),Power2max NGeco MTB,Kickr Core,328,327,1
119728,202549,2021-02-23 17:22:36,wahoo,Zwift - Zwift Racing League | WTRL - Men&#039;s/Mixed EMEA E1 DIVISION 5 (A),Power2max NGeco MTB,Kickr Core,336,330,6
122289,202549,2021-02-28 12:36:07,wahoo,Zwift - Haute Route Watopia 2021 Stage 3 (B),Power2max NGeco MTB,Kickr Core,310,310,0
122293,202549,2021-02-27 12:37:16,wahoo,Zwift - Haute Route Watopia 2021 Stage 2 (B),Power2max NGeco MTB,Kickr Core,313,315,-2
59052,202972,2020-10-02 12:25:01,wahoo,Zwift - Orange Unicorn (Short),Assioma,Kickr,244,255,-11
59366,202972,2020-10-03 13:50:01,wahoo,Zwift - DIRT Dadurday Chase Race  (C),Assioma,Kickr,285,288,-3
113552,203414,2021-02-12 18:02:20,wahoo,Zwift - TDZ Stage 8 (uncalibrated Kickr),Garmin Vector,Wahoo Kickr,266,252,14
115224,203414,2021-02-15 18:30:01,wahoo,Zwift - Steve Ridley (TVT Swim)&#039;s Meetup - Whole Lotta Lava,Garmin Vector,Wahoo Kickr,242,229,13
120451,203414,2021-02-24 18:33:47,wahoo,Zwift - Watopia,Garmin Vector,Wahoo Kickr,222,211,11
55351,204625,2020-09-15 15:00:02,wahoo,Kicker 4 vs SW Dual Power Crank,SW Dual Power Crank,Kicker 4,225,206,19
55548,204625,2020-09-16 15:01:14,wahoo,Kicker 4 vs SW Dual Power Crank - NEW Battery Right Side,SW Dual Power Crank,Kicker 4,278,251,27
9292,204774,2020-01-14 14:59:56,wahoo,Zwift - Dubai Roadsters Club ride (C),Garmin Vector 3,Wahoo Kicker,304,305,-1
9512,204774,2020-01-15 19:15:00,wahoo,Zwift - Tour de Zwift // Pro-Am Invitational (A),Garmin Vector 3,Wahoo Kickr,396,403,-7
11857,204774,2020-01-31 19:14:59,wahoo,Zwift - Tour de Zwift // Pro-Am Invitational (A),Garmin Vector 3,Wahoo Kickr,425,425,0
12004,204774,2020-02-01 13:44:59,wahoo,Zwift - WTRL Winter Racing League (A),Garmin Vector 3,Wahoo Kickr,382,382,0
16573,204774,2020-02-29 15:59:54,neo,Zwift - PACK SUB2 Ride - Bob&#039;s After Party Blob (D),Garmin Vector 3,Tacx Neo Bike,170,181,-11
17344,204774,2020-03-09 10:30:01,neo,Zwift - DIRTy Dozen Sprint League (A),Garmin Vector 3,Tacx Neo Bike,398,408,-10
17474,204774,2020-03-10 16:10:00,neo,Zwift - Stage 1 Race (A) - Tour of Watopia 2020,Garmin Vector 3,Tacx Neo Bike,416,425,-9
17920,204774,2020-03-13 10:10:00,neo,Zwift - Stage 2 Race (A) - Tour of Watopia 2020,Garmin Vector 3,Tacx Neo Bike,397,400,-3
18014,204774,2020-03-14 09:30:00,neo,Zwift - DBR Saturday Race (A),Garmin Vector 3,Tacx Neo Bike,412,414,-2
18111,204774,2020-03-15 10:10:00,neo,Zwift - Stage 2 Race (A) - Tour of Watopia 2020,Garmin Vector 3,Tacx Neo Bike,387,394,-7
18127,204774,2020-03-15 11:05:00,neo,Zwift - 3R Innsbruckring Sprint Race - 1 Lap (8.8km/5.5mi 77m) (A),Garmin Vector 3,Tacx Neo Bike,423,429,-6
18409,204774,2020-03-17 16:04:59,neo,Zwift - 3R SuperCRITical Race Series - Round 4of4 (A),Garmin Vector 3,Tacx Neo Bike,391,396,-5
18536,204774,2020-03-18 09:44:59,neo,Zwift - DIRT & IS: Wednesday Worlds (A),Garmin Vector 3,Tacx Neo Bike,367,369,-2
18553,204774,2020-03-18 11:09:58,neo,Zwift - Stage 3 Race (A) - Tour of Watopia 2020,Garmin Vector 3,Tacx Neo Bike,400,401,-1
19123,204774,2020-03-22 10:35:00,neo,Zwift - Volcano CCW Short Race,Garmin Vector 3,Tacx Neo Bike,371,368,3
19460,204774,2020-03-24 19:14:46,neo,Zwift - Tour of Watopia Pro-Am Men&#039;s Race #3 (A),Garmin Vector 3,Tacx Neo Bike,401,402,-1
22156,204774,2020-04-05 09:00:00,neo,Zwift - Ronde van Zwift (A),Garmin Vector 3,Tacx Neo Bike,384,389,-5
22494,204774,2020-04-06 09:38:00,neo,Zwift - ZHR Zwift Handicap Race (A),Garmin Vector 3,Tacx Neo Bike,386,388,-2
24477,204774,2020-04-14 09:49:59,neo,Zwift - SZR Lunch Race (A),Garmin Vector 3,Tacx Neo Bike,377,381,-4
24807,204774,2020-04-15 09:44:58,neo,Zwift - USA Cycling Race League by Indoor Specialist  (A),Garmin Vector 3,Tacx Neo Bike,383,389,-6
25110,204774,2020-04-16 09:18:59,neo,Zwift - Cycling Australia&#039;s The Chop by AHDR (A),Garmin Vector 3,Tacx Neo Bike,403,405,-2
25450,204774,2020-04-11 10:46:27,neo,Zwift - 3R Lagurdia Super Sprint Race - 1 Lap (3.7km/2.6mi 27m) (A),Garmin Vector 3,Tacx Neo Bike,422,424,-2
25513,204774,2020-04-11 16:17:01,neo,Zwift - Crit City Race (A),Garmin Vector 3,Tacx Neo Bike,423,426,-3
25873,204774,2020-04-18 14:14:58,neo,Zwift - OH CRIT!! - Saturday Smash Series (A),Garmin Vector 3,Tacx Neo Bike,415,419,-4
26140,204774,2020-04-19 09:43:56,neo,Zwift - Points Race League by Team DIRT (A),Garmin Vector 3,Tacx Neo Bike,394,396,-2
27845,204774,2020-04-25 10:30:00,neo,Zwift - 3R Volcano Climb Race - 1 Lap (22.4km/14mi 204m) (A),Garmin Vector 3,Tacx Neo Bike,415,413,2
28171,204774,2020-04-26 10:09:38,neo,Zwift - 3R Sand & Sequoias - 1 Lap (20km/12.5mi 173m) (A),Garmin Vector 3,Tacx Neo Bike,379,373,6
28400,204774,2020-04-27 10:30:00,neo,Zwift - Crit City Slam Race // Zwift Classic (A),Garmin Vector 3,Tacx Neo Bike,392,394,-2
28705,204774,2020-04-28 14:05:17,neo,Zwift - 3R LaGuardia Super Sprint Race - 1 Lap (3.7km/2.6mi 27m) (A),Garmin Vector 3,Tacx Neo Bike,419,420,-1
30101,204774,2020-05-01 13:34:53,neo,Zwift - Crit City Race (A),Garmin Vector 3,Tacx Neo Bike,411,416,-5
30135,204774,2020-05-01 14:44:51,neo,Zwift - Crit City    (A),Garmin Vector 3,Tacx Neo Bike,399,399,0
30558,204774,2020-05-02 14:14:52,neo,Zwift - OH CRIT!! - Saturday Super League (A),Garmin Vector 3,Tacx Neo Bike,387,391,-4
31236,204774,2020-05-04 14:14:52,neo,Zwift - 3R Classique Reverse Flat Race - 5 Laps (32km/20.1mi 76m) (A),Garmin Vector 3,Tacx Neo Bike,440,443,-3
31532,204774,2020-05-05 09:19:50,neo,Zwift - The After Party Race (A),Garmin Vector 3,Tacx Neo Bike,405,407,-2
32916,204774,2020-05-09 10:09:44,neo,Zwift - Tour for All 2020: Stage 2 Longer Race A/B,Garmin Vector 3,Tacx Neo Bike,394,392,2
33577,204774,2020-05-11 13:09:51,neo,Zwift - Tour for All 2020: Stage 2 Longer Race A/B,Garmin Vector 3,Tacx Neo Bike,388,388,0
34264,204774,2020-05-13 11:59:50,neo,Zwift - TTR Mini RACE (A),Garmin Vector 3,Tacx Neo Bike,430,429,1
34707,204774,2020-05-14 15:14:51,neo,Zwift - OH CRIT!! - The Double Race - Lockdown Series Round 2 Race 1 (A),Garmin Vector 3,Tacx Neo Bike,430,431,-1
34708,204774,2020-05-14 16:04:50,neo,Zwift - OH CRIT!! - Lockdown Series - Round 2 Race 2 (A),Garmin Vector 3,Tacx Neo Bike,405,405,0
35626,204774,2020-05-17 10:59:52,neo,Zwift - Tour for All 2020: Stage 4 Longer Ride,Garmin Vector 3,Tacx Neo Bike,396,396,0
35643,204774,2020-05-16 14:14:51,neo,Zwift - OH CRIT!! - Saturday Smash Series (A),Garmin Vector 3,Tacx Neo Bike,420,423,-3
94834,207273,2021-01-11 11:34:41,neo,Zwift - 8wk Race Day Prep Week 4 Z6 Intervals,Garmin Vector 3,Tacx Neo,331,330,1
96532,207273,2021-01-13 18:29:58,neo,Zwift - NCF Vintercup 2021 - Runde 1 - Herrer (A),Garmin Vector 3,Tacx Neo,361,366,-5
113474,207415,2021-02-12 16:14:59,wahoo,Zwift - Threshold #1 (105%),V3,Kickr Core,247,250,-3
123716,207672,2021-03-03 17:59:59,neo,Zwift - MIDWEEK Crit Race Series by SZR (A) 8th,Favero Assimoa ,Tacx NeoBike,359,365,-6
128647,207672,2021-03-10 17:59:45,neo,Zwift - MIDWEEK Crit Race Series by SZR (A),Favero Assimoa ,Tacx NeoBike,376,381,-5
14377,208469,2019-10-25 16:55:01,neo,NEo 1 ,Pow P1,NEO 1,310,319,-9
106424,208514,2021-01-31 19:42:56,neo,Zwift - Townsend,Vector 3,Neo,231,228,3
127497,208514,2021-03-12 15:55:14,neo,Zwift - Collins +1,Vector 3,Neo,280,265,15
107718,208885,2021-02-03 00:29:52,wahoo,Zwift - Zwift Racing League | WTRL - Women&#039;s AMERICAS E DIVISION 1 (A),Garmin Vector 3S,wahoo kickr,303,311,-8
111877,208885,2021-02-10 00:36:46,wahoo,Zwift - Zwift Racing League | WTRL - Women&#039;s AMERICAS E DIVISION 1 (A),Garmin Vector 3S,wahoo kickr,295,303,-8
112843,208885,2021-02-11 16:29:59,wahoo,Zwift - OTAKAM Race Series,Garmin Vector 3S,wahoo kickr,288,299,-11
116199,208885,2021-02-17 00:29:26,wahoo,Zwift - Miracle,Garmin Vector 3S,wahoo kickr,285,307,-22
118293,208885,2021-02-20 14:30:04,wahoo,3 Sisters Ride-Along!,Garmin Vector 3S,wahoo kickr,269,284,-15
119026,208885,2021-02-22 16:57:35,wahoo,Zwift - Watopia,Garmin Vector 3S,wahoo kickr,282,280,2
120067,208885,2021-02-24 00:29:49,wahoo,Zwift - Zwift Racing League | WTRL - Women&#039;s AMERICAS E DIVISION 1 (A),Garmin Vector 3S,wahoo kickr,298,290,8
124683,208885,2021-03-05 19:45:02,wahoo,Zwift - Zwift Racing League | WTRL Battle Royale Playoff - Women&#039;s Points Race (A),Garmin Vector 3S,wahoo kickr,289,291,-2
125140,208885,2021-03-06 19:05:07,wahoo,Zwift - Zwift Racing League | WTRL Battle Royale Playoff - Women&#039;s TTT (A),Garmin Vector 3S,wahoo kickr,289,276,13
109805,208932,2021-02-06 10:00:02,wahoo,Zwift - Watopia free ride. Testing Kickr,Favero Assioma,Wahoo Kickr v5,165,162,3
110099,208932,2021-02-06 17:01:27,wahoo,Zwift - TDZ Stage 7: Women&#039;s Ride,Favero Assioma ANT+ Garmin Edge 1030,Wahoo Kickr v5 ANT+,173,167,6
110616,208932,2021-02-07 18:00:02,wahoo,Zwift - USMES Sunday Decaf Ride (D),Favero Assioma ANT+ Garmin Edge 1030,Wahoo Kickr v5 BT,155,150,5
112353,208932,2021-02-10 19:01:31,wahoo,Zwift - TDZ Stage 8: Group Ride,Favero Assioma ANT+ Garmin Edge 1030,Wahoo Kickr v5 BT,158,155,3
124538,208932,2021-03-05 18:24:20,wahoo,Zwift - Watopia 2,Favero Assioma,Wahoo Kickr v5,105,101,4
125762,208932,2021-03-06 08:09:46,wahoo,Zwift - Matando o Corpo® by PETA-Z (E),Favero Assioma BT,Wahoo Kickr v5,187,176,11
125820,208932,2021-03-08 17:59:58,wahoo,Zwift -  MUSSARA RIDE BY ETIXX WOMEN&#039;S DAY (E),Favero Assioma ANT+Zwift,Wahoo Kickr v5 Garmin1030,172,165,7
86325,210207,2020-12-23 02:06:03,wahoo,Zwift - Zwift Time Trial Tuesday: Bologna (E),Specialized Power Crank,Wahoo Kickr,257,258,-1
87307,210207,2020-12-26 01:04:47,wahoo,Zwift - TGIF Group Ride (D),Specialized Power Crank,Wahoo Kickr,304,289,15
88045,210207,2020-12-28 03:04:59,wahoo,Zwift - 3R Figure 8 Hilly Race - 1 Lap (29.2km/18.1m 234m) (B),Specialized Power Crank,Wahoo Kickr,356,351,5
92011,210207,2021-01-06 02:02:23,wahoo,Zwift - TDZ Stage 1: Standard Ride,Specialized Power Crank,Wahoo Kickr,345,340,5
92517,210207,2021-01-07 01:45:59,wahoo,Zwift - The Nightcap by STPC (B),Specialized Power Crank,Wahoo Kickr,359,349,10
92518,210207,2021-01-07 03:02:03,wahoo,Zwift - TDZ Stage 1: Standard Ride,Specialized Power Crank,Wahoo Kickr,250,234,16
93136,210207,2021-01-08 02:38:58,wahoo,Zwift - WTRL Team Time Trial - Zone 11 (C),Specialized Power Crank,Wahoo Kickr,289,281,8
93616,210207,2021-01-09 01:16:19,wahoo,Zwift - DIRT Friday Night Battle (B),Specialized Power Crank,Wahoo Kickr,326,324,2
94195,210207,2021-01-09 22:37:49,wahoo,Zwift - Dutch Diesel Cycling Endurance Ride (C),Specialized Power Crank,Wahoo Kickr,259,243,16
96292,210207,2021-01-13 03:00:54,wahoo,Zwift - Zwift Racing League | WTRL - Men&#039;s/Mixed AMERICAS W DIVISION 1 (B),Specialized Power Crank,Wahoo Kickr,384,360,24
98345,210207,2021-01-17 02:01:58,wahoo,Zwift - The P Race (B),Specialized Power Crank,Wahoo Kickr,328,323,5
101218,210207,2021-01-22 02:38:16,wahoo,Zwift - WTRL Team Time Trial - Zone 11 (B),Specialized Power Crank,Wahoo Kickr,253,254,-1
102074,210207,2021-01-23 18:59:52,wahoo,Zwift - EVR Winter Series (B),Specialized Power Crank,Wahoo Kickr,354,341,13
102558,210207,2021-01-24 18:14:48,wahoo,Zwift - REVO Athena and Clydesdale Climbers (E),Specialized Power Crank,Wahoo Kickr,309,305,4
103857,210207,2021-01-27 03:01:16,wahoo,Zwift - Zwift Racing League | WTRL - Men&#039;s/Mixed AMERICAS W DIVISION 1 (B),Specialized Power Crank,Wahoo Kickr,365,362,3
104950,210207,2021-01-29 02:37:52,wahoo,Zwift - WTRL Team Time Trial - Zone 11 (C),Specialized Power Crank,Wahoo Kickr,333,336,-3
105894,210207,2021-01-30 19:09:55,wahoo,Zwift - Innsbruck,Specialized Power Crank,Wahoo Kickr,319,315,4
106958,210207,2021-02-01 19:17:25,wahoo,Zwift - ZMCC EyeballZ (C),Specialized Power Crank,Wahoo Kickr,305,301,4
107797,210207,2021-02-03 03:01:16,wahoo,Zwift - Zwift Racing League | WTRL - Men&#039;s/Mixed AMERICAS W DIVISION 1 (B),Specialized Power Crank,Wahoo Kickr,366,365,1
117552,210207,2021-02-19 02:37:51,wahoo,Zwift - WTRL Team Time Trial - Zone 14 (C),Specialized Power Crank,Wahoo Kickr,330,344,-14
120018,210207,2021-02-24 03:00:55,wahoo,Zwift - Zwift Racing League | WTRL - Men&#039;s/Mixed AMERICAS W DIVISION 1 (B),Specialized Power Crank,Wahoo Kickr,351,362,-11
121012,210207,2021-02-26 02:40:25,wahoo,Zwift - WTRL Team Time Trial - Zone 14 (C),Specialized Power Crank,Wahoo Kickr,300,308,-8
121349,210207,2021-02-26 22:49:55,wahoo,Zwift - Herd Beginner Racing Series (E),Specialized Power Crank,Wahoo Kickr,377,380,-3
123793,210207,2021-03-04 03:00:13,wahoo,Zwift - Watopia,Specialized Power Crank,Wahoo Kickr,263,270,-7
124322,210207,2021-03-05 03:04:55,wahoo,Zwift - 3R Greater London Flat Race - 2 Laps (28.5km/17.7mi 90m) (B),Specialized Power Crank,Wahoo Kickr,326,344,-18
125277,210207,2021-03-07 00:59:56,wahoo,Zwift - Herd Beginner Racing Series (E),Specialized Power Crank,Wahoo Kickr,378,379,-1
128591,210207,2021-03-15 01:29:47,wahoo,Zwift -  ZHQ Beta Experience Mode Mondays,Specialized Power Crank,Wahoo Kickr,332,319,13
6115,210632,2019-12-12 18:19:55,wahoo,Zwift - WTRL Team Time Trial (C),Favero BePro Duo,Kickr Core,382,377,5
10614,210632,2020-01-23 18:01:34,wahoo,Zwift - Hudik Triathlon Time Trial,Favero BePro Duo,Kickr Core,441,438,3
10794,210632,2020-01-24 18:09:58,wahoo,Zwift - Tour de Zwift: Stage 4 Race (A),Favero BePro Duo,Kickr Core,330,328,2
11366,210632,2020-01-28 18:59:56,wahoo,Zwift - ZwiftTeamPL League – Classic Series (A),Favero BePro Duo,Kickr Core,374,382,-8
12504,210632,2020-02-04 18:59:57,wahoo,Zwift - ZwiftTeamPL League – Sprinters Series (A),Favero BePro Duo,Kickr Core,346,343,3
14593,210632,2020-02-18 18:59:55,wahoo,Zwift - ZwiftTeamPL League – Classic Series (A),Favero BePro Duo,Kickr Core,361,355,6
14917,210632,2020-02-20 18:21:46,wahoo,Zwift - WTRL Team Time Trial (C),Favero BePro Duo,Kickr Core,367,364,3
15579,210632,2020-02-25 19:00:05,wahoo,Zwift - ZTPL.CC League  – Sprinters Series (A),Favero BePro Duo,Kickr Core,351,354,-3
24603,210632,2020-04-14 17:35:21,wahoo,Zwift - ZTPLCCTour2020 Stage 2 (E),Favero BePro Duo,Kickr Core,366,330,36
103609,210632,2021-01-26 18:31:43,wahoo,Zwift - The Carnival Race League Stage 3 with ZTPL.CC (B),Favero BePro Duo,Kickr Core,346,332,14
107401,210632,2021-02-02 18:32:03,wahoo,Test,Favero BePro Duo,Kickr Core,340,339,1
111627,210632,2021-02-09 18:32:04,wahoo,Zwift - ZTPL.CC Winter League 2021 Stage 7,Favero BePro Duo,Kickr Core,341,330,11
115811,210632,2021-02-16 18:32:01,wahoo,Zwift - ZTPL.CC Winter League 2021 Stage 9 (B),Favero BePro Duo,Kickr Core,342,338,4
118352,210632,2021-02-20 17:01:39,wahoo,Zwift - ZTPL.CC Winter League 2021 Stage 10 (B),Favero BePro Duo,Kickr Core,332,331,1
5714,210667,2019-12-06 20:24:19,wahoo,3R Innsbruckring Flat Race - 4 Laps (35.2km/21.9mi 308m),Assioma Duo,Kickr16,296,302,-6
6197,210667,2019-12-13 20:24:17,wahoo,Kickr16 / Assioma Duo,Assioma Duo,Kickr16,307,306,1
6428,210667,2019-12-16 17:59:14,wahoo,Kickr16 / Assioma,Assioma,Kickr16,297,307,-10
6539,210667,2019-12-17 19:10:14,wahoo,Kickr16 / Assioma,Assioma,Kickr16,303,308,-5
7683,210667,2019-12-30 17:30:07,wahoo,Kickr16 / Assioma Duo,Assioma Duo,Kickr16,312,331,-19
7920,210667,2020-01-02 19:34:06,wahoo,Kickr16 / Assioma Duo,Assioma Duo,Kickr16,318,325,-7
8697,210667,2020-01-09 18:30:04,wahoo,Assioma Duo / Kickr16,Assioma Duo,Kickr16,302,308,-6
9048,210667,2020-01-12 17:19:02,wahoo,Kickr16 / Assioma Duo,Assioma Duo,Kickr16,320,331,-11
10031,210667,2020-01-19 17:18:59,wahoo,Kickr18 / Assioma Duo,Assioma Duo,Kickr18,339,341,-2
10181,210667,2020-01-20 17:29:59,wahoo,Kickr18 / Assioma Duo,Assioma Duo,Kickr18,311,315,-4
10379,210667,2020-01-21 17:08:57,wahoo,Kickr18 / Assioma Duo,Assioma Duo,Kickr18,322,324,-2
11128,210667,2020-01-26 12:20:57,wahoo,Kickr18 / Assioma Duo,Assioma Duo,Kickr18,324,325,-1
11447,210667,2020-01-28 19:00:57,wahoo,Kickr16 / Assioma Duo,Assioma Duo,Kickr16,311,318,-7
11756,210667,2020-01-30 19:34:55,wahoo,ZHR Up & Down Race,Assioma Duo,Kickr18,309,317,-8
11939,210667,2020-01-31 20:24:56,wahoo,Kickr18 / Assioma Duo,Assioma Duo,Kickr18,291,299,-8
12162,210667,2020-02-02 17:19:55,wahoo,Kickr18 / Assioma Duo,Assioma Duo,Kickr18,338,346,-8
12296,210667,2020-02-03 17:30:54,wahoo,Kickr18 / Assioma Duo,Assioma Duo,Kickr18,330,340,-10
12887,210667,2020-02-06 19:00:52,wahoo,Kickr18 / Assioma Duo,Assioma Duo,Kickr18,339,349,-10
13006,210667,2020-02-08 13:19:53,wahoo,Kickr18 / Assioma Duo,Assioma Duo,Kickr18,283,290,-7
13289,210667,2020-02-10 17:59:50,wahoo,Kickr18 / Assioma Duo,Assioma Duo,Kickr18,288,299,-11
13390,210667,2020-02-11 16:29:49,wahoo,Kickr18 / Assioma Duo,Assioma Duo,Kickr18,314,324,-10
13684,210667,2020-02-13 12:29:50,wahoo,Zwift - Eastern Canadian Quest Racing Series (ECQRS) (A),Assioma Duo,Kickr18,343,353,-10
14050,210667,2020-02-14 21:04:50,wahoo,Zwift - 3R LaGuardia Loop Flat Race - 8 Laps (22.9km/14.2mi 216m) (A),Assioma Duo,Kickr18,312,322,-10
14321,210667,2020-02-16 18:14:48,wahoo,Zwift - 3R Watopia Hilly Reverse Race - 4 Laps (36.7km/22.8mi 400m) (A),Assioma Duo,Kickr18,307,312,-5
14604,210667,2020-02-18 19:14:48,wahoo,Kickr18 / Assioma Duo,Assioma Duo,Kickr18,332,343,-11
15014,210667,2020-02-20 19:44:43,wahoo,Kickr18 / Assioma Duo,Assioma Duo,Kickr18,315,322,-7
15399,210667,2020-02-23 14:44:45,wahoo,Zwift - La Bicicletta Toronto Donut Race (A),Assioma Duo,Kickr18,317,320,-3
15669,210667,2020-02-25 17:39:43,wahoo,Zwift - Team Italy Specialissima Race (A),Assioma Duo,Kickr18,294,302,-8
15810,210667,2020-02-26 19:39:43,wahoo,Zwift - The Knights Race Series - Series X (A),Assioma Duo,Kickr18,300,308,-8
16145,210667,2020-02-29 13:19:42,wahoo,Zwift - 3R Innsbruckring Flat Race - 5 Laps (44km/27.3mi 385m) (A),Assioma Duo,Kickr18,300,305,-5
16407,210667,2020-03-01 17:19:42,wahoo,Zwift - 3R Greater London 8 Hilly Race - 1 Lap (23.8km/14.8mi 238m) (A),Assioma Duo,Kickr18,335,340,-5
16726,210667,2020-03-03 19:14:39,wahoo,Zwift - Feltet.dk Race Series (A),Assioma Duo,Kickr18,325,333,-8
17044,210667,2020-03-05 17:39:38,wahoo,Zwift - Team Italy Specialissima Race  (A),Assioma Duo,Kickr18,300,297,3
17615,210667,2020-03-09 18:00:00,wahoo,Zwift - 3R Gotham Grind Flat Race - 3 Laps (27.8km/17.4mi 87m) (A),Assioma Duo,Kickr18,306,311,-5
17618,210667,2020-03-10 18:35:00,wahoo,Zwift - Team Sportslab Road Race League (A),Assioma Duo,Kickr18,333,336,-3
17917,210667,2020-03-12 19:43:54,wahoo,Zwift - WTRL Team Time Trial (C),Assioma Duo,Kickr18,330,331,-1
18112,210667,2020-03-14 13:19:58,wahoo,Zwift - 3R Innsbruckring Flat Race - 5 Laps (44km/27.3mi 385m) (A),Assioma Duo,Kickr18,305,307,-2
21000,210667,2020-03-31 15:29:48,wahoo,Zwift - Sydkysten Cycling - Carl Ras Race (A),Assioma Duo,Kickr18,304,315,-11
27500,210667,2020-04-23 19:00:00,wahoo,KISS at Race - EU PM (A),Assioma Duo,Kickr18,301,310,-9
29755,210667,2020-04-30 18:04:06,wahoo,Zwift - WTRL Team Time Trial (C),Assioma Duo,Kickr18,292,304,-12
31859,210667,2020-05-05 17:09:58,wahoo,Zwift - 3R Volcano KOM After Party Race - 2 laps + climb (40.2km/25mi 286m) (A),Assioma Duo,Kickr18,306,314,-8
32806,210667,2020-05-08 19:34:56,wahoo,Zwift - 3R Watopia Hilly Race - 3 Laps (27km/16.8mi 300m) (A),Assioma Duo,Kickr18,331,334,-3
33731,210667,2020-05-11 16:59:57,wahoo,Zwift - 3R Queens Highway Race - 6 Laps (A),Assioma Duo,Kickr18,301,307,-6
34062,210667,2020-05-12 18:14:57,wahoo,Zwift - UNO X CUP powered by DCU & Feltet.dk (A),Assioma Duo,Kickr18,310,316,-6
34805,210667,2020-05-14 17:29:57,wahoo,Zwift - FUSION ECT BEUNSTOPPABLE Racing Series (A),Assioma Duo,Kickr18,301,309,-8
36167,210667,2020-05-19 18:14:58,wahoo,Zwift - UNO X CUP powered by DCU & Feltet.dk (A),Assioma Duo,Kickr18,317,307,10
36925,210667,2020-05-22 19:34:58,wahoo,Zwift - 3R Watopia Hilly Race - 3 Laps (27km/16.8mi 300m) (A),Assioma Duo,Kickr18,323,319,4
37182,210667,2020-05-23 16:49:59,wahoo,Zwift - 3R Innsbruckring Flat Race - 3 Laps (26.4km/16.4mi 231m) (A),Assioma Duo,Kickr16,314,331,-17
37447,210667,2020-05-24 17:20:00,wahoo,Zwift - 3R Greater London 8 Hilly Race - 1 Lap (23.8km/14.8mi 238m) (A),Assioma Duo,Kickr16,334,342,-8
39990,210667,2020-06-06 12:15:02,wahoo,Zwift - Team ODZ RACE (A),Assioma Duo,Kickr16,314,323,-9
41269,210667,2020-06-12 15:14:59,wahoo,Zwift - 3R Sand and Sequoias Race (A),Assioma Duo,Kickr16,317,325,-8
41436,210667,2020-06-13 13:19:58,wahoo,Zwift - 3R Innsbruckring Flat Race - 5 Laps (44km/27.3mi 385m) (A),Assioma Duo,Kickr16,315,318,-3
42475,210667,2020-06-18 18:29:57,wahoo,Zwift - ZHR Up & Down Race (A),Assioma Duo,Kickr18,309,305,4
42821,210667,2020-06-20 13:14:57,wahoo,Zwift - Peloton Istanbul Weekend Race (A),Assioma Duo,Kickr18,293,293,0
44253,210667,2020-06-30 16:39:59,wahoo,Zwift - Team Italy Specialissima Race (A),Assioma Duo,Kickr18,308,305,3
44709,210667,2020-07-03 17:59:58,wahoo,Zwift - TFC Summer Series (A),Assioma Duo,Kickr18,310,304,6
44996,210667,2020-07-05 11:55:56,wahoo,Zwift - Peel Cycling - Sunday Chase (A),Assioma Duo,Kickr18,298,298,0
45289,210667,2020-07-07 16:35:10,wahoo,Zwift - Team Sportslab UK Road Race League (A),Assioma Duo,Kickr18,334,334,0
45637,210667,2020-07-09 16:00:59,wahoo,Zwift - Virtual Tour de France - Open - Stage 2 Discovery Ride,Assioma Duo,Kickr18,311,308,3
45826,210667,2020-07-10 19:34:59,wahoo,Zwift - 3R Watopia Hilly Race - 3 Laps (27km/16.8mi 300m) (A),Assioma Duo,Kickr18,318,315,3
47063,210667,2020-07-20 17:30:00,wahoo,Zwift - Team CLS Fast &#039;n&#039; Furious Racing League (A),Assioma Duo,Kickr18,297,301,-4
48322,210667,2020-07-30 14:40:20,wahoo,Zwift - Team Italy Specialissima Race (A),Assioma Duo,Kickr18,306,304,2
50759,210667,2020-08-19 18:24:59,wahoo,Zwift - Deeside Thistle and Moray Firth Race (A),Assioma Duo,Kickr16,307,318,-11
50978,210667,2020-08-20 17:59:59,wahoo,Zwift - The Cycling Ireland Zwift Race with Nicholas Roche (A),Assioma Duo,Kickr16,334,334,0
51390,210667,2020-08-23 17:19:58,wahoo,Zwift - 3R Greater London 8 Hilly Race - 1 Lap (23.8km/14.8mi 238m) (A),Assioma Duo,Kickr16,332,339,-7
51859,210667,2020-08-25 17:54:59,wahoo,Zwift - Team Italy & Frenchy Fuzion League (A),Assioma Duo,Kickr16,309,316,-7
52248,210667,2020-08-27 18:44:58,wahoo,Zwift - XRS - ZTR Thursday Night Race (A),Assioma Duo,Kickr16,322,324,-2
53121,210667,2020-09-02 18:04:59,wahoo,Zwift - DBR Wednesday Race (A),Assioma Duo,Kickr16,292,303,-11
53577,210667,2020-09-05 18:05:10,wahoo,Zwift - 3R Three Sisters Hilly Race (47km/29.2mi 879m) (A),Assioma Duo,Kickr18,311,311,0
53967,210667,2020-09-08 16:34:58,wahoo,Zwift - Team Sportslab UK Road Race League (A),Assioma Duo,Kickr18,334,330,4
54638,210667,2020-09-11 20:24:58,wahoo,Zwift - 3R Innsbruckring Flat Race - 4 Laps (35.2km/21.9mi 308m) (A),Assioma Duo,Kickr18,297,293,4
55816,210667,2020-09-17 17:29:59,wahoo,Zwift - FUSION ECT BEUNSTOPPABLE Racing Series (A),Assioma Duo,Kickr18,354,352,2
56180,210667,2020-09-18 19:34:57,wahoo,Zwift - 3R Watopia Hilly Race - 3 Laps (27km/16.8mi 300m) (A),Assioma Duo,Kickr18,335,328,7
56543,210667,2020-09-20 15:25:00,wahoo,Zwift - 3R Watopia 65km Race - 6 laps (40mi 324m) (A),Assioma Duo,Kickr18,300,302,-2
57322,210667,2020-09-24 18:29:58,wahoo,Zwift - ZHR Up & Down Race (A),Assioma Duo,Kickr18,328,327,1
57943,210667,2020-09-27 16:19:58,wahoo,Zwift - Stages of DIRT (A),Assioma Duo,Kickr18,326,327,-1
58068,210667,2020-09-28 17:14:57,wahoo,Zwift - DBR Ride´N´Roll League (A),Assioma Duo,Kickr18,322,324,-2
58588,210667,2020-09-30 17:45:01,wahoo,Zwift - DCU powered by Feltet.dk (A),Quarq DZero,Kickr18,332,326,6
58855,210667,2020-10-01 17:29:58,wahoo,Zwift - FUSION ECT BEUNSTOPPABLE Racing Series (A),Quarq DZero,Kickr18,310,305,5
59241,210667,2020-10-03 12:14:58,wahoo,Zwift - Team ODZ RACE (A),Quarq DZero,Kickr18,302,282,20
59613,210667,2020-10-05 17:00:03,wahoo,Zwift - 3R Queens Highway Race - 6 Laps (A),Quarq DZero,Kickr18,304,298,6
59872,210667,2020-10-06 17:54:58,wahoo,Zwift - Team Italy & Frenchy Fuzion League (A),Quarq DZero,Kickr18,312,312,0
60439,210667,2020-10-08 18:59:17,wahoo,Zwift - WTRL Team Time Trial - Zone 6 (C),Quarq DZero,Kickr18,308,303,5
60643,210667,2020-10-09 19:35:00,wahoo,Zwift - 3R Watopia Hilly Race - 3 Laps (27km/16.8mi 300m) (A),Quarq DZero,Kickr18,327,314,13
61603,210667,2020-10-13 18:45:08,wahoo,Zwift - Zwift Racing League | WTRL (A),Quarq DZero,Kickr18,330,333,-3
62485,210667,2020-10-16 17:04:42,wahoo,Zwift - Team WEZ Friday Race (A),Quarq DZero,Kickr18,305,302,3
63574,210667,2020-10-20 17:54:57,wahoo,Zwift - Team Italy & Frenchy Fuzion League (A),Quarq DZero,Kickr18,305,309,-4
64248,210667,2020-10-22 18:29:48,wahoo,Zwift - ZHR Up & Down Race (A),Quarq DZero,Kickr18,329,331,-2
64688,210667,2020-10-24 18:05:00,wahoo,Zwift - 3R Three Sisters Hilly Race (47km/29.2mi 879m) (A),Quarq DZero,Kickr5,321,320,1
64903,210667,2020-10-25 17:19:58,wahoo,Zwift - 3R Greater London 8 Hilly Race - 1 Lap (23.8km/14.8mi 238m) (A),Quarq DZero,Kickr5,323,328,-5
65551,210667,2020-10-27 19:45:06,wahoo,Zwift - Zwift Racing League | WTRL - EMEA W (MEN) -  Division 1 (A),Quarq DZero,Kickr5,323,320,3
66505,210667,2020-10-30 19:35:15,wahoo,Zwift - 3R Watopia Hilly Race - 3 Laps (27km/16.8mi 300m) (A),Quarq DZero,Kickr5,314,316,-2
66692,210667,2020-10-31 13:59:59,wahoo,Zwift - XRS Races: Saturday Climbing Series (A),Quarq DZero,Kickr5,321,323,-2
67234,210667,2020-11-02 17:30:06,wahoo,Zwift - EVO CC Sprint Race Series  (A),Quarq DZero,Kickr5,313,317,-4
67604,210667,2020-11-03 17:29:58,wahoo,Zwift - WTRL Racing (A),Quarq DZero,Kickr5,333,336,-3
67934,210667,2020-11-04 18:59:59,wahoo,Zwift - DCU – Feltet.dk November series,Quarq DZero,Kickr5,320,325,-5
68798,210667,2020-11-07 14:19:49,wahoo,Zwift - CCBoucherville-V2000 FUN Races (A),Quarq DZero,Kickr5,308,311,-3
69326,210667,2020-11-09 16:59:35,wahoo,Zwift - 3R Queens Highway Race - 6 Laps (A),Quarq DZero,Kickr5,315,302,13
69964,210667,2020-11-10 15:20:34,wahoo,"Kickr Vs, Assioma",Quarq DZero,Kickr5,140,138,2
71695,210667,2020-11-15 16:04:38,wahoo,Zwift - 3R Tick Tock Flat Race - 1 Lap (19km/11.8mi 50m) (A),Quarq DZero,Kickr5,297,293,4
71992,210667,2020-11-16 16:39:38,wahoo,Zwift - Team Italy PISSEI Race (A),Quarq DZero,Kickr5,325,316,9
72379,210667,2020-11-17 19:46:45,wahoo,Zwift - Zwift Racing League | WTRL - Men&#039;s EMEA W1 DIVISION 1 (A),Quarq DZero,Kickr5,292,289,3
74553,210667,2020-11-23 16:09:36,wahoo,Zwift - 3R Classique Reverse Flat Race - 4 Laps (26.9km/16.7mi 57m) (A),Quarq DZero,Kickr5,297,291,6
75196,210667,2020-11-24 19:44:35,wahoo,Zwift - Zwift Racing League | WTRL - Men&#039;s EMEA W1 DIVISION 1,Quarq DZero,Kickr5,316,309,7
77049,210667,2020-11-28 16:49:33,wahoo,Zwift - 3R Innsbruckring Flat Race - 3 Laps (26.4km/16.4mi 231m) (A),Quarq DZero,Kickr5,312,297,15
77292,210667,2020-11-29 13:44:32,wahoo,Zwift - La Bicicletta Toronto & Toronto Hustle Donut Race (A),Quarq DZero,Kickr5,356,350,6
79790,210667,2020-12-05 14:19:31,wahoo,Zwift - CCBoucherville-V2000 FUN Races (A),Quarq DZero,Kickr5,287,286,1
80275,210667,2020-12-06 18:39:30,wahoo,Zwift - XRS Races Crit (A),Quarq DZero,Kickr5,312,304,8
81046,210667,2020-12-08 18:34:28,wahoo,Zwift - Team Sportslab UK Road Race League (A),Quarq DZero,Kickr5,306,301,5
81712,210667,2020-12-10 18:29:28,wahoo,Zwift - FUSION DECEMBER CUP (A),Quarq DZero,Kickr5,316,311,5
82860,210667,2020-12-13 17:19:28,wahoo,Zwift - 3R Racing (A),Quarq DZero,Kickr5,339,335,4
85574,210667,2020-12-20 18:39:24,wahoo,Zwift - XRS Races Crit (A),Quarq DZero,Kickr5,303,302,1
88281,210667,2020-12-28 12:39:22,wahoo,Zwift - 3R Volcano Climb Race - 1 Lap (22.4km/14mi 204m) (A),Quarq DZero,Kickr5,332,323,9
89146,210667,2020-12-30 18:29:19,wahoo,Zwift - 3R Race - France Petit Boucle - 45KM (A),Quarq DZero,Kickr5,352,345,7
89833,210667,2021-01-01 16:04:20,wahoo,Zwift - 3R Volcano Flat Race - 3 Laps (36.6km/22.7mi 138m) (A),Quarq DZero,Kickr5,316,309,7
90704,210667,2021-01-03 13:44:20,wahoo,Zwift - La Bicicletta Toronto & Toronto Hustle Donut Race (A),Quarq DZero,Kickr5,332,323,9
91741,210667,2021-01-05 16:04:58,wahoo,Zwift - 3R Volcano Circuit Flat Race - 8 Laps (35.2km/21.9mi 160m) (A),Quarq DZero,Kickr5,296,289,7
93038,210667,2021-01-07 18:29:58,wahoo,Zwift - FUSION WINTER CUP (A),Quarq DZero,Kickr5,328,317,11
94556,210667,2021-01-10 17:19:55,wahoo,Zwift - 3R Racing (A),Quarq DZero,Kickr5,318,307,11
96416,210667,2021-01-13 17:29:55,wahoo,Zwift - 3R & British Cycling South West - Series 2 (A),Quarq DZero,Kickr5,309,293,16
97588,210667,2021-01-15 19:34:42,wahoo,Zwift - 3R Watopia Hilly Race - 3 Laps (27km/16.8mi 300m) (A),Quarq DZero,Kickr5,321,311,10
98670,210667,2021-01-17 17:19:30,wahoo,Zwift - 3R Racing (A),Quarq DZero,Kickr5,350,342,8
100616,210667,2021-01-20 17:30:12,wahoo,Zwift - 3R & British Cycling South West - Series 2 (A),Quarq DZero To Garmin,Kickr V5 To Zwift,289,285,4
101091,210667,2021-01-21 18:29:41,wahoo,Zwift - FUSION WINTER CUP (A),Quarq DZero To Zwift,Kickr V5 To Wahoo App,315,305,10
102471,210667,2021-01-24 15:29:51,wahoo,Zwift - Team Draft Racing (A),Quarq DZero To Garmin,Kickr V5 To Zwift,314,307,7
103707,210667,2021-01-26 19:51:52,wahoo,Zwift - Zwift Racing League | WTRL - Men&#039;s/Mixed EMEA W2 DIVISION 1 (A),Quarq DZero To Zwift,Kickr V5 To Wahoo App,327,317,10
104775,210667,2021-01-28 18:29:44,wahoo,Zwift - FUSION WINTER CUP (A),Quarq DZero To Zwift,Kickr V5 To Wahoo App,342,333,9
107615,210667,2021-02-02 19:51:30,wahoo,Zwift - Zwift Racing League | WTRL - Men&#039;s/Mixed EMEA W2 DIVISION 1 (A),Quarq DZero To Zwift,Kickr V5 To Wahoo App,326,317,9
109017,210667,2021-02-04 18:29:37,wahoo,Zwift - FUSION WINTER CUP (A),Quarq DZero To Zwift,Kickr V5 To Wahoo App,329,322,7
110940,210667,2021-02-08 16:39:29,wahoo,Zwift - Team Italy PISSEI Race (A),Quarq DZero To Zwift,Kickr V5 To Wahoo App,320,312,8
111664,210667,2021-02-09 18:32:32,wahoo,Zwift - Zwift Racing League | WTRL - Men&#039;s/Mixed EMEA E2 DIVISION 6 (A),Quarq DZero To Zwift,Kickr V5 To Wahoo App,318,315,3
113094,210667,2021-02-11 18:25:43,wahoo,Zwift - FUSION WINTER CUP (A),Quarq DZero To Zwift,Kickr V5 To Wahoo App,331,322,9
115072,210667,2021-02-15 11:28:50,wahoo,Zwift - 3R Innsbruckring Flat Race - 3 Laps (26.4km/16.4mi 231m) (A),Quarq DZero To Zwift,Kickr V5 To Wahoo App,310,303,7
115948,210667,2021-02-16 18:25:57,wahoo,Zwift - Zwift Racing League | WTRL - Men&#039;s/Mixed EMEA E2 DIVISION 6 (A),Quarq DZero To Zwift,Kickr V5 To Wahoo App,352,338,14
117359,210667,2021-02-18 18:29:50,wahoo,Zwift - FUSION WINTER CUP (A),Quarq DZero To Zwift,Kickr V5 To Wahoo App,305,296,9
119724,210667,2021-02-23 18:25:41,wahoo,Zwift - Zwift Racing League | WTRL - Men&#039;s/Mixed EMEA E2 DIVISION 6 (A),Quarq DZero To Zwift,Kickr V5 To Wahoo App,328,316,12
120882,210667,2021-02-25 18:28:48,wahoo,Zwift - FUSION WINTER CUP (A),Quarq DZero To Zwift,Kickr V5 To Wahoo App,350,338,12
121624,210667,2021-02-27 14:20:00,wahoo,Zwift - CCBoucherville-V2000 FUN Races (A),Quarq DZero To Garmin,Kickr V5 To Zwift,316,302,14
122942,210667,2021-03-02 17:08:40,wahoo,Zwift - 3R Volcano KOM After Party Race - 2 laps + climb (40.2km/25mi 286m) (A),Quarq DZero To Zwift,Kickr V5 To Wahoo App,324,313,11
124912,210667,2021-03-06 11:12:09,wahoo,Zwift - Peloton Istanbul & BMC Turkiye Granfondo Series (A),Quarq DZero To Zwift,Kickr V5 To Wahoo App,334,324,10
127218,210667,2021-03-11 18:26:45,wahoo,Zwift - FUSION SPRING CUP (A),Quarq DZero To Zwift,Kickr V5 To Wahoo App,317,307,10
129236,210667,2021-03-16 17:09:09,wahoo,Zwift - 3R Volcano KOM After Party Race - 2 laps + climb (40.2km/25mi 286m) (A) INSANE Pace On Flats!!!,Quarq DZero To Zwift,Kickr V5 To Wahoo App,305,294,11
129644,210667,2021-03-17 16:07:58,wahoo,Zwift - 3R Tick Tock Flat Race - 2 Lap (36km/22.4mi 100m) (A),Quarq DZero To Zwift,Kickr V5 To Wahoo App,292,280,12
75456,210781,2020-11-24 21:39:58,neo,4iiii vs Neo OG Low,4iii Dual,Neo OG Low,333,356,-23
75457,210781,2020-11-24 21:39:58,neo,4iiii vs Neo OG High,4iiii Dual,Neo OG High,347,356,-9
101119,210781,2021-01-21 20:32:29,neo,Zwift - Watopia,FSA Powerbox ,Tacx Neo OG 36x17,235,233,2
106403,210781,2021-01-31 18:41:22,neo,Zwift - Watopia,Power2Max NG (1%),Neo OG 36x17 Erg,232,233,-1
64230,212789,2020-10-22 16:13:42,wahoo,Stages Gen2 Left Side Only / kickr,Stages Gen2 Left Side Only,kickr,230,237,-7
69246,212789,2020-11-08 12:01:34,wahoo,kickr / 2020-11-08-12-01-30,2020-11-08-12-01-30,kickr,302,318,-16
73046,212789,2020-11-18 14:12:22,wahoo,Stages Gen2 Left Side Only / kickr,Stages Gen2 Left Side Only,kickr,294,291,3
73050,212789,2020-11-19 17:11:13,wahoo,kickr / Stages Gen2 Left Side Only,Stages Gen2 Left Side Only,kickr,267,291,-24
75061,212789,2020-11-24 18:04:22,wahoo,Stages Gen2 Left Side Only / kickr,Stages Gen2 Left Side Only,kickr,271,283,-12
75508,212789,2020-11-25 16:42:51,wahoo,kickr / Stages Gen2 Left Side Only,Stages Gen2 Left Side Only,kickr,277,292,-15
56168,212924,2020-09-18 17:48:35,wahoo,Zwift - GGCC GlasgowGreen CC TT  (A),Quarq Elsa,Wahoo Kickr 18,386,354,32
56562,212924,2020-09-20 18:14:34,wahoo,Zwift - 3R Watopia Hilly Reverse Race - 4 Laps (36.7km/22.8mi 400m) (A),Quarq Elsa,Wahoo Kickr 18,385,363,22
57074,212924,2020-09-23 17:44:29,wahoo,Zwift - NCF Vinter Cup 2020 - Runde 1 - Herrer (A),Quarq Elsa,Wahoo Kickr 18,393,374,19
57863,212924,2020-09-27 10:09:22,wahoo,Zwift - 3R Sand & Sequoias - 1 Lap (20km/12.5mi 173m) (A),Quarq Elsa,Wahoo Kickr 18,419,397,22
58558,212924,2020-09-30 17:29:09,wahoo,Zwift - NCF Vinter Cup 2020 - Runde 2 - Herrer (A),Quarq Elsa,Wahoo Kickr 18,390,378,12
59459,212924,2020-10-04 17:19:13,wahoo,Zwift - 3R Greater London 8 Hilly Race - 1 Lap (23.8km/14.8mi 238m) (A),Quarq Elsa,Wahoo Kickr 18,418,399,19
60815,212924,2020-10-10 14:14:26,wahoo,Zwift - OH MY CRIT - Saturday Smash Race (A),Quarq Elsa,Wahoo Kickr 18,414,390,24
61903,212924,2020-10-14 17:29:09,wahoo,Zwift - NCF Vinter Cup 2020 - Runde 4 - Herrer (A),Quarq Elsa,Wahoo Kickr 18,431,419,12
63912,212924,2020-10-21 17:29:03,wahoo,Zwift - NCF Vinter Cup 2020 - Runde 5 - Herrer (A),Quarq Elsa,Wahoo Kickr 18,422,407,15
64379,212924,2020-10-23 13:02:42,wahoo,Zwift - Zwift Fast Fridays: Tempus Fugit Time Trial (E),Quarq Elsa,Wahoo Kickr 18,425,401,24
65901,212924,2020-10-28 18:28:56,wahoo,Zwift - NCF Vinter Cup 2020 - Runde 6 - Herrer (A),Quarq Elsa,Wahoo Kickr 18,430,392,38
66455,212924,2020-10-30 16:03:54,wahoo,Zwift - 3R Volcano Flat Race - 3 Laps (36.6km/22.7mi 138m) (A),Quarq Elsa,Wahoo Kickr 18,408,399,9
67940,212924,2020-11-04 18:28:50,wahoo,Zwift - NCF Vinter Cup 2020 - Runde 7 - Herrer (A),Quarq Elsa,Wahoo Kickr 18,421,409,12
68528,212924,2020-11-06 16:40:39,wahoo,Zwift - ZA Tri: TT Race - 40k,Quarq Elsa,Wahoo Kickr 18,385,372,13
70352,212924,2020-11-11 18:28:36,wahoo,Zwift - NCF Vinter Cup 2020 - Runde 8 - Herrer (A),Quarq Elsa,Wahoo Kickr 18,403,405,-2
71964,212924,2020-11-16 16:58:34,wahoo,Zwift - 3R Queens Highway Race - 6 Laps (A),Quarq Elsa,Wahoo Kickr 18,435,429,6
73205,212924,2020-11-19 19:28:31,wahoo,Zwift - World Championships Experience // Danish Cycling Federation,Quarq Elsa,Wahoo Kickr 18,388,383,5
74996,212924,2020-11-24 17:08:33,wahoo,Zwift - 3R Volcano KOM After Party Race - 2 laps + climb (40.2km/25mi 286m) (A),Quarq Elsa,Wahoo Kickr 18,441,427,14
79741,212924,2020-12-05 09:59:45,wahoo,Zwift - Nations Challenge // Norway (E),Quarq Elsa,Wahoo Kickr 18,340,338,2
82439,212924,2020-12-12 15:40:37,wahoo,Zwift - ZA Tri: TT Race - 20k,Quarq Elsa,Wahoo Kickr 18,362,362,0
97078,212924,2021-01-14 18:17:42,wahoo,Zwift - Espresso,Quarq Elsa,Wahoo Kickr 18,371,366,5
101344,212924,2021-01-22 12:29:55,wahoo,Zwift - ZHQ FutureWorks Crit City Race - Anti-sandbagging (A),Quarq Elsa,Wahoo Kickr 18,373,370,3
104673,212924,2021-01-28 18:29:41,wahoo,Zwift - British Cycling Time Trial Series (A),Quarq Elsa,Wahoo Kickr 18,381,376,5
116729,212924,2021-02-17 18:29:51,wahoo,Zwift - NCF Vintercup 2021 - Runde 6 - Herrer (A),Quarq Elsa,Wahoo Kickr 18,368,371,-3
120461,212924,2021-02-24 18:44:18,wahoo,Zwift - Scandinavian Cup 2021 - Round 1 - Men (A),Quarq Elsa,Wahoo Kickr 18,391,382,9
124349,212924,2021-03-04 10:58:38,wahoo,Zwift - MGCC D Pursuit Race (A),Quarq Elsa,Wahoo Kickr 18,380,372,8
126186,212924,2021-03-09 18:09:22,wahoo,Zwift - SZR iTT Spring Racing League (A),Quarq Elsa,Wahoo Kickr 18,379,377,2
65045,212990,2020-10-26 13:35:13,wahoo,Zwift - Crit City Race (A),Pioneer ,Kickr core,337,337,0
65602,212990,2020-10-27 23:00:03,wahoo,Zwift - ZHR Masters Atlantic (A),Pioneer ,Kickr core,365,365,0
65792,212990,2020-10-28 17:30:06,wahoo,Zwift - EVO CC Sprint Race Series  (A),Pioneer ,Kickr core,349,346,3
66097,212990,2020-10-29 17:05:02,wahoo,Zwift - OH MY CRIT! - The Double Race 2/2 (A),Pioneer ,Kickr core,376,387,-11
66226,212990,2020-10-29 20:20:03,wahoo,Zwift - 3R LaGuardia Loop Flat Race - 6 Laps (17.5km/10.9 162m) (A),Pioneer ,Kickr core,373,372,1
67013,212990,2020-11-01 16:30:01,wahoo,Zwift - Spaded Sweetie,Pioneer ,Kickr core,335,355,-20
67086,212990,2020-11-01 22:05:02,wahoo,Zwift - 3R Watopia Flat Route Reverse Race - 2 Laps (20.5km/12.7mi 108m) (A),Pioneer ,Kickr core,390,391,-1
67758,212990,2020-11-04 00:51:34,wahoo,Zwift - Zwift Racing League | WTRL - Men&#039;s AMERICAS E DIVISION 2 (A),Pioneer tt ,Kickr core,356,373,-17
68132,212990,2020-11-04 18:00:03,wahoo,Zwift - MIDWEEK Autumn Series by SZR (A),Pioneer ,Kickr core,363,368,-5
68162,212990,2020-11-05 16:15:02,wahoo,Zwift - OH MY CRIT! - The Double Race 1/2 (A),Pioneer tt ,Kickr core,416,428,-12
68176,212990,2020-11-05 17:05:02,wahoo,Zwift - OH MY CRIT! - The Double Race 2/2 (A),Pioneer tt ,Kickr core,380,380,0
69183,212990,2020-11-08 22:20:02,wahoo,Zwift - VO2 Max - 4x4 (40/20),Pioneer ,Kickr core,370,376,-6
69984,212990,2020-11-10 23:15:01,wahoo,Zwift - Velocious Sport Tue Night Criterium (Race) (A),Pioneer ,Kickr core,383,386,-3
70649,212990,2020-11-12 00:00:01,wahoo,Zwift - Pierre-Luc Samson [ClanKnox]&#039;s Meetup - Innsbruckring,Pioneer ,Kickr core,416,424,-8
71691,212990,2020-11-15 14:15:02,wahoo,KISS 100 Race Series - Americas,Pioneer ,Kickr core,376,378,-2
71939,212990,2020-11-16 16:10:06,wahoo,Zwift - 3R Classique Reverse Flat Race - 4 Laps (26.9km/16.7mi 57m) (A),Pioneer ,Kickr core,358,356,2
72087,212990,2020-11-16 17:00:02,wahoo,Zwift - 3R Queens Highway Race - 6 Laps (A),Pioneer ,Kickr core,405,406,-1
72983,212990,2020-11-19 16:15:04,wahoo,OH MY CRIT! - The Double Race 1/2,Pioneer ,Kickr core,370,377,-7
73438,212990,2020-11-20 13:00:03,wahoo,Zwift - Race 1 // Men // Z Pro Tri // Community (A),Pioneer ,Kickr core,370,376,-6
73455,212990,2020-11-20 13:30:03,wahoo,Zwift - Race 2 // Men // Z Pro Tri // Community (A),Pioneer ,Kickr core,344,353,-9
73465,212990,2020-11-20 14:00:02,wahoo,Zwift - Race 3 // Men // Z Pro Tri // Community (A),Pioneer ,Kickr core,400,409,-9
73866,212990,2020-11-21 15:15:04,wahoo,Zwift - OH MY CRIT - Saturday Smash Race (A),Pioneer ,Kickr core,379,385,-6
74513,212990,2020-11-23 13:35:02,wahoo,Zwift - Crit City Race (A),Pioneer ,Kickr core,328,335,-7
74551,212990,2020-11-23 17:00:04,wahoo,Zwift - 3R Queens Highway Race - 6 Laps (A),Pioneer ,Kickr core,374,386,-12
74716,212990,2020-11-23 20:10:03,wahoo,Zwift - GGCC Glasgow Green Cycle Club Race Series (A),Pioneer ,Kickr core,376,387,-11
75148,212990,2020-11-24 19:45:04,wahoo,Zwift - Zwift Racing League | WTRL - Men&#039;s EMEA W1 DIVISION 1,Pioneer ,Kickr core,422,434,-12
77567,212990,2020-11-30 13:30:05,wahoo,Zwift - ZHQ FutureWorks Circuit Race - Anti-sandbagging (A),Pioneer dual side,Kickr core,356,365,-9
77585,212990,2020-11-30 14:15:04,wahoo,Zwift - London,Pioneer dual side,Kickr core,339,345,-6
79434,212990,2020-12-04 17:30:05,wahoo,Zwift - EVO CC / Le Col - Sprint Race Series (A),Pioneer dual side,Kickr core,357,374,-17
79452,212990,2020-12-04 18:00:04,wahoo,Zwift - KIRCHMAIR Race Series (A),Pioneer dual side,Kickr core,408,423,-15
79807,212990,2020-12-05 16:05:04,wahoo,3R Classique Flat Race - 4 Laps (26.9km/16.7mi 76m),Pioneer dual side,Kickr core,371,382,-11
79826,212990,2020-12-05 16:45:05,wahoo,Crit City Race,Pioneer dual side,Kickr core,376,382,-6
80185,212990,2020-12-06 15:25:05,wahoo,Zwift - 3R Watopia 65km Race - 6 laps (40mi 324m) (A),Pioneer dual side,Kickr core,370,380,-10
80590,212990,2020-12-08 00:00:05,wahoo,Zwift - EVR Americas Race (A),Pioneer dual side,Kickr core,396,404,-8
81293,212990,2020-12-09 23:59:59,wahoo,Zwift - Pierre-Luc Samson [ClanKnox]&#039;s Meetup - Volcano Flat,Pioneer dual side,Kickr core,385,393,-8
81987,212990,2020-12-11 17:30:06,wahoo,Zwift - EVO CC / Le Col - Sprint Race Series (A),Pioneer dual side,Kickr core,396,399,-3
81994,212990,2020-12-11 18:00:05,wahoo,Zwift - KIRCHMAIR Race Series (A),Pioneer dual side,Kickr core,372,364,8
82019,212990,2020-12-11 18:30:05,wahoo,Zwift - KIRCHMAIR Race Series (A),Pioneer dual side,Kickr core,355,352,3
82413,212990,2020-12-12 15:15:06,wahoo,Zwift - OH MY CRIT - Saturday Smash Race (A),Pioneer dual side,Kickr core,444,444,0
82985,212990,2020-12-14 01:05:04,wahoo,Zwift - 3R Watopia Flat Route Race - 2 Laps (20.5km/12.7mi 108m) (A),Pioneer dual side,Kickr core,367,370,-3
83178,212990,2020-12-14 17:30:03,wahoo,Zwift - EVO CC Sprint Race Series  (A),Pioneer dual side,Kickr core,333,337,-4
83179,212990,2020-12-14 17:00:05,wahoo,Zwift - 3R Queens Highway Race - 6 Laps (A),Pioneer dual side,Kickr core,389,395,-6
84292,212990,2020-12-17 16:15:05,wahoo,Zwift - OH MY CRIT! - The Double Race 1/2 (A),Pioneer ,Kickr core,361,367,-6
85146,212990,2020-12-19 15:15:06,wahoo,Zwift - OH MY CRIT - Saturday Smash Race (A),Pioneer ,Kickr core,424,426,-2
86314,212990,2020-12-23 00:30:05,wahoo,Zwift - Midweek Criterium Race (A),Pioneer ,Kickr core,370,367,3
86738,212990,2020-12-24 02:16:58,wahoo,Zwift - Watopia,Pioneer ,Kickr core,417,409,8
87628,212990,2020-12-26 21:45:05,wahoo,Zwift - Crit City Race (A),Pioneer ,Kickr core,413,401,12
87639,212990,2020-12-26 22:15:04,wahoo,Zwift - 3R Classique Flat Race (A),Pioneer ,Kickr core,392,377,15
88238,212990,2020-12-28 16:10:04,wahoo,Zwift - 3R Classique Reverse Flat Race - 4 Laps (26.9km/16.7mi 57m) (A),Pioneer ,Kickr core,394,378,16
88312,212990,2020-12-28 19:20:05,wahoo,Zwift - Team TFC Mad Monday Winter Series (A),Pioneer ,Kickr core,423,417,6
88605,212990,2020-12-29 15:00:00,wahoo,Zwift - Vincent Arpin - MARDIS MACHINE&#039;s Meetup - Volcano Flat,Pioneer ,Kickr core,374,373,1
89028,212990,2020-12-30 15:00:01,wahoo,Zwift - bruno break away a deux ,Pioneer ,Kickr core,377,387,-10
89509,212990,2020-12-31 15:00:01,wahoo,Zwift - B-Vincent Arpin - MARDIS MACHINE&#039;s Meetup - Douce France,Pioneer ,Kickr core,434,431,3
90317,212990,2021-01-02 16:30:08,wahoo,Zwift - TEAM VEGAN Tofu Tornado (A),Pioneer ,Kickr core,402,395,7
90796,212990,2021-01-03 15:25:04,wahoo,Zwift - 3R Watopia 65km Race - 6 laps (40mi 324m) (A),Pioneer ,Kickr core,387,371,16
91380,212990,2021-01-04 19:20:06,wahoo,Zwift - Team TFC Mad Monday Winter Series (A),Pioneer ,Kickr core,387,395,-8
91450,212990,2021-01-04 22:30:04,wahoo,Zwift - 3R LaGuardia Loop Reverse Flat Race - 6 Laps (19.1km/11.9 162m) (A),Pioneer ,Kickr core,357,362,-5
91674,212990,2021-01-05 14:05:27,wahoo,Zwift - 3R LaGuardia Super Sprint Race - 1 Lap (3.7km/2.6mi 27m) (A),Pioneer ,Kickr core,351,361,-10
91704,212990,2021-01-05 14:30:05,wahoo,Zwift - DBR Tuesday Race (A),Pioneer ,Kickr core,376,375,1
91975,212990,2021-01-05 23:30:06,wahoo,Zwift - SweatFest Fall/Winter Series 2020/21 (A),Pioneer ,Kickr core,424,430,-6
92503,212990,2021-01-07 00:00:00,wahoo,Zwift - Pierre-Luc Samson (Clan Knox)&#039;s Meetup - The Fan Flats,Pioneer ,Kickr core,411,412,-1
92866,212990,2021-01-07 18:15:04,wahoo,Zwift - Vienna,Pioneer ,Kickr core,423,425,-2
93334,212990,2021-01-08 13:30:06,wahoo,Zwift - ZHQ FutureWorks Circuit Race - Anti-sandbagging (A),Pioneer ,Kickr core,345,346,-1
93475,212990,2021-01-08 18:50:06,wahoo,Zwift - Team CLS Racing - Hills &#039;n&#039; Thrills S5 (E),Pioneer ,Kickr core,384,379,5
93915,212990,2021-01-09 15:15:07,wahoo,Zwift - OH MY CRIT - Saturday Smash Race (A),Pioneer ,Kickr core,403,395,8
94970,212990,2021-01-11 19:15:04,wahoo,Zwift - Premier Division // Zwift Racing League (men) (A),Pioneer ,Kickr core,423,411,12
95502,212990,2021-01-12 14:05:27,wahoo,Zwift - 01/12/2021,Pioneer ,Kickr core,418,419,-1
95708,212990,2021-01-12 19:30:04,wahoo,Zwift - British Cycling Race Series (A),Pioneer ,Kickr core,379,377,2
96378,212990,2021-01-13 18:00:04,wahoo,Zwift - MIDWEEK Winter Series by SZR (A),Pioneer ,Kickr core,430,424,6
96634,212990,2021-01-14 00:00:00,wahoo,Zwift - Pierre-Luc Samson (Clan Knox)&#039;s Meetup - Lutece Express,Pioneer ,Kickr core,404,406,-2
96973,212990,2021-01-14 18:17:04,wahoo,Zwift - Vienna,Pioneer ,Kickr core,400,412,-12
97246,212990,2021-01-15 01:00:04,wahoo,Zwift - KISS Race Series - Americas PM (A),Pioneer ,Kickr core,350,361,-11
98313,212990,2021-01-16 23:00:03,wahoo,Zwift - ZHQ FutureWorks Crit City Race - Boost mode (A),Pioneer ,Kickr core,352,359,-7
98925,212990,2021-01-18 13:40:05,wahoo,Zwift - 3R Richmond UCI Hilly Race - 1 Lap (16.2km/10.1mi 142m) (A),Pioneer ,Kickr core,383,383,0
99209,212990,2021-01-18 19:53:06,wahoo,Zwift - Premier Division // Zwift Racing League (men) (A),Pioneer ,Kickr core,413,412,1
100830,212990,2021-01-21 16:15:05,wahoo,Zwift - OH MY CRIT! - The Double Race 1/2 (A),Pioneer ,Kickr core,386,373,13
101144,212990,2021-01-21 23:15:10,wahoo,Zwift - Koa Sports League Warrior Race (A),Pioneer ,Kickr core,351,343,8
102533,212990,2021-01-24 18:40:04,wahoo,Zwift - XRS Races Crit (A),Pioneer ,Kickr core,350,346,4
102544,212990,2021-01-24 19:35:04,wahoo,Zwift - 01/24/2021,Pioneer ,Kickr core,395,381,14
102632,212990,2021-01-24 23:10:04,wahoo,Zwift - The Bump Sprint Race (A),Pioneer ,Kickr core,396,410,-14
102633,212990,2021-01-25 00:15:04,wahoo,Zwift - 3R LaGuardia Loop Reverse Flat Race - 8 Laps (24.5km/15.2mi 216m) (A),Pioneer ,Kickr core,396,394,2
104899,212990,2021-01-28 23:15:05,wahoo,Zwift - Koa Sports League Warrior Race (A),Pioneer ,Kickr core,378,368,10
104901,212990,2021-01-28 23:45:04,wahoo,Zwift - Crit City Race (A),Pioneer ,Kickr core,370,364,6
105136,212990,2021-01-29 15:10:29,wahoo,Zwift - VO2 Max - 3 min,Pioneer ,Kickr core,352,361,-9
105663,212990,2021-01-30 15:15:05,wahoo,Zwift - OH MY CRIT!! - Saturday Smash Race (A),Pioneer ,Kickr core,394,386,8
105935,212990,2021-01-30 22:30:04,wahoo,Zwift - ZHQ FutureWorks Crit City Race - Anti-sandbagging (A),Pioneer ,Kickr core,385,383,2
106238,212990,2021-01-31 15:25:04,wahoo,Zwift - 3R Watopia 65km Race - 6 laps (40mi 324m) (A),Pioneer ,Kickr core,401,397,4
106344,212990,2021-01-31 15:25:04,wahoo,Zwift - XRS Races Crit (A),Pioneer ,Kickr core,401,367,34
106622,212990,2021-02-01 13:40:03,wahoo,Zwift - 3R Richmond UCI Hilly Race - 1 Lap (16.2km/10.1mi 142m) (A),Pioneer ,Kickr core,384,386,-2
106893,212990,2021-02-01 20:07:04,wahoo,Zwift - Premier Division // Zwift Racing League (men) (A),Pioneer ,Kickr core,427,424,3
107439,212990,2021-02-02 19:30:04,wahoo,Zwift - British Cycling Race Series (A),Pioneer ,Kickr core,379,377,2
107720,212990,2021-02-03 00:30:04,wahoo,Zwift - Midweek Crit: Around the World (The 6 Train) (A),Pioneer ,Kickr core,369,372,-3
108519,212990,2021-02-04 00:10:04,wahoo,Zwift - La Classique du Clan Knox (A),Pioneer ,Kickr core,363,375,-12
109338,212990,2021-02-05 15:30:07,wahoo,Zwift - DBR Friday Race (A),Pioneer ,Kickr core,402,409,-7
109932,212990,2021-02-06 15:15:04,wahoo,Zwift - OH MY CRIT!! - Saturday Smash Race (A),Pioneer ,Kickr core,447,461,-14
110720,212990,2021-02-08 01:05:06,wahoo,Zwift - 3R Watopia Flat Route Race - 2 Laps (20.5km/12.7mi 108m) (A),Pioneer ,Kickr core,380,373,7
111030,212990,2021-02-08 19:18:07,wahoo,Zwift - Premier Division // Zwift Racing League (men) (A),Pioneer ,Kickr core,427,432,-5
113209,212990,2021-02-12 01:00:08,wahoo,Zwift - KISS Race Series - Americas PM (A),Pioneer dual side,Kickr core,361,364,-3
113765,212990,2021-02-13 00:27:13,wahoo,Zwift - Ramp Test,Pioneer dual side,Kickr core,392,409,-17
115151,212990,2021-02-15 12:40:15,wahoo,Zwift - 3R Volcano Climb Race - 1 Lap (22.4km/14mi 204m) (A),2021_02_15_07_40_28,Kickr core,377,393,-16
115391,212990,2021-02-15 20:02:04,wahoo,Zwift - Premier Division // Zwift Racing League (men) (A),Pioneer dual side,Kickr core,439,445,-6
115690,212990,2021-02-16 12:33:11,wahoo,Zwift - 30 sec + 1 min + 2 min,Pioneer dual side,Kickr core,338,342,-4
116466,212990,2021-02-17 12:30:03,wahoo,Zwift - 3R LaGuardia Loop Flat Race - 10 Laps (28.3km/17.6mi 270m) (A),Pioneer dual side,Kickr core,388,390,-2
117489,212990,2021-02-18 23:15:02,wahoo,Zwift - Koa Sports League Warrior Race (A),Pioneer dual side,Kickr core,384,383,1
117491,212990,2021-02-18 23:45:02,wahoo,Zwift - Crit City Race (A),Pioneer dual side,Kickr core,365,366,-1
118735,212990,2021-02-21 14:15:03,wahoo,Zwift - KISS 100 Race Series - Americas (A),Pioneer dual side,Kickr core,381,380,1
121665,212990,2021-02-27 15:15:04,wahoo,Zwift - OH MY CRIT!! - Saturday Smash Race (A),Pioneer dual side,Kickr core,368,377,-9
121856,212990,2021-02-27 20:05:03,wahoo,Zwift - 3R Flat Race (A),Pioneer dual side,Kickr core,341,346,-5
122208,212990,2021-02-28 18:40:02,wahoo,Zwift - XRS Races Crit (A),Pioneer dual side,Kickr core,368,367,1
122367,212990,2021-03-01 14:30:03,wahoo,Zwift - Aero Army Wyn TT Series (A),Pioneer dual side,Kickr core,413,417,-4
122614,212990,2021-03-01 20:15:03,wahoo,Zwift - Premier Division // Zwift Racing League (men) (A),Pioneer dual side,Kickr core,402,402,0
125403,212990,2021-03-07 14:20:02,wahoo,Zwift - Macro to Micro,Pioneer dual side,Kickr core,374,387,-13
126212,212990,2021-03-09 19:03:03,wahoo,Zwift - 3R Omnium Event - Race 1 - Scatch Race,Pioneer dual side,Kickr core,404,402,2
129292,212990,2021-03-16 18:55:05,wahoo,Zwift - Team Italy & Frenchy Fuzion League (A),Pioneer dual side,Kickr core,420,426,-6
83375,214973,2020-12-15 10:16:26,wahoo,kickr / quarq,quarq,kickr,321,320,1
128201,214973,2021-03-14 04:05:01,wahoo,Zwift - 3R Innsbruckring Flat Race - 2 Laps (17.6km/10.9m 154m) (A),nishijo.2021-03-14-04-30-35-415Z.GarminPush.85305721696,Kickr v5,300,298,2
26731,217039,2020-04-17 13:20:19,neo,Zwift - Watopia,assioma duo,tacx neo,345,340,5
26928,217039,2020-04-22 09:44:46,neo,Zwift - USA Cycling Race League by Indoor Specialist  (A),assioma duo,tacx neo,346,345,1
31971,217649,2020-05-06 09:53:19,wahoo,4iiii Precision Dual Powermeter / Wahoo Kickr,4iiii Precision Dual Powermeter,Wahoo Kickr,176,180,-4
101863,217993,2021-01-23 13:29:43,wahoo,Zwift - Fierce Felines Racing Series: Gravel (B),stages,kickr,258,246,12
102362,217993,2021-01-24 12:02:01,wahoo,Zwift - USA Cycling Xtra Long Ride by DIRT (D),kickr,kickr,174,163,11
102363,217993,2021-01-24 12:02:01,wahoo,Zwift - USA Cycling Xtra Long Ride by DIRT (D),stages,kickr,174,163,11
105580,217993,2021-01-30 13:30:22,wahoo,Zwift - Fierce Felines Racing Series: Criterium (B),stages,kickr,223,223,0
105586,217993,2021-01-30 13:29:55,wahoo,Zwift - Fierce Felines Racing Series: Criterium (B),stages,kickr,242,223,19
108273,217993,2021-02-03 18:19:47,wahoo,Zwift - NCF Vintercup 2021 - Runde 4 - Kvinner (B),stages,kickr,259,236,23
110597,217993,2021-02-07 17:29:50,neo,Zwift - Wakey-Wakey Kiwi Crew (C),stages,tax neo,194,177,17
112265,217993,2021-02-10 18:19:55,neo,Zwift - NCF Vintercup 2021 - Runde 5 - Kvinner (B),stages,tax neo,236,219,17
116632,217993,2021-02-17 18:19:48,neo,Zwift - NCF Vintercup 2021 - Runde 6 - Kvinner (B),stages,tax neo,233,216,17
97418,218100,2021-01-15 13:00:02,wahoo,Assioma,Assioma,Kickr,319,312,7
85840,219489,2020-12-21 18:58:19,wahoo,Zwift - EVR Europe Race (A),powermeter,wahoo kickr 5.0,347,350,-3
86155,219489,2020-12-21 18:58:19,wahoo,Zwift - ZHR Masters Europe (C),powermeter,wahoo kickr 5.0,347,358,-11
86677,219489,2020-12-23 19:00:27,wahoo,Zwift - Zwift NL Race Day (A),powermeter,wahoo kickr 5.0,370,370,0
87155,219489,2020-12-25 12:17:16,wahoo,Zwift - Peak-PTY Climb Challenge Fridays (A),powermeter,wahoo kickr 5.0,406,408,-2
87428,219489,2020-12-26 13:17:17,wahoo,Zwift - 3R Innsbruckring Flat Race - 5 Laps (44km/27.3mi 385m) (A),2020-12-26-131717-ELEMNT BOLT F810-92-0,wahoo kickr 5.0,353,349,4
87796,219489,2020-12-27 13:04:50,wahoo,Zwift - 3R Watopia Flat Route Race - 4 Laps (40.5km/25.1mi 216m) (A),powermeter,wahoo kickr 5.0,359,353,6
90691,219489,2021-01-03 12:19:40,wahoo,Zwift - Ottawa TopSpeed Race (A),powermeter,wahoo kickr 5.0,392,399,-7
92984,219489,2021-01-07 18:57:11,wahoo,Zwift - BENELIGA 2020-2021 (E),powermeter,wahoo kickr 5.0,387,386,1
100216,219489,2021-01-20 14:20:41,wahoo,Zwift - Team Italy Specialissima Race  (A),2021-01-20-142041-ELEMNT BOLT F810-109-0,wahoo kickr 5.0,386,381,5
115971,219489,2021-02-16 19:17:48,wahoo,Zwift - ZHR Masters (m50+),powermeter,wahoo kickr 5.0,384,403,-19
118827,219489,2021-02-21 14:12:51,wahoo,Zwift - KISS 100 Race Series - Americas (A),powermeter,wahoo kickr 5.0,354,373,-19
123074,219489,2021-03-02 19:22:16,wahoo,Zwift - ZHR Masters (C),powermeter,wahoo kickr 5.0,417,415,2
87290,219964,2020-12-24 00:14:34,wahoo,Zwift - Cycling Canada Wednesday Night Race Series (A),Quarq DFour91,Wahoo Kickr Gen2,347,375,-28
88816,219964,2020-12-30 00:29:58,wahoo,Zwift - Toronto Hustle Holiday Classic Stage Race: Stage Three (A),Quarq DFour91,Wahoo Kickr Gen2,371,397,-26
90033,219964,2021-01-02 06:30:00,wahoo,Zwift - XRS Races - The Saturday Classic (A),Quarq DFour91,Wahoo Kickr Gen2,387,413,-26
92603,219964,2021-01-07 08:29:57,wahoo,Zwift - KISS Race Series - Down Under (A),Quarq DFour91,Wahoo Kickr Gen2,393,392,1
96134,219964,2021-01-13 08:29:57,wahoo,Zwift - Climbers Day p/b dPAC.fit & Precision Hydration (A),Quarq DFour91,Wahoo Kickr Gen2,386,385,1
100496,219964,2021-01-20 08:29:58,wahoo,Zwift - Climbers Day p/b dPAC.fit & Precision Hydration (A),Quarq DFour91,Wahoo Kickr Gen2,392,383,9
101640,219964,2021-01-23 06:29:58,wahoo,Zwift - XRS Races - The Saturday Classic (A),Quarq DFour91,Wahoo Kickr Gen2,405,407,-2
112063,219964,2021-02-10 08:29:58,wahoo,Zwift - Climbers Day p/b dPAC.fit & Precision Hydration (A),Quarq DFour91,Wahoo Kickr Gen2,375,381,-6
127721,219964,2021-03-13 06:29:56,wahoo,Zwift - XRS Races - The Saturday Classic (A),Quarq DFour91,Wahoo Kickr Gen2,395,391,4
127725,219964,2021-03-12 22:09:57,wahoo,Zwift - Watopia,Stages TT,Wahoo Kickr Gen2,295,292,3
129529,219964,2021-03-17 09:04:58,wahoo,Zwift - 3R Watopia Flat Route Race - 3 Laps (30.3km/18.8mi 162m) (A),Quarq DFour91,Wahoo Kickr Gen2,361,375,-14
25261,222519,2020-04-11 10:44:18,wahoo,Stages / kickr,Stages,kickr,352,376,-24
56155,222947,2020-09-18 16:04:51,wahoo,3R Volcano Flat Race - 3 Laps (36.6km/22.7mi 138m),Stages R G3 Ultra R8000,Wahoo Kickr (v5),308,323,-15
65866,222947,2020-10-27 19:50:50,wahoo,Zwift Racing League | WTRL - Men&#039;s EMEA W2 DIVISION 1,Stages R G3 Ultra R8000,Wahoo Kickr (v5),294,316,-22
93071,223557,2021-01-07 18:59:45,wahoo,Zwift - BENELIGA 2020-2021 (E),4iiii Precision,Wahoo Kickr,355,328,27
26051,224371,2020-04-16 00:29:10,wahoo,Zwift - USA Cycling Race League by Indoor Specialist  (A),Quarq Dzero,Kickr 2018,388,378,10
27029,224371,2020-04-22 17:28:33,wahoo,Zwift - USA Cycling Race League by Indoor Specialist  (A),Quarq Dzero ,Kickr 2018,372,366,6
29224,224371,2020-04-29 17:30:56,wahoo,Zwift - USA Cycling Race League by Indoor Specialist  (A),favero assioma duo,Kickr 2018,389,381,8
29263,224371,2020-04-28 23:15:46,wahoo,Zwift - Midweek Criterium Race (A),favero assioma duo,Kickr 2018,372,365,7
31828,224371,2020-05-05 22:54:34,wahoo,Zwift - Midweek Criterium Race (A),Quarq Dzero ,Kickr 2018,354,349,5
32120,224371,2020-05-06 17:28:31,wahoo,Zwift - USA Cycling Race League p/b Saris+ThePro&#039;sCloset  (A),Quarq Dzero ,Kickr 2018,361,354,7
19309,225517,2020-03-23 18:29:23,wahoo,Zwift - Stage 4 Race (B) - Tour of Watopia 2020,Stages,Kicker,290,303,-13
20694,225517,2020-03-30 20:55:54,wahoo,Zwift - Ramp Test,Stages,Kicker,336,335,1
21564,225517,2020-04-02 22:07:28,wahoo,Zwift - 4x8 Sweet spot,Stages,Kicker,271,256,15
23624,225517,2020-04-10 23:36:53,wahoo,Zwift - 3x15 Sweet spot,Stages,Kicker,266,264,2
23911,225517,2020-04-12 02:30:17,wahoo,Zwift - London,Stages,Kicker,336,325,11
26068,225517,2020-04-18 22:43:34,wahoo,Zwift - 3x15 Sweet spot,Stages,Kicker,268,242,26
26772,225517,2020-04-21 17:30:13,wahoo,Zwift - New Workout,Stages,Kicker,286,275,11
27741,225517,2020-04-24 21:41:36,wahoo,Zwift - 2x10FTP,Stages,Kicker,299,286,13
27742,225517,2020-04-22 16:00:11,wahoo,Zwift - 6wk Beginner FTP Builder Week 5 Active Recovery,Stages,Kicker,209,209,0
28559,225517,2020-04-28 03:30:02,wahoo,Zwift - 2. Half-Distance Power Development,Stages,Kicker,265,248,17
31860,225517,2020-05-06 04:32:11,wahoo,Zwift - Ramp Test,Stages,Kicker,339,348,-9
32624,225517,2020-05-08 03:38:14,wahoo,Zwift - 4. Endurance Stimulation,Stages,Kicker,302,289,13
33142,225517,2020-05-10 00:16:01,wahoo,Zwift - 3. FTP Development,Stages,Kicker,309,301,8
56751,225517,2020-09-21 17:59:45,wahoo,Zwift - Build Me Up - Ham Sandwich,Stages,Kicker,251,254,-3
57314,225517,2020-09-21 18:02:54,wahoo,Zwift - Build Me Up - Yellow Unicorn,Stages,Kicker,256,254,2
57782,225517,2020-09-26 18:28:55,wahoo,Zwift - Build Me Up - Amalgam,Stages,Kicker,267,274,-7
59113,225517,2020-10-02 17:56:24,wahoo,Zwift - Build Me Up - Purple Unicorn,Stages,Kicker,266,270,-4
59585,225517,2020-10-05 09:56:57,wahoo,Ramp test + #8,Stages,Kicker,327,347,-20
60605,225517,2020-10-09 11:41:02,wahoo,Zwift - Build Me Up - Escalation,Stages,Kicker,299,314,-15
60860,225517,2020-10-10 17:38:44,wahoo,Zwift - Build Me Up - Method,Stages,Kicker,253,251,2
61577,225517,2020-10-12 18:05:34,wahoo,Zwift - Build Me Up - 15.9,Stages,Kicker,253,265,-12
61942,225517,2020-10-14 18:14:44,wahoo,Zwift - Build Me Up - C.A.,Stages,Kicker,290,294,-4
62236,225517,2020-10-15 17:48:32,wahoo,Zwift - Build Me Up - Uphill Battle,Stages,Kicker,289,293,-4
62366,225517,2020-10-16 08:20:48,wahoo,Zwift - Build Me Up - Attack!,Stages,Kicker,259,255,4
62586,225517,2020-10-17 09:50:10,wahoo,Zwift - MGCC Bagel (B),Stages,Kicker,313,324,-11
63512,225517,2020-10-20 17:51:44,wahoo,Zwift - Build Me Up - Giza,Stages,Kicker,246,250,-4
63946,225517,2020-10-21 18:33:50,wahoo,Zwift - Build Me Up - Spaded Sweetie,Stages,Kicker,294,310,-16
64256,225517,2020-10-22 18:14:14,wahoo,Zwift - Build Me Up - Kirizuma,Stages,Kicker,295,317,-22
64759,225517,2020-10-25 06:54:53,wahoo,Zwift - Build Me Up - Cucumber,Stages,Kicker,289,291,-2
65914,225517,2020-10-28 18:53:50,wahoo,Zwift - Build Me Up - Hang Ten,Stages,Kicker,262,272,-10
66506,225517,2020-10-30 20:18:13,wahoo,Zwift TT,Stages,Kicker,319,334,-15
66875,225517,2020-11-01 08:13:45,wahoo,Zwift - Build Me Up - Bricolage,Stages,Kicker,293,307,-14
67181,225517,2020-11-02 13:47:16,wahoo,Zwift - Build Me Up - Circus,Stages,Kicker,299,330,-31
67899,225517,2020-11-04 14:36:59,wahoo,Zwift - Build Me Up - Malevolent,Stages,Kicker,310,329,-19
68439,225517,2020-11-06 08:01:32,wahoo,Zwift - Build Me Up - Mosaic,Stages,Kicker,278,292,-14
68951,225517,2020-11-08 08:05:35,wahoo,Zwift - Build Me Up - Melange,Stages,Kicker,267,274,-7
69880,225517,2020-11-10 19:28:45,wahoo,Zwift - Build Me Up - Potpourri,Stages,Kicker,261,270,-9
70322,225517,2020-11-11 18:58:31,wahoo,Zwift - Build Me Up - Exemplar,Stages,Kicker,274,286,-12
71711,225517,2020-11-15 10:46:26,wahoo,Zwift - Build Me Up - Serrated,Stages,Kicker,279,288,-9
73575,225517,2020-11-20 15:18:07,wahoo,Zwift - Build Me Up - Aspire,Stages,Kicker,289,294,-5
74200,225517,2020-11-22 11:13:53,wahoo,Zwift - Build Me Up - Tenacity,Stages,Kicker,280,283,-3
76959,225517,2020-11-28 15:23:09,wahoo,Zwift - Ramp Test,Stages,Kicker,346,364,-18
101038,225517,2021-01-21 18:44:45,wahoo,Zwift - Build Me Up - Devedeset,Stages,Kicker,262,261,1
16754,227489,2020-03-04 10:22:01,wahoo,DIRT & IS: Bakers Dozen,4iiii PM,Kickr Core,348,346,2
42806,227489,2020-06-20 11:03:55,wahoo,Herd Summer racing League #2,4iiii PM,Kickr Core,350,353,-3
46823,227489,2020-07-18 10:45:15,wahoo,HERD Watopia Hilly 4 race,4iiii PM,Kickr Core,316,298,18
47880,227489,2020-07-26 18:58:39,wahoo,BRT Championship - Magnificent 8 ,4iiii PM,Kickr Core,326,326,0
48491,227489,2020-08-01 11:09:54,wahoo,Zwift - Herd Summer Racing League Race 8 (B),4iiii PM,Kickr Core,334,345,-11
57675,227489,2020-09-26 10:57:53,wahoo,Herd Summer Racing League Series,4iiii PM,Kickr Core,353,355,-2
67503,227544,2020-11-03 10:30:00,neo,Zwift - European Lunch Ride (E),2020-11-03-13-33-54-Bike,TACX NEO,231,227,4
67507,227544,2020-11-03 10:30:00,neo,Zwift - European Lunch Ride (E),Stages LEFT FELT,TACX NEO,231,227,4
67842,227544,2020-11-04 08:30:00,neo,Zwift - Climbers Day p/b dPAC.fit & Precision Hydration (B),Stages LEFT FELT,TACX NEO,314,324,-10
68448,227544,2020-11-06 09:41:06,neo,Zwift - Watopia - hilly route recovey ,Stages LEFT LYNSKEY,TACX NEO,216,230,-14
12995,229626,2020-02-08 11:14:29,wahoo,Zwift - wife’s 2018 Kickr power test. 2 hr ,Quarq DZero,2018 Wahoo Kickr ,334,333,1
36753,230338,2020-05-21 21:41:40,wahoo,Wahoo Kickr V3 / Pioneer SGY-910H,Pioneer SGY-910H,Wahoo Kickr V3,281,278,3
38005,230338,2020-05-27 09:02:00,wahoo,Wahoo Kickr V3 / Pioneer SGY-910H2,Pioneer SGY-910H2,Wahoo Kickr V3,272,267,5
38435,230338,2020-05-28 19:53:47,wahoo,JETT Base Ride (2.7~4.5w/kg)75km (A)　RIDEA oval gear,Pioneer SGY-910H,Wahoo Kickr V3,263,254,9
38623,230338,2020-05-30 06:57:13,wahoo,London　RIDEA oval gear,Favero Assioma Duo,Wahoo Kickr V3,294,289,5
40099,230338,2020-06-07 05:02:49,wahoo,3R Volcano Flat Race　6min　RIDEA oval gear@SGY-PM910V　vs　KICKRv3,Pioneer SGY-910V,Wahoo Kickr V3,232,227,5
40248,230338,2020-06-07 18:53:51,wahoo,RIDEA oval gear@SGY-PM910V　vs　KICKRv3　 TBR Power Up with WonderBoy (C),Pioneer SGY-910V,Wahoo Kickr V3,262,251,11
40914,230338,2020-06-11 01:10:35,wahoo,RIDEA oval gear@SGY-PM910H　vs　KICKRv3  ZwiftWorkout  ERGMODE,Pioneer SGY-910H,Wahoo Kickr V3,270,256,14
44658,230338,2020-07-03 08:53:58,wahoo,Rotor ALDHU Crank@Oval50-36T KICKRv3 vs INSpider (windowsAPP/BT),INSpider,Wahoo Kickr V3,296,272,24
45360,230338,2020-07-08 03:01:16,wahoo,Rotor ALDHU Crank@Oval50-36T KICKRv3 vs INSpider (windowsAPP/BT),INSpider,Wahoo Kickr V3,308,291,17
45544,230338,2020-07-09 05:51:12,wahoo,Wahoo KICKR V3(iphone app calibration)/Pioneer PM910H2 50/38t,Pioneer SGY-910H2,Wahoo Kickr V3,257,266,-9
45736,230338,2020-07-10 04:48:12,wahoo,Wahoo KICKR V3(iphone app calibration)/Pioneer PM910H2 50/38t,Pioneer SGY-910H2,Wahoo Kickr V3,234,228,6
45839,230338,2020-07-10 22:27:38,wahoo,Wahoo KICKR V3( Zwift calibration)/Pioneer PM910H2 50/38t,Pioneer SGY-910H2,Wahoo Kickr V3,215,218,-3
45881,230338,2020-07-11 06:49:29,wahoo,Wahoo KICKR V3( Zwift calibration)/Pioneer PM910H2 50/38t,Pioneer SGY-910H2,Wahoo Kickr V3,234,232,2
47580,230338,2020-07-24 20:48:43,wahoo,Zwift - Virtual Tour de France - A - Stage 6 Discovery Ride,Pioneer SGY-910HL,Wahoo Kickr V3,232,239,-7
47618,230338,2020-07-25 07:20:08,wahoo,KICKRv3 vs XCADEY XPOWER-S@Oval50-36T (P Adjust 50%),XCADEY XPOWER-S,Wahoo Kickr V3,218,238,-20
47852,230338,2020-07-27 10:36:52,wahoo,Zwift - ZWC Hill Climb Battle (A),XCADEY XPOWER-S,Wahoo Kickr V3,308,289,19
50698,230338,2020-08-19 10:55:40,wahoo,KICKRv3 vs XCADEY XPOWER-S@Oval50-36T (P Adjust 110%),XCADEY XPOWER-S（ NEW）,Wahoo Kickr V3,199,208,-9
51028,230338,2020-08-21 02:04:56,wahoo,KICKRv3 vs XCADEY XPOWER-S@Oval50-36T (P Adjust 112%),XCADEY XPOWER-S（ NEW）,Wahoo Kickr V3,248,256,-8
51193,230338,2020-08-22 07:48:57,wahoo,KICKRv3 vs XCADEY XPOWER-S@Oval50-36T (P Adjust 115%),XCADEY XPOWER-S＿Gr,Wahoo Kickr V3,231,234,-3
51290,230338,2020-08-22 19:52:15,wahoo,KICKRv3 vs XCADEY XPOWER-S@Oval50-36T (P Adjust 119%),XCADEY XPOWER-S＿Gr,Wahoo Kickr V3,243,237,6
51565,230338,2020-08-24 20:44:41,wahoo,KICKRv3 vs XCADEY XPOWER-S@Oval50-36T (P Adjust 118%),XCADEY XPOWER-S＿Gr,Wahoo Kickr V3,303,293,10
51619,230338,2020-08-25 08:50:48,wahoo,KICKRv3 vs XCADEY XPOWER-S@Oval50-36T (P Adjust 117%),XCADEY XPOWER-S＿Gr,Wahoo Kickr V3,240,237,3
52110,230338,2020-08-27 07:59:56,wahoo,: KICKRv3 vs XCADEY XPOWER-S@Oval50-36T (P Adjust 117%),XCADEY XPOWER-S＿Gr,Wahoo Kickr V3,253,258,-5
54522,230338,2020-09-11 04:57:40,wahoo,KICKRv3 vs XCADEY XPOWER-S@Oval50-36T (P Adjust 58%/Firmware 29),XCADEY XPOWER-S＿Gr,Wahoo Kickr V3,299,295,4
56953,230338,2020-09-23 08:51:49,wahoo,KICKRv3 vs XCADEY XPOWER-S@Oval50-36T (P Adjust 133%/Firmware 27),XCADEY XPOWER-S＿Gr,Wahoo Kickr V3,201,203,-2
56957,230338,2020-09-23 09:10:44,wahoo, KICKRv3 vs XCADEY XPOWER-S@Oval50-36T (P Adjust 132%/Firmware 27),XCADEY XPOWER-S＿Gr,Wahoo Kickr V3,244,245,-1
56958,230338,2020-09-23 09:31:09,wahoo, KICKRv3 vs XCADEY XPOWER-S@Oval50-36T (P Adjust 132%/Firmware 27),XCADEY XPOWER-S＿Gr,Wahoo Kickr V3,225,225,0
57103,230338,2020-09-23 19:32:25,wahoo, KICKRv3 vs XCADEY XPOWER-S@Oval50-36T (P Adjust 132%/Firmware 27),XCADEY XPOWER-S＿Gr,Wahoo Kickr V3,186,183,3
57157,230338,2020-09-24 07:34:49,wahoo,KICKRv3 vs XCADEY XPOWER-S@Oval50-36T (P Adjust 96%/Firmware 27),XCADEY XPOWER-S＿Bl,Wahoo Kickr V3,272,261,11
57162,230338,2020-09-24 08:00:02,wahoo,KICKRv3 vs XCADEY XPOWER-S@Oval50-36T (P Adjust 93%/Firmware 27),XCADEY XPOWER-S＿Bl,Wahoo Kickr V3,216,212,4
57165,230338,2020-09-24 08:18:55,wahoo,KICKRv3 vs XCADEY XPOWER-S@Oval50-36T (P Adjust 92%/Firmware 27),XCADEY XPOWER-S＿Bl,Wahoo Kickr V3,199,201,-2
57415,230338,2020-09-25 05:54:37,wahoo,KICKRv3 vs XCADEY XPOWER-S@Oval50-36T (P Adjust 92%/Firmware 27),XCADEY XPOWER-S＿Bl,Wahoo Kickr V3,273,276,-3
57958,230338,2020-09-27 19:00:02,wahoo,Zwift - KISS at Race - EU PM (A) KICKRv3 vs XCADEY XPOWER-S@Oval50-36T (P Adjust 132%/Firmware 27),XCADEY XPOWER-S＿Gr,Wahoo Kickr V3,270,260,10
62363,230338,2020-10-16 07:39:00,wahoo,KICKRv3 vs XCADEY XPOWER-S@Oval50-36T (P Adjust 132%/Firmware 29),XCADEY XPOWER-S＿Gr,Wahoo Kickr V3,244,252,-8
82986,230338,2020-12-14 01:00:53,wahoo,Zwift - 3R Watopia Flat Route Race - 2 Laps (20.5km/12.7mi 108m) (A),XCADEY XPOWER-S＿Gr,Wahoo Kickr V3,287,285,2
88026,230338,2020-12-28 00:06:39,wahoo,Wahoo Kickr V3 / XCADEY XPOWER-S＿Gr,XCADEY XPOWER-S＿Gr,Wahoo Kickr V3,269,279,-10
89245,230338,2020-12-31 00:40:17,wahoo,Wahoo Kickr V3 / 4541924636,4541924636,Wahoo Kickr V3,258,260,-2
92497,230338,2021-01-06 22:50:18,wahoo,Zwift - TDZ Stage 1: Longer Ride,XCADEY XPOWER-S＿Bl,Wahoo Kickr V3,272,261,11
92534,230338,2021-01-07 05:27:29,wahoo,Zwift - Watopia,XCADEY XPOWER-S＿Bl,Wahoo Kickr V3,261,263,-2
93089,230338,2021-01-07 22:07:16,wahoo,Zwift - 3R Alpe Du Zwift KOM Race (20km 1444m) (A),XCADEY XPOWER-S＿Bl,Wahoo Kickr V3,289,288,1
93597,230338,2021-01-09 01:12:28,wahoo,Zwift - Richmond,Favero Assioma Duo,Wahoo Kickr V3,240,237,3
93627,230338,2021-01-09 04:12:44,wahoo,Zwift - Watopia,XCADEY XPOWER-S＿Gr,Wahoo Kickr V3,266,273,-7
95948,230338,2021-01-12 23:26:50,wahoo,Zwift - ZHQ FutureWorks Circuit Race - Anti-sandbagging (A),XCADEY XPOWER-S＿Gr,Wahoo Kickr V3,269,277,-8
96203,230338,2021-01-13 11:00:01,wahoo,Zwift - yas Miyamoto(TCR)&#039;s Meetup - Hilly Route,XCADEY XPOWER-S＿Gr,Wahoo Kickr V3,262,263,-1
100133,230338,2021-01-20 10:58:04,wahoo,Zwift - yas Miyamoto(TCR)&#039;s Meetup - Whole Lotta Lava,XCADEY XPOWER-S＿Gr,Wahoo Kickr V3,302,290,12
102208,230338,2021-01-24 07:32:36,wahoo,Zwift - TDZ Stage 5: Longer Ride,XCADEY XPOWER-S＿Gr,Wahoo Kickr V3,273,278,-5
103311,230338,2021-01-26 12:22:15,wahoo,EMU Japan Race,XCADEY XPOWER-S＿Gr,Wahoo Kickr V3,298,291,7
104489,230338,2021-01-28 10:49:40,wahoo,Zwift - EMU Japan Short Race (A),XCADEY XPOWER-S＿Gr,Wahoo Kickr V3,300,309,-9
109091,230338,2021-02-04 21:29:28,wahoo,Zwift - TDZ Stage 7: Shorter Ride,XCADEY XPOWER-S＿Gr,Wahoo Kickr V3,284,288,-4
111399,230338,2021-02-09 11:23:16,wahoo,Zwift - EMU Japan Race (A),XCADEY XPOWER-S＿Gr,Wahoo Kickr V3,294,295,-1
111889,230338,2021-02-09 23:22:47,wahoo,Zwift - TDZ Stage 8: Group Ride,XCADEY XPOWER-S＿Gr,Wahoo Kickr V3,246,250,-4
113760,230338,2021-02-12 23:09:43,wahoo,Zwift - Crit City Race (A),XCADEY XPOWER-S＿Gr,Wahoo Kickr V3,276,281,-5
115701,230338,2021-02-16 12:02:59,wahoo,Zwift - EMU Japan Race (A),XCADEY XPOWER-S＿Gr,Wahoo Kickr V3,294,295,-1
121003,230338,2021-02-25 23:22:06,wahoo,Zwift - Haute Route Watopia 2021 Stage 1 (A),XCADEY XPOWER-S＿Gr,Wahoo Kickr V3,246,244,2
121417,230338,2021-02-27 06:48:52,wahoo,Zwift - Haute Route Watopia 2021 Stage 2 (A),XCADEY XPOWER-S＿Gr,Wahoo Kickr V3,248,249,-1
122029,230338,2021-02-28 09:21:42,wahoo,Zwift - Haute Route Watopia 2021 Stage 3 (A),XCADEY XPOWER-S＿Gr,Wahoo Kickr V3,250,254,-4
122831,230338,2021-03-02 11:19:10,wahoo,Zwift - EMU Japan Race (A),XCADEY XPOWER-S＿Gr,Wahoo Kickr V3,288,293,-5
123884,230338,2021-03-04 10:44:39,wahoo,EMU Japan Short Race,XCADEY XPOWER-S＿Gr,Wahoo Kickr V3,298,303,-5
126065,230338,2021-03-09 11:48:54,wahoo,Zwift - EMU Japan Race (A),XCADEY XPOWER-S＿Gr,Wahoo Kickr V3,288,287,1
126840,230338,2021-03-11 08:25:01,wahoo,Zwift - ZHQ Steering Race // FutureWorks - Crit City (A),XCADEY XPOWER-S＿Bl,Wahoo Kickr V3,271,266,5
127284,230338,2021-03-11 23:05:14,wahoo,Zwift - Summit City Zwift League Endurance Ride (D),XCADEY XPOWER-S＿Bl,Wahoo Kickr V3,192,189,3
51076,230545,2020-08-21 09:07:51,neo,Zwift - TBR Burrito Race (A),Dura-Ace R9100-P Crank-PM,Tacx Neo,361,349,12
51494,230545,2020-08-24 09:27:23,neo,Zwift - DIRTy Dozen Sprint League (A),Dura-Ace R9100-P Crank-PM,Tacx Neo,411,396,15
53057,230545,2020-09-02 12:58:01,neo,Zwift - KISS at Race - Pacific AM (A),Dura-Ace R9100-P Crank-PM,Tacx Neo,369,352,17
57467,230545,2020-09-25 09:14:09,neo,Zwift - TBR Burrito Race (A),Dura-Ace R9100-P Crank-PM,Tacx Neo,430,404,26
59494,230545,2020-10-04 18:58:42,neo,Zwift - KISS at Race - EU PM (A),Dura-Ace R9100-P Crank-PM,Tacx Neo,407,380,27
59866,230545,2020-10-06 17:42:02,neo,Zwift - Team Italy & Frenchy Fuzion League (A),Dura-Ace R9100-P Crank-PM,Tacx Neo,413,402,11
60111,230545,2020-10-07 16:28:04,neo,Zwift - ZHQ Steering Race // FutureWorks (A),Dura-Ace R9100-P Crank-PM,Tacx Neo,395,382,13
60315,230545,2020-10-08 16:01:00,neo,Zwift - OH MY CRIT! - The Double Race 2/2 (A),Dura-Ace R9100-P Crank-PM,Tacx Neo,436,409,27
62205,230545,2020-10-15 17:28:59,neo,Zwift - FUSION ECT BEUNSTOPPABLE Racing Series (A),Dura-Ace R9100-P Crank-PM,Tacx Neo,460,437,23
62903,230545,2020-10-17 14:15:23,neo,Zwift - OH MY CRIT - Saturday Smash Race (A),Dura-Ace R9100-P Crank-PM,Tacx Neo,407,394,13
62904,230545,2020-10-18 16:25:07,neo,Zwift - ZHQ Beta Circuit Race  (A),Dura-Ace R9100-P Crank-PM,Tacx Neo,391,384,7
63233,230545,2020-10-19 18:16:09,neo,Zwift - TFC Mad Monday Autumn Series (A),Dura-Ace R9100-P Crank-PM,Tacx Neo,414,399,15
63916,230545,2020-10-21 18:01:25,neo,Zwift - DBR HEINO CUP III (A),Dura-Ace R9100-P Crank-PM,Tacx Neo,385,363,22
64147,230545,2020-10-22 15:08:59,neo,Zwift - OH MY CRIT! - The Double Race 1/2 (A),Dura-Ace R9100-P Crank-PM,Tacx Neo,390,375,15
64669,230545,2020-10-24 15:50:02,neo,Zwift - ZHQ FutureWorks Crit City Race - Boost mode (A),Dura-Ace R9100-P Crank-PM,Tacx Neo,388,375,13
64806,230545,2020-10-25 09:02:51,neo,Zwift - Newbury Velo Road Race (A),Dura-Ace R9100-P Crank-PM,Tacx Neo,428,411,17
65135,230545,2020-10-26 19:18:26,neo,Zwift - TFC Mad Monday Autumn Series (A),Dura-Ace R9100-P Crank-PM,Tacx Neo,379,353,26
65851,230545,2020-10-28 18:46:49,neo,Zwift - DBR HEINO CUP III (A),Dura-Ace R9100-P Crank-PM,Tacx Neo,407,393,14
66085,230545,2020-10-29 16:05:55,neo,Zwift - OH MY CRIT! - The Double Race 1/2 (A),Dura-Ace R9100-P Crank-PM,Tacx Neo,407,388,19
67208,230545,2020-11-02 16:09:05,neo,Zwift - 3R Classique Reverse Flat Race -(A) No riders nearby,Dura-Ace R9100-P Crank-PM,Tacx Neo,403,388,15
68849,230545,2020-11-07 19:04:16,neo,Zwift - 3R Innsbruckring Sprint Race - 1 Lap (8.8km/5.5mi 77m) (A),Dura-Ace R9100-P Crank-PM - To Garmin 1030,Tacx Neo - To Zwift,384,369,15
69626,230545,2020-11-10 10:59:33,neo,Zwift - KISS at Race - Americas AM (A) 2nd,Dura-Ace R9100-P Crank-PM,Tacx Neo,482,460,22
70113,230545,2020-11-11 10:43:59,neo,Zwift - USA Cycling Race League by Indoor Specialist (A),Dura-Ace R9100-P Crank-PM,Tacx Neo,404,377,27
70640,230545,2020-11-12 16:14:26,neo,Zwift - OH MY CRIT! - The Double Race 1/2 (A),Dura-Ace R9100-P Crank-PM,Tacx Neo,412,398,14
71578,230545,2020-11-15 11:04:52,neo,Zwift - 3R Innsbruckring Sprint Race - 1 Lap (8.8km/5.5mi 77m) (A),Dura-Ace R9100-P Crank-PM,Tacx Neo,421,402,19
76163,230545,2020-11-26 18:29:49,neo,Zwift - FUSION ECT BEUNSTOPPABLE Racing Series (A),Dura-Ace R9100-P Crank-PM,Tacx Neo,376,363,13
76969,230545,2020-11-28 14:59:49,neo,Zwift - Focus: Colours of PARI - Shorter Ride,Dura-Ace R9100-P Crank-PM,Tacx Neo,368,353,15
78003,230545,2020-12-01 16:04:54,neo,Zwift - 3R Volcano Circuit Flat Race - 8 Laps (35.2km/21.9mi 160m) (A),Dura-Ace R9100-P Crank-PM,Tacx Neo,409,380,29
115718,230545,2021-02-16 12:57:47,neo,Zwift - TDZ Stage 5: Shorter Ride,Dura-Ace R9100-P Crank-PM,Tacx Neo,359,340,19
115727,230545,2021-02-13 15:14:57,neo,Zwift - Chasing Cancellara Time Trial,Dura-Ace R9100-P Crank-PM,Tacx Neo,416,408,8
117805,230545,2021-02-19 17:59:07,neo,Zwift - KIRCHMAIR Race Series (A),Dura-Ace R9100-P Crank-PM,Tacx Neo,391,375,16
118155,230545,2021-02-20 10:29:32,neo,Zwift - Cycling Weekly Winter Lockdown RR Series (A),Dura-Ace R9100-P Crank-PM,Tacx Neo,393,383,10
118988,230545,2021-02-22 15:14:58,neo,Zwift - 3R Volcano Circuit Sprint Flat Race - 1 Lap (6.6km/4.1mi 20m) (A),Dura-Ace R9100-P Crank-PM,Tacx Neo,368,352,16
119498,230545,2021-02-23 15:28:59,neo,Zwift - Team Draft Innsbruckring Race (A),Dura-Ace R9100-P Crank-PM,Tacx Neo,348,332,16
122026,230545,2021-02-28 11:27:26,neo,Zwift - Stages of DIRT (E),Dura-Ace R9100-P Crank-PM,Tacx Neo,342,329,13
122394,230545,2021-03-01 16:08:56,neo,Zwift - 3R Classique Reverse Flat Race - 4 Laps (26.9km/16.7mi 57m) (A),Dura-Ace R9100-P Crank-PM,Tacx Neo,357,337,20
124151,230545,2021-03-04 17:04:06,neo,Zwift - OH MY CRIT!! - The Double Race 2/2 (A),Dura-Ace R9100-P Crank-PM,Tacx Neo,420,405,15
125049,230545,2021-03-06 15:50:24,neo,Zwift - 3R Endurance Series p/b OTE Sports (A),Dura-Ace R9100-P Crank-PM,Tacx Neo,361,344,17
126539,230545,2021-03-10 17:58:23,neo,Zwift - MIDWEEK Crit Race Series by SZR (A),Dura-Ace R9100-P Crank-PM,Tacx Neo,383,377,6
71681,231847,2020-11-15 14:11:00,wahoo,Zwift - ZA Road Race #2 (B),Garmin Vector 3 pedals,Wahoo Kickr,232,229,3
74629,231847,2020-11-23 19:01:01,wahoo,Zwift - ZA Road Group Ride (B),Garmin Vector 3 pedals,Wahoo Kickr,145,145,0
75175,231847,2020-11-24 19:16:01,wahoo,Zwift - Zwift Racing League | WTRL - Women&#039;s EMEA W1 DIVISION 1,Garmin Vector 3 pedals,Wahoo Kickr,239,235,4
78173,231847,2020-12-01 19:23:35,wahoo,Zwift - Zwift Racing League | WTRL - Women&#039;s EMEA W1 DIVISION 1,Garmin Vector 3 pedals,Wahoo Kickr,229,231,-2
129067,233443,2021-03-16 11:01:00,wahoo,Zwift - DIRT Rolling Thunder Ride (C),Assioma Duo,Kickr,205,204,1
122322,234868,2021-03-01 02:29:32,wahoo,XTERRA Series: Bike Race (E),assioma,kickr,271,262,9
126340,234868,2021-03-09 20:14:30,wahoo,assioma / kickr,assioma,kickr,292,284,8
74488,235068,2020-11-22 08:59:33,neo,Zwift - ZA Road Race #1: 4 - 5 w/kg,Garmin Vector 2/Polar Vantage,tacx neo/appel tv,320,315,5
113518,236649,2021-02-12 15:03:24,wahoo,Zwift - TDZ Stage 8: Group Ride,Garmin Vector 3,Wahoo Kickr 5.0,266,268,-2
113857,236649,2021-02-13 07:29:57,wahoo,Zwift - 3R 100 Steady Ride [~2.5w/kg avg] (C),Garmin Vector 3,Wahoo Kickr 5.0,292,291,1
115205,236649,2021-02-15 18:15:57,wahoo,Zwift -  DBR Monday Race (B),Garmin Vector 3,Wahoo Kickr 5.0,311,315,-4
86432,238583,2020-12-22 16:45:22,neo,zzk.lv - neo vs vector,vector,neo,314,308,6
88098,238583,2020-12-26 09:14:47,neo,JM - 1 diena,Vector 3,Neo,316,321,-5
88099,238583,2020-12-27 07:34:50,neo,JM - 2 diena,Vector 3,Neo,272,282,-10
101226,240499,2021-01-22 03:36:53,wahoo,Zwift - Ramp Test,Quarq DZero,Kickr V5,407,381,26
54239,242954,2020-09-09 21:29:59,wahoo,3R Endurance Steady Ride [~3.0],Power Pedals ,Wahoo Kickr ,242,247,-5
55125,242954,2020-09-14 18:29:00,wahoo,Invitational League // Qualifying Race #1,Power Pedals ,Wahoo Kickr ,265,273,-8
57573,242954,2020-09-25 19:08:51,wahoo,Three Sisters 09/25/2020,Power Pedals ,Wahoo Kickr ,254,270,-16
61211,242954,2020-10-12 17:18:03,wahoo,Zwift Racing League | WTRL - PREMIER DIVISION (WOMEN),Power Pedals ,Wahoo Kickr ,253,259,-6
63183,242954,2020-10-19 19:00:02,wahoo,Zwift - Premier Division // Zwift Racing League (women) (A),Power Pedals ,Wahoo Kickr ,248,259,-11
65265,242954,2020-10-26 19:59:44,wahoo,Wahoo Kickr  / Power Pedals ,Power Pedals ,Wahoo Kickr ,244,256,-12
67350,242954,2020-11-02 19:56:58,wahoo,Zwift - Premier Division // Zwift Racing League (women) (A),Power Pedals ,Wahoo Kickr ,252,260,-8
69377,242954,2020-11-09 19:03:59,wahoo,Zwift - Premier Division // Zwift Racing League (women) (A),Power Pedals ,Wahoo Kickr ,279,289,-10
72159,242954,2020-11-16 19:54:17,wahoo,Premier Division // Zwift Racing League (women) (A),Power Pedals ,Wahoo Kickr ,247,250,-3
74648,242954,2020-11-23 18:52:00,wahoo,Zwift Racing League | WTRL - PREMIER DIVISION (WOMEN),Power Pedals ,Wahoo Kickr ,262,268,-6
77782,242954,2020-11-16 21:59:42,wahoo,Premier Division // Zwift Racing League (women) (A),Power Pedals ,Wahoo Kickr ,259,250,9
93905,242954,2021-01-09 15:03:23,wahoo,equipment check prior to ZRL ,Power Pedals ,Wahoo Kickr ,249,248,1
95110,242954,2021-01-11 20:02:00,wahoo,Zwift - Premier Division // Zwift Racing League (women) #1 ,Power Pedals ,Wahoo Kickr ,290,270,20
99145,242954,2021-01-18 19:06:31,wahoo,Zwift Racing League | WTRL - PREMIER DIVISION (WOMEN),Power Pedals ,Wahoo Kickr ,248,252,-4
105205,242954,2021-01-29 16:27:33,wahoo,1/29/2021,Power Pedals ,Wahoo Kickr ,247,243,4
115287,242954,2021-02-15 19:03:59,wahoo,Zwift - Premier Division // Zwift Racing League (women) (A),Power Pedals ,Wahoo Kickr ,271,276,-5
97877,244562,2021-01-16 10:01:56,wahoo,Zwift - TDZ Stage 3: Standard Ride,4iiii powermeter,Wahoo Kickr Core,268,268,0
114706,244562,2021-02-14 15:34:36,wahoo,Zwift - Ramp Test,4iiii powermeter,Wahoo Kickr Core,303,310,-7
30729,247818,2020-05-02 18:49:29,neo,Zwift - Escape Velocity Spring Series (B),Assioma Duo,Tacx Neo,367,352,15
9690,248374,2020-01-16 18:06:02,wahoo,Zwift - ZHR Hare & Hounds Race (B),Zwift,Wahoo Kickr ,301,297,4
21185,248374,2020-04-01 17:31:55,wahoo,Zwift - Flanders Cycling Happening (C),Stages,Kickr,277,257,20
40540,248374,2020-06-09 16:13:27,wahoo,SMT Laatste Dans,Stages,Kickr,269,261,8
104696,248374,2021-01-28 18:34:56,wahoo,Zwift - 01/28/2021,Stages,Wahoo Kickr Uncallibrated,285,276,9
59248,248622,2020-10-03 11:14:47,wahoo,Zwift - 3R Tick Tock Flat Race - 2 Lap (36km/22.4mi 100m) (A),Favero Assioma Duo Pedals,Wahoo KickR,289,281,8
59789,248622,2020-10-06 11:17:32,wahoo,Extensive Anaerobic Capacity,Favero Assioma Duo Pedals,Wahoo KickR,220,220,0
60056,248622,2020-10-07 12:20:15,wahoo,Zwift - TTR Booster 2.0-2.5W (D),Favero Assioma Duo Pedals,Wahoo KickR,181,179,2
60793,248622,2020-10-10 11:09:48,wahoo,Zwift - ZA Road Race #1: 4 - 5 w/kg,Favero Assioma Duo Pedals,Wahoo KickR,295,283,12
60979,248622,2020-10-11 12:45:20,wahoo,Tempo/Endurance,Favero Assioma Duo Pedals,Wahoo KickR,244,232,12
61124,248622,2020-10-12 11:22:03,wahoo,Zwift - ZSUN Rise & Shine Ride (C),Favero Assioma Duo Pedals,Wahoo KickR,194,188,6
61469,248622,2020-10-13 12:00:02,wahoo,Zwift - Tempo,Wahoo KickR,Wahoo KickR,218,218,0
62866,248622,2020-10-18 13:00:53,wahoo,Zwift - ZA Road Group Ride: 1.7 - 2.2 w/kg ,Favero Assioma Duo Pedals,Wahoo KickR,228,223,5
63359,248622,2020-10-20 12:19:07,wahoo,Extensive Anaerobic Capacity ,Favero Assioma Duo Pedals,Wahoo KickR,242,238,4
63373,248622,2020-10-20 11:34:51,wahoo,Warm Up and Tempo,Wahoo KickR,Wahoo KickR,215,215,0
63760,248622,2020-10-21 10:59:59,wahoo, Haute Route Community Rides // Americas,Favero Assioma Duo Pedals,Wahoo KickR,239,235,4
64364,248622,2020-10-23 12:31:43,wahoo,Active Recovery,Favero Assioma Duo Pedals,Wahoo KickR,193,189,4
64635,248622,2020-10-24 11:14:58,wahoo,Zwift - Herd Summer Racing League Series (A),Favero Assioma Duo Pedals,Wahoo KickR,278,267,11
64852,248622,2020-10-25 11:02:02,wahoo,USA Cycling Xtra Long Ride by DIRT,Favero Assioma Duo Pedals,Wahoo KickR,176,176,0
65022,248622,2020-10-26 11:17:41,wahoo,Active Recovery ,Favero Assioma Duo Pedals,Wahoo KickR,185,184,1
65720,248622,2020-10-28 11:19:21,wahoo,Zwift - Aerobic Openers w/ Sprints,Wahoo KickR,Wahoo KickR,221,221,0
66684,248622,2020-10-31 10:29:57,wahoo,Zwift - Jose Wence [DIRT]&#039;s Meetup - Tick Tock,Favero Assioma Duo Pedals,Wahoo KickR,193,193,0
66947,248622,2020-11-01 14:03:40,wahoo,Tempo/Endurance ,Favero Assioma Duo Pedals,Wahoo KickR,211,210,1
67160,248622,2020-11-02 12:04:47,wahoo,Active Recovery ,Favero Assioma Duo Pedals,Wahoo KickR,181,179,2
67879,248622,2020-11-04 12:04:57,wahoo,Metabolic Endurance ,Favero Assioma Duo Pedals,Wahoo KickR,218,216,2
68788,248622,2020-11-07 12:58:35,wahoo,NmP/Strength and Endurance,Favero Assioma Duo Pedals,Wahoo KickR,197,193,4
69013,248622,2020-11-08 11:29:55,wahoo,Zwift - Stages of DIRT (A),Favero Assioma Duo Pedals,Wahoo KickR,283,274,9
70155,248622,2020-11-11 11:55:50,wahoo,Metabolic Endurance,Favero Assioma Duo Pedals,Wahoo KickR,217,212,5
71064,248622,2020-11-13 13:14:19,wahoo,Active Recovery ,Favero Assioma Duo Pedals,Wahoo KickR,157,156,1
71380,248622,2020-11-14 13:00:37,wahoo,Force Development w/Sprints,Favero Assioma Duo Pedals,Wahoo KickR,270,259,11
71645,248622,2020-11-15 12:07:01,wahoo,Metabolic Endurance,Favero Assioma Duo Pedals,Wahoo KickR,194,188,6
71896,248622,2020-11-16 11:41:50,wahoo,Zwift - Watopia,Favero Assioma Duo Pedals,Wahoo KickR,211,203,8
73842,248622,2020-11-21 11:59:04,wahoo,NmP/Strength + Endurance,Favero Assioma Duo Pedals,Wahoo KickR,181,176,5
74150,248622,2020-11-22 11:30:17,wahoo,Zwift - Stages of DIRT (A),Favero Assioma Duo Pedals,Wahoo KickR,288,279,9
74508,248622,2020-11-23 12:07:42,wahoo,Active Recovery,Favero Assioma Duo Pedals,Wahoo KickR,185,182,3
74930,248622,2020-11-24 11:46:45,wahoo,Zwift - LT + VO2 Openers,Wahoo KickR,Wahoo KickR,228,229,-1
77554,248622,2020-11-30 12:15:55,wahoo,Active Recovery ,Favero Assioma Duo Pedals,Wahoo KickR,178,175,3
77951,248622,2020-12-01 11:24:58,wahoo,Anaerobic ,Favero Assioma Duo Pedals,Wahoo KickR,249,243,6
77960,248622,2020-11-29 11:29:54,wahoo,Zwift - Stages of DIRT (A),Favero Assioma Duo Pedals,Wahoo KickR,314,303,11
78504,248622,2020-12-02 11:48:13,wahoo,Endurance ,Favero Assioma Duo Pedals,Wahoo KickR,195,191,4
79356,248622,2020-12-04 13:24:59,wahoo,Zwift - DIRT Friday Pacific Sprintapalooza  (C),Favero Assioma Duo Pedals,Wahoo KickR,196,189,7
79736,248622,2020-12-05 11:45:54,wahoo,Endurance w/form sprints,Favero Assioma Duo Pedals,Wahoo KickR,226,222,4
80075,248622,2020-12-06 11:29:55,wahoo,Stages of DIRT A,Favero Assioma Duo Pedals,Wahoo KickR,290,282,8
83355,248622,2020-12-14 11:50:54,wahoo,Active Recovery ,Favero Assioma Duo Pedals,Wahoo KickR,185,186,-1
83928,248622,2020-12-16 11:08:38,wahoo,Metabolic Endurance ,Favero Assioma Duo Pedals,Wahoo KickR,188,186,2
85079,248622,2020-12-19 11:20:24,wahoo,Metabolic Endurance ,Favero Assioma Duo Pedals,Wahoo KickR,254,247,7
85383,248622,2020-12-20 11:29:54,wahoo,Zwift - Stages of DIRT (A),Favero Assioma Duo Pedals,Wahoo KickR,288,281,7
90061,248622,2021-01-01 11:53:20,wahoo,Zwift - Watopia,Favero Assioma Duo Pedals,Wahoo KickR,174,173,1
91631,248622,2021-01-05 12:01:58,wahoo,Zwift - TDZ Stage 1: Standard Ride,Favero Assioma Duo Pedals,Wahoo KickR,224,221,3
92141,248622,2021-01-06 11:19:54,wahoo,Zwift - 3R Volcano Circuit Flat Race - 6 Laps (27km/16.8mi 120m) (A),Favero Assioma Duo Pedals,Wahoo KickR,284,274,10
93850,248622,2021-01-09 11:49:16,wahoo,Metabolic Endurance,Favero Assioma Duo Pedals,Wahoo KickR,204,200,4
93855,248622,2021-01-09 11:30:03,wahoo,Pre-Calibration Spinout,Favero Assioma Duo Pedals,Wahoo KickR,162,159,3
94351,248622,2021-01-10 11:29:52,wahoo,Zwift - Stages of DIRT (E),Favero Assioma Duo Pedals,Wahoo KickR,277,268,9
95496,248622,2021-01-12 11:29:53,wahoo,Zwift - 3R Volcano Circuit Flat Race - 8 Laps (35.2km/21.9mi 160m) (A),Favero Assioma Duo Pedals,Wahoo KickR,295,289,6
98447,248622,2021-01-17 11:29:57,wahoo,Zwift - Stages of DIRT (E),Favero Assioma Duo Pedals,Wahoo KickR,278,272,6
99536,248622,2021-01-19 11:29:53,wahoo,Zwift - 3R Volcano Circuit Flat Race - 8 Laps (35.2km/21.9mi 160m) (A),Favero Assioma Duo Pedals,Wahoo KickR,265,258,7
101858,248622,2021-01-23 11:23:11,wahoo,Metabolic Endurance w/Form Sprints,Favero Assioma Duo Pedals,Wahoo KickR,200,197,3
101861,248622,2021-01-23 13:01:58,wahoo,Metabolic Endurance,Favero Assioma Duo Pedals,Wahoo KickR,192,188,4
102320,248622,2021-01-24 11:29:51,wahoo,Zwift - Stages of DIRT (E),Favero Assioma Duo Pedals,Wahoo KickR,298,285,13
102739,248622,2021-01-25 12:01:45,wahoo,Active Recovery ,Favero Assioma Duo Pedals,Wahoo KickR,156,155,1
103293,248622,2021-01-26 11:29:49,wahoo,3R Volcano Circuit Flat Race - 8 Laps (35.2km/21.9mi 160m),Favero Assioma Duo Pedals,Wahoo KickR,288,283,5
105847,248622,2021-01-30 11:15:14,wahoo,Metabolic Endurance ,Favero Assioma Duo Pedals,Wahoo KickR,214,213,1
106116,248622,2021-01-31 11:29:50,wahoo,Zwift - Stages of DIRT (E),Favero Assioma Duo Pedals,Wahoo KickR,292,280,12
114009,248622,2021-02-13 12:06:51,wahoo,Openers,Favero Assioma Duo Pedals,Wahoo KickR,244,242,2
115657,248622,2021-02-16 11:29:54,wahoo,3R Volcano Circuit Flat Race - 8 Laps (35.2km/21.9mi 160m),Favero Assioma Duo Pedals,Wahoo KickR,293,285,8
122830,248622,2021-03-02 11:12:48,wahoo,Metabolic Endurance,Favero Assioma Duo Pedals,Wahoo KickR,225,223,2
128559,248622,2021-03-14 09:58:07,wahoo,Metabolic Endurance w/Tempo,Favero Assioma Duo Pedals,Wahoo KickR,272,266,6
129020,248622,2021-03-16 10:13:16,wahoo,LT Stim,Favero Assioma Duo Pedals,Wahoo KickR,293,292,1
126904,248762,2021-03-11 10:32:48,wahoo,Zwift - Japan ZWIFT Hill Climb Race (A),Garmin Vector3,Wahoo Kickr V5,333,333,0
93892,249864,2021-01-09 15:01:00,wahoo,Zwift - TDZ Stage 2: Standard Ride,Stages,Kickr18,384,385,-1
96710,249864,2021-01-13 18:29:03,wahoo,Zwift - NCF Vintercup 2021 - Runde 1 - Herrer (A),Stages,Kickr18,378,384,-6
104180,249864,2021-01-27 18:29:03,wahoo,Zwift - NCF Vintercup 2021 - Runde 3 - Herrer (A),Stages,Kickr18,413,410,3
105061,249864,2021-01-29 11:59:36,wahoo,Zwift - TDZ Stage 6: Longer Ride,Stages,Kickr18,384,385,-1
108587,249864,2021-02-03 18:29:05,wahoo,Zwift - NCF Vintercup 2021 - Runde 4 - Herrer (A),Stages,Kickr18,383,387,-4
112444,249864,2021-02-10 18:29:30,wahoo,Zwift - NCF Vintercup 2021 - Runde 5 - Herrer (A),Stages,Kickr18,397,402,-5
124507,249864,2021-03-05 16:07:34,wahoo,Zwift - Crit City Race (A),Stages,Kickr18,371,365,6
30501,250612,2020-05-02 08:59:49,wahoo,Zwift - KRT/KISS 80 km Endurance Ride,Vector3 Pedals,Kickr ‘16,246,254,-8
30907,250612,2020-05-03 09:46:55,wahoo,Zwift - Points Race League by Team DIRT (B),Vector3 Pedals,Kickr ‘16,304,302,2
33242,250612,2020-05-10 09:46:20,wahoo,Points Race League by Team DIRT,Vector3 Pedals,Kickr ‘16,287,301,-14
34916,250612,2020-05-14 23:41:08,wahoo,Zwift - WTRL Team Time Trial (D),Vector3 Pedals,Kickr ‘16,286,290,-4
35562,250612,2020-05-17 09:47:27,wahoo,Zwift - Points Race League by Team DIRT (B),Vector3 Pedals,Kickr ‘16,302,308,-6
36570,250612,2020-05-21 09:34:27,wahoo,Zwift - WTRL Team Time Trial (D),Vector3 Pedals,Kickr ‘16,281,297,-16
83787,251712,2020-12-15 19:20:26,wahoo,Zwift - ZHR Masters Britain (B),Assioma Uno,Kickr Core,338,337,1
87440,251712,2020-12-25 12:46:36,wahoo,Zwift - Zwift Fast Fridays: Tempus Fugit Time Trial (E),Assioma Uno,Kickr Core,358,351,7
87441,251712,2020-12-26 13:52:51,wahoo,Zwift - The P Race (A),Assioma Uno,Kickr Core,349,343,6
88873,251712,2020-12-29 17:47:12,wahoo,Zwift - SZR iTT Winter Racing League (A),Assioma Uno,Kickr Core,339,335,4
88874,251712,2020-12-29 19:26:12,wahoo,Zwift - ZHR Masters Britain (B),Assioma Uno,Kickr Core,319,323,-4
88991,251712,2020-12-30 13:13:26,wahoo,Zwift - Crit City Race (A),Assioma Uno,Kickr Core,340,345,-5
92535,251712,2021-01-06 18:52:26,wahoo,Zwift - Newbury Velo Midweek TT (D),Assioma Uno,Kickr Core,360,352,8
93160,251712,2021-01-07 19:27:57,wahoo,Zwift - Crit City Race (A),Assioma Uno,Kickr Core,372,371,1
94751,251712,2021-01-09 16:40:30,wahoo,Zwift - Crit City Race (A),Assioma Uno,Kickr Core,361,361,0
95312,251712,2021-01-11 17:37:02,wahoo,Zwift - SCF SWE Cup (A),Assioma Uno,Kickr Core,369,365,4
99562,251712,2021-01-18 18:49:31,wahoo,Zwift -  SCF SWE Cup Men (A),Assioma Uno,Kickr Core,358,360,-2
101363,251712,2021-01-16 14:29:40,wahoo,Zwift - Crit City Race (A),Assioma Uno,Kickr Core,357,360,-3
101364,251712,2021-01-21 19:31:25,wahoo,Zwift - Crit City Race (A),Assioma Uno,Kickr Core,355,350,5
102874,251712,2021-01-25 17:13:25,wahoo,Zwift -  SCF SWE Cup Men (A),Assioma Uno,Kickr Core,358,358,0
106813,251712,2021-02-01 18:53:05,wahoo,Zwift -  SCF SWE Cup Men (A),Assioma Uno,Kickr Core,365,364,1
107814,251712,2021-02-02 19:24:45,wahoo,Zwift - ZHR Masters Britain (B),Assioma Uno,Kickr Core,349,346,3
111303,251712,2021-02-08 17:17:00,wahoo,Zwift -  SCF SWE Cup Men (A),Assioma Uno,Kickr Core,357,363,-6
113404,251712,2021-02-10 19:18:41,wahoo,Zwift - British Cycling Crit City Series (A),Assioma Uno,Kickr Core,354,348,6
113411,251712,2021-02-11 19:25:25,wahoo,Zwift - Crit City Race (A),Assioma Uno,Kickr Core,369,358,11
115272,251712,2021-02-15 18:50:01,wahoo,Zwift -  SCF SWE Cup Men (A),Assioma Uno,Kickr Core,358,360,-2
117579,251712,2021-02-18 17:35:53,wahoo,Zwift - Frappe,Assioma Uno,Kickr Core,336,335,1
120436,251712,2021-02-24 19:21:08,wahoo,Zwift - British Cycling Crit City Series,Assioma Duo,Kickr Core,367,365,2
121777,251712,2021-02-26 16:16:08,wahoo,Zwift - SZ AW Party by SZR (A),Assioma Duo,Kickr Core,377,370,7
123826,251712,2021-03-03 18:45:00,wahoo,Zwift - Newbury Velo Midweek TT (D),Assioma Duo,Kickr Core,351,352,-1
125623,251712,2021-03-05 16:32:07,wahoo,Zwift - Crit City Race (A),Assioma Duo,Kickr Core,372,373,-1
126358,251712,2021-03-09 19:17:06,wahoo,Zwift - ZHR Masters (B),Assioma Duo,Kickr Core,367,368,-1
126810,251712,2021-03-10 18:52:28,wahoo,Zwift - XRS Races: Wednesday iTT series (A),Assioma Duo,Kickr Core,365,367,-2
127363,251712,2021-03-11 19:02:21,wahoo,Zwift - BRT Criterium Racing League (A),Assioma Duo,Kickr Core,357,361,-4
128913,251712,2021-03-15 18:43:23,wahoo,Zwift -  SCF SWE Cup Men (A),Assioma Duo,Kickr Core,371,374,-3
129461,251712,2021-03-16 18:44:41,wahoo,Zwift - 3R Omnium Event - Race 2 - iTT (A),Assioma Duo,Kickr Core,340,346,-6
100029,252278,2019-01-24 02:54:25,wahoo,2019.01.23 TR Ramp Test,Stages,Kickr,217,235,-18
101208,252278,2021-01-22 00:32:57,wahoo,Zwift - PM Test - FSA Stages vs Kickr,FSA Stages,Kickr,220,207,13
101209,252278,2021-01-22 00:48:51,wahoo,Zwift - PM Test,Ultegra Stages,Kickr,207,208,-1
101216,252278,2021-01-22 00:59:53,wahoo,Zwift - Watopia - PM Test - Kickr vs Ultegra Stages,Ultegra Stages,Kickr,171,176,-5
102095,252278,2021-01-23 19:21:30,wahoo,Zwift - Watopia -  Tour of Fire and Ice,Ultegra Stages,Kickr,184,182,2
102103,252278,2021-01-23 18:59:28,wahoo,Zwift - Watopia - Pre-calibration,Ultegra Stages,Kickr,138,133,5
104558,252278,2021-01-27 00:56:56,wahoo,Zwift - Richmond,Ultegra Stages,Kickr,240,248,-8
104559,252278,2021-01-27 01:30:34,wahoo,Zwift - Watopia,Ultegra Stages,Kickr,123,119,4
104947,252278,2021-01-29 00:18:05,wahoo,Zwift - Ramp Test,Ultegra Stages,Kickr,263,260,3
106479,252278,2021-01-31 22:48:59,wahoo,Zwift - ZHQ FutureWorks Crit City Race - Boost mode (C),FSA Stages,Kickr,256,249,7
108560,252278,2021-02-03 23:58:33,wahoo,Zwift - FTP Builder - Foundation,Ultegra Stages,Kickr (no cal),166,166,0
118887,252278,2021-02-21 21:58:54,wahoo,Zwift - FTP Builder - Tempo,Ultegra Stages,6312376735_ACTIVITY Kickr,198,208,-10
17,252557,2019-08-12 15:43:05,wahoo,Zwift - 3R Classique Reverse Flat Race - 4 Laps (26.9km/16.7mi 57m) (A),Favero Assioma DUO,Wahoo Kickr Core 2018,442,434,8
124,252557,2019-08-14 09:17:43,wahoo,"#1 - Four man breakaway. Hard as hell, got it on the line!  - Zwift - The Morning Grind (A)",Favero Assioma DUO,Wahoo Kickr Core 2018,438,430,8
566,252557,2019-08-20 18:09:57,wahoo,FUSION ECT Racing League,Favero Assioma DUO,Wahoo Kickr Core 2018,423,425,-2
720,252557,2019-08-23 13:57:01,wahoo,3R Innsbruckring Flat Race - 2 Laps (17.6km/10.9m 154m),Favero Assioma DUO,Wahoo Kickr Core 2018,427,422,5
722,252557,2019-08-23 13:57:01,wahoo,Zwift - 3R Sand and Sequoias Race (A),Favero Assioma DUO,Wahoo Kickr Core 2018,438,430,8
800,252557,2019-08-26 17:03:01,wahoo,#3 - Legs stopped working on the last climb - Zwift - DBR Monday Race League (A),Favero Assioma DUO,Wahoo Kickr Core 2018,471,478,-7
1172,252557,2019-09-02 17:01:44,wahoo,#4 - Gotta learn to save energy :) - 2 hours outside before this race - Zwift - DBR Monday Race League (A),Favero Assioma DUO,Wahoo Kickr Core 2018,416,403,13
1330,252557,2019-09-05 17:33:28,wahoo,#39 - Just too fat - Zwift - Watopia Cup // Zwift Classic ,Favero Assioma DUO,Wahoo Kickr Core 2018,494,508,-14
1874,252557,2019-09-15 12:53:50,wahoo,#4 - When your teammate attacks and the only one he drops is you! 40k solo to clame 4th - Zwift - KISS 100 Race - Americas (A),Favero Assioma DUO,Wahoo Kickr Core 2018,431,426,5
1929,252557,2019-09-16 16:18:06,wahoo,#4 - Teamattack split the peloton. Fun race - Zwift - DBR Monday Race League (A),Favero Assioma DUO,Wahoo Kickr Core 2018,456,454,2
2006,252557,2019-09-17 17:34:22,wahoo,Zwift - FUSION ECT Racing League (A),Favero Assioma DUO,Wahoo Kickr Core 2018,441,443,-2
2391,252557,2019-09-23 16:45:32,wahoo,"#6th - Too tired, 2 restdays coming up :) - Zwift - DBR Monday Race League (A)",Favero Assioma DUO,Wahoo Kickr Core 2018,454,444,10
3162,252557,2019-10-03 17:47:35,wahoo,"#13 - still not at 100 percent. No top power, but a high heart rate, though :P - Zwift - FUSION ECT BEUNSTOPPABLE Racing Series (A)",Favero Assioma DUO,Wahoo Kickr Core 2018,419,416,3
3247,252557,2019-10-04 18:46:59,wahoo,#1 - body start to feel better &lt;3 - Zwift - EVR Europe Race (E),Favero Assioma DUO,Wahoo Kickr Core 2018,439,456,-17
4488,252557,2019-11-19 18:05:35,wahoo,Zwift - WORLDOFFUSION Racing Series (A),Favero Assioma DUO,Wahoo Kickr Core 2018,463,446,17
4536,252557,2019-11-20 11:28:15,wahoo,Random uphill intervals,Favero Assioma DUO,Wahoo Kickr Core 2018,422,409,13
5062,252557,2019-11-28 11:43:07,wahoo,4th . Crushed by the ODZ train :) - Zwift - TeamODZ Thursday Morning Throwdown (E),Favero Assioma DUO,Wahoo Kickr 18,424,421,3
5415,252557,2019-12-03 18:13:08,wahoo,"#23th, I think. Not a fan of Box Hil l :) - Zwift - WORLDOFFUSION Racing Series (A)",Favero Assioma DUO,Wahoo Kickr 18,499,498,1
5576,252557,2019-12-05 17:47:55,wahoo,Zwift - FTP Test,Favero Assioma DUO,Wahoo Kickr 18,452,454,-2
5680,252557,2019-12-07 09:20:42,wahoo,#14th - Don�t know what happend. Dropped on downhill from Titans Grove - Zwift - DBR Saturday Race (A),Favero Assioma DUO,Wahoo Kickr 18,443,442,1
5745,252557,2019-12-08 08:49:09,wahoo,#1st  - solo 1 lap :o - Zwift - Danmarks Cykle Union Racing League (A),Favero Assioma DUO,Wahoo Kickr 18,454,454,0
5748,252557,2019-12-08 08:49:09,wahoo,7 or 8th. Went long to set up Simon for sprint. And then Lind took it! ;) - Zwift - 3R Sand & Sequoias - 1 Lap (20km/12.5mi 173m) (A),Favero Assioma DUO,Wahoo Kickr 18,422,425,-3
5750,252557,2019-12-08 08:49:09,wahoo,#4th. 3rd race of the day #dead - 3R Innsbruckring Sprint Race - 1 Lap (8.8km/5.5mi 77m),Favero Assioma DUO,Wahoo Kickr 18,434,423,11
5949,252557,2019-12-10 18:09:48,wahoo,Zwift - Danmarks Cykle Union Racing League (A),Favero Assioma DUO,Wahoo Kickr 18,474,492,-18
5950,252557,2019-12-10 18:09:48,wahoo,12th - no sprint after 2 races today - Zwift - WORLDOFFUSION Racing Series (A),Favero Assioma DUO,Wahoo Kickr 18,440,447,-7
6173,252557,2019-12-13 13:30:21,wahoo,"#4th - had to sprint seated because the Kickr made the room jump, and my Macbook was about to fall on the floor. Waste of Aero PU :/ - Zwift - KISS at Race - Pacific AM (A)",Favero Assioma DUO,Wahoo Kickr 18,430,402,28
6510,252557,2019-12-17 18:02:37,wahoo,6th - Det var ledt - Zwift - Danmarks Cykle Union Racing League (A),Favero Assioma DUO,Wahoo Kickr 18,446,458,-12
6827,252557,2019-12-20 13:28:52,wahoo,#2 - used all my matches to chase down a guy who is not even on Zwiftpower #stupid - Zwift - KISS at Race - Pacific AM (A),Favero Assioma DUO,Wahoo Kickr 18,458,455,3
7365,252557,2019-12-26 15:54:19,wahoo,Zwift - OH CRITMAS!! - The Double Race - Race 1/2 (A),Favero Assioma DUO,Wahoo Kickr 18,404,425,-21
7367,252557,2019-12-26 15:54:19,wahoo,Zwift - OH CRITMAS!! - The Double Race - Race 2/2 (A),Favero Assioma DUO,Wahoo Kickr 18,443,441,2
7666,252557,2019-12-30 17:11:46,wahoo,#1st - Happy new year! - Zwift - Danmarks Cykle Union New Year&#039;s Special  (A),Favero Assioma DUO,Wahoo Kickr 18,418,433,-15
7813,252557,2020-01-01 18:25:25,wahoo,"#2nd - team attack on the last climb, easy sprint victory for Simon - Zwift - DBR Wednesday Race (A)",Favero Assioma DUO,Wahoo Kickr 18,437,436,1
7981,252557,2020-01-03 15:05:54,wahoo,"7th- Brain wanted to attack, legs wanted to quit. We settled on the sprint. Bad timing once again :) - Zwift - 3R Sand and Sequoias Race (A)",Favero Assioma DUO,Wahoo Kickr 18,414,429,-15
8064,252557,2020-01-04 13:39:43,wahoo,Zwift - WTRL Winter Racing League,Favero Assioma DUO,Wahoo Kickr 18,396,396,0
8066,252557,2020-01-04 13:39:43,wahoo,10th - 2nd race in a row - tried to go with 1000m again. Died with cramps in both legs.Zwift - The P Race (A),Favero Assioma DUO,Wahoo Kickr 18,416,420,-4
8233,252557,2020-01-06 17:31:44,wahoo,"#8th - Remember that you can not kick twice in Zwift sprints, goddammit! :) - Zwift - DBR Caresport Crit Cup  (A)",Favero Assioma DUO,Wahoo Kickr 18,421,424,-3
8401,252557,2020-01-08 08:54:21,wahoo,Zwift - 3R Watopia Flat Route Race - 3 Laps (30.3km/18.8mi 162m) (A),Favero Assioma DUO,Wahoo Kickr 18,422,420,2
8402,252557,2020-01-08 08:54:21,wahoo,Zwift - 01/08/2020,Favero Assioma DUO,Wahoo Kickr 18,446,451,-5
9015,252557,2020-01-12 13:15:40,wahoo,11th - one of the hardest Zwift-races ever! - Zwift - KISS at Race 100 - Americas (A),Power2max,Wahoo Kickr 18,429,418,11
9562,252557,2020-01-15 18:19:28,wahoo,"Top 100, wuhu! 11th in the first point-spring, and pure surival til Legsnapper where the legs snapped! :) - Zwift - Tour de Zwift // Pro-Am Invitational (A)",Power2max,Wahoo Kickr 18,491,477,14
10261,252557,2020-01-21 14:35:10,wahoo,Zwift - 3R Ultimate Racing League - Round 3 (A),Power2max,Wahoo Kickr 18,467,459,8
10361,252557,2020-01-21 14:35:10,wahoo,Zwift - 3R Volcano Circuit Flat Race - 8 Laps (35.2km/21.9mi 160m) (A),Power2max,Wahoo Kickr 18,443,431,12
10899,252557,2020-01-25 15:40:35,wahoo,4th - Hate that hill. Zwift - Tour de Zwift: Stage 4 Race (A),Power2max,Wahoo Kickr 18,523,522,1
11339,252557,2020-01-28 17:16:51,wahoo,#1st - That was a tough one! - Zwift - Danmarks Cykle Union 2020 Cup (A),Power2max,Wahoo Kickr 18,463,456,7
11555,252557,2020-01-29 18:41:07,wahoo,Zwift - DBR Wednesday Race (A),Power2max,Wahoo Kickr 18,456,446,10
11799,252557,2020-01-30 18:40:56,wahoo,"#14th -Ppl got fooled by the distance bug. Had to follow wheels, which messed up my sprint - Zwift - KALAS Cup - Round 1 (A)",Power2max,Wahoo Kickr 18,462,459,3
12254,252557,2020-02-03 14:08:06,wahoo,#1st - best sprint in a while! :) - Zwift - 3R Classique Reverse Flat Race - 5 Laps (32km/20.1mi 76m) (A),Power2max,Wahoo Kickr 18,386,373,13
12840,252557,2020-02-06 17:51:47,wahoo,Zwift - Danmarks Cykle Union 2020 Cup (A),Power2max,Wahoo Kickr 18,325,317,8
12841,252557,2020-02-06 17:51:47,wahoo,"Made the split on Box Hill, but gravity killed me before the top - Zwift - KALAS Cup - Round 2 (A)",Power2max,Wahoo Kickr 18,509,504,5
13110,252557,2020-02-08 15:05:48,wahoo,#1st - solo from that stupid long hill that I can&#039;t remember the name on! :D - Zwift - Tour de Zwift: Stage 7 Race (A),Power2max,Wahoo Kickr 18,498,491,7
13257,252557,2020-02-10 12:50:09,wahoo,"#2nd - aggressive racing paid of, and I&#039;m more than satisfied with 2. place - Zwift - Magnum mOnDayZ RACE presented by Team ODZ (A)",Power2max,Wahoo Kickr 18,524,521,3
13472,252557,2020-02-11 17:03:51,wahoo,Zwift - Danmarks Cykle Union 2020 Cup (A),Power2max,Wahoo Kickr 18,449,437,12
13474,252557,2020-02-11 17:03:51,wahoo,21st - 2 man breakaway with Noehr - had to wheelsuck to survive Watopia Hill. #2ndracetoday #3hrs_on_Zwift - Zwift - ,Power2max,Wahoo Kickr 18,424,415,9
13783,252557,2020-02-13 13:29:00,wahoo,#1st - That finale! Pheww - Zwift - Crit City Race (A),Power2max,Wahoo Kickr 18,451,449,2
14243,252557,2020-02-16 13:54:46,wahoo,Zwift - KISS at Race 100 - Americas (A),Power2max,Wahoo Kickr 18,470,467,3
14360,252557,2020-02-17 15:09:51,wahoo,Recovery ride with cadance drills - Zwift - Watopia,Favero Assioma DUO,Wahoo Kickr 18,258,255,3
14611,252557,2020-02-18 18:11:10,wahoo,"7th - opened a bit early, but satisfited  - Zwift - Feltet.dk Race Series",Power2max,Wahoo Kickr 18,422,420,2
15307,252557,2020-02-23 14:14:23,wahoo,"#6th - +400w up the Alp did not succed. HRM died, se link in description - Zwift - 3R Alpe Du Zwift KOM Race (20km 1444m) (A)",Favero Assioma DUO,Wahoo Kickr 18,427,429,-2
15498,252557,2020-02-24 13:05:11,wahoo,#1st - Zwift - Magnum mOnDayZ RACE presented by Team ODZ (A),Favero Assioma DUO,Wahoo Kickr 18,409,406,3
16496,252557,2020-03-02 17:22:24,wahoo,Zwift - Danmarks Cykle Union 2020 Cup (A),Favero Assioma DUO,Wahoo Kickr 18,467,461,6
16499,252557,2020-03-02 17:22:24,wahoo,Zwift - DBR Winter Cup (A),Favero Assioma DUO,Wahoo Kickr 18,434,429,5
18335,252557,2020-03-16 17:41:07,wahoo,7th - dropped chain in the sprint.... #ffs - Zwift - DBR Monday Race (A),Favero Assioma DUO,Wahoo Kickr 18,425,422,3
18866,252557,2020-03-20 12:27:20,wahoo,"#1st - wheel suckers victory, almost died both times on Titans Grove! - Zwift - KISS at Race - Pacific AM (A)",Favero Assioma DUO,Wahoo Kickr 18,416,411,5
18989,252557,2020-03-21 09:14:43,wahoo,7th - That. Was. Hard - Zwift - DBR Saturday Race (A),Favero Assioma DUO,Wahoo Kickr 18,491,494,-3
21226,252557,2020-04-01 17:12:42,wahoo,Zwift - Danmarks Cykle Union – mid-week racing  (A),Favero Assioma DUO,Wahoo Kickr 18,420,412,8
21227,252557,2020-04-01 17:12:42,wahoo,"#5th - Had Lisons wheel, but yeahhhh :) - Zwift - DBR Wednesday Race (A)",Favero Assioma DUO,Wahoo Kickr 18,399,387,12
29777,252557,2020-04-30 18:51:09,wahoo,3rd - fun little race :) - Zwift - Zwift Beta Race,Power2max,Wahoo Kickr 18,420,414,6
30484,252557,2020-05-02 07:45:45,wahoo,35-ish... pure pain - Zwift - DBR Sufferday League (A),Power2max,Wahoo Kickr 18,507,501,6
31795,252557,2020-05-05 18:00:33,wahoo,Zwift - 05/05/2020,Power2max,Wahoo Kickr 18,500,489,11
34267,252557,2020-05-12 17:34:41,wahoo,#Sat af - Zwift - UNO X CUP powered by DCU & Feltet.dk (A),Power2max,Wahoo Kickr 18,435,425,10
35132,252557,2020-05-15 13:55:37,wahoo,Zwift - 3R Innsbruckring Flat Race - 2 Laps (17.6km/10.9m 154m) (A),Power2max,Wahoo Kickr 18,460,425,35
35133,252557,2020-05-15 13:55:37,wahoo,Zwift - 3R Sand and Sequoias Race (A),Power2max,Wahoo Kickr 18,460,454,6
35644,252557,2020-05-17 04:47:50,wahoo,"Too many attacks, paid the price #dropped - Zwift - KISS at Race 100 - EU (A)",Power2max,Wahoo Kickr 18,436,432,4
36328,252557,2020-05-20 09:35:51,wahoo,#19. Little race before Lokke Fonden-training later. Unplaned lead out for Simon :) - Zwift - USA Cycling Race League by Indoor Specialist (A),Power2max,Wahoo Kickr 18,426,418,8
36827,252557,2020-05-22 09:53:42,wahoo,"#2nd - So Conor Swift did a TT breakaway, the rest of us had to battle for 2nd - Zwift - 3R Innsbruckring Flat Race - 4 Laps (35.2km/21.9mi 308m) (A)",Power2max,Wahoo Kickr 18,440,440,0
39744,252557,2020-06-04 17:06:05,wahoo,11th - messed up the finale  - Zwift - FUSION ECT BEUNSTOPPABLE Racing Series (A),Power2max,Wahoo Kickr 18,407,398,9
40307,252557,2020-06-07 15:12:20,wahoo,"#3rd - Bad sportsmanship for higher ranked racers to quit the event on the last km, as the find out they can&#039;t gain points - Zwift - 3R Watopia 65km Race - 6 laps (40mi 324m) (A)",Power2max,Wahoo Kickr 18,411,399,12
41382,252557,2020-06-13 08:21:33,wahoo,"#13th - lag fiesta, every pedalstroke was 2-3 seconds late :/ But win for Maaloe! - Zwift - DBR Saturday Race  (A)",Power2max,Wahoo Kickr 18,440,430,10
44285,252557,2020-06-30 14:30:58,wahoo,Zwift - 3R & Wahoo Ride Real Race Series - Round 7 of 7 (A),Power2max,Wahoo Kickr 18,412,405,7
45135,252557,2020-07-04 08:58:25,wahoo,Zwift - 3R Hilly Race - Watopia Hilly Route - 2 Laps (A),Power2max,Wahoo Kickr 18,483,476,7
45290,252557,2020-07-07 14:13:00,wahoo,Zwift - Sydkysten Cycling - Carl Ras Race (A),Power2max,Wahoo Kickr 18,445,438,7
45291,252557,2020-07-07 14:13:00,wahoo,Zwift - 3R Volcano Circuit Flat Race - 8 Laps (35.2km/21.9mi 160m) (A),Power2max,Wahoo Kickr 18,417,411,6
46176,252557,2020-07-13 16:27:59,wahoo,Zwift - Virtual Tour de France - Open - Stage 4 Discovery Ride,Power2max,Wahoo Kickr 18,477,471,6
48686,252557,2020-08-03 16:45:58,wahoo,#2 - first ever stream. Find it at ,Power2max,Wahoo Kickr 18,426,423,3
50540,252557,2020-08-18 14:08:50,wahoo,#11th - The finish line came faster than expected xD Wishful thinking &#039;cause the counter was right! - Zwift - 3R Turbocharged Team Race Series - Round 6 (A),Power2max,Wahoo Kickr 18,397,388,9
50986,252557,2020-08-20 12:54:56,wahoo,Zwift - Off The MAAP Stage 2 Race (A),Power2max,Wahoo Kickr 18,387,388,-1
50987,252557,2020-08-20 12:54:56,wahoo,"#4th - Chaos race, with no riders list, and all riders from the open world visible - Zwift - 3R Classique Flat Race - 6 Laps (37.7km/23.4mi 114m) (A)",Power2max,Wahoo Kickr 18,433,428,5
53045,252557,2020-09-02 10:15:04,wahoo,"#3rd - Hs Zwift changed their algoritm, so honor more raw power? &lt;3 - Zwift - Peak-PTY Midweek TT Climb Challenge (A)",Power2max,Wahoo Kickr 18,468,457,11
53293,252557,2020-09-03 10:55:28,wahoo,#1st - super hard finish :O - Zwift - Team ODZ Thursday Morning Throwdown (E),Power2max,Wahoo Kickr 18,413,402,11
53438,252557,2020-09-04 14:57:46,wahoo,#7th - Totallu got that sprint wrong! :O - Zwift - 3R Sand and Sequoias Race (A),Power2max,Wahoo Kickr 18,447,443,4
53581,252557,2020-09-05 17:44:20,wahoo,#4th - big boy got his butt kicked in the mountains xD - Zwift - 3R Three Sisters Hilly Race (47km/29.2mi 879m) (A),Power2max,Wahoo Kickr 18,475,474,1
54351,252557,2020-09-10 10:29:17,wahoo,#4th - dropped my chain in sprint for 2nd. ZP hero destroyed the race :/ - Zwift - Team ODZ Thursday Morning Throwdown (E),Power2max,Wahoo Kickr 18,416,411,5
57068,252557,2020-09-23 17:03:20,wahoo,"#34 - Vi vandt ikke, men havde en fucking fest med det &lt;3 - Zwift - DCU powered by Feltet.dk (A)",Power2max,Wahoo Kickr 18,484,477,7
58463,252557,2020-09-29 17:49:54,wahoo,#3rd - Zwift - Team Italy & Frenchy Fuzion League (A),Favero Assioma DUO,Wahoo Kickr 18,438,434,4
58554,252557,2020-09-30 17:28:24,wahoo,"#10th - opened too early in the sprint, with dead legs :) - Zwift - DCU powered by Feltet.dk (A)",Favero Assioma DUO,Wahoo Kickr 18,455,459,-4
60567,252557,2020-10-09 11:54:02,wahoo,#1st - Zwift - TEAM G7 and Mysenlan Friday Indoor Race (A),Favero Assioma DUO,Wahoo Kickr 18,414,409,5
60927,252557,2020-10-11 07:08:11,wahoo,Zwift - 10/11/2020,Favero Assioma DUO,Wahoo Kickr 18,436,428,8
61614,252557,2020-10-13 16:39:13,wahoo,"#42 - won the first sprint, but godt dropped on Volcano - Zwift - Zwift Racing League | WTRL",Favero Assioma DUO,Wahoo Kickr 18,487,481,6
62301,252557,2020-10-15 17:08:30,wahoo,#12th - Zwift - FUSION ECT BEUNSTOPPABLE Racing Series (A),Favero Assioma DUO,Wahoo Kickr 18,500,493,7
63520,252557,2020-10-20 16:46:42,wahoo,TTT - Zwift Racing League - WTRL ,Favero Assioma DUO,Wahoo Kickr 18,437,447,-10
64467,252557,2020-10-23 16:36:09,wahoo,Zwift - Crit City Race (A),Favero Assioma DUO,Wahoo Kickr 18,427,434,-7
65109,252557,2020-10-26 17:57:10,wahoo,"#16th in scratch, dunno in points - Zwift - DBR Ride´N´Roll League (A)",Favero Assioma DUO,Wahoo Kickr 18,459,460,-1
67165,252557,2020-11-02 11:49:04,wahoo,Testing new Kickr V5 - Zwift - Base training,Favero Assioma DUO,Wahoo Kickr V5,354,359,-5
68574,252557,2020-11-06 15:18:51,wahoo,#2nd... 0.020 from the victory - Zwift - 3R Volcano Flat Race - 3 Laps (36.6km/22.7mi 138m) (A),Favero Assioma DUO,Wahoo Kickr V5,423,414,9
69393,252557,2020-11-09 18:52:00,wahoo,#2nd again - Zwift - EVR Europe Race (A),Favero Assioma DUO,Wahoo Kickr V5,418,418,0
71418,252557,2020-11-14 14:57:17,wahoo,#18th - hard as fuck - Zwift - OH MY CRIT - Saturday Smash Race (A),Favero Assioma DUO,Wahoo Kickr V5,419,417,2
72249,252557,2020-11-17 17:49:46,wahoo,"A little part of me died, there - Zwift - Zwift Racing League | WTRL - Men&#039;s EMEA E1 DIVISION 1 (A)",Favero Assioma DUO,Wahoo Kickr V5,443,437,6
73794,252557,2020-11-21 10:34:00,wahoo,#27th - glad I&#039;m not riding the WTRL-race :D - Zwift - Into the Red by RELENTLESS (A),Favero Assioma DUO,Wahoo Kickr V5,452,454,-2
75434,252557,2020-11-25 12:21:12,wahoo,"1st - pretty eassy rice, but a win is a win :D - Zwift - 3R LaGuardia Loop Flat Race - 10 Laps (28.3km/17.6mi 270m) (A)",Favero Assioma DUO,Wahoo Kickr V5,436,438,-2
76166,252557,2020-11-26 18:18:21,wahoo,3rd - just got beatern by a faster man - Zwift - FUSION ECT BEUNSTOPPABLE Racing Series (A),Favero Assioma DUO,Wahoo Kickr V5,422,428,-6
76958,252557,2020-11-28 13:56:34,wahoo,#1st - Zwift - CCBoucherville-V2000 FUN Races (A),Favero Assioma DUO,Wahoo Kickr V5,439,441,-2
77287,252557,2020-11-29 11:14:31,wahoo,Zwift - Stages of DIRT (A),Favero Assioma DUO,Wahoo Kickr V5,486,494,-8
77288,252557,2020-11-29 11:14:31,wahoo,"#2nd - second race, emp�ty legs - Zwift - Ottawa TopSpeed Race (A)",Favero Assioma DUO,Wahoo Kickr V5,389,395,-6
78212,252557,2020-12-01 17:56:09,wahoo,Another ride in the hurt box - Zwift - TT(T) Warm Up,Favero Assioma DUO,Wahoo Kickr V5,442,444,-2
79101,252557,2020-12-03 17:30:51,wahoo,Zwift - FUSION DECEMBER CUP (A),Favero Assioma DUO,Wahoo Kickr V5,407,410,-3
80196,252557,2020-12-06 14:06:45,wahoo,"#20th-something... Racing 116 km Zwift race, just to drop the chain with 300m to go. Hur-fucking-ray! - Zwift - KISS 100 Race Series - Americas (A)",Favero Assioma DUO,Wahoo Kickr V5,442,452,-10
81071,252557,2020-12-09 15:42:10,wahoo,#3rd - did I just learn to sprint in the dessert? - Zwift - 3R Tick Tock Flat Race - 2 Lap (36km/22.4mi 100m) (A),Favero Assioma DUO,Wahoo Kickr V5,447,446,1
82197,252557,2020-12-10 17:47:45,wahoo,#32 - Volcano needed to be 1 minute shorter xD - Zwift - FUSION DECEMBER CUP (A),Favero Assioma DUO,Wahoo Kickr V5,469,473,-4
82662,252557,2020-12-13 05:47:54,wahoo,#12th - Never again - Zwift - KISS 100 Race Series - EU (A),Favero Assioma DUO,Wahoo Kickr V5,463,465,-2
83975,252557,2020-12-16 15:33:15,wahoo,Zwift - Sydkysten Race (A),Favero Assioma DUO,Wahoo Kickr V5,397,389,8
84490,252557,2020-12-17 17:36:52,wahoo,#15th - Victory for El Falco - How did I NOT get dropped today :O So much pain. - Zwift - FUSION DECEMBER CUP (A),Favero Assioma DUO,Wahoo Kickr V5,449,451,-2
89060,252557,2020-12-30 13:48:42,wahoo,Zwift - KISS Race Series - Pacific AM (A),Favero Assioma DUO,Wahoo Kickr V5,421,412,9
93074,252557,2021-01-07 18:19:12,wahoo,Zwift - FUSION WINTER CUP (A),Favero Assioma DUO,Wahoo Kickr V5,466,458,8
94536,252557,2021-01-10 14:04:54,wahoo,Zwift - KISS 100 Race Series - Americas (A),Favero Assioma DUO,Wahoo Kickr V5,469,472,-3
96333,252557,2021-01-13 15:51:09,wahoo,"#30-something. Lead out attack for Falk, who won :) - Zwift - Sydkysten Race (A)",Favero Assioma DUO,Wahoo Kickr V5,430,426,4
98174,252557,2021-01-16 15:41:59,wahoo,Zwift - 3R Classique Flat Race - 4 Laps (26.9km/16.7mi 76m) (A),Favero Assioma DUO,Wahoo Kickr V5,429,427,2
98179,252557,2021-01-16 15:41:59,wahoo,#4th - Zwift - TDZ Stage 3: Shorter Ride,Favero Assioma DUO,Wahoo Kickr V5,438,440,-2
99864,252557,2021-01-19 17:52:20,wahoo,Zwift - TTT,Favero Assioma DUO,Wahoo Kickr V5,449,441,8
100210,252557,2021-01-20 10:48:55,wahoo,#3rd - Zwift - TDZ Stage 4: Longer Ride,Favero Assioma DUO,Wahoo Kickr V5,434,436,-2
101046,252557,2021-01-21 18:12:27,wahoo,"#10th - hard on gravel, but fun! - Zwift - FUSION WINTER CUP (A)",Favero Assioma DUO,Wahoo Kickr V5,459,462,-3
102941,252557,2021-01-25 17:43:29,wahoo,3rd. Win for youngstar Oscar! Zwift -  DBR Monday Race (A),Favero Assioma DUO,Wahoo Kickr V5,429,425,4
103999,252557,2021-01-27 10:35:07,wahoo,Zwift - The Morning Grind by STPC (A),Favero Assioma DUO,Wahoo Kickr V5,475,475,0
104001,252557,2021-01-27 10:35:07,wahoo,Zwift - TDZ Stage 5: Shorter Ride,Favero Assioma DUO,Wahoo Kickr V5,398,397,1
104787,252557,2021-01-28 17:53:41,wahoo,#31. Nothing in the legs. Restday tomorrow :) - Zwift - FUSION WINTER CUP (A),Favero Assioma DUO,Wahoo Kickr V5,465,471,-6
106297,252557,2021-01-31 14:05:34,wahoo,6th - how on earth did I manage that!? - Zwift - KISS 100 Race Series - Americas (A),Favero Assioma DUO,Wahoo Kickr V5,519,520,-1
108330,252557,2021-02-03 18:33:23,wahoo,"#last maybe - no pwerups the first 2 laps, then 2xdraft and 2xfeather. Nevermind sprinting then ;) - Zwift - Danmarks Cykle Union & Partners 4/6 (A)",Favero Assioma DUO,Wahoo Kickr V5,459,454,5
109361,252557,2021-02-05 15:23:31,wahoo,6th - can&#039;t sprint anymore - Zwift - DBR Friday Race (A),Favero Assioma DUO,Wahoo Kickr V5,458,452,6
111393,252557,2021-02-09 10:55:46,wahoo,Zwift - TDZ Stage 8: Group Ride,Favero Assioma DUO,Wahoo Kickr V5,438,439,-1
111394,252557,2021-02-09 10:55:46,wahoo,Zwift - 3R Gotham Grind Flat Race - 2 Laps (18.5km/11.6mi 58m) (A),Favero Assioma DUO,Wahoo Kickr V5,422,417,5
113074,252557,2021-02-11 18:21:38,wahoo,"#27th - team attack again, and again, and again.... Zwift - FUSION WINTER CUP (A)",Favero Assioma DUO,Wahoo Kickr V5,488,481,7
114748,252557,2021-02-14 13:52:23,wahoo,"#2nd! - More downhill sprints please! - Damn you, Teugels! :D - Zwift - KISS 100 Race Series - Americas (A)",Favero Assioma DUO,Wahoo Kickr V5,449,454,-5
115719,252557,2021-02-16 13:34:20,wahoo,#1st - longest sprint ever! - Zwift - Endurance,Favero Assioma DUO,Wahoo Kickr V5,507,509,-2
117747,252557,2021-02-19 13:01:45,wahoo,#1st - KISS - Zwift,Favero Assioma DUO,Wahoo Kickr V5,484,487,-3
120921,252557,2021-02-25 17:40:12,wahoo,#15th - FUSION WINTER CUP - Zwift,Favero Assioma DUO,Wahoo Kickr V5,521,530,-9
123020,252557,2021-03-02 17:45:44,wahoo,PLAY OFF BABY!!,Favero Assioma DUO,Wahoo Kickr V5,477,476,1
126087,252557,2021-03-08 12:59:14,wahoo,2nd - Zwift - Magnum mOnDayZ RACE presented by Team ODZ,Favero Assioma DUO,Wahoo Kickr V5,415,423,-8
65894,256586,2020-10-27 18:17:37,wahoo,Zwift - Zwift Racing League | WTRL - EMEA E (MEN) -  Division 1 (D),Favero Assioma Duo,Wahoo Kickr 18,309,303,6
69913,256586,2020-11-10 18:17:52,wahoo,Zwift - Zwift Racing League | WTRL - EMEA E1 (MEN) -  Division 1 (D),Favero Assioma Duo,Wahoo Kickr 18,354,337,17
75083,256586,2020-11-24 18:17:44,wahoo,Zwift - Zwift Racing League | WTRL - Men&#039;s EMEA E1 DIVISION 1,Favero Assioma Duo,Wahoo Kickr 18,350,340,10
102994,256970,2021-01-25 18:55:02,neo,Zwift - SCF SWE Cup Women (C),Powertap,Tacx Neo,227,214,13
103268,256970,2021-01-12 19:41:06,neo,Zwift - Yorkshire,Powertap,Tacx Neo,215,215,0
83340,257264,2020-12-08 19:47:29,wahoo,Zwift - Zwift Racing League | WTRL - Men&#039;s EMEA W2 DIVISION 1 (B),STAGES CYCLING POWER L/R,Wahoo Kickr 2020 v5,412,405,7
70898,257309,2020-11-12 20:11:49,wahoo,trainerroad erg mode,Favero Assioma,Wahoo Kickr V5,325,306,19
72478,257309,2020-11-17 20:59:41,wahoo,Favero Assioma / Wahoo Kickr V5,Favero Assioma,Wahoo Kickr V5,159,170,-11
72480,257309,2020-11-17 21:12:47,wahoo,Favero Assioma / Wahoo Kickr V5,Favero Assioma,Wahoo Kickr V5,289,285,4
73367,257309,2020-11-19 20:50:50,wahoo,Favero Assioma / Wahoo Kickr V5,Favero Assioma,Wahoo Kickr V5,286,284,2
74438,257309,2020-11-22 13:16:42,wahoo,Wahoo Kickr V5 / Favero Assioma,Favero Assioma,Wahoo Kickr V5,320,314,6
85725,257309,2020-12-13 19:41:53,wahoo,Favero Assioma / Wahoo Kickr V5,Favero Assioma,Wahoo Kickr V5,302,294,8
86086,257309,2020-12-21 20:56:17,wahoo,Zwift - 3R Watopia Flat Route Reverse Race - 3 Laps (30.8km/19.1mi 162m) (B),Favero Assioma,Wahoo Kickr V5,325,324,1
86841,257309,2020-12-23 19:40:05,wahoo,Favero Assioma / Wahoo Kickr V5,Favero Assioma,Wahoo Kickr V5,184,190,-6
87466,257309,2020-12-26 13:14:13,wahoo,Favero Assioma / Wahoo Kickr V5,Favero Assioma,Wahoo Kickr V5,297,289,8
89414,257309,2020-12-29 20:11:43,wahoo,Favero Assioma / Wahoo Kickr V5,Favero Assioma,Wahoo Kickr V5,259,259,0
89416,257309,2020-12-31 13:35:25,wahoo,Favero Assioma / Wahoo Kickr V5,Favero Assioma,Wahoo Kickr V5,331,330,1
89418,257309,2020-12-31 14:12:20,wahoo,Favero Assioma / Wahoo Kickr V5,Favero Assioma,Wahoo Kickr V5,268,263,5
91123,257309,2021-01-01 18:55:14,wahoo,Zwift - MEC Bikes NZ - Ride / Race (B),Favero Assioma,Wahoo Kickr V5,326,322,4
94764,257309,2021-01-10 20:20:20,wahoo,Favero Assioma / Wahoo Kickr V5,Favero Assioma,Wahoo Kickr V5,286,282,4
98370,257309,2021-01-16 07:49:25,wahoo,Favero Assioma / Wahoo Kickr V5,Favero Assioma,Wahoo Kickr V5,307,298,9
99445,257309,2021-01-17 18:38:50,wahoo,Favero Assioma / Wahoo Kickr V5,Favero Assioma,Wahoo Kickr V5,287,280,7
100116,257309,2021-01-19 19:30:53,wahoo,Wahoo Kickr V5 / Favero Assioma,Favero Assioma,Wahoo Kickr V5,276,270,6
128613,257309,2021-03-13 18:34:42,wahoo,Favero Assioma / Wahoo Kickr V5,Favero Assioma,Wahoo Kickr V5,253,254,-1
27105,258899,2019-12-13 12:37:17,wahoo,Zwift - MAP Test 5 w 15 s,New Quarq,Kickr,417,403,14
12327,259131,2020-02-03 17:59:47,wahoo,Zwift - Tour de Zwift: Stage 6 Group Ride - Long Distance,Stages Dura ace,Wahoo Kickr,372,381,-9
12330,259131,2020-02-02 05:59:49,wahoo,Zwift - KISS at Race 100 - EU (A),Stages Dura ace,Wahoo Kickr,305,310,-5
12425,259131,2020-02-04 19:39:47,wahoo,Zwift - 3R Ultimate Racing League - Round 5 (A),Stages Dura ace,Wahoo Kickr,338,350,-12
12811,259131,2020-02-06 18:59:44,wahoo,Zwift - KALAS Cup - Round 2 (A),Stages Dura ace,Wahoo Kickr,378,384,-6
13032,259131,2020-02-07 18:09:46,wahoo,Zwift - 3R Lutscher CCW Climbing Race - 1 Lap (22.1km/13.9mi 827m) (A),Stages Dura ace,Wahoo Kickr,368,380,-12
13425,259131,2020-02-11 19:39:42,wahoo,Zwift - 3R Ultimate Racing League - Round 6 (A),Stages Dura ace,Wahoo Kickr,350,360,-10
14519,259131,2020-02-13 18:59:41,wahoo,Zwift - KALAS Cup - Round 3 (A),Stages Dura ace,Wahoo Kickr,342,349,-7
14641,259131,2020-02-18 19:14:57,wahoo,Zwift - Feltet.dk Race Series,Stages Dura ace,Wahoo Kickr,359,365,-6
15059,259131,2020-02-20 18:59:56,wahoo,Zwift - KALAS Cup - Round 4 (A),Stages Dura ace,Wahoo Kickr,351,361,-10
15982,259131,2020-02-27 18:59:58,wahoo,Zwift - KALAS Cup - Round 5 (A),Stages Dura ace,Wahoo Kickr,345,344,1
16082,259131,2020-02-29 09:29:57,wahoo,Zwift - DBR Saturday Race (A),Stages Dura ace,Wahoo Kickr,364,370,-6
16495,259131,2020-03-02 19:19:55,wahoo,Zwift - TFC & WTRL Mad Monday London Series (1 of 6) (A),Stages Dura ace,Wahoo Kickr,364,374,-10
16949,259131,2020-03-05 18:59:53,wahoo,Zwift - KALAS Cup - Round 6 (A),Stages Dura ace,Wahoo Kickr,338,344,-6
17527,259131,2020-03-10 19:14:47,wahoo,Zwift - Feltet.dk Race Series (A),Stages Dura ace,Wahoo Kickr,366,373,-7
17832,259131,2020-03-12 19:14:47,wahoo,Zwift - Tour of Watopia Pro-Am Men&#039;s Race #1 (A),Stages Dura ace,Wahoo Kickr,392,401,-9
18190,259131,2020-03-15 18:09:59,wahoo,Zwift - Stage 2 Race (A) - Tour of Watopia 2020,Stages Dura ace,Wahoo Kickr,385,397,-12
19116,259131,2020-03-20 19:15:00,wahoo,Zwift - Tour of Watopia Pro-Am Men&#039;s Race #2 (A),Stages Dura ace,Wahoo Kickr,369,384,-15
19443,259131,2020-03-24 18:59:59,wahoo,Zwift - NCF Spring Cup (A),Stages Dura ace,Wahoo Kickr,393,408,-15
20283,259131,2020-03-29 07:59:54,wahoo,Zwift -  KALAS Indoor EFCT race series #Road race (A),Stages Dura ace,Wahoo Kickr,348,355,-7
21484,259131,2020-04-02 17:59:52,wahoo,Zwift - KALAS Cup - Round 10 (A),Stages Dura ace,Wahoo Kickr,342,359,-17
22164,259131,2020-04-05 08:59:49,wahoo,Zwift - Ronde van Zwift (A),Stages Dura ace,Wahoo Kickr,367,381,-14
25108,259131,2020-04-14 17:59:59,wahoo,Zwift - NCF Spring Cup (A),Stages Dura ace,Wahoo Kickr,362,361,1
25999,259131,2020-04-17 18:10:58,wahoo,Zwift - Richmond Challenge // Zwift Classic (A),Stages Dura ace,Wahoo Kickr,370,372,-2
26482,259131,2020-04-20 18:19:58,wahoo,Zwift - TFC Mad Monday World Series (2 of 6) (A),Stages Dura ace,Wahoo Kickr,365,370,-5
30601,259131,2020-05-02 15:59:53,wahoo,Zwift - YANA Pro/AM Invitiational (A),Stages Dura ace,Wahoo Kickr,385,385,0
31679,259131,2020-05-05 16:59:57,wahoo,Zwift - NCF Grand Prix 2020 - Runde 1 - Elite (A),Stages Dura ace,Wahoo Kickr,387,393,-6
36608,259131,2020-05-19 16:59:55,wahoo,Zwift - NCF Grand Prix 2020 - Runde 3 - Elite Herrer/Kvinner (A),Stages Dura ace,Wahoo Kickr,365,378,-13
36728,259131,2020-05-21 18:16:54,wahoo,Zwift - Tour for All Invitational Race // Men (A),Stages Dura ace,Wahoo Kickr,350,360,-10
38366,259131,2020-05-28 18:16:58,wahoo,Zwift - Tour for All Invitational Race // Men (A),Stages Dura ace,Wahoo Kickr,375,384,-9
55278,259131,2020-09-14 17:59:53,wahoo,Zwift - Invitational League // Qualifying Race #1,Stages Dura ace,Wahoo Kickr,346,346,0
56436,259131,2020-09-20 12:59:58,wahoo,Zwift - Invitational League // Qualifying Race #3 (Men) (A),Stages Dura ace,Wahoo Kickr,335,343,-8
57161,259131,2020-09-23 17:44:57,wahoo,Zwift - NCF Vinter Cup 2020 - Runde 1 - Herrer (A),Stages Dura ace,Wahoo Kickr,323,324,-1
60208,259131,2020-10-07 17:29:57,wahoo,Zwift - NCF Vinter Cup 2020 - Runde 3 - Herrer (A),Stages Dura ace,Wahoo Kickr,348,345,3
62034,259131,2020-10-13 17:54:58,wahoo,Zwift - Team Italy & Frenchy Fuzion League (A),Stages Dura ace,Wahoo Kickr,345,342,3
62035,259131,2020-10-14 17:29:58,wahoo,Zwift - NCF Vinter Cup 2020 - Runde 4 - Herrer (A),Stages Dura ace,Wahoo Kickr,331,326,5
63971,259131,2020-10-21 17:29:58,wahoo,Zwift - NCF Vinter Cup 2020 - Runde 5 - Herrer (A),Stages Dura ace,Wahoo Kickr,346,339,7
64324,259131,2020-10-22 17:20:16,wahoo,Zwift - Espresso,Stages Dura ace,Wahoo Kickr V5,332,329,3
65839,259131,2020-10-28 18:29:58,wahoo,Zwift - NCF Vinter Cup 2020 - Runde 6 - Herrer (A),Stages Dura ace,Wahoo Kickr V5,357,358,-1
11965,260941,2020-01-31 19:14:49,wahoo,Zwift - Tour de Zwift // Pro-Am Invitational (A),Assioma Pedals,Kickr 18,378,363,15
11991,260941,2020-02-01 09:09:54,wahoo,Zwift - Tour de Zwift: Stage 6 Race ,Assioma Pedals,Kickr 18,370,354,16
12469,260941,2020-02-04 19:14:53,wahoo,Zwift - Tour de Zwift // Pro-Am Invitational,Assioma Pedals,Kickr 18,398,374,24
12830,260941,2020-02-06 17:09:51,wahoo,Zwift - Tour de Zwift: Stage 7 Race ,Assioma Pedals,Kickr 18,385,365,20
13602,260941,2020-02-10 16:59:53,wahoo,Zwift - Tour de Zwift: Stage 1 Ride - 2nd,Assioma Pedals,Kickr 18,398,384,14
13604,260941,2020-02-11 17:09:55,wahoo,Zwift - 3R Volcano KOM After Party Race ,Assioma Pedals,Kickr 18,407,392,15
14370,260941,2020-02-17 16:59:55,wahoo,Zwift - 3R LaGuardia Loop Flat Race - 6 Laps,Assioma Pedals,Kickr 18,362,344,18
55092,260941,2020-09-14 17:59:14,wahoo,Zwift - Invitational League // Qualifying Race #1,Assioma Pedals,Kickr 18,376,347,29
58091,260941,2020-09-28 16:09:08,wahoo,Zwift - 3R Classique Reverse Flat Race,Assioma Pedals,Kickr 18,345,327,18
69354,260941,2020-11-08 18:59:53,wahoo,Zwift -  Tour De Spartacus - Stage 3 - letting the team down,Assioma Pedals,Kickr 18,376,366,10
95042,260941,2021-01-11 19:14:27,wahoo,Zwift - Premier Division // Zwift Racing League,Assioma Pedals,Kickr 18,334,318,16
119138,260941,2021-02-22 19:07:38,wahoo,Zwift - Premier Division // Zwift Racing League (men) (A),Assioma Pedals,Kickr 18,364,360,4
107091,260985,2021-02-01 19:04:46,neo,Zwift - Premier Division // Zwift Racing League (women) (A),stages power meter,tacx neo,241,255,-14
14780,263018,2020-02-20 00:00:53,wahoo,Zwift - BRT Wednesday Night Race (A),Garmin Vector 2,Wahoo Kickr,317,314,3
61710,265859,2020-10-14 01:45:22,neo,Zwift - Zwift Racing League | WTRL,Favero Assioma Duo 2,Neo ,256,256,0
117614,266630,2021-02-18 17:30:16,wahoo,02/18/2021,StagesL,Kickrcore,349,349,0
124904,266630,2021-03-06 09:01:30,wahoo,Zwift -  Flanders Toeristenkoers (B),StagesL,Kickrcore,341,341,0
125362,266630,2021-02-18 17:20:58,wahoo,Zwift - Ride with Rouleur (D),StagesL,Kickrcore,348,321,27
127710,266630,2021-03-12 15:00:44,wahoo,Zwift - PACK Slackers SUB2 Ride (D),StagesL,Kickrcore,261,256,5
127715,266630,2021-03-11 18:29:17,wahoo,Zwift - Flanders Thursday Blues Ride (D),StagesL,Kickrcore,223,223,0
127953,266630,2021-03-13 10:05:02,wahoo,Zwift - PartyAnimal 80 palapala #2 (B),StagesL,Kickrcore,369,374,-5
81197,272035,2020-12-09 19:28:47,neo,Zwift - British Cycling Crit City Series (A),Assioma UNO,Tacx neo 1,336,308,28
83680,272035,2020-12-15 18:26:45,neo,Zwift - Team Sportslab UK Road Race League (A),Assioma UNO,Tacx Neo 1,325,298,27
84341,272035,2020-12-17 15:41:05,neo,Zwift - Mikkeller and Friends Race (A),Assioma UNO,Tacx Neo 1,323,312,11
89132,272035,2020-12-30 10:34:06,neo,Zwift - Watopia,Assioma UNO,Tacx Neo 1,293,298,-5
95302,272035,2021-01-11 17:42:34,neo,Zwift - SCF SWE Cup (A),Assioma UNO,Tacx Neo 1,335,334,1
96959,272035,2021-01-14 15:58:30,neo,Zwift - TDZ Stage 3: Longer Ride,Assioma UNO,Tacx Neo 1,318,296,22
99160,272035,2021-01-18 18:51:12,neo,Zwift -  SCF SWE Cup Men (A),Assioma UNO,Tacx Neo 1,346,333,13
101967,272035,2021-01-23 10:59:59,neo,Zwift - TDZ Stage 4: Longer Ride,Assioma UNO,Tacx Neo 1,319,296,23
102989,272035,2021-01-25 17:21:52,neo,Zwift -  SCF SWE Cup Men (A),Assioma UNO,Tacx Neo 1,349,323,26
106863,272035,2021-02-01 18:47:45,neo,Zwift -  SCF SWE Cup Men (A),Assioma UNO,Tacx Neo 1,361,346,15
108437,272035,2021-02-03 18:49:38,neo,Zwift - TDZ Stage 7: Longer Ride,Assioma UNO,Tacx Neo 1,330,306,24
112476,272035,2021-02-10 19:59:36,neo,Zwift - TDZ Stage 8: Group Ride,Assioma UNO,Tacx neo 1,343,328,15
115230,272035,2021-02-15 18:44:26,neo,Zwift -  SCF SWE Cup Men (A),Assioma UNO,Tacx Neoeo 1,347,339,8
117762,272035,2021-02-19 15:44:07,neo,Zwift - TDZ Stage 8: Group Ride,Assioma UNO,Tacx Neo 1,331,321,10
119061,272035,2021-02-22 17:26:34,neo,Zwift -  SCF SWE Cup Men (A),Assioma UNO,Tacx neo 1,369,366,3
120463,272035,2021-02-24 18:40:09,neo,Zwift - Scandinavian Cup 2021 - Round 1 - Men (A),Assioma UNO,Tacx Neo 1,324,319,5
33079,272199,2020-05-09 17:18:42,neo,Zwift - Tour for All 2020: Stage 2 Longer Ride,Favero Assioma UNO,Tacx Neo,280,278,2
33216,272199,2020-05-10 06:59:17,neo,Zwift - EVO CC 160km Base Ride Cat B [~3-3.5w/kg avg] (B),Favero Assioma UNO,Tacx Neo,290,283,7
33635,272199,2020-05-11 16:16:54,neo,Zwift Academy 2018 Semi-Final Workout #1: 30/15&#039;s With Threshold,Favero Assioma UNO,Tacx Neo,337,345,-8
35242,272199,2020-05-16 08:29:38,neo,Zwift - Infinitri Sports Olympic Race (A),Favero Assioma UNO,Tacx Neo,320,320,0
35568,272199,2020-05-17 06:59:11,neo,Zwift - EVO CC 160km Base Ride Cat B [~3-3.5w/kg avg] (B),Favero Assioma UNO,Tacx Neo,272,275,-3
36645,272199,2020-05-21 17:21:09,neo,Zwift - WTRL Team Time Trial (C),Favero Assioma UNO,Tacx Neo,329,318,11
37200,272199,2020-05-23 17:40:00,neo,Zwift - Team 3R&#039;s Choice: Stage 5 Longer Race A/B,Favero Assioma UNO,Tacx Neo,331,337,-6
37323,272199,2020-05-24 08:41:15,neo,Zwift - Ganas de Mussara (ciclismo sin condiciones) Powered by ADZteam.eu (A),Favero Assioma UNO,Tacx Neo,325,327,-2
38419,272199,2020-05-28 17:40:05,neo,Zwift - WTRL Team Time Trial (C),Favero Assioma UNO,Tacx Neo,348,347,1
38714,272199,2020-05-30 15:30:08,neo,Zwift - 2a Etapa Fasttriatlon Virtual Tour Powered by ADZteam.eu (A),Favero Assioma UNO,Tacx Neo,358,355,3
45026,272199,2020-07-05 18:01:14,neo,Zwift - L&#039;Etape du Tour Stage 1 - Open Top25,Favero Assioma UNO,Tacx Neo,364,357,7
31401,273987,2020-03-18 23:00:36,wahoo,Zwift - Stage 4 - Longer Ride - Tour of Watopia 2020,2020-03-18-17-52-55,Kickr,343,350,-7
9128,274131,2020-01-13 15:15:47,neo,Zwift - 3R Volcano Circuit Sprint Flat Race - 1 Lap (6.6km/4.1mi 20m) (A),Power2Max NG eco,Tacx Neo (recorded via Wahoo app),368,363,5
9136,274131,2020-01-13 16:10:02,neo,Zwift - 3R Classique Reverse Flat Race - 4 Laps (26.9km/16.7mi 57m) (A),Power2Max NG eco,Tacx Neo (recorded via Wahoo app),353,347,6
10256,274131,2020-01-21 15:29:58,neo,Sydkysten Cycling - Carl Ras Race,Power2Max NG eco,Tacx Neo (recorded via Wahoo app),366,346,20
10647,274131,2020-01-23 19:12:42,neo,Zwift - Tour de Zwift // Pro-Am Invitational,Power2Max NG eco,Tacx Neo,370,376,-6
11190,274131,2020-01-27 18:40:23,neo,Tour de Zwift: Stage 4 Race,Power2Max NG eco,Tacx Neo,385,394,-9
14721,274131,2020-02-19 18:59:55,neo,Zwift - Zwift NL Community race - Alles uit de kast (A),Power2Max NG eco,Tacx Neo (recorded via Wahoo app),360,362,-2
47299,274131,2020-07-22 13:35:15,neo,Zwift - Crit City Race (A),Power2Max NG eco,Tacx Neo (recorded via Wahoo app),322,318,4
88292,274382,2020-12-28 18:45:18,wahoo,BC South Christmas LIZR Series - the hilly road race (OPEN),Stages PM,Wahoo Kickr PM,329,332,-3
31271,275059,2020-05-04 16:09:59,wahoo,Zwift - Tour for All 2020: Stage 1 Longer Race A/B,Stages - L (zwift),Kickr 18 (Garmin),313,303,10
44407,275059,2020-06-30 14:30:00,wahoo,Zwift - Sydkysten Cycling - Carl Ras Race (B),Stages - L (zwift),Kickr 18 (Garmin),309,305,4
46772,275059,2020-07-17 08:46:01,wahoo,Zwift - Crit City Race (B),Stages - L (zwift),Kickr 18 (Garmin),298,288,10
47082,275059,2020-07-20 08:46:14,wahoo,Zwift - Crit City Race (B),Stages - L (zwift),Kickr 18 (Garmin),301,289,12
78721,275059,2020-11-30 20:01:07,wahoo,Zwift - Crit City Race (B),Stages (L),Kickr 18,311,308,3
78724,275059,2020-12-02 22:30:13,wahoo,Zwift - ZHQ FutureWorks Crit City Race - Anti-sandbagging (A),Stages (L) Garmin,Kickr 18 zwift,311,310,1
83236,275059,2020-12-14 19:20:03,wahoo,Zwift - Team TFC Mad Monday Winter Series (A),Stages (L) Garmin,Kickr 18 zwift,327,320,7
108340,275059,2021-02-03 19:00:01,wahoo,Zwift - Open - Movistar Team Challenge Community Qualifier Race #1,Stages (L) Garmin,Kickr 18 zwift,349,331,18
108353,275059,2021-01-29 18:35:14,wahoo,Zwift - Newbury Velo Crit (A),Stages (L) Garmin,Kickr 18 zwift,316,316,0
116865,275059,2021-02-17 19:30:01,wahoo,Zwift - British Cycling Crit City Series (A),Stages (L) Garmin,Kickr 18 zwift,328,323,5
124077,275059,2021-03-04 18:20:03,wahoo,Zwift - WTRL Team Time Trial - Zone 4 (D),Stages (L) Garmin,Kickr 18 zwift,312,304,8
89164,276756,2020-12-30 12:18:02,wahoo,Kickr / Power Meter,Power Meter,Kickr,201,197,4
89397,276756,2020-12-31 10:36:26,wahoo,Kickr / Power Meter,Power Meter,Kickr,250,243,7
89786,276756,2021-01-01 11:40:07,wahoo,Kickr / Power Meter,Power Meter,Kickr,167,163,4
90252,276756,2021-01-02 12:07:50,wahoo,Zwift - DIRT Dadurday Chase Race  (B),Power Meter,Kickr,258,250,8
90848,276756,2021-01-03 15:45:07,wahoo,Zwift - Watopia,Power Meter,Kickr,242,239,3
92274,276756,2021-01-06 14:40:06,wahoo,Zwift - Watopia,Power Meter,Kickr,251,248,3
92894,276756,2021-01-07 18:16:14,wahoo,Zwift - Watopia,Power Meter,Kickr,177,172,5
93493,276756,2021-01-08 19:00:04,wahoo,Zwift - Tour De Boudicca,Power Meter,Kickr,285,273,12
94099,276756,2021-01-09 19:02:42,wahoo,Zwift -  Tour De Boudicca,Power Meter,Kickr,263,254,9
94630,276756,2021-01-10 19:03:43,wahoo,Zwift -  Tour De Boudicca,Power Meter,Kickr,276,272,4
95744,276756,2021-01-12 17:59:45,wahoo,Zwift - Donny Chain Gang (E),Power Meter,Kickr,276,269,7
96844,276756,2021-01-13 11:16:29,wahoo,ZADA Verification - 3 sisters,Power Meter,Kickr,263,258,5
97040,276756,2021-01-14 17:55:57,wahoo,Zwift - Richmond,Power Meter,Kickr,205,197,8
99140,276756,2021-01-18 19:05:17,wahoo,Zwift - Premier Division // Zwift Racing League (women) (A),Power Meter,Kickr,264,259,5
103073,276756,2021-01-25 20:04:42,wahoo,Zwift - Premier Division // Zwift Racing League (women) (A),Power Meter,Kickr,278,272,6
106854,276756,2021-02-01 19:04:42,wahoo,Zwift - Premier Division // Zwift Racing League (women) (A),Shimano Dura Ace PM,Kickr,283,279,4
111120,276756,2021-02-08 19:54:30,wahoo,Zwift - Premier Division // Zwift Racing League (women) (A),Shimano Dura Ace PM,Kickr,282,272,10
112372,276756,2021-02-10 19:01:47,wahoo,Zwift - Movistar Team Challenge // Round 1 (B),Shimano Dura Ace PM,Kickr,270,267,3
113591,276756,2021-02-12 19:01:39,wahoo,Zwift - Movistar Team Challenge // Round 1 (women),Shimano Dura Ace PM,Kickr,265,268,-3
115248,276756,2021-02-15 19:04:42,wahoo,Zwift - Premier Division // Zwift Racing League (women) (A),Shimano Dura Ace PM,Kickr,280,283,-3
117878,276756,2021-02-19 19:01:39,wahoo,Zwift - Movistar Team Challenge // Round 2 (women),Shimano Dura Ace PM,Kickr,290,295,-5
119194,276756,2021-02-22 20:00:38,wahoo,Zwift - Premier Division // Zwift Racing League (women) (A),Shimano Dura Ace PM,Kickr,254,256,-2
122468,276756,2021-03-01 19:16:51,wahoo,Zwift - Premier Division // Zwift Racing League (women) (A),Shimano Dura Ace PM,Kickr,274,274,0
124680,276756,2021-03-05 19:39:29,wahoo,Zwift - Movistar Team Challenge // Points Race (women) ,Shimano Dura Ace PM,Kickr,262,263,-1
124682,276756,2021-03-05 18:59:39,wahoo,Zwift - Ramp Test,Shimano Dura Ace PM,Kickr,292,302,-10
19595,280522,2020-03-24 19:15:15,wahoo,Zwift - Tour of Watopia Pro-Am Men&#039;s Race #3 (A),Vectors 3s,Wahoo Kickr ,405,405,0
22170,280522,2020-04-05 09:00:18,wahoo,Zwift - Ronde van Zwift (A),Vectors 3s (Secondary),Wahoo Kickr 18 (Zwift),414,418,-4
23333,280522,2020-04-09 18:30:16,wahoo,Zwift - Yorkshire Grand Prix Race (A) - 3rd,Infocrank (Secondary),Wahoo Kickr 18 (Zwift),390,377,13
26120,280522,2020-04-19 08:05:18,wahoo,Zwift - 3R Watopia Flat Route Race - 4 Laps (40.5km/25.1mi 216m) (A),Infocrank (Secondary),Wahoo Kickr 18 (Zwift),407,389,18
26563,280522,2020-04-21 06:25:16,wahoo,Zwift - 3R Watopia Flat Route Race - 3 Laps (30.3km/18.8mi 162m) (A) - 1st,Infocrank (Secondary),Wahoo Kickr 18 (Zwift),382,361,21
26884,280522,2020-04-22 08:05:22,wahoo,Zwift - 3R Tempus Fugit Flat Race - 1 Lap (19.8km/12.3mi 20m) (A) - 5th,Infocrank (Secondary),Wahoo Kickr 18 (Zwift),406,387,19
27177,280522,2020-04-23 07:00:15,wahoo,Zwift - ZHQ Beta Crit City Race (A) - 1st,Infocrank (Zwift),Wahoo Kickr 18 (Secondary),389,367,22
27532,280522,2020-04-24 07:00:15,wahoo,Zwift - ZHQ Beta Crit City Race (A) - 1st,Infocrank (Zwift),Wahoo Kickr 18 (Secondary),405,382,23
28038,280522,2020-04-25 18:10:17,wahoo,Zwift - Crit City Slam // Zwift Classic (A),Infocrank (Zwift),Wahoo Kickr 18 (Secondary),420,393,27
29379,280522,2020-04-30 06:10:15,wahoo,Zwift - 3R Watopia Flat Route Race - 3 Laps (30.3km/18.8mi 162m) (A) - 1st,Infocrank (Zwift),Wahoo Kickr 18 (Secondary),418,399,19
30605,280522,2020-05-02 16:00:20,wahoo,Zwift - YANA Pro/AM Invitiational (A) - 25th,Infocrank (Zwift),Wahoo Kickr 18 (Secondary),420,396,24
31145,280522,2020-05-04 06:30:17,wahoo,Zwift - ZHQ Beta Crit City Race (A) - 1st,Infocrank (Zwift),Wahoo Kickr 18 (Secondary),454,435,19
31908,280522,2020-05-06 06:30:15,wahoo,Zwift - Cycling Southland Wednesday Worlds p/b GreenMonkey - 3rd,Infocrank (Zwift),Wahoo Kickr 18 (Secondary),370,351,19
33519,280522,2020-05-11 06:30:15,wahoo,Zwift - ZHQ Beta Crit City Race (A) - 1st,Infocrank (Zwift),Wahoo Kickr 18 (Secondary),394,374,20
35755,280522,2020-05-18 06:30:17,wahoo,Zwift - ZHQ Beta Crit City Race (A) - 1st,Infocrank (Zwift),Wahoo Kickr 18 (Secondary),386,374,12
35956,280522,2020-05-19 06:25:16,wahoo,Zwift - 3R Watopia Flat Route Race - 3 Laps (30.3km/18.8mi 162m) (A),Infocrank (Zwift),Wahoo Kickr 18 (Secondary),428,409,19
36706,280522,2020-05-21 18:17:16,wahoo,Zwift - Tour for All Invitational Race // Men (A),Infocrank (Zwift),Wahoo Kickr 18 (Secondary),372,354,18
38223,280522,2020-05-28 06:10:15,wahoo,Zwift - 3R Watopia Flat Route Race - 3 Laps (30.3km/18.8mi 162m) (A) - 1st,Infocrank (Zwift),Wahoo Kickr 18 (Secondary),431,433,-2
38494,280522,2020-05-29 06:30:16,wahoo,Zwift - ZHQ Beta Crit City Race (A) - 1st,Infocrank (Zwift),Wahoo Kickr 18 (Secondary),390,390,0
39011,280522,2020-06-02 06:25:22,wahoo,Zwift - 3R Watopia Flat Route Race - 3 Laps (30.3km/18.8mi 162m) (A) - 1st,Infocrank (Zwift),Wahoo Kickr 18 (Secondary),396,383,13
40553,280522,2020-06-09 17:30:32,wahoo,Zwift - UKAF Cycling Community Race Night - 3rd,Infocrank (Zwift),Wahoo Kickr 18 (Secondary),395,380,15
40728,280522,2020-06-10 11:20:14,wahoo,Zwift - British Cycling Crit City Series (A) - 2nd,Infocrank (Secondary),Wahoo Kickr Core,382,388,-6
40943,280522,2020-06-11 06:10:15,wahoo,Zwift - 3R Watopia Flat Route Race - 3 Laps (30.3km/18.8mi 162m) (A) - 4th,Infocrank (Zwift),Wahoo Kickr Core (Secondary),433,430,3
41181,280522,2020-06-12 06:30:15,wahoo,Zwift - ZHQ Beta Crit City Race (A) - 1st,Infocrank (Secondary),Wahoo Kickr Core (Primary),383,394,-11
49758,280522,2020-08-12 19:15:15,wahoo,Zwift - 3R Tick Tock Flat Race - 2 Lap (36km/22.4mi 100m) (A) - 3rd,Infocrank (Zwift),Wahoo Kickr 18 (Secondary),328,317,11
50721,280522,2020-08-19 16:00:25,wahoo,Zwift - Off The MAAP Stage 2 Race (A) -1st,Infocrank (Zwift),Wahoo Kickr 18 (Secondary),382,376,6
50990,280522,2020-08-20 21:00:27,wahoo,Zwift - Off The MAAP Stage 2 Race (A) - 1st,Infocrank (Zwift),Wahoo Kickr 18 (Secondary),363,360,3
52793,280522,2020-08-31 18:20:20,wahoo,Zwift - TFC Mad Monday Summer Series (9 of 10) (A) - 7th,Infocrank (Zwift),Wahoo Kickr 18 (Secondary),410,404,6
53462,280522,2020-09-04 18:35:15,wahoo,Zwift - Newbury Velo Crit (A) - 1st,Infocrank (Zwift),Wahoo Kickr 18 (Secondary),432,432,0
53818,280522,2020-09-07 18:20:20,wahoo,Zwift - TFC Mad Monday Summer Series (10 of 10) (A),Infocrank (Zwift),Wahoo Kickr 18 (Secondary),395,394,1
54465,280522,2020-09-10 18:30:18,wahoo,Zwift - Cycling Ireland Zwift Sprint Race (A) - 1st,Infocrank (Zwift),Wahoo Kickr 18 (Secondary),365,364,1
55210,280522,2020-09-14 17:59:53,wahoo,Zwift - Invitational League // Qualifying Race #1,Infocrank (Secondary),Wahoo Kickr 18 (Zwift),405,386,19
56896,280522,2020-09-22 18:44:23,wahoo,Zwift - 3R Sundown Race Series  (E),Infocrank (Zwift),Wahoo Kickr 18 (Secondary),419,410,9
57351,280522,2020-09-24 19:00:15,wahoo,Zwift - KISS at Race - EU PM (A) ,Infocrank (Secondary),Wahoo Kickr 18 (Zwift),438,418,20
58606,280522,2020-09-30 18:30:14,wahoo,Zwift - British Cycling Crit City Series (A) - 2nd,Infocrank (Secondary),Wahoo Kickr 18 (Zwift),403,378,25
58896,280522,2020-10-01 19:00:16,wahoo,Zwift - KISS at Race - EU PM (A) - 2nd,Infocrank (Secondary),Wahoo Kickr 18 (Zwift),384,362,22
59646,280522,2020-10-05 18:20:22,wahoo,Zwift - TFC Mad Monday Autumn Series (A) - 5th,Infocrank (Secondary),Wahoo Kickr 18 (Zwift),414,392,22
59904,280522,2020-10-06 19:00:17,wahoo,Zwift - KISS at Race - EU PM (A) - 2nd,Vector 3s (Secondary),Wahoo Kickr 18 (Zwift),418,390,28
60449,280522,2020-10-08 19:00:19,wahoo,Zwift - KISS at Race - EU PM (A) - 1st,Infocrank (Secondary),Wahoo Kickr 18 (Zwift),448,421,27
61338,280522,2020-10-12 19:00:16,wahoo,Zwift - EVR Europe Race (A) - 2nd,Infocrank (Secondary),Wahoo Kickr 18 (Zwift),401,363,38
61650,280522,2020-10-13 19:00:14,wahoo,Zwift - KISS at Race - EU PM (A) - 3rd,Infocrank (Secondary),Wahoo Kickr 18 (Zwift),396,364,32
62128,280522,2020-10-15 15:15:17,wahoo,Zwift - OH MY CRIT! - The Double Race 1/2 (A) - 6th,Infocrank (Secondary),Wahoo Kickr 18 (Zwift),428,397,31
63175,280522,2020-10-19 18:20:18,wahoo,Zwift - TFC Mad Monday Autumn Series (A) - 3rd,Infocrank (Secondary),Wahoo Kickr 18 (Zwift),427,391,36
63583,280522,2020-10-20 18:30:16,wahoo,Zwift - ZHR Masters Britain (A) - 1st,Infocrank (Secondary),Wahoo Kickr 18 (Zwift),431,397,34
64462,280522,2020-10-23 18:35:14,wahoo,Zwift - Newbury Velo Crit (A) - 1st,Infocrank (Secondary),Wahoo Kickr 18 (Zwift),386,360,26
66622,280522,2020-10-31 09:15:16,wahoo,Zwift - ZHR Audax (D),Infocrank (Secondary),Wahoo Kickr 18 (Zwift),442,415,27
67079,280522,2020-11-01 07:35:03,wahoo,Zwift - Watopia,Infocrank (Secondary),Wahoo Kickr 18 (Zwift),429,405,24
67739,280522,2020-11-03 15:30:13,wahoo,Zwift - Sydkysten Cycling - Carl Ras Race (A) - 3rd,Infocrank (Secondary),Wahoo Kickr 18 (Zwift),427,394,33
67991,280522,2020-11-04 20:00:27,wahoo,Zwift - EVR Definitely Not the WTNC (A) - 1st,Infocrank (Secondary),Wahoo Kickr 18 (Zwift),352,333,19
68144,280522,2020-11-05 14:05:15,wahoo,Zwift - 3R Classique Flat Race - 6 Laps (37.7km/23.4mi 114m) (A),Infocrank (Secondary),Wahoo Kickr 18 (Zwift),404,384,20
72529,280522,2020-11-18 10:45:13,wahoo,Zwift - USA Cycling Race League by Indoor Specialist (A),Infocrank (Zwift),Wahoo Kickr 18 (Secondary),427,405,22
73452,280522,2020-11-20 11:20:13,wahoo,Zwift - 3R LaGuardia Loop Reverse Flat Race - 8 Laps (24.5km/15.2mi 216m) (A) - 4th,Infocrank (Zwift),Wahoo Kickr 18 (Secondary),400,380,20
74987,280522,2020-11-24 16:05:22,wahoo,Zwift - 3R Volcano Circuit Flat Race - 8 Laps (35.2km/21.9mi 160m) (A) - 1st,Infocrank (Zwift),Wahoo Kickr 18 (Secondary),415,396,19
75878,280522,2020-11-26 12:25:27,wahoo,Zwift - EMU Japan Race (A) - 7th,Infocrank (Zwift),Wahoo Kickr 18 (Secondary),432,411,21
77952,280522,2020-12-01 11:20:14,wahoo,Zwift - British Cycling Race Series (A) - 1 st,Infocrank (Zwift),Wahoo Kickr 18 (Secondary),380,365,15
46337,282743,2020-06-30 17:52:32,neo,Zwift - British Cycling Race Series (B),FADa,Neo1c,362,367,-5
72397,284890,2020-11-17 21:55:58,wahoo,Zwift - Tempo plus quick FTP x2 (PWR),Pioneer Dual-sided powermeter,Wahoo KICKR (primary used in zwift),427,423,4
72790,284890,2020-11-19 00:55:31,wahoo,Zwift - Cycling Canada Wednesday Night Race Series (A),Pioneer Dual-sided powermeter,Wahoo KICKR (primary used in zwift),458,457,1
74380,284890,2020-11-22 19:42:45,wahoo,Zwift - SS 2x15 plus endurance (PWR),Power2Max NGeco,Wahoo KICKR (primary used in zwift),385,376,9
120858,286673,2021-02-25 18:59:52,wahoo,Zwift - Team KST ,Stages,Wahoo Kickr,342,325,17
14107,288940,2020-02-15 13:29:24,neo,Zwift - Fierce Felines Racing Series: TT (B),4iiii Podiiiium Dura Ace,Tacx Neo 1,239,246,-7
14358,288940,2020-02-16 19:01:41,neo,Zwift - VoxTour Stage 1: Laura Winter (E),4iiii Podiiiium Dura Ace,Tacx Neo 1,221,223,-2
15619,288940,2020-02-25 19:58:35,neo,Zwift - VoxTour Stage 5: Ashleigh Moolman Pasio (E),4iiii Podiiiium Dura Ace,Tacx Neo 1,244,249,-5
16187,288940,2020-02-29 13:28:46,neo,Zwift - Fierce Felines Racing Series: Circuit (B),4iiii Podiiiium Dura Ace,Tacx Neo 1,232,230,2
50478,289822,2020-08-17 08:44:50,neo, Off the MAAP invitational race//Stage 2 (Women’s),Garmin Vector left sided,Tack Neo to Zwift,252,268,-16
11845,291099,2020-01-31 16:44:53,wahoo,Zwift - Crit City Race (A),Garmin Vector 3 dual pedals,Wahoo kickr 18,348,345,3
12077,291099,2020-02-02 06:44:57,wahoo,Zwift - Mtri Race (A),Garmin Vector 3 Dual,Wahoo kickr 18,347,347,0
12740,291099,2020-02-06 17:09:51,wahoo,Zwift - Tour de Zwift: Stage 7 Race (A),Garmin Vector 3 Dual,Wahoo kickr 18,377,380,-3
22929,291099,2020-04-08 06:59:59,wahoo,Zwift - ZHQ Beta Crit City Race (A),Stage G3 single sided ,Wahoo kickr 18,349,350,-1
23421,291099,2020-04-10 06:10:00,wahoo,Zwift - 3R Volcano Circuit Flat Race - 4 Laps (18.9km/11.7mi 80m) (A),Stage G3 single sided ,Wahoo kickr 18,347,346,1
23440,291099,2020-04-10 07:00:00,wahoo,Zwift - ZHQ Beta Crit City Race (A),Stage G3 single sided ,Wahoo kickr 18,315,321,-6
24447,291099,2020-04-14 06:24:59,wahoo,Zwift - 3R Watopia Flat Route Race - 3 Laps (30.3km/18.8mi 162m) (A),Stage G3 single sided ,Wahoo kickr 18,398,400,-2
24448,291099,2020-04-14 07:29:58,wahoo,Zwift - Trofeo Bologna Race (A),Stages G3 single sided ,Wahoo kickr 18,433,430,3
48226,291099,2020-07-29 06:30:00,wahoo,Zwift - ZHQ Beta Crit City Race (A),Stages G3 single sided ,Wahoo kickr 18,348,351,-3
51196,291099,2020-08-22 05:59:58,wahoo,Zwift - Off The MAAP Stage 3 Race (A),Stages G3 single sided ,Wahoo kickr 18,376,374,2
101418,291099,2021-01-22 16:00:18,wahoo,Zwift - TDZ Stage 4: Longer Ride,Stages G3 single sided ,Wahoo Kickr 5,397,392,5
102297,291099,2021-01-24 06:47:49,wahoo,Renegade Race - TT,Stages G2 single sided ,Wahoo Kickr 5,382,389,-7
105085,291099,2021-01-29 11:59:58,wahoo,Zwift - TDZ Stage 6: Longer Ride,Stages G2 single sided ,Wahoo Kickr 5,383,384,-1
106029,291099,2021-01-31 06:00:02,wahoo,Zwift - KISS 100 Race Series - EU,Stages G2 single sided ,Wahoo Kickr 5,391,402,-11
110245,291099,2021-02-07 06:00:01,wahoo,Zwift - KISS 100 Race Series - EU (A),Stages G2 single sided ,Wahoo Kickr 5,388,395,-7
21122,291238,2020-03-31 22:59:25,wahoo,Midweek Criterium A 3_31_Dual Record Test 2,Bolt/Giant PowerPro,Garmin/KICKR,367,365,2
22863,291238,2020-04-07 18:04:24,wahoo,3R Spring Loaded Race Series 2/6,Bolt/Giant PowerPro,Garmin/KICKR,362,363,-1
23342,291238,2020-04-09 17:34:27,wahoo,London International,Bolt/Giant PowerPro,Garmin/KICKR,427,435,-8
24691,291238,2020-04-14 17:57:20,wahoo,Zwift,Bolt/Giant PowerPro,Zwift/Kickr,424,430,-6
24727,291238,2020-04-14 22:59:57,wahoo,Midweek Criterium A 4_14,Bolt/Giant PowerPro,Zwift/Kickr,366,364,2
36230,291238,2020-05-19 21:03:27,wahoo,Zwift - this is a good one,Bolt/Giant PowerPro,Zwift/Kickr,409,401,8
36498,291238,2020-05-20 21:27:40,wahoo,Zwift - 1m effort,Bolt/Giant PowerPro,Zwift/Kickr,304,298,6
37846,291238,2020-05-21 17:27:12,wahoo,Tour for All Invitational Race // Men,Bolt/Giant PowerPro,Zwift/Kickr,398,393,5
38422,291238,2020-05-28 17:27:37,wahoo,Tour for All Invitational Race // Men,Bolt/Giant PowerPro,Zwift/Kickr,453,455,-2
38590,291238,2020-05-29 21:28:42,wahoo,Zwift - Z3ish,Bolt/Stages,Zwift/Kickr,313,316,-3
40741,291238,2020-06-09 21:51:36,wahoo,Zwift - Watopia,Bolt/Giant PowerPro,Zwift/Kickr,403,405,-2
41132,291238,2020-06-10 21:39:30,wahoo,Zwift - Endurance w/ Pop,Bolt/Stages,Zwift/Kickr,294,314,-20
55447,291238,2020-09-15 21:23:01,wahoo,Zwift - Yorkshire,Bolt/Giant PowerPro,Zwift/Kickr,280,281,-1
55946,291238,2020-09-17 17:25:32,wahoo,Zwift - Qualifier #2,Bolt/Giant PowerPro,Zwift/Kickr,403,401,2
56503,291238,2020-09-20 12:22:04,wahoo,Zwift - Q3,Bolt/Quarq,Zwift/Kickr,434,411,23
56718,291238,2020-09-21 21:31:22,wahoo,Zwift - 45m / 20min Effort + Cadence,Bolt/Quarq,Zwift/Kickr,324,310,14
56995,291238,2020-09-22 21:31:52,wahoo,Zwift - 2 x 8x40s w/ 2m20s 5m tgt,Bolt/Quarq,Zwift/Kickr,311,304,7
58449,291238,2020-09-29 21:52:05,wahoo,Zwift - Z3ish,Bolt/Quarq,Zwift/Kickr,322,311,11
60561,291238,2020-10-08 21:34:19,wahoo,Zwift - 45m / 20min Effort + Cadence,Bolt/Quarq,Zwift/Kickr,326,310,16
60780,291238,2020-10-10 10:52:01,wahoo,Zwift - Morning Spin,Bolt/Quarq,Zwift/Kickr,252,242,10
61331,291238,2020-10-12 18:16:30,wahoo,Zwift Racing League // Race 1 - Watopia Big Foot Hills,Bolt/Quarq,Zwift/Kickr,440,428,12
61833,291238,2020-10-13 21:32:17,wahoo,Zwift - 3x15 Touch-N-Go,Bolt/Quarq,Zwift/Kickr,356,336,20
61994,291238,2020-10-14 21:53:26,wahoo,Zwift - Yorkshire,Bolt/Quarq,Zwift/Kickr,307,310,-3
63114,291238,2020-10-19 17:36:57,wahoo,Zwift - Premier Division // Zwift Racing League (men) ,Bolt/Quarq,Zwift/Kickr,401,391,10
63983,291238,2020-10-21 21:24:06,wahoo,Zwift - 2x25 SS,Bolt/Quarq,Zwift/Kickr,369,348,21
64958,291238,2020-10-25 14:21:59,wahoo,Zwift - WUs,Bolt/Quarq,Zwift/Kickr_v5,332,323,9
65228,291238,2020-10-26 19:25:59,wahoo,Zwift Premier League Mens Race #3,Bolt/Quarq,Zwift/Kickr_v5,426,402,24
66442,291238,2020-10-28 21:21:58,wahoo,Zwift - WUs,Bolt/Quarq,Zwift/Kickr_v5,310,306,4
67419,291238,2020-11-02 18:22:18,wahoo,Premier Division // Zwift Racing League (men),Bolt/Quarq,Zwift/Kickr_v5,389,378,11
69459,291238,2020-11-09 19:25:26,wahoo,Zwift - Warmup,Bolt/Quarq,Zwift/Kickr,450,438,12
74392,291238,2020-11-22 16:36:02,wahoo,Zwift - 60m Endurance,PC7/PM7,Zwift/Kickr_v5,296,277,19
74745,291238,2020-11-23 19:20:16,wahoo,Zwift - Premier Division // Zwift Racing League (men) (A),Bolt/Quarq,Zwift/Kickr,444,442,2
76443,291238,2020-11-27 01:50:37,wahoo,Zwift - Watopia,Bolt/Quarq,Zwift/Kickr,419,415,4
77724,291238,2020-11-30 18:42:56,wahoo,Zwift - Warmup,Bolt/Quarq,Zwift/Kickr,379,374,5
78271,291238,2020-12-01 22:16:22,wahoo,Zwift - 60m z3,PC7/PM7,Zwift/Kickr_v5,338,325,13
78716,291238,2020-12-02 22:18:23,wahoo,Zwift - 45m / 20min Effort + Cadence,PC7/PM7,Zwift/Kickr_v5,331,313,18
79178,291238,2020-12-03 22:25:52,wahoo,Zwift - Z2ish,PC7/PM7,Zwift/Kickr_v5,286,278,8
79512,291238,2020-12-04 18:08:09,wahoo,Zwift - 60m z3,PC7/PM7,Zwift/Kickr_v5,314,308,6
83264,291238,2020-12-14 22:19:41,wahoo,Zwift - Z2ish,PC7/PM7,Zwift/Kickr_v5,280,276,4
84127,291238,2020-12-16 22:14:25,wahoo,Zwift - 2 x 6x60,PC7/PM7,Zwift/Kickr_v5,309,299,10
84131,291238,2020-12-15 22:41:32,wahoo,Zwift - Z2,PC7/PM7,Zwift/Kickr_v5,233,225,8
84512,291238,2020-12-17 19:22:12,wahoo,Zwift - Warmup,Bolt/Quarq,Zwift/Kickr_v5,396,392,4
85953,291238,2020-12-21 21:52:16,wahoo,Zwift - Z2ish,PC7/PM7,Zwift/Kickr_v5,285,278,7
86302,291238,2020-12-22 21:55:04,wahoo,Zwift - 2 x 5x80s w/ 2m40s 5m tgt,PC7/PM7,Zwift/Kickr_v5,308,300,8
87631,291238,2020-12-26 22:10:06,wahoo,Zwift - Warmup+ 1x4mTest,Bolt/Quarq,Zwift/Kickr_v5,425,426,-1
89113,291238,2020-12-29 21:59:51,wahoo,Zwift - 3x15m TNG ,PC7/PM7,Zwift/Kickr_v5,384,375,9
89379,291238,2020-12-30 22:07:51,wahoo,Zwift - Z3ish,PC7/PM7,Zwift/Kickr_v5,299,298,1
95044,291238,2021-01-11 18:53:29,wahoo,Premier Division // Zwift Racing League (men),Bolt/Quarq,Zwift/Kickr_v5,403,396,7
102970,291238,2021-01-25 18:44:09,wahoo,Zwift - Premier Division // Zwift Racing League (men) (A),Bolt/Quarq,Zwift/Kickr_v5,405,397,8
104718,291238,2021-01-28 17:49:43,wahoo,Zwift - Warmup,Bolt/Quarq,Zwift/Kickr_v5,407,392,15
105746,291238,2021-01-30 15:21:41,wahoo,Zwift - Warmup+Test,Bolt/Quarq,Zwift/Kickr_v5,310,304,6
105927,291238,2021-01-30 20:12:30,wahoo,Zwift - Warmup+Test,Bolt/Quarq,Zwift/Kickr_v5,445,426,19
106961,291238,2021-02-01 19:45:24,wahoo,Zwift - Premier Division // Zwift Racing League (men) (A),Bolt/Quarq,Zwift/Kickr_v5,419,392,27
110397,291238,2021-02-06 17:41:00,wahoo,Zwift - NYC,Bolt/Quarq,Zwift/Kickr_v5,411,396,15
111090,291238,2021-02-08 19:03:01,wahoo,Zwift - Premier Division // Zwift Racing League (men) (A),Bolt/Quarq,Zwift/Kickr_v5,431,420,11
115436,291238,2021-02-15 19:35:23,wahoo,Zwift - Premier Division // Zwift Racing League (men) (A),Bolt/Quarq,Zwift/Kickr_v5,442,423,19
119165,291238,2021-02-22 18:49:57,wahoo,Zwift - Premier Division // Zwift Racing League (men) (A),Bolt/Quarq,Zwift/Kickr_v5,382,366,16
119970,291238,2021-02-24 00:10:40,wahoo,Zwift - Warmup,Bolt/Quarq,Zwift/Kickr_v5,402,394,8
120725,291238,2021-02-24 22:27:53,wahoo,Zwift - 4x 8m,Bolt/Quarq,Zwift/Kickr_v5,376,370,6
122650,291238,2021-03-01 20:02:58,wahoo,Zwift - Premier Division // Zwift Racing League (men) (A),Bolt/Quarq,Zwift/Kickr_v5,409,403,6
124255,291238,2021-03-03 22:32:21,wahoo,Zwift - 90m w 2x25min SS,Bolt/Stages,Zwift/Kickr_v5,344,341,3
126229,291238,2021-03-05 22:31:10,wahoo,Zwift - Open,Bolt/Stages,Zwift/Kickr_v5,336,344,-8
126490,291238,2021-03-09 22:24:26,wahoo,Zwift - 90m w 2x25min SS,Bolt/Stages,Zwift/Kickr_v5,341,342,-1
5406,292632,2019-12-03 19:41:16,wahoo,Zwift - Ultimate Racing League by 3R & WTRL (B),ASSIMO,KICKR,315,317,-2
122313,295659,2021-03-01 07:37:16,wahoo,Zwift - Ramp Test,Assioma DUo,Kickr Core,321,322,-1
99395,296459,2021-01-16 11:13:14,wahoo,Zwift - 3R Tick Tock Flat Race - 2 Lap (36km/22.4mi 100m) (A),Quarq Dzero,Wahoo Kickr,389,403,-14
100172,296459,2021-01-20 00:53:29,wahoo,Zwift - Zwift Racing League | WTRL - Men&#039;s/Mixed AMERICAS E DIVISION 1 (A),Quarq Dzero,Wahoo Kickr,413,425,-12
104361,296459,2021-01-27 00:45:47,wahoo,Zwift - Zwift Racing League | WTRL - Men&#039;s/Mixed AMERICAS E DIVISION 1 (A),Quarq Dzero,Wahoo Kickr,442,450,-8
79766,297188,2020-12-05 09:58:20,wahoo,Zwift - Nations Challenge // Norway (E),Vector 3,Kickr 2018,214,207,7
88974,297188,2020-12-29 18:23:57,wahoo,Zwift - ZADA 3 sisters test,Vector 3,Kickr 2018,212,207,5
90040,297188,2020-12-30 19:44:46,wahoo,Zwift Academy Road: Workout 7 | VO2 Development,Vector 3,Kickr 2018,216,225,-9
90052,297188,2021-01-01 19:46:16,wahoo,Zwift - Beach Island loop - Power Zone 2,Vector 3,Kickr 2018,146,137,9
90668,297188,2021-01-02 13:50:17,wahoo,Zwift - Catrina&#039;s Endurance 100k (C),Vector 3,Kickr 2018,153,147,6
91740,297188,2021-01-04 16:48:25,wahoo,Zwift - TDZ Stage 1: Longer Ride,Vector 3,Kickr 2018,190,189,1
92805,297188,2021-01-06 19:57:10,wahoo,Zwift - TDZ Stage 1: Shorter Ride,Vector 3,Kickr 2018,205,197,8
92814,297188,2021-01-06 20:33:31,wahoo,Zwift - Watopi after TDZ  ,Vector 3,Kickr 2018,177,169,8
92817,297188,2021-01-06 21:05:52,wahoo,Kickr 2018 / Vector 3,Vector 3,Kickr 2018,192,189,3
93699,297188,2021-01-08 16:19:17,wahoo,Zwift - 8wk Race Day Prep Week 7 Taper Intervals,Vector 3,Kickr 2018,173,171,2
117419,297188,2021-02-18 18:23:30,wahoo,Zwift - FUSION WINTER CUP (B),Vector 3,Kickr 2018,218,203,15
118224,297188,2021-02-20 10:12:18,wahoo,Zwift - ZSUN Base Builder (C),Vector 3,Kickr 2018,184,182,2
124220,297188,2021-03-04 18:35:25,wahoo,Zwift - CX 2by2&#039;s - Xert,Vector 3,Kickr 2018,188,186,2
124246,297188,2021-02-25 20:08:19,wahoo,Zwift - Feel the burn,Vector 3,Kickr 2018,181,174,7
125195,297188,2021-03-06 17:49:13,wahoo,The Iceni Women’s Series (A),Vector 3,Kickr 2018,213,210,3
125215,297188,2021-03-06 17:15:26,wahoo,Zwift - Feel the burn,Vector 3,Kickr 2018,173,173,0
129358,297188,2021-03-16 18:14:22,wahoo,Women Only // CeramicSpeed Series: Open race,Vector 3,Kickr 2018,212,211,1
129362,297188,2021-03-08 19:19:22,wahoo,Zwift - Oreo Cookie Blues - Xert,Vector 3,Kickr 2018,202,200,2
17395,297624,2020-03-09 19:15:44,wahoo,Zwift - TFC & WTRL Mad Monday London Series (2 of 6) (A),Assioma Duo Pedals,Wahoo Kickr Core 2018,362,343,19
32796,297624,2020-05-08 17:55:55,wahoo,Zwift - The Friday Criterium Winter Race Series  (A),Assioma Duo Pedals,Wahoo Kickr Core 2018,351,347,4
36053,297624,2020-05-18 08:41:58,wahoo,Zwift - Crit City Race (A),Assioma Duo Pedals,Wahoo Kickr Core 2018,327,329,-2
36834,297624,2020-05-20 14:57:51,wahoo,Zwift - ZHQ Beta Crit City Race (A),2020-05-20-145747-ELEMNT BOLT 1063-69-12,Wahoo Kickr Core 2018,342,321,21
39112,297624,2020-06-01 18:18:39,wahoo,Zwift - TFC Mad Monday Series (2 of 6) (A),Assioma Duo Pedals,Wahoo Kickr Core 2018,355,356,-1
41460,297624,2020-06-12 17:58:54,wahoo,Zwift - The Friday Criterium Spring Race Series  (A),Assioma Duo Pedals,Wahoo Kickr Core 2018 (Zwift),363,377,-14
42638,297624,2020-06-19 17:58:12,wahoo,Zwift - The Friday Criterium Spring Race Series  (A),Assioma Duo Pedals ( on Element Bolt ),Wahoo Kickr Core 2018 (Zwift),332,319,13
43525,297624,2020-06-24 11:59:08,wahoo,Zwift - FutureWorks Boost Mode Test Race (A),2020-06-24-115908-ELEMNT BOLT 1063-84-12,Wahoo Kickr Core 2018 (Zwift),354,364,-10
43827,297624,2020-06-26 17:59:19,wahoo,Zwift - TFC Summer Series (A),Assioma Duo Pedals ( on Element Bolt ),Wahoo Kickr Core 2018 (Zwift),342,334,8
46943,297624,2020-07-17 17:58:06,wahoo,Zwift - TFC Summer Series (A),Assioma Duo Pedals ( on Element Bolt ),Wahoo Kickr Core 2018 (Zwift),367,378,-11
49267,297624,2020-08-07 17:58:42,wahoo,Zwift - TFC Summer Series  (A),Assioma Duo Pedals ( on Element Bolt ),Wahoo Kickr Core 2018 (Zwift),335,314,21
59106,297624,2020-10-02 17:54:50,wahoo,Zwift - TFC Autumn Race Series (A),2020-10-02-175450-ELEMNT BOLT 1063-101-0,Wahoo Kickr Core 2018 (Zwift),361,343,18
60698,297624,2020-10-09 17:50:00,wahoo,Zwift - Team CLS Hills &#039;n&#039; Thrills Racing S4 (E),Assioma Duo Pedals ( on Element Bolt ),Wahoo Kickr Core 2018 (Zwift),367,336,31
61546,297624,2020-10-13 17:12:29,wahoo,Zwift - Zwift Racing League | WTRL,Assioma Duo Pedals ( on Element Bolt ),Wahoo Kickr Core 2018 (Zwift),363,330,33
94563,298016,2021-01-10 18:40:55,wahoo,Stages / Wahoo KICKR,Stages,Wahoo KICKR,150,144,6
114535,298643,2021-02-14 10:09:58,wahoo,Zwift - 3R Sand & Sequoias - 1 Lap (20km/12.5mi 173m) (A),Sram Quarq,Wahoo Kicker,342,328,14
115632,298643,2021-02-16 10:49:56,wahoo,Zwift - SZR Lunch Race (A),Sram Quarq,Wahoo Kickr,335,315,20
98839,300885,2021-01-14 19:00:14,wahoo,Zwift - BENELIGA 2020-2021 (E),4iiii Precision,Wahoo KICKR Core,374,375,-1
93001,301237,2021-01-07 19:01:34,wahoo,Zwift - 2x20 SST #powered by rage against the machine,Stages,Kickr ,257,260,-3
93528,301237,2021-01-08 16:26:12,wahoo,Zwift - TDZ Stage 1: Longer Ride - Z2,Stages,Kickr ,191,198,-7
94398,301237,2021-01-10 08:02:05,wahoo,Zwift -  KRT/KISS 100km Endurance Ride (C) Z2,Stages,Kickr ,216,223,-7
95237,301237,2021-01-11 20:01:13,wahoo,Zwift - 1.5h Endurance Z2,Stages,Kickr ,192,190,2
97834,301237,2021-01-16 08:02:55,wahoo,Zwift - TDZ Stage 3: Shorter Ride z2,Stages,Kickr ,208,208,0
97838,301237,2021-01-16 09:20:20,wahoo,Zwift - KRT/KISS 80 km Endurance Ride (C),Stages,Kickr ,218,219,-1
101056,301237,2021-01-19 19:45:46,wahoo,Zwift - Zwift Racing League | WTRL - Men&#039;s/Mixed EMEA W1 DIVISION 1 (B),Stages,Kickr ,289,296,-7
103700,301237,2021-01-26 19:41:33,wahoo,Zwift - Zwift Racing League | WTRL - Men&#039;s/Mixed EMEA W1 DIVISION 1 (B),Stages,Kickr ,292,320,-28
104796,301237,2021-01-28 18:00:06,wahoo,Zwift - Martin Chambers&#039;s Meetup - R.G.V. - z2,Stages,Kickr ,185,190,-5
105362,301237,2021-01-29 15:42:45,wahoo,no warn up - Stages zeroed - No Spin down ,Stages,Kickr ,196,199,-3
105363,301237,2021-01-29 16:16:40,wahoo,Test - Kickr spindown - No Stages re-zero,Stages,Kickr ,192,194,-2
105364,301237,2021-01-29 16:51:03,wahoo,Test 3 - Re-zero stages (no change to Kickr) ,Stages,Kickr ,187,194,-7
109465,301237,2021-02-02 19:42:51,wahoo,Zwift - Zwift Racing League | WTRL - Men&#039;s/Mixed EMEA W1 DIVISION 1 (B),Stages,Kickr ,309,329,-20
109467,301237,2021-02-04 20:19:32,wahoo,Zwift - 4 x10 x 30/15 Vo2,Stages,Kickr ,264,281,-17
110661,301237,2021-02-06 08:28:42,wahoo,Zwift - Zwift Fondo Series: Medio Fondo - z2 ish,4iii,Kickr ,255,245,10
111997,301237,2021-02-09 19:47:56,wahoo,Zwift - Zwift Racing League | WTRL - Men&#039;s/Mixed EMEA W1 DIVISION 1 (B) 30:07,4iii,Kickr ,299,302,-3
116331,301237,2021-02-16 19:43:29,wahoo,Zwift - Zwift Racing League | WTRL - Men&#039;s/Mixed EMEA W1 DIVISION 1 (B),4iii,Kickr ,293,288,5
123802,301237,2021-03-01 16:47:34,wahoo,Zwift - Ramp Test,4iii,Kickr ,333,341,-8
123804,301237,2021-03-02 19:49:22,wahoo,Zwift - Zwift Racing League | WTRL - Men&#039;s/Mixed EMEA W1 DIVISION 1 (B),4iii,Kickr ,297,291,6
40225,304839,2020-06-07 15:24:58,wahoo,Zwift - 3R Watopia 65km Race - 6 laps (40mi 324m) (A),Vectors,Wahoo Kickr,293,300,-7
69182,304839,2020-11-08 23:09:58,wahoo,Zwift - The Bump Sprint Race (A),Vectors,Wahoo Kickr,343,315,28
71502,304839,2020-11-14 21:10:00,wahoo,Zwift - 3R Gotham Grind Flat Race - 3 Laps (27.8km/17.4mi 87m) (A),Vectors,Wahoo Kickr,306,303,3
72621,304839,2020-11-18 17:59:59,wahoo,Zwift - MIDWEEK Autumn Series by SZR (A),Vectors,Wahoo Kickr,337,315,22
73309,304839,2020-11-20 01:59:58,wahoo,Zwift - ZHQ FutureWorks Circuit Race - Anti-sandbagging (A),Vectors,Wahoo Kickr,322,296,26
74007,304839,2020-11-21 19:12:59,wahoo,Zwift - TBR Pancake Chase Race! (A),Vectors,Wahoo Kickr,307,306,1
79969,304839,2020-12-05 23:29:58,wahoo,Zwift - ZHQ FutureWorks Circuit Race - Anti-sandbagging (A),Vectors,Wahoo Kickr,297,299,-2
80305,304839,2020-12-06 20:14:58,wahoo,Zwift - 3R Greater London Flat Race - 3 Laps (40.2km/25mi 135m) (A),Vectors,Wahoo Kickr,294,285,9
81571,304839,2020-12-10 17:29:59,wahoo,Zwift - EVO CC Sprint Race Series  (A),Vectors,Wahoo Kickr,306,293,13
82582,304839,2020-12-13 00:15:01,wahoo,Zwift - 3R & ZID Merdeka Classique Flat Race Series - Round 4 of 4 (A),Vectors,Wahoo Kickr,307,300,7
85556,304839,2020-12-20 17:24:59,wahoo,Zwift - ZTPL.CC Coffee Ride (B),Vectors,Wahoo Kickr,293,285,8
101396,304839,2021-01-21 17:34:59,wahoo,Zwift - 3R PedalPlay Interval Ride [~3.5-4.0w/kg avg] (B),Vectors,Wahoo Kickr,296,289,7
114371,304839,2021-02-13 18:59:56,wahoo,Zwift - EVR Winter Series (A),Vectors,Wahoo Kickr,294,292,2
6290,305016,2019-12-14 21:29:57,wahoo,Zwift - Crit City Race (A) // 2nd,Favero Assioma Duo,Kickr 18,344,347,-3
6665,305016,2019-12-18 19:05:00,wahoo,Zwift - DBR HEINO CUP (A),Favero Assioma Duo,Kickr 18,373,380,-7
8492,305016,2020-01-08 18:59:59,wahoo,Zwift - FIETS Magazine Race Series (A),Favero Assioma Duo,Kickr 18,373,380,-7
9407,305016,2020-01-14 22:44:56,wahoo,KICKR 18 vs Garmin Vector 3&#039;s first ride,Garmin Vector 3 Dual,Kickr 18,247,250,-3
9520,305016,2020-01-15 19:14:58,wahoo,Zwift - Tour de Zwift // Pro-Am Invitational (A),Garmin Vector 3 Dual,Kickr 18,369,367,2
10692,305016,2020-01-23 19:14:57,wahoo,Zwift - Tour de Zwift // Pro-Am Invitational,Garmin Vector 3,Kickr 18,379,383,-4
12201,305016,2020-01-31 19:14:59,wahoo,Zwift - Tour de Zwift // Pro-Am Invitational (A),Garmin Vector 3,Kickr 18,381,383,-2
14990,305016,2020-02-20 19:00:01,wahoo,Zwift - KALAS Cup - Round 4 (A),Garmin Vector 3,Kickr 18,360,364,-4
21499,305016,2020-04-02 18:00:02,wahoo,Zwift - KALAS Cup - Round 10 (A),Favero Assioma Duo,Kickr 18,386,384,2
38386,305016,2020-05-28 18:17:04,wahoo,Zwift - Tour for All Invitational Race // Men (A),Garmin Vector 3,Kickr 18,383,385,-2
40579,305016,2020-06-09 18:40:14,wahoo,Zwift - 3R & Wahoo Ride Real Race Series - Round 4 of 7 (A),Garmin Vector 3,Kickr 18,352,348,4
6945,305747,2019-12-21 14:56:25,wahoo,Zwift - New Workout,favero assioma duo,wahoo kickr core,376,377,-1
13493,305747,2020-02-11 22:57:34,wahoo,Zwift - Midweek Criterium Race (A),Favero Assioma Duo,Wahoo Kickr Core,439,440,-1
14992,305747,2020-02-20 20:50:25,wahoo,Zwift - 6wk Beginner FTP Builder Week 2 Foundation,Favero Assioma Duo,Wahoo Kickr Core,257,261,-4
16298,305747,2020-03-01 13:55:21,wahoo,Zwift - KISS at Race 100 - Americas (A),Pioneer PM910H,Wahoo Kickr Core,433,426,7
16707,305747,2020-03-03 22:56:08,wahoo,Zwift - Midweek Criterium Race (A),Favero Assioma Duo,Wahoo Kickr Core,364,366,-2
33619,305747,2020-05-11 15:42:25,wahoo,Zwift - Ramp Test,Favero Assioma Duo,Wahoo Kickr Core,432,444,-12
34892,305747,2020-05-14 21:11:33,wahoo,Zwift - 3R Alpe Du Zwift KOM Race (20km 1444m) (A),Favero Assioma Duo,Wahoo Kickr Core,378,392,-14
34893,305747,2020-05-14 21:11:33,wahoo,Zwift - Crit City Race (A),Favero Assioma Duo,Wahoo Kickr Core,395,407,-12
74266,305747,2020-11-22 14:09:00,wahoo,Zwift - KISS 100 Race Series - Americas (A),Favero Assioma Duo,Wahoo Kickr &#039;18,395,385,10
75251,305747,2020-11-24 22:09:07,wahoo,Zwift - ZHQ FutureWorks Crit City Race - Anti-sandbagging (A),Favero Assioma Duo,Wahoo Kickr &#039;18,357,346,11
78293,305747,2020-12-01 23:27:20,wahoo,Zwift - Midweek Criterium Race (A),Favero Assioma Duo,Wahoo Kickr &#039;18,375,366,9
80283,305747,2020-12-06 16:44:07,wahoo,Zwift - ZHQ FutureWorks Crit City Race - Boost mode (A),Favero Assioma Duo,Wahoo Kickr &#039;18,370,363,7
80285,305747,2020-12-06 16:44:07,wahoo,Zwift - 3R Watopia Hilly Reverse Race - 4 Laps (36.7km/22.8mi 400m) (A),Favero Assioma Duo,Wahoo Kickr &#039;18,372,361,11
80984,305747,2020-12-08 22:44:03,wahoo,Zwift - Velocious Sport Tue Night Criterium (Race) (A),Favero Assioma Duo,Wahoo Kickr &#039;18,376,366,10
80985,305747,2020-12-08 22:44:03,wahoo,Zwift - Midweek Criterium Race (A),Favero Assioma Duo,Wahoo Kickr &#039;18,358,350,8
82858,305747,2020-12-13 13:59:48,wahoo,Zwift - KISS 100 Race Series - Americas (A),Favero Assioma Duo,Wahoo Kickr &#039;18,413,402,11
83641,305747,2020-12-15 18:09:32,wahoo,Zwift - Team Italy & Frenchy Fuzion League (A),Favero Assioma Duo,Wahoo Kickr &#039;18,423,410,13
85058,305747,2020-12-18 15:22:45,wahoo,Zwift - Innsbruck,Favero Assioma Duo,Wahoo Kickr &#039;18 (AFS),264,263,1
85116,305747,2020-12-19 14:46:53,wahoo,Zwift - Ramp Test Dec. 2020,Favero Assioma Duo,Wahoo Kickr &#039;18 (AFS),420,417,3
85463,305747,2020-12-20 13:50:38,wahoo,Zwift - KISS 100 Race Series - Americas (A),Favero Assioma Duo,Wahoo Kickr &#039;18 (AFS),399,395,4
88706,305747,2020-12-29 17:01:38,wahoo,Zwift - Watopia,Favero Assioma Duo,Wahoo Kickr &#039;18 (AFS),347,342,5
90993,305747,2021-01-03 14:04:36,wahoo,Zwift - KISS 100 Race Series - Americas (A),Favero Assioma Duo,Wahoo Kickr &#039;18 (AFS),427,424,3
91976,305747,2021-01-05 22:08:27,wahoo,Zwift - ZHQ FutureWorks Crit City Race - Anti-sandbagging (A),Favero Assioma Duo,Wahoo Kickr &#039;18 (AFS),351,347,4
91977,305747,2021-01-05 22:08:27,wahoo,Zwift - ZHQ FutureWorks Crit City Race - Boost mode (A),Favero Assioma Duo,Wahoo Kickr &#039;18 (AFS),345,342,3
94470,305747,2021-01-10 13:56:56,wahoo,Zwift - KISS 100 Race Series - Americas (A),Favero Assioma Duo,Wahoo Kickr &#039;18 (AFS),424,419,5
97188,305747,2021-01-14 20:11:32,wahoo,Zwift - Watopia,Favero Assioma Duo,Wahoo Kickr &#039;18 (AFS),350,346,4
98576,305747,2021-01-17 13:54:32,wahoo,Zwift - KISS 100 Race Series - Americas (A),Favero Assioma Duo,Wahoo Kickr &#039;18 (AFS),354,350,4
99976,305747,2021-01-19 23:18:37,wahoo,Zwift - Zwift Racing League | WTRL - Men&#039;s/Mixed AMERICAS E DIVISION 2 (A),Favero Assioma Duo,Wahoo Kickr &#039;18 (AFS),369,374,-5
100535,305747,2021-01-20 22:12:53,wahoo,Zwift - NYC,Favero Assioma Duo,Wahoo Kickr &#039;18 (AFS),245,243,2
101156,305747,2021-01-21 21:01:38,wahoo,Zwift - Watopia,Favero Assioma Duo,Wahoo Kickr &#039;18 (AFS),419,414,5
102446,305747,2021-01-24 14:10:46,wahoo,Zwift - KISS 100 Race Series - Americas (A),Favero Assioma Duo,Wahoo Kickr &#039;18 (AFS),376,373,3
103789,305747,2021-01-26 23:28:53,wahoo,Zwift - Zwift Racing League | WTRL - Men&#039;s/Mixed AMERICAS E DIVISION 2 (A),Favero Assioma Duo,Wahoo Kickr &#039;18 (AFS),418,414,4
104890,305747,2021-01-28 20:47:14,wahoo,Zwift - London,Favero Assioma Duo,Wahoo Kickr &#039;18 (AFS),434,433,1
107709,305747,2021-02-02 23:44:44,wahoo,Zwift - Zwift Racing League | WTRL - Men&#039;s/Mixed AMERICAS E DIVISION 2 (A),Favero Assioma Duo,Wahoo Kickr &#039;18 (AFS),388,378,10
110538,305747,2021-02-07 13:44:10,wahoo,Zwift - KISS 100 Race Series - Americas (A),Favero Assioma Duo,Wahoo Kickr &#039;18 (AFS),395,391,4
111876,305747,2021-02-09 23:53:15,wahoo,Zwift - Zwift Racing League | WTRL - Men&#039;s/Mixed AMERICAS E DIVISION 2 (A),Favero Assioma Duo,Wahoo Kickr &#039;18 (AFS),393,389,4
116196,305747,2021-02-16 23:36:48,wahoo,Zwift - Zwift Racing League | WTRL - Men&#039;s/Mixed AMERICAS E DIVISION 2 (A),Favero Assioma Duo,Wahoo Kickr &#039;18 (AFS),399,397,2
116891,305747,2021-02-17 20:52:51,wahoo,Zwift - ZWC Morning Hill Climb Race (A),Favero Assioma Duo,Wahoo Kickr &#039;18 (AFS),384,380,4
118751,305747,2021-02-21 13:58:39,wahoo,Zwift - KISS 100 Race Series - Americas (A),Favero Assioma Duo,Wahoo Kickr &#039;18 (AFS),366,365,1
121646,305747,2021-02-27 13:42:52,wahoo,Zwift - OH MY CRIT!! - Saturday Smash Race (A),Favero Assioma Duo,Wahoo Kickr &#039;18 (AFS),354,349,5
65915,307476,2020-10-28 21:53:24,wahoo,Zwift - 3R Endurance Steady Ride [~3.0/2.5w/kg avg] (B),Favero Assioma Duo,Wahoo Kickr Core,279,279,0
66112,307476,2020-10-29 17:29:55,wahoo,Zwift - 3R iTT Race - Watopia Tick Tock - 1 Lap (A),Favero Assioma Duo,Wahoo Kickr Core,337,337,0
67753,307476,2020-11-03 23:59:49,wahoo,Zwift - ZHR Masters Atlantic (C),Favero Assioma Duo,Wahoo Kickr Core,288,287,1
68653,307476,2020-11-06 23:05:01,wahoo,Zwift - 3R Innsbruckring Flat Race - 2 Laps (17.6km/10.9m 154m) (A),Favero Assioma Duo,Wahoo Kickr Core,295,293,2
70414,307476,2020-11-12 00:39:52,wahoo,Zwift - 3R Volcano Circuit Flat Race - 4 Laps (18.9km/11.7mi 80m) (A),Favero Assioma Duo,Wahoo Kickr Core,347,347,0
70714,307476,2020-11-12 18:59:52,wahoo, Flanders The BZR Ronde ,Favero Assioma Duo,Wahoo Kickr Core,361,365,-4
71471,307476,2020-11-14 17:29:53,wahoo,Zwift - EVR Summer Series (A),Favero Assioma Duo,Wahoo Kickr Core,343,344,-1
72404,307476,2020-11-17 23:29:54,wahoo,Zwift - SweatFest Fall/Winter Series 2020/21 (A),Favero Assioma Duo,Wahoo Kickr Core,337,337,0
72778,307476,2020-11-18 23:04:55,wahoo,Zwift - 3R Volcano Flat Reverse 50k Race - 4 Laps (48.8km/30.7mi 184m) (A),Favero Assioma Duo,Wahoo Kickr Core,316,316,0
74314,307476,2020-11-22 17:19:58,wahoo,Zwift - 3R Racing (A),Favero Assioma Duo,Wahoo Kickr Core,356,356,0
75998,307476,2020-11-26 18:11:56,wahoo,Zwift - ZHR Hare & Hounds Race (A),Favero Assioma Duo,Wahoo Kickr Core,310,310,0
81305,307476,2020-12-10 00:29:55,wahoo,Zwift - Austin Driveway Series Criterium (A),Favero Assioma Duo,Wahoo Kickr Core,291,292,-1
119323,307476,2021-02-23 00:04:08,wahoo,Zwift - France,Favero Assioma Duo,Wahoo Kickr Core,277,278,-1
106647,309928,2021-01-30 12:45:53,wahoo,Zwift - WTRL Racing (B),Stages L crank,wahoo kickr,316,310,6
94805,310060,2021-01-11 10:39:55,wahoo,Zwift - ZWC Hill Climb Battle (A),Power2Max Type S 110 50/34,Wahoo Kickr,289,281,8
96778,310060,2021-01-14 10:34:46,wahoo,Zwift - Japan ZWIFT Hill Climb Race (A),Power2Max Type S 110 50/34,Wahoo Kickr,340,334,6
98094,310060,2021-01-16 16:00:00,wahoo,Zwift - TDZ Stage 3: Rookie Ride,Power2Max Type S 110 50/34,Wahoo Kickr,329,326,3
98484,310060,2021-01-17 11:29:36,wahoo,Zwift - MGCC Pretzel (B),Power2Max Type S 110 50/34,Wahoo Kickr,347,342,5
101800,310060,2021-01-23 10:59:51,wahoo,Zwift - DIRT Badge Hunts (B),Power2Max Type NG 130 53/39,Wahoo Kickr,309,307,2
4540,311597,2019-11-20 10:45:22,wahoo,Zwift - DIRT Cup Series (A),Assiomas,KICKr,492,485,7
4543,311597,2019-11-19 19:10:01,wahoo,Zwift - WORLDOFFUSION Racing Series (A),Assiomas,KICKr,444,428,16
4577,311597,2019-11-20 19:04:59,wahoo,Zwift - DBR HEINO CUP (A),Assiomas,KICKr,471,467,4
4938,311597,2019-11-26 18:29:58,wahoo,Zwift - Flanders De Ronde Race (A),Assiomas,KICKr,458,449,9
5360,311597,2019-12-03 10:20:02,wahoo,Zwift - Eat The Pain Race (A),Assiomas,KICKr,439,425,14
5933,311597,2019-12-10 18:30:01,wahoo,Zwift - Flanders De Ronde Race (A),Assiomas,KICKr,388,365,23
5982,311597,2019-12-11 10:45:02,wahoo,Zwift - DIRT Cup Series (A),Assiomas,KICKr,458,446,12
6047,311597,2019-12-11 19:00:01,wahoo,Zwift - FIETS Magazine Race Series (A),Assiomas,KICKr,419,411,8
6281,311597,2019-12-14 17:30:00,wahoo,Zwift - Crit City Race (A),Assiomas,KICKr,433,429,4
6658,311597,2019-12-18 19:00:12,wahoo,Zwift - FIETS Magazine Race Series (A),Assiomas,KICKr,425,436,-11
6725,311597,2019-12-19 16:05:01,wahoo,Zwift - OH CRIT!! - The Double Race - Race 1/2 (A),Assiomas,KICKr,421,406,15
6726,311597,2019-12-19 17:04:59,wahoo,Zwift - OH CRIT!! - The Double Race - Race 2/2 (A),Assiomas,KICKr,412,406,6
7271,311597,2019-12-25 19:00:04,wahoo,Zwift - FIETS Magazine Race Series (A),Assiomas,KICKr,406,401,5
8355,311597,2020-01-07 18:30:03,wahoo,Zwift - Flanders De Ronde Race (A),Assiomas,KICKr,469,457,12
8485,311597,2020-01-08 19:00:01,wahoo,Zwift - FIETS Magazine Race Series (A),Assiomas,KICKr,491,479,12
9586,311597,2020-01-15 19:15:03,wahoo,Zwift - Tour de Zwift // Pro-Am Invitational,Assiomas (Wahoo Bolt),KICKr (Zwift Power Source),465,445,20
9591,311597,2020-01-15 19:15:03,wahoo,Zwift - Tour de Zwift // Pro-Am Invitational,Assiomas (Wahoo Bolt),KICKr (Zwift Power Source),463,444,19
9756,311597,2020-01-17 08:20:25,wahoo,Zwift - Classic SweetSpot 3x15,Assiomas,Kickr (to Bolt),381,372,9
10312,311597,2020-01-21 10:20:06,wahoo,Zwift - Eat The Pain Race (A),Assiomas (Wahoo Bolt),KICKr (Zwift Power Source),459,439,20
10465,311597,2020-01-22 18:56:45,wahoo,Zwift - PowerMeter Comparaison Greg&#039;s Test Lab,Assiomas (Wahoo Bolt),KICKr (Zwift Power Source),387,381,6
10651,311597,2020-01-23 19:15:00,wahoo,Zwift - Tour de Zwift // Pro-Am Invitational,Assiomas (Wahoo Bolt),KICKr (Zwift Power Source),511,507,4
11453,311597,2020-01-28 17:00:04,wahoo,Zwift - Crank it Up Fiets (E),Assiomas (Wahoo Bolt),KICKr (Zwift Power Source),459,415,44
11609,311597,2020-01-30 07:52:58,wahoo,Zwift - PRE-RACE DAY SPIN,Assiomas (to Roam),KICKr (Zwift Power Source),381,384,-3
11912,311597,2020-01-31 19:15:12,wahoo,Zwift - Tour de Zwift // Pro-Am Invitational (A),Assiomas (to Roam),KICKr (Zwift Power Source),443,437,6
12115,311597,2020-02-02 08:42:14,wahoo,Zwift - FRC work failed,Assiomas (to Roam),KICKr (Zwift Power Source),429,431,-2
12223,311597,2020-02-03 08:14:05,wahoo,Legs Tune Up,Assiomas (to Roam),KICKr (Zwift Power Source),385,389,-4
12440,311597,2020-02-04 19:39:58,wahoo,Zwift - 3R Ultimate Racing League - Round 5 (A),Assiomas (to Roam),KICKr (Zwift Power Source),411,410,1
12467,311597,2020-02-04 19:14:59,wahoo,Zwift - Tour de Zwift // Pro-Am Invitational (A),Assiomas (to Roam),KICKr (Zwift Power Source),435,428,7
12569,311597,2020-02-05 10:44:59,wahoo,Zwift - DIRT & IS: Baker&#039;s Dozen (A),Assiomas (to Roam),KICKr (Zwift Power Source),404,406,-2
13235,311597,2020-02-09 14:00:01,wahoo,Zwift - Zwift Gran Fondo,Assiomas (to Roam),KICKr (Zwift Power Source),410,412,-2
13529,311597,2020-02-12 10:44:58,wahoo,Zwift - DIRT & IS: Baker&#039;s Dozen (A),Assiomas (to Roam),KICKr (Zwift Power Source),420,411,9
13644,311597,2020-02-12 19:29:58,wahoo,Zwift - Charles Issendorf,Assiomas (to Roam),KICKr (Zwift Power Source),414,409,5
13646,311597,2020-02-12 19:54:57,wahoo,Zwift - Zwift Beta Race #3,Assiomas (to Roam),KICKr (Zwift Power Source),406,394,12
14353,311597,2020-02-16 16:55:00,wahoo,Zwift - LIVE finals of De Ronde League (A),Assiomas (to Roam),Wahoo Kickr18 (Live event),445,423,22
15928,311597,2020-02-27 19:00:04,wahoo,Zwift - KALAS Cup - Round 5 (A),Assiomas (to Roam),KICKr (Zwift Power Source),443,443,0
16751,311597,2020-03-04 10:45:12,wahoo,DIRT & IS: Bakers Dozen,Assiomas (to Roam),KICKr (Zwift Power Source),437,455,-18
16827,311597,2020-03-04 19:30:00,wahoo,Zwift - Zwift Beta Race (A),Assiomas (to Roam),KICKr (Zwift Power Source),420,421,-1
17334,311597,2020-03-09 07:26:54,wahoo,Zwift - Absa Cape Epic Workout 5,Assiomas (to Roam),KICKr (Zwift Power Source),424,415,9
17827,311597,2020-03-12 19:15:02,wahoo,Zwift - Tour of Watopia Pro-Am Men&#039;s Race #1 (A),Assiomas (to Roam),KICKr (Zwift Power Source),435,425,10
17923,311597,2020-03-13 08:39:56,wahoo,Zwift - Absa Cape Epic Workout 13,Assiomas (to Roam),KICKr (Zwift Power Source),427,414,13
18285,311597,2020-03-15 08:15:23,wahoo,Zwift - Absa Cape Epic Workout 8,Assiomas (to Roam),KICKr (Zwift Power Source),375,371,4
18362,311597,2020-03-17 09:20:00,wahoo,Zwift - Eat The Pain Race (A),Assiomas (to Roam),KICKr (Zwift Power Source),416,409,7
18929,311597,2020-03-20 19:15:00,wahoo,Zwift - Tour of Watopia Pro-Am Men&#039;s Race #2 (A),Assiomas (to Roam),KICKr (Zwift Power Source),431,425,6
19395,311597,2020-03-24 15:14:05,wahoo,Zwift - Watopia,2020-03-24-151405-ELEMNT ROAM 710E-72-12,KICKr (Zwift Power Source),371,359,12
19441,311597,2020-03-24 19:14:55,wahoo,Zwift - Tour of Watopia Pro-Am Men&#039;s Race #3 (A),Assiomas (to Roam),KICKr (Zwift Power Source),421,417,4
19828,311597,2020-03-26 18:59:59,wahoo,Zwift - KALAS Cup - Round 9 (A),"Assiomas (to Roam, Secondary)",KICKr (Zwift Power Source),441,436,5
19974,311597,2020-03-27 17:00:00,wahoo,Zwift -  KALAS Indoor EFCT race series #iTT (A),"Assiomas (to Bolt, Secondary)",KICKr (Zwift Power Source),439,436,3
20077,311597,2020-03-28 09:00:05,wahoo, KALAS Indoor EFCT race series #Crit,"Assiomas (to Bolt, Secondary)",KICKr (Zwift Power Source),404,397,7
20401,311597,2020-03-29 08:00:02,wahoo,Zwift -  KALAS Indoor EFCT race series #Road race (A),"Assiomas (to Bolt, Secondary)",KICKr (Zwift Power Source),425,416,9
21315,311597,2020-04-02 09:45:15,wahoo,Zwift - Koa Sports League Race (A),"Assiomas (to Bolt, Secondary)",KICKr (Zwift Power Source),409,412,-3
23336,311597,2020-04-09 18:10:00,wahoo,Zwift - London International // Zwift Classic (A),"Assiomas (Secondary, to Bolt)","Kickr (Primary, to Zwift)",496,497,-1
24635,311597,2020-04-14 18:40:00,wahoo,Zwift - 3R Spring Loaded Race Series - Round 3of6 (A),"Assiomas (Secondary, to Bolt)","Kickr (Primary, to Zwift)",447,439,8
25117,311597,2020-04-16 09:45:06,wahoo,Zwift - Koa Sports League Race (A),"Assiomas (Secondary, to Bolt)","Kickr (Primary, to Zwift)",428,424,4
25655,311597,2020-04-17 18:11:03,wahoo,Zwift - Richmond Challenge // Zwift Classic (A),"Assiomas (Secondary, to Bolt)","Kickr (Primary, to Zwift)",451,447,4
25922,311597,2020-04-17 18:11:03,wahoo,OH CRIT! Saturday Smash Series,"Assiomas (Secondary, to Bolt)","Kickr (Primary, to Zwift)",404,395,9
27054,311597,2020-04-22 17:00:10,wahoo,Zwift - Swedish Zwift Racing Cup by SZR (A),"Assiomas (Secondary, to Bolt)","Kickr (Primary, to Zwift)",390,390,0
27058,311597,2020-04-22 17:55:10,wahoo,Zwift - USA Cycling Race League by Indoor Specialist  (A),"Assiomas (Secondary, to Bolt)","Kickr (Primary, to Zwift)",432,435,-3
28045,311597,2020-04-25 18:09:59,wahoo,Zwift - Crit City Slam // Zwift Classic (A),"Assiomas (Secondary, to Bolt)","Kickr (Primary, to Zwift)",452,432,20
28663,311597,2020-04-28 09:20:13,wahoo,Zwift - The After Party Race (A),"Assiomas (Secondary, to Bolt)","Kickr (Primary, to Zwift)",501,492,9
28848,311597,2020-04-28 18:40:10,wahoo,Zwift - 3R Spring Loaded Race Series - Round 5of6 (Reverse) (A),"Assiomas (Secondary, to Bolt)","Kickr (Primary, to Zwift)",435,421,14
29035,311597,2020-04-29 09:45:11,wahoo,Zwift - USA Cycling Race League by Indoor Specialist  (A),"Assiomas (Secondary, to Bolt)","Kickr (Primary, to Zwift)",387,381,6
29486,311597,2020-04-30 09:45:13,wahoo,Zwift - Koa Sports League Race (A),"Assiomas (Secondary, to Bolt)","Kickr (Primary, to Zwift)",436,423,13
29773,311597,2020-04-30 19:00:06,wahoo,Zwift - Zwift Beta Race,"Assiomas (Secondary, to Bolt)","Kickr (Primary, to Zwift)",386,374,12
30648,311597,2020-05-02 16:00:00,wahoo,Zwift - YANA Pro/AM Invitiational (A),"Assiomas (Secondary, to Bolt)","Kickr (Primary, to Zwift)",481,477,4
31217,311597,2020-05-04 10:00:02,wahoo,Zwift -  RCC Zwift Championships - APAC Region (E),"Assiomas (Secondary, to Bolt)","Kickr (Primary, to Zwift)",391,393,-2
41761,311597,2020-06-15 06:19:36,wahoo,Zwift - 2x20 SST,"Infocrank (Primary, to Zwift)","Kickr (Secondary, to Wahoo App)",387,375,12
43256,311597,2020-06-23 18:40:07,wahoo,Zwift - 3R & Wahoo Ride Real Race Series - Round 6 of 7 (A),"Infocrank (Primary, to Zwift)","Kickr (Secondary, to BOLT)",489,470,19
60520,311597,2020-10-09 06:41:37,wahoo,Zwift Academy 2019 Workout #2: Race Practice,"Infocrank (Secondary, to Bolt)","Kickr (Primary, to Zwift)",437,420,17
60920,311597,2020-10-11 07:36:55,wahoo,Zwift Academy Road: Workout 2 | Sprint Profile,"Infocrank (Primary, to Zwift)","Kickr (Secondary, to BOLT)",343,317,26
61024,311597,2020-10-11 16:34:58,wahoo,Zwift - PRE-RACE DAY SPIN,"Infocrank (Secondary, to BOLT)","Kickr (Primary, to Zwift)",401,391,10
67554,311597,2020-11-03 17:01:16,wahoo,Zwift - Watopia,Infocrank ,Wahoo Kickr v5,422,411,11
70700,311597,2020-11-12 14:09:56,wahoo,Zwift - ZA Road - Race #2 (A),"Infocrank (Primary, to Zwift)","Kickr v5 (Secondary, to BOLT)",445,436,9
71986,311597,2020-11-16 19:10:06,wahoo,Zwift - Premier Division // Zwift Racing League (men) (A),"Infocrank (Secondary, to Bolt)","Kickr v5 (Primary, to Zwift)",448,434,14
73068,311597,2020-11-19 16:14:58,wahoo,Zwift - OH MY CRIT! - The Double Race 1/2 (A),"Infocrank (Primary, to Zwift)","Kickr v5 (Secondary, to BOLT)",435,422,13
73069,311597,2020-11-19 17:04:59,wahoo,Zwift - OH MY CRIT! - The Double Race 2/2 (A),"Infocrank (Primary, to Zwift)","Kickr v5 (Secondary, to BOLT)",399,390,9
74359,311597,2020-11-22 18:32:15,wahoo,Zwift Academy Road: Workout 2 | Sprint Profile,"Infocrank (Primary, to Zwift)","Kickr v5 (Secondary, to BOLT)",346,338,8
74444,311597,2020-11-23 08:29:57,wahoo,Zwift - France,"Infocrank (Secondary, to Bolt)","Kickr v5 (Primary, to Zwift)",273,263,10
74740,311597,2020-11-23 20:00:01,wahoo,Zwift - Premier Division // Zwift Racing League (men) (A),"Infocrank (Secondary, to Bolt)","Kickr v5 (Primary, to Zwift)",460,449,11
76178,311597,2020-11-26 18:11:59,wahoo,Zwift - WTRL NOPINZ WORLD TTT CHAMPIONSHIPS - Zone 4 (C),"Infocrank (Secondary, to Bolt)","Kickr v5 (Primary, to Zwift)",458,452,6
77743,311597,2020-11-30 19:14:53,wahoo,Zwift - Premier Division // Zwift Racing League (men) (A),"Infocrank (Secondary, to Bolt)","Kickr v5 (Primary, to Zwift)",446,439,7
87883,311597,2020-12-27 14:14:58,wahoo,Zwift - KISS 100 Race Series - Americas (A),"Infocrank (Primary, to Zwift)","Kickr v5 (Secondary, to BOLT)",393,385,8
88677,311597,2020-12-28 07:56:59,wahoo,Zwift - Sprint!,"Infocrank (Primary, to Zwift)","Kickr v5 (Secondary, to BOLT)",351,342,9
89834,311597,2021-01-01 16:09:04,wahoo,Zwift - Absa Cape Epic Workout 4,"Infocrank (Primary, to Zwift)","Kickr v5 (Secondary, to ROAM)",415,405,10
90586,311597,2021-01-03 09:00:26,wahoo,Zwift - Zwift Fondo Series 2020/21 (A),"Infocrank (Primary, to Zwift)","Kickr v5 (Secondary, to ROAM)",419,412,7
91095,311597,2021-01-04 08:01:13,wahoo,Zwift - Absa Cape Epic Workout 5,"Infocrank (Primary, to Zwift)","Kickr v5 (Secondary, to ROAM)",419,414,5
94535,311597,2021-01-10 17:31:25,wahoo,Cadence Crusher,"Infocrank (Secondary, to Roam)","Kickr v5 (Primary, to Zwift)",377,374,3
94979,311597,2021-01-11 19:15:01,wahoo,Zwift - Premier Division // Zwift Racing League (men) (A),"Infocrank (Secondary, to Roam)","Kickr v5 (Primary, to Zwift)",402,389,13
96337,311597,2021-01-13 07:27:45,wahoo,Zwift - Absa Cape Epic Workout 7,"Infocrank (Primary, to Zwift)","Kickr v5 (Secondary, to ROAM)",437,425,12
99233,311597,2021-01-18 19:58:29,wahoo,Zwift - Premier Division // Zwift Racing League (men) (A),"Infocrank (Secondary, to Roam)","Kickr v5 (Primary, to Zwift)",449,438,11
100134,311597,2021-01-20 10:45:00,wahoo,Zwift - The Morning Grind by STPC (A),"Infocrank (Secondary, to Roam)","Kickr v5 (Primary, to Zwift)",476,467,9
102969,311597,2021-01-25 19:04:06,wahoo,Zwift - Premier Division // Zwift Racing League (men) (A),"Infocrank (Secondary, to Roam)","Kickr v5 (Primary, to Zwift)",480,463,17
104703,311597,2021-01-28 18:15:16,wahoo,Zwift - Vienna,"Infocrank (Secondary, to Roam)","Kickr v5 (Primary, to Zwift)",429,422,7
106337,311597,2021-01-31 17:02:21,wahoo,Zwift - PRE-Race,"Infocrank (Secondary, to Roam)","Kickr v5 (Primary, to Zwift)",382,373,9
106899,311597,2021-02-01 20:06:55,wahoo,Zwift - Premier Division // Zwift Racing League (men) (A),"Infocrank (Secondary, to Roam)","Kickr v5 (Primary, to Zwift)",421,408,13
107956,311597,2021-02-03 10:45:01,wahoo,Zwift - The Morning Grind by STPC (A),"Infocrank (Secondary, to Roam)","Kickr v5 (Primary, to Zwift)",406,397,9
111072,311597,2021-02-08 19:24:36,wahoo,Zwift - Premier Division // Zwift Racing League (men) (A),"Infocrank (Secondary, to Roam)","Kickr v5 (Primary, to Zwift)",472,460,12
111241,311597,2021-02-07 16:05:04,wahoo,Zwift - 3R Tick Tock Flat Race - 1 Lap (19km/11.8mi 50m) (A),"Infocrank (Secondary, to Roam)","Kickr v5 (Primary, to Zwift)",418,409,9
112092,311597,2021-02-10 10:45:00,wahoo,Zwift - The Morning Grind by STPC (A),"Infocrank (Primary, to Zwift)","Kickr (Secondary, to Roam)",486,471,15
112676,311597,2021-02-11 08:16:43,wahoo,Pacerbot Amelia,"Infocrank (Primary, to Zwift)","Kickr (Secondary, to Roam)",294,285,9
114906,311597,2021-02-14 17:02:34,wahoo,Zwift Academy 2019 Semi-Finals Workout #2: Phosphate Sprints,"Infocrank (Secondary, to Roam)","Kickr v5 (Primary, to Zwift)",397,393,4
115394,311597,2021-02-15 20:01:58,wahoo,Zwift - Premier Division // Zwift Racing League (men) (A),"Infocrank (Secondary, to Roam)","Kickr v5 (Primary, to Zwift)",470,459,11
116419,311597,2021-02-17 10:44:46,wahoo,Zwift - The Morning Grind by STPC (A),"Infocrank (Secondary, to Roam)","Kickr v5 (Primary, to Zwift)",446,440,6
118913,311597,2021-02-22 08:42:30,wahoo,Zwift - Pre-Race ride,"Infocrank (Secondary, to Roam)","Kickr v5 (Primary, to Zwift)",402,390,12
119117,311597,2021-02-22 19:09:56,wahoo,Zwift - Premier Division // Zwift Racing League (men) (A),"Infocrank (Secondary, to Roam)","Kickr v5 (Primary, to Zwift)",424,410,14
122638,311597,2021-03-01 20:21:55,wahoo,Zwift - Premier Division // Zwift Racing League (men) (A),"Infocrank (Secondary, to Roam)","Kickr v5 (Primary, to Zwift)",455,443,12
127358,311597,2021-03-11 16:14:54,wahoo,Zwift - OH MY CRIT!! - The Double Race 1/2 (A),"Infocrank (Secondary, to Roam)","Kickr v5 (Primary, to Zwift)",437,432,5
127360,311597,2021-03-11 17:04:58,wahoo,Zwift - OH MY CRIT!! - The Double Race 2/2 (A),"Infocrank (Secondary, to Roam)","Kickr v5 (Primary, to Zwift)",410,392,18
128477,311597,2021-03-14 14:15:00,wahoo,Zwift - KISS 100 Race Series (Americas) (A),"Infocrank (Primary, to Zwift)","Kickr (Secondary, to Roam)",425,418,7
129286,311597,2021-03-16 18:29:55,wahoo,Zwift - CeramicSpeed Race Series: Open Race (A),"Infocrank (Secondary, to Roam)","Kickr v5 (Primary, to Zwift)",475,464,11
126437,312328,2021-03-10 10:50:23,wahoo,Zwift - KISS at Base Training Ride (B),rotor inspider,wahoo kicker core,220,221,-1
129569,312328,2021-03-17 11:18:28,wahoo,Zwift - Innsbruck,rotor inspider,wahoo kicker core,295,296,-1
16506,313243,2020-03-02 18:14:49,wahoo,"Zwift - DBR Winter Cup (A) #6 4,4 W/kg avg 350 w avg 1. time QuarQ Power!!! Great",Quarq Power meter,Wahoo Kickr 2019,421,403,18
17397,313243,2020-03-09 18:14:56,wahoo,"Zwift - DBR Winter Cup (A) #2 Only one step more. 328 W/avg 4,1 W/kg avg",Quarq Power meter ,Wahoo Kickr 2019,419,438,-19
17702,313243,2020-03-11 19:04:59,wahoo,"Zwift - DBR Winter Cup (A) #5 338 W Avg 4,2 W/kg avg #1 DBR Winter cup overall...",Quarq Power meter ,Wahoo Kickr 2019,438,455,-17
18465,313243,2020-03-17 19:14:57,wahoo,Zwift - Feltet.dk Race Series (A) FTP Test??? first team race. Tough,Quarq Power meter ,Wahoo Kickr 2019,389,409,-20
18737,313243,2020-03-19 19:00:01,wahoo,"Zwift - KALAS Cup - Round 8 (A) #12 Strong riders... 4,6 W/kg avg Tough with tv time",Quarq Power meter ,Wahoo Kickr 2019,409,425,-16
18981,313243,2020-03-21 09:29:56,wahoo,"Zwift - DBR Saturday Race (A) #15 ZP Bennett,Meintjes & Cort Sandwich",Quarq Power meter ,Wahoo Kickr 2019,410,428,-18
19318,313243,2020-03-23 18:14:52,wahoo,Zwift - DBR Monday Race (A) #4 Race... ,Quarq Power meter ,Wahoo Kickr 2019,435,447,-12
19618,313243,2020-03-25 19:04:53,wahoo,Zwift - DBR Wednesday Race (A) #2 Long sprint,Quarq Power meter ,Wahoo Kickr 2019,414,430,-16
20615,313243,2020-03-28 09:29:59,wahoo,Zwift - DBR Saturday Race (A) Small dropouts every 500m... Draft issues???,Quarq Power meter ,Wahoo Kickr 2019,428,447,-19
20654,313243,2020-03-30 17:15:00,wahoo,Zwift - DBR Monday Race (A) #5 368 W Avg ,Quarq Power meter ,Wahoo Kickr 2019,387,407,-20
21949,313243,2020-04-04 08:30:02,wahoo,Zwift - DBR Sufferday League (A) #27 Event Suffer,Quarq Power meter ,Wahoo Kickr 2019,388,405,-17
22587,313243,2020-04-06 17:14:59,wahoo,Zwift - DBR Wahoo League (A) #7 Sprint finish,Quarq Power meter,Wahoo Kickr,442,425,17
23051,313243,2020-04-08 18:04:56,wahoo,Zwift - DBR Sprinthooligan Cup (A) Points race #17,Quarq Power meter,Wahoo Kickr,425,422,3
23675,313243,2020-04-11 08:29:54,wahoo,"Zwift - DBR Sufferday League (A) Legs felt tired. 4,3 W/kg avg",Quarq Power meter,Wahoo Kickr,382,379,3
24283,313243,2020-04-13 17:14:54,wahoo,"Zwift - DBR Wahoo League (A) #4 Sprint finish 4,4 W/kg avg",Quarq Power meter,Wahoo Kickr,423,402,21
24963,313243,2020-04-15 18:04:59,wahoo,"Zwift - DBR Sprinthooligan Cup (A) #19 No sleep, no gain",Quarq Power meter,Wahoo Kickr,396,379,17
26534,313243,2020-04-20 17:14:54,wahoo,Zwift - DBR Wahoo League (A) #8 ZP Hard that Box... ,Quarq Power meter,Wahoo Kickr,456,441,15
28461,313243,2020-04-27 17:15:00,wahoo,Zwift - DBR Wahoo League (A) #16 Legs wont listen... Shut up they said... go too hell they said. :_),Quarq Power meter,Wahoo Kickr,421,400,21
29147,313243,2020-04-29 18:04:59,wahoo,Zwift - DBR Sprinthooligan Cup (A) #2 Sprint is getting better,Quarq Power meter,Wahoo Kickr,410,397,13
30415,313243,2020-05-02 08:29:59,wahoo,Zwift - DBR Sufferday League (A) #46 ZP Get some sleep now,Quarq Power meter,Wahoo Kickr,431,414,17
31292,313243,2020-05-04 17:14:56,wahoo,Zwift - DBR Wahoo League (A) #12 Pace-Pace-Pace...,Quarq Power meter,Wahoo Kickr,425,407,18
31704,313243,2020-05-05 18:14:54,wahoo,Zwift - UNO X CUP powered by DCU & Feltet.dk (A) #38 Trying to keep up with the Elite,Quarq Power meter,Wahoo Kickr,434,419,15
32578,313243,2020-05-07 18:16:59,wahoo,Zwift - WTRL Team Time Trial (C) F...... Crazy Guys,Quarq Power meter,Wahoo Kickr,384,374,10
33649,313243,2020-05-11 17:14:57,wahoo,Zwift - DBR Wahoo League (A) #18 Get the legs spinning...,Quarq Power meter,Wahoo Kickr,400,373,27
34098,313243,2020-05-12 18:14:55,wahoo,Zwift - UNO X CUP powered by DCU & Feltet.dk (A),Quarq Power meter,Wahoo Kickr,416,403,13
38952,313243,2020-06-01 17:14:52,wahoo,Zwift - DBR Wahoo League (A) #14 That hurt...,Quarq Power meter,Wahoo Kickr,431,419,12
39435,313243,2020-06-03 18:04:56,wahoo,Zwift - DBR Boerkop Cykler Cup (A) #4 ,Quarq Power meter,Wahoo Kickr,405,385,20
40394,313243,2020-06-08 17:14:55,wahoo,Zwift - DBR Wahoo League (A) #3 Birthday Podium,Quarq Power meter,Wahoo Kickr,453,440,13
40395,313243,2020-06-08 18:19:55,wahoo,Zwift - TFC Mad Monday Series (3 of 6) (A) Spinout ;-),Quarq Power meter,Wahoo Kickr,370,363,7
53759,313243,2020-09-07 17:14:54,wahoo,Zwift - DBR Ride´N´Roll League (A) #15 3 days off racing. Training tomorrow only... ,Quarq Power meter,Wahoo Kickr,438,420,18
54223,313243,2020-09-09 18:04:53,wahoo,Zwift - DBR Wednesday Race (A) #10 ,Quarq Power meter ,Wahoo Kickr 2019,391,391,0
55069,313243,2020-09-14 17:58:58,wahoo,Zwift - Invitational League // Qualifying Race #1 #81st postion Hard as F...,Quarq Power meter ,Wahoo Kickr 2019,434,407,27
57044,313243,2020-09-23 18:04:54,wahoo,Zwift - DBR Wednesday Race (A),Quarq Power meter,Wahoo Kickr,415,396,19
58539,313243,2020-09-30 18:05:05,wahoo,Zwift - DBR Wednesday Race (A) #2 Sprinter??? I think so,Quarq Power meter,Wahoo Kickr,390,373,17
60120,313243,2020-10-07 18:04:54,wahoo,Zwift - DBR HEINO CUP III (A),Quarq Power meter,Wahoo Kickr,383,364,19
113031,313243,2021-02-11 18:29:49,wahoo,Zwift - FUSION WINTER CUP (A),Quarq Power meter ,Kickr V5 loan,411,396,15
30853,315856,2020-05-03 07:25:34,neo,Zwift - ZTS x Paceheads | Etappe II Greatest London Loop (26.2km/360hm) (A),Garmin Vector 3,TACX Neo,440,432,8
32061,315856,2020-05-06 15:28:45,neo,Zwift - FAT-MAX!,Garmin Vector 3 - Garmin Edge 1030,TACX Neo - Zwift,376,364,12
115589,317060,2021-02-15 16:20:02,wahoo,Zwift - Macro to Micro,Favero Assioma Duo ,Wahoo Kickr Core,247,255,-8
116438,317060,2021-02-16 19:13:02,wahoo,Zwift - Zwift Racing League | WTRL - Women&#039;s EMEA W1 DIVISION 1 (A),2021-02-16-191302-ELEMNT ROAM 17DD-147-0,Wahoo Kickr Core,304,314,-10
116442,317060,2021-02-16 19:13:02,wahoo,Zwift - Zwift Racing League | WTRL - Women&#039;s EMEA W1 DIVISION 1 (A),Favero Assioma Duo ,Wahoo Kickr Core,304,314,-10
119763,317060,2021-02-23 19:13:15,wahoo,Zwift - Zwift Racing League | WTRL - Women&#039;s EMEA W1 DIVISION 1 (A),Favero Assioma Duo ,Wahoo Kickr Core,318,321,-3
67748,319770,2020-11-03 22:33:52,wahoo,kickr / p2m,p2m,kickr,278,281,-3
68793,319770,2020-11-07 15:12:14,wahoo,kickr / p2m s6,p2m s6,kickr,261,262,-1
68905,319770,2020-11-07 20:43:23,wahoo,kickr (zwift) / p2m s6,p2m s6,kickr (zwift),329,341,-12
69348,319770,2020-11-09 13:44:10,wahoo,kickr / p2m TT,p2m TT,kickr,256,250,6
74836,320052,2020-11-23 18:53:00,wahoo,ZPL Round 7 - With the 3R Girls,Garmin 800/Power Tap,Wahoo Kickr Core,230,227,3
95884,320052,2021-01-12 19:14:46,wahoo,ZRL with R3R All Saints,Garmin 800/Power Tap,Wahoo Kickr Core,262,250,12
99888,320052,2021-01-19 19:13:59,wahoo,ZRL WTRL TTT - with R3R All Saints - Absolutely loved it :0),Garmin 800/Power Tap,Wahoo Kickr Core,231,230,1
104041,320052,2021-01-26 19:13:56,wahoo,ZRL with the superb 3R All Saints,Garmin 800/Power Tap,Wahoo Kickr Core,248,249,-1
119831,320052,2021-02-23 19:14:00,wahoo,ZRL with the 3R All Saints,Garmin 800/Power Tap,Wahoo Kickr Core,241,239,2
124247,320052,2021-03-04 18:18:19,wahoo,WTRL Team Time Trial - with the 3R Lunachicks,Garmin 800/Power Tap,Wahoo Kickr Core,229,228,1
127237,320052,2021-03-11 19:15:00,wahoo,WTRL TTT - with the 3R Lunachicks,Garmin 800/Power Tap,Wahoo Kickr Core,227,228,-1
122815,323424,2021-03-02 12:04:57,wahoo,Zwift - 3R Gotham Grind Flat Race - 2 Laps (18.5km/11.6mi 58m) (A),Garmin Vector 3,Wahoo Kickr,351,352,-1
32658,323690,2020-05-07 18:59:50,wahoo,Zwift - KISS at Race - EU PM (A),SRM X-Power,KICKR,304,313,-9
33792,323690,2020-05-11 17:29:51,wahoo,Zwift - Tour for All 2020: Stage 2 Longer Ride with Alexis Ryan,SRM X-Power,KICKR,300,323,-23
55215,323690,2020-09-14 17:59:53,neo,Zwift - Invitational League // Qualifying Race #1,Quarq DZero,Tacx Neo,332,330,2
15043,324062,2020-02-21 13:29:57,wahoo,Zwift - Tour of Innsbruck // Stage 1,V3 Pedals,Kickr,341,350,-9
15413,324062,2020-02-24 09:53:51,wahoo,Zwift - ANA + VO2,V3 Pedals,Kickr,285,302,-17
15532,324062,2020-02-25 10:29:47,wahoo,Zwift - ZHR Masters (C),V3 Pedals,Kickr,354,359,-5
15533,324062,2020-02-25 09:49:03,wahoo,Zwift - London,V3 Pedals,Kickr,223,223,0
17639,324062,2020-03-11 10:46:55,wahoo,PM calibration,V3 Pedals,Kickr,189,186,3
17871,324062,2020-03-12 18:47:16,wahoo,Zwift - Tour of Watopia Pro-Am Men&#039;s Race #1 (A),V3 Pedals,Kickr,379,380,-1
18681,324062,2020-03-19 15:32:02,wahoo,Zwift - NYC,V3 Pedals,Kickr,194,193,1
18898,324062,2020-03-20 19:13:01,wahoo,Zwift - Tour of Watopia Pro-Am Men&#039;s Race #2 (A),V3 Pedals,Kickr,393,394,-1
23176,324062,2020-04-09 08:01:29,wahoo,Zwift - Cervelo Jungle Rush Series Rd 3 - Cervelo R5 (A),V3 Pedals,Kickr,152,155,-3
23455,324062,2020-04-09 18:09:37,wahoo,Zwift - London International // Zwift Classic (A),V3 Pedals,Kickr,373,376,-3
23456,324062,2020-04-09 18:09:37,wahoo,Zwift - London International // Zwift Classic (A),V3 Pedals,Kickr,372,376,-4
28131,324062,2020-04-25 18:09:08,wahoo,Zwift - Crit City Slam // Zwift Classic (A),V3 Pedals,Kickr,357,363,-6
28132,324062,2020-04-25 18:09:08,wahoo,Zwift - Crit City Slam // Zwift Classic (A),V3 Pedals,Kickr,355,368,-13
33088,324062,2020-05-05 09:30:15,wahoo,Zwift - Watopia,V3 Pedals,Kickr,368,377,-9
75935,324062,2020-11-26 15:40:19,wahoo,Zwift - ZA Tri: TT Race - 40k ,V3 Pedals,Kickr 2018,333,351,-18
76481,324062,2020-11-27 14:59:59,wahoo,Zwift - Focus: Colours of PARI - Shorter Ride,V3 Pedals,Kickr 2018,250,257,-7
77034,324062,2020-11-28 14:59:46,wahoo,Zwift - Focus: Colours of PARI - Shorter Ride,V3 Pedals,Kickr 2018,319,315,4
77588,324062,2020-11-30 13:34:31,wahoo,Zwift - Crit City Race (A),V3 Pedals (Ult),Kickr 2018,305,307,-2
34155,324901,2020-05-12 22:59:38,wahoo,Zwift - Tour for All 2020: Stage 3 Longer Ride with Masafumi NISHITANI,Rotor 2-InPower,Wahoo KICKR,242,246,-4
43547,324901,2020-06-25 12:25:17,wahoo,Zwift - EMU Japan Race (B),Rotor 2-InPower,Wahoo KICKR,318,310,8
44629,324901,2020-07-03 01:38:19,wahoo,Zwift - WTRL TTT (Frappe),Rotor 2-InPower,Wahoo KICKR,326,322,4
45604,324901,2020-07-09 12:25:16,wahoo,Zwift - EMU Japan Race (B),Rotor 2-InPower,Wahoo KICKR,319,317,2
45861,324901,2020-07-11 05:01:02,wahoo,Zwift - L&#039;Etape du Tour Stage 2 - Open,Rotor 2-InPower,Wahoo KICKR,288,283,5
127338,324901,2021-03-12 05:31:44,wahoo,Zwift - EVO CC Vortex Interval Ride [~3-3.8w/kg avg] (B),SRAM RED AXS POWER METER KIT,Wahoo KICKR,300,298,2
34314,324947,2020-05-06 17:59:37,neo,USA Cycling Race League p/b Saris+ThePro&#039;sCloset  (A),Zwift,Taxc Neo ,260,261,-1
34471,324947,2020-05-13 17:59:40,neo,USA Cycling Race League by Indoor specialist (A),Assioma Favero,Taxc Neo ,252,251,1
35079,324947,2020-05-15 15:40:04,neo,Zwift - Zada test 1,Assioma Favero and Garmin 1030,Taxc Neo,258,262,-4
37241,324947,2020-05-23 17:59:49,neo,Zwift - WOMEN&#039;S TOUR OF THE GILA STAGE 2 CIRCUIT RACE (A),Assioma Favero,Taxc Neo ,251,255,-4
37465,324947,2020-05-24 17:59:28,neo,Zwift - WOMEN&#039;S TOUR OF THE GILA STAGE 3 EPIC QOM QUEEN STAGE (A),Assioma Favero,Taxc Neo ,244,247,-3
37841,324947,2020-05-26 18:16:39,neo,Zwift - Tour for All Invitational Race // Women (A),Assioma Favero and Garmin 1030,Taxc Neo ,273,269,4
53301,324947,2020-09-03 17:28:33,neo,Zwift - Vienna,Assioma Favero and Garmin 1030,Taxc Neo ,251,244,7
61629,324947,2020-10-13 18:14:36,wahoo,Zwift - Zwift Racing League | WTRL,Assioma Favero,Wahoo Kickr,272,268,4
72956,324947,2020-11-17 19:26:05,wahoo,Zwift - Zwift Racing League | WTRL - Women&#039;s EMEA W1 DIVISION 1 (A),Assioma Favero,Wahoo Kickr,243,245,-2
75830,324947,2020-11-24 19:15:18,wahoo,Zwift - Zwift Racing League | WTRL - Women&#039;s EMEA W1 DIVISION 1,Assioma Favero,Wahoo Kickr,268,270,-2
76009,324947,2020-11-26 18:21:59,wahoo,Zwift - WTRL NOPINZ WORLD TTT CHAMPIONSHIPS - Zone 5 (E),Assioma Favero,Wahoo Kickr,272,267,5
82561,324947,2020-12-12 19:22:11,wahoo,Zwift - Fearless Women&#039;s Team Championships - 2020 (A),Assioma Favero,Wahoo Kickr,265,260,5
88622,324947,2020-12-29 13:43:47,wahoo,Zwift - Watopia - ZADA,Assioma Favero and Garmin 1030,Wahoo Kickr,265,260,5
95132,324947,2021-01-11 20:06:06,wahoo,Zwift - Premier Division // Zwift Racing League (women) (A),Favero Assioma DUO,Wahoo Kickr,286,280,6
99054,324947,2021-01-18 19:08:31,wahoo,Zwift - Premier Division // Zwift Racing League (women) (A),Favero Assioma DUO,Wahoo Kickr,256,257,-1
103031,324947,2021-01-25 20:04:06,wahoo,Zwift - Premier Division // Zwift Racing League (women) (A),Assioma Favero and Garmin 1030,Wahoo Kickr,268,272,-4
106778,324947,2021-02-01 19:02:59,wahoo,Zwift - Premier Division // Zwift Racing League (women) (A),Assioma Favero and Garmin 1030,Wahoo Kickr,279,269,10
111109,324947,2021-02-08 19:54:06,wahoo,Zwift - Premier Division // Zwift Racing League (women) (A),Assioma Favero and Garmin 1030,Wahoo Kickr,274,274,0
115255,324947,2021-02-15 19:02:59,wahoo,Zwift - Premier Division // Zwift Racing League (women) (A),Assioma Favero and Garmin 1030,Wahoo Kickr,271,268,3
119187,324947,2021-02-22 19:58:59,wahoo,Zwift - Premier Division // Zwift Racing League (women) (A),Assioma Favero and Garmin 1030,Wahoo Kickr,286,286,0
122449,324947,2021-03-01 19:18:22,wahoo,Zwift - Premier Division // Zwift Racing League (women) (A),Assioma Favero and Garmin 1030,Wahoo Kickr,252,252,0
92279,325006,2021-01-06 09:58:03,wahoo,Zwift - EVR Definitely Not the WTNC (A),Quarq dFour AXS1 to Zwift,Wahoo KickrV5 to Edge1030,460,448,12
108846,325006,2021-02-04 09:14:02,wahoo,Zwift - Ramp Test 20w/3min,Quarq dFour AXS1 to Edge 1030,Wahoo Kickr V5 to Zwift,469,453,16
109360,325006,2021-02-05 09:17:43,wahoo,Zwift - Ramp Test 20w/1min,Quarq dFour AXS1 to Edge 1030,Wahoo Kickr V5 to Zwift,492,481,11
69877,326478,2020-11-10 17:26:13,wahoo,Zwift - SZR Funride (C),Favero Assioma,KICKR Core,340,353,-13
72311,326478,2020-11-17 18:29:38,wahoo,Zwift - Jenson Button & Leger Social Ride (C) - KICKR Core ANT+ calibration app,Favero Assioma Duo,KICKR Core,286,294,-8
72380,326478,2020-11-17 18:29:38,wahoo,Favero Assioma Duo,Favero Assioma Duo,KICKR Core,286,294,-8
73207,326478,2020-11-19 17:58:44,wahoo,Zwift - Hudik Triathlon Time Trial,Favero Assioma Duo,KICKR Core,342,347,-5
90633,326478,2021-01-03 08:59:33,wahoo,Zwift - Zwift Fondo Series 2020/21 (A),Favero Assioma Duo,KICKR Core,313,313,0
92977,326478,2021-01-07 17:29:56,wahoo,Zwift - ZHQ FutureWorks Circuit Race - Anti-sandbagging (A),Favero Assioma Duo,KICKR Core,334,338,-4
97115,326478,2021-01-14 18:19:17,wahoo,Zwift - WTRL Team Time Trial - Zone 5 (C),Favero Assioma Duo,KICKR Core,343,340,3
99758,326478,2021-01-19 18:27:03,wahoo,Zwift - Zwift Racing League | WTRL - Men&#039;s/Mixed EMEA E2 DIVISION 4 (A),Favero Assioma Duo,KICKR Core,323,330,-7
101136,326478,2021-01-21 18:12:01,wahoo,Zwift - Espresso,Favero Assioma Duo,KICKR Core,314,318,-4
103565,326478,2021-01-26 18:03:37,wahoo,Zwift - Zwift Racing League | WTRL - Men&#039;s/Mixed EMEA E2 DIVISION 4 (A),Favero Assioma Duo,KICKR Core,351,351,0
107599,326478,2021-02-02 18:26:26,wahoo,Zwift - Zwift Racing League | WTRL - Men&#039;s/Mixed EMEA E2 DIVISION 4 (A),2021-02-02-182626-ELEMNT BOLT 8D4E-532-0,KICKR Core,342,352,-10
109069,326478,2021-02-04 17:44:45,wahoo,Zwift - Jörg Linke#TEAMSHIMANO&#039;s Meetup - Lutece Express,2021-02-04-174445-ELEMNT BOLT 8D4E-534-0,KICKR Core,320,332,-12
110532,326478,2021-02-07 14:31:16,wahoo,Zwift - Zwift Fondo Series: Medio Fondo,Favero Assioma Duo,KICKR Core,325,335,-10
113137,326478,2021-02-11 17:45:01,wahoo,Zwift - Jörg Linke#TEAMSHIMANO&#039;s Meetup - 2015 UCI Worlds Course,Favero Assioma Duo,KICKR Core,319,329,-10
113628,326478,2021-02-12 18:36:38,wahoo,Zwift - Team CLS Racing - Hills &#039;n&#039; Thrills S5 (E),Favero Assioma Duo,KICKR Core,342,354,-12
116000,326478,2021-02-16 18:26:49,wahoo,Zwift - Zwift Racing League | WTRL - Men&#039;s/Mixed EMEA E2 DIVISION 4 (A),Favero Assioma Duo,KICKR Core,352,368,-16
117433,326478,2021-02-18 17:56:51,wahoo,Zwift - Jörg Linke#TEAMSHIMANO&#039;s Meetup - 2018 UCI Worlds Short Lap,Favero Assioma Duo,KICKR Core,284,298,-14
117984,326478,2021-02-19 18:49:59,wahoo,Zwift - Team CLS Racing - Hills &#039;n&#039; Thrills S5 (E),Favero Assioma Duo,KICKR Core,379,385,-6
125352,326478,2021-03-07 09:59:58,wahoo,Zwift - Climbers Day p/b dPAC.fit & Precision Hydration (A),Favero Assioma Duo,KICKR Core,323,332,-9
127246,326478,2021-03-11 18:00:12,wahoo,Zwift - Renegade Race (A),Favero Assioma Duo,KICKR Core,336,344,-8
128388,326478,2021-03-14 12:09:59,wahoo,Zwift - The BMTR Fundo (A),Favero Assioma Duo,KICKR Core,348,362,-14
129374,326478,2021-03-16 17:25:38,wahoo,Zwift - Mario Serratore///PCA&#039;s Meetup - Tick Tock,Favero Assioma Duo,KICKR Core,279,286,-7
129800,326478,2021-03-17 18:34:58,wahoo,Zwift - BRT Time Trial League (A),Favero Assioma Duo,KICKR Core,359,380,-21
8099,326788,2020-01-04 21:10:08,wahoo,Zwift - 3R Gotham Grind Flat Race - 3 Laps (27.8km/17.4mi 87m) (A),Stages left side ,Kickr,390,406,-16
23194,326788,2020-04-09 09:44:58,wahoo,Zwift - Koa Sports League Race,Stages left side ,Kickr,377,390,-13
24809,326788,2020-04-15 09:44:59,wahoo,Zwift - USA Cycling Race League by Indoor Specialist  (A),Stages,Kickr,372,386,-14
27206,326788,2020-04-23 09:44:57,wahoo,Zwift - Koa Sports League Race (A),Stages,Kickr,325,356,-31
32319,326788,2020-05-07 09:44:57,wahoo,Zwift - Koa Sports League Race (A),Stages,Kickr,405,405,0
35616,326788,2020-05-17 11:04:58,wahoo,Zwift - 3R Innsbruckring Sprint Race - 1 Lap (8.8km/5.5mi 77m) (A),Stages left side ,Kickr,413,416,-3
43518,326788,2020-06-25 09:59:57,wahoo,Zwift - Koa Sports League Race (A),Stages,Kickr,390,391,-1
47802,326788,2020-07-27 01:04:57,wahoo,Zwift - 3R Watopia Flat Route Race - 2 Laps (20.5km/12.7mi 108m) (A),Giant PowerPro ,Kickr,362,393,-31
47919,326788,2020-07-28 01:00:13,wahoo,Zwift - Norseman Festival of Climbing: Ride #1 (E),Giant PowerPro ,Kickr,334,331,3
48268,326788,2020-07-30 09:59:56,wahoo,Zwift - Koa Sports League Race (A),Giant PowerPro ,Kickr,370,380,-10
49026,326788,2020-08-06 09:59:56,wahoo,Zwift - Koa Sports League Race (A),Giant PowerPro ,Kickr,389,399,-10
52860,326788,2020-09-01 09:59:56,wahoo,Zwift - KISS at Race - Americas AM (A),Giant PowerPro ,Kickr,372,386,-14
58044,326788,2020-09-28 14:30:59,wahoo,Zwift - France,Giant PowerPro ,Kickr,275,282,-7
58196,326788,2020-09-29 10:00:18,wahoo,Zwift - KISS at Race - Americas AM (A),Giant PowerPro ,Kickr,358,363,-5
62404,326788,2020-10-16 10:04:56,wahoo,Zwift - 3R Innsbruckring Flat Race - 4 Laps (35.2km/21.9mi 308m) (A),Giant PowerPro ,Kickr,368,351,17
65993,326788,2020-10-29 09:59:57,wahoo,Zwift - KISS at Race - Americas AM (A),Giant PowerPro ,Kickr,390,389,1
68363,326788,2020-11-05 01:45:12,wahoo,Zwift - USA Cycling Race League by Indoor Specialist (A),Giant PowerPro ,Kickr,384,387,-3
68584,326788,2020-11-06 19:00:45,wahoo,Zwift -  Tour De Spartacus  (A),Giant PowerPro ,Kickr,385,376,9
68855,326788,2020-11-07 18:59:57,wahoo,Zwift -  Tour De Spartacus  (A),Giant PowerPro ,Kickr,361,354,7
69187,326788,2020-11-08 18:59:59,wahoo,Zwift -  Tour De Spartacus  (A) ELEMNT died on lap two...,Giant PowerPro ,Kickr,408,406,2
78821,326788,2020-12-03 10:29:23,wahoo,Zwift - WTRL Team Time Trial - Zone 2 (C),Giant PowerPro ,Kickr,369,358,11
84201,326788,2020-12-17 10:39:02,wahoo,Zwift - WTRL Team Time Trial - Zone 2 (D),Giant PowerPro ,Kickr,337,328,9
86017,326788,2020-12-22 10:50:02,wahoo,Zwift - SZR Lunch Race (A),Giant PowerPro ,Kickr,370,369,1
32964,327750,2020-05-09 11:08:52,wahoo,Zwift - DIRT Dadurday Chase Race  (A),garmin vector 3&#039;s dual side ,wahoo kickr core,342,346,-4
35838,329169,2020-05-18 17:30:44,neo,Zwift - Fast &#039;n&#039; Furious Team CLS Racing S5 (C),4iii crank5,tacx neo,263,263,0
35840,329169,2020-05-18 17:30:44,neo,Zwift - Fast &#039;n&#039; Furious Team CLS Racing S5 (C),4iii crank,tacx neo,263,263,0
78758,331284,2020-12-02 15:39:18,wahoo,Zwift - Fill in the blanks,Zwift/ Garmin,Kickr,273,285,-12
93134,331284,2021-01-08 03:06:58,wahoo,Zwift - Watopia,Vector,Kickr,291,264,27
98263,331284,2021-01-16 16:05:02,wahoo,Kickr / SRM,SRM,Kickr,409,411,-2
104139,331284,2021-01-27 16:29:59,wahoo,Zwift - ZHQ FutureWorks Crit City Race - Anti-sandbagging (A)aaaarrrrgggghhh,Zwift,Kickr,399,392,7
110475,331284,2021-02-06 15:25:00,wahoo,BRAC Race,SRM,Kickr,366,355,11
75135,335185,2020-11-23 23:05:33,wahoo,Zwift - Watopia,SRM,Kicker Core,169,161,8
75252,335185,2020-11-24 22:03:51,wahoo,Zwift - Zwift Time Trial Tuesday: Tempus Fugit (E),SRM,Kicker Core,395,390,5
49999,335467,2020-08-14 09:44:54,wahoo,Zwift - Off the MAAP Invitational Race // Stage 1 (Women) (A),Assioma Duo,WAHOO KICKR,223,222,1
50337,335467,2020-08-17 08:44:43,wahoo,Zwift - Off the MAAP Invitational Race // Stage 2 (Women) ,Assioma Duo,WAHOO KICKR,253,251,2
50886,335467,2020-08-20 09:30:00,wahoo,Zwift - Off the MAAP Invitational Race // Stage 3 (women) ,Assioma Duo,WAHOO KICKR,251,257,-6
40919,335605,2020-06-10 23:30:15,wahoo,Zwift - Austin Driveway Series Criterium (A),power2Max NG eco,Wahoo Kickr,301,310,-9
41364,335605,2020-06-13 08:30:14,wahoo,Zwift - DBR Saturday Race  (A),power2Max NG eco,Wahoo Kickr,275,290,-15
41916,335605,2020-06-16 09:09:57,wahoo,Zwift - SRAM Send it Series - Race 6 - Men&#039;s (E),power2Max NG eco,Wahoo Kickr,342,326,16
42132,335605,2020-06-17 09:45:09,wahoo,Zwift - USA Cycling Race League by Indoor Specialist (A),power2Max NG eco,Wahoo Kickr,304,320,-16
45591,335605,2020-07-09 10:34:56,wahoo,Zwift - Japan ZWIFT Hill Climb Race (A),power2Max NG eco,Wahoo Kickr,315,329,-14
46265,335605,2020-07-14 10:00:04,wahoo,Zwift - KISS at Race - Americas AM (A),power2Max NG eco,Wahoo Kickr,284,296,-12
46266,335605,2020-07-14 11:10:01,wahoo,Zwift - Japan Zwift Tuesday Race (A),power2Max NG eco,Wahoo Kickr,275,290,-15
46583,335605,2020-07-16 10:34:57,wahoo,Zwift - Japan ZWIFT Hill Climb Race (A),power2Max NG eco,Wahoo Kickr,314,319,-5
46812,335605,2020-07-18 08:29:54,wahoo,Zwift - DBR Saturday Race  (A),power2Max NG eco,Wahoo Kickr,306,308,-2
49654,335605,2020-08-12 04:04:41,wahoo,Zwift - 3R Watopia Flat Route Reverse Race - 3 Laps (30.8km/19.1mi 162m) (A),power2Max NG eco,Wahoo Kickr,278,288,-10
58716,335605,2020-10-01 10:35:13,wahoo,Zwift - Japan ZWIFT Hill Climb Race (A),power2Max NG eco,Wahoo Kickr,335,340,-5
64762,335605,2020-10-25 08:05:00,wahoo,Zwift - 3R Volcano Circuit - 6 Laps (A),power2Max NG eco,Wahoo Kickr,307,323,-16
65002,335605,2020-10-26 10:00:26,wahoo,Zwift - ZA Road 2020 - Segment Ride #1: Innsbruck Course,power2Max NG eco,Wahoo Kickr,316,324,-8
65346,335605,2020-10-27 09:59:47,wahoo,Zwift - KISS at Race - Americas AM (A),power2Max NG eco,Wahoo Kickr,340,353,-13
65990,335605,2020-10-29 10:00:03,wahoo,Zwift - KISS at Race - Americas AM (A),power2Max NG eco,Wahoo Kickr Core,346,357,-11
66524,335605,2020-10-30 22:10:25,wahoo,Zwift - ZA Road - Race #2 (A),power2Max NG eco,Wahoo Kickr Core,284,295,-11
67479,335605,2020-11-03 09:03:41,wahoo,Zwift - Zwift Racing League | WTRL - Men&#039;s APAC DIVISION 1 (A),power2Max NG eco,Wahoo Kickr Core,318,337,-19
67495,335605,2020-11-03 01:00:11,wahoo,Zwift - ZA Road 2020 - Segment Ride #1: Three Sisters Course,power2Max NG eco,Wahoo Kickr Core,312,327,-15
68113,335605,2020-11-04 10:45:14,wahoo,Zwift - USA Cycling Race League by Indoor Specialist (A),power2Max NG eco,Wahoo Kickr Core,308,329,-21
68787,335605,2020-11-07 01:30:19,wahoo,Zwift - TFC Autumn Race Series (A),power2Max NG eco,Wahoo Kickr Core,308,321,-13
68928,335605,2020-11-08 01:00:04,wahoo,Zwift - Road to Okinawa Race (A),power2Max NG eco,Wahoo Kickr Core,314,338,-24
69593,335605,2020-11-10 08:44:59,wahoo,Zwift - Zwift Racing League | WTRL - APAC (MEN) -  Division 1 (A),power2Max NG eco,Wahoo Kickr Core,343,368,-25
70165,335605,2020-11-11 10:45:13,wahoo,Zwift - USA Cycling Race League by Indoor Specialist (A),power2Max NG eco,Wahoo Kickr Core,314,340,-26
72101,335605,2020-11-17 10:59:50,wahoo,Zwift - KISS Race Series - Americas AM (A),power2Max NG eco,Wahoo Kickr Core,323,339,-16
72911,335605,2020-11-18 10:44:48,wahoo,Zwift - USA Cycling Race League by Indoor Specialist (A),power2Max NG eco,Wahoo Kickr Core,350,368,-18
72913,335605,2020-11-19 10:59:54,wahoo,Zwift - KISS Race Series - Americas AM (A),power2Max NG eco,Wahoo Kickr Core,317,345,-28
74875,335605,2020-11-24 08:45:13,wahoo,Zwift - Zwift Racing League | WTRL - Men&#039;s APAC DIVISION 1,power2Max NG eco,Wahoo Kickr Core,336,355,-19
75422,335605,2020-11-25 10:45:12,wahoo,Zwift - USA Cycling Race League by Indoor Specialist (A),power2Max NG eco,Wahoo Kickr Core,325,339,-14
77953,335605,2020-12-01 10:59:54,wahoo,Zwift - KISS Race Series - Americas AM (A),power2Max NG eco,Wahoo Kickr Core,301,320,-19
78439,335605,2020-12-02 10:45:04,wahoo,Zwift - USA Cycling Race League by Indoor Specialist (A),power2Max NG eco,Wahoo Kickr Core,296,313,-17
80673,335605,2020-12-03 10:59:45,wahoo,Zwift - KISS Race Series - Americas AM (A),power2Max NG eco,Wahoo Kickr Core,314,339,-25
80674,335605,2020-12-08 08:45:13,wahoo,Zwift - Zwift Racing League | WTRL - Men&#039;s APAC DIVISION 1 (A),power2Max NG eco,Wahoo Kickr Core,311,328,-17
85322,335605,2020-12-20 05:59:57,wahoo,Zwift - KISS 100 Race Series - EU (A),power2Max NG eco,Wahoo Kickr Core,296,317,-21
89279,335605,2020-12-31 06:43:59,wahoo,ZADA TEST - THREE SISTERS,power2Max NG eco,Wahoo Kickr Core,336,337,-1
89706,335605,2021-01-01 08:14:57,wahoo,Zwift - ZADA Test WahooKickrCore:Power2max - 1min,power2Max NG eco,Wahoo Kickr Core,220,225,-5
89707,335605,2021-01-01 08:30:51,wahoo,Zwift - ZADA Test WahooKickrCore:Power2max - 15sec,power2Max NG eco,Wahoo Kickr Core,151,154,-3
93576,335605,2021-01-08 22:04:56,wahoo,Zwift - 3R Volcano Flat 50k Race - 4 Laps (48.8km/30.7mi 184m) (A),power2Max NG eco,Wahoo Kickr Core,303,312,-9
94716,335605,2021-01-11 00:59:59,wahoo,Zwift - TDZ Stage 2: Longer Ride,power2Max NG eco,Wahoo Kickr Core,281,290,-9
94971,335605,2021-01-11 19:14:31,wahoo,Zwift - Premier Division // Zwift Racing League (men) (A),power2Max NG eco,Wahoo Kickr Core,319,313,6
96176,335605,2021-01-13 10:45:03,wahoo,Zwift - The Morning Grind by STPC (A),power2Max NG eco,Wahoo Kickr Core,281,296,-15
96808,335605,2021-01-14 12:24:49,wahoo,Zwift - EMU Japan Race (A),power2Max NG eco,Wahoo Kickr Core,281,294,-13
99222,335605,2021-01-18 19:52:48,wahoo,Zwift - Premier Division // Zwift Racing League (men) (A),power2Max NG eco,Wahoo Kickr Core,336,329,7
102987,335605,2021-01-25 19:04:22,wahoo,Zwift - Premier Division // Zwift Racing League (men) (A),power2Max NG eco,Wahoo Kickr Core,318,322,-4
103955,335605,2021-01-27 10:44:30,wahoo,Zwift - The Morning Grind by STPC (A),power2Max NG eco,Wahoo Kickr Core,347,354,-7
104478,335605,2021-01-28 10:59:35,wahoo,Zwift - KISS Race Series - Americas AM (A),power2Max NG eco,Wahoo Kickr Core,322,327,-5
105383,335605,2021-01-30 08:05:18,wahoo,Zwift - 3R Weekend Race Club - Race 1 (A),power2Max NG eco,Wahoo Kickr Core,309,309,0
106908,335605,2021-02-01 20:06:31,wahoo,Zwift - Premier Division // Zwift Racing League (men) (A),power2Max NG eco,Wahoo Kickr Core,321,328,-7
107954,335605,2021-02-03 10:44:55,wahoo,Zwift - The Morning Grind by STPC (A),power2Max NG eco,Wahoo Kickr Core,288,295,-7
109788,335605,2021-02-06 10:30:14,wahoo,Zwift - Zwift Fondo Series: Gran Fondo,power2Max NG eco,Wahoo Kickr Core,307,315,-8
111034,335605,2021-02-08 19:22:09,wahoo,Zwift - Premier Division // Zwift Racing League (men) (A),power2Max NG eco,Wahoo Kickr Core,332,332,0
113812,335605,2021-02-13 08:04:51,wahoo,Zwift - 3R Weekend Race Club - Race 1 (A),power2Max NG eco,Wahoo Kickr Core,285,296,-11
114504,335605,2021-02-14 05:59:45,wahoo,Zwift - KISS 100 Race Series - EU (A),power2Max NG eco,Wahoo Kickr Core,278,285,-7
115390,335605,2021-02-15 20:01:35,wahoo,Zwift - Premier Division // Zwift Racing League (men) (A),power2Max NG eco,Wahoo Kickr Core,337,345,-8
116424,335605,2021-02-17 10:44:47,wahoo,Zwift - The Morning Grind by STPC (A),power2Max NG eco,Wahoo Kickr Core,309,318,-9
117075,335605,2021-02-18 10:59:47,wahoo,Zwift - KISS Race Series - Americas AM (A),power2Max NG eco,Wahoo Kickr Core,345,355,-10
119164,335605,2021-02-22 19:09:44,wahoo,Zwift - Premier Division // Zwift Racing League (men) (A),power2Max NG eco,Wahoo Kickr Core,310,315,-5
120130,335605,2021-02-24 10:44:58,wahoo,Zwift - The Morning Grind by STPC (A),power2Max NG eco,Wahoo Kickr Core,324,328,-4
122635,335605,2021-03-01 20:18:33,wahoo,Zwift - Premier Division // Zwift Racing League (men) (A),power2Max NG eco,Wahoo Kickr Core,339,333,6
123890,335605,2021-03-04 10:35:17,wahoo,Zwift - Japan ZWIFT Hill Climb Race (A),power2Max NG eco,Wahoo Kickr Core,326,327,-1
60480,336213,2020-10-08 15:14:59,wahoo,Zwift - OH MY CRIT! - The Double Race 1/2 (A),4iiii,Kicker,338,365,-27
60481,336213,2020-10-08 16:04:58,wahoo,Zwift - OH MY CRIT! - The Double Race 2/2 (A),4iiii,Kicker,350,378,-28
62699,336213,2020-10-17 14:14:59,wahoo,Zwift - OH MY CRIT - Saturday Smash Race (A),4iiii,Kicker,330,359,-29
64292,336213,2020-10-22 15:14:59,wahoo,Zwift - OH MY CRIT! - The Double Race 2/2 (A),4iiii,Kicker,343,338,5
64293,336213,2020-10-22 16:04:59,wahoo,Zwift - OH MY CRIT! - The Double Race 2/2 (A),4iiii,Kicker,317,338,-21
64294,336213,2020-10-22 15:14:59,wahoo,Zwift - OH MY CRIT! - The Double Race 1/2 (A),4iiii,Kicker,343,365,-22
105137,338739,2021-01-29 15:30:15,wahoo,Zwift - DBR Friday Race (A),Garmin Vector,Kickr 2014,340,340,0
107352,338739,2021-02-02 18:28:52,wahoo,Zwift - Zwift Racing League | WTRL - Men&#039;s/Mixed EMEA E2 DIVISION 6 (A),Garmin Vector,Kickr 2014,377,373,4
108126,338739,2021-02-03 17:03:00,wahoo,Zwift - Guayaba Race by PETA-Z (A),Garmin Vector,Kickr 2014,356,362,-6
108808,338739,2021-02-04 17:29:59,wahoo,Zwift - TT Sands and Sequoia,Garmin Vector,Kickr 2014,352,348,4
110018,338739,2021-02-06 16:58:26,wahoo,Zwift - GCA Liga 2021 #2 (A),Garmin Vector,Kickr 2014,365,380,-15
111596,338739,2021-02-09 18:30:14,wahoo,Zwift - Race Warm Up,Garmin Vector,Kickr 2014,386,383,3
112196,338739,2021-02-09 18:30:14,wahoo,Zwift - Guayaba Race by PETA-Z (A),Garmin Vector,Kickr 2014,386,390,-4
112197,338739,2021-02-10 17:03:04,wahoo,Zwift - Guayaba Race by PETA-Z (A),Garmin Vector,Kickr 2014,387,390,-3
112886,338739,2021-02-11 17:29:30,wahoo,Zwift - 3R iTT Race - Watopia Tick Tock - 1 Lap (A),Garmin Vector,Kickr 2014,386,398,-12
119629,338739,2021-02-23 18:28:56,wahoo,Zwift - Zwift Racing League | WTRL - Men&#039;s/Mixed EMEA E2 DIVISION 6 (A),Garmin Vector,Kickr 2014,407,395,12
120232,338739,2021-02-24 17:05:00,wahoo,Zwift - Guayaba Race by PETA-Z (A),Garmin Vector,Kickr 2014,388,400,-12
123078,338739,2021-03-02 18:29:02,wahoo,Zwift - Zwift Racing League | WTRL - Men&#039;s/Mixed EMEA E2 DIVISION 6 (A),Vector,Kickr 2014,364,373,-9
126159,338739,2021-03-09 17:29:41,wahoo,Zwift - ZHR Masters (B),Vector,Kickr 2014,393,398,-5
17168,340007,2020-03-07 13:29:55,neo,Zwift - Fierce Felines Racing Series: Climb (B),Favero Assioma Duo F04.25,Tacx Neo v1,259,260,-1
17722,340007,2020-03-11 18:59:58,neo,Zwift - Stage 1 - Longer Ride - Tour of Watopia 2020,Favero Assioma Duo F04.25,Tacx Neo v1,201,187,14
18070,340007,2020-03-14 13:30:14,neo,Zwift - Fierce Felines Racing Series: TT (B),Favero Assioma Duo F04.25,Tacx Neo v1,278,266,12
18072,340007,2020-03-14 14:59:56,neo,Zwift - Stage 2 - Longer Ride - Tour of Watopia 2020,Favero Assioma Duo F04.25,Tacx Neo v1,238,228,10
42635,340007,2020-06-19 18:12:49,neo,Zwift - Fearless Women&#039;s Time Trial (C),Favero Assioma Duo F04.25,Tacx Neo v1,237,238,-1
42972,340007,2020-06-21 14:24:17,neo,Zwift - 3R Alpe Du Zwift KOM Race (20km 1444m) (C),Favero Assioma Duo F04.25,Tacx Neo v1,236,235,1
43226,340007,2020-06-23 14:55:30,neo,Zwift - Uphill Battle,Favero Assioma Duo F04.25,Tacx Neo v1,209,200,9
114356,340007,2021-02-13 17:40:00,neo,Zwift - TDZ Stage 8: Group Ride,Favero Assioma Duo F04.25,Tacx Neo v1,220,211,9
114900,340007,2021-02-14 19:27:28,neo,TDZ Stage 7: Women&#039;s Ride,Favero Assioma Duo F04.25,Tacx Neo v1,195,184,11
115428,340007,2021-02-15 19:32:31,neo,TDZ Stage 7: Shorter Ride,Favero Assioma Duo F04.25,Tacx Neo v1,150,143,7
116413,340007,2021-02-16 19:12:37,neo,Zwift Racing League | WTRL - Women&#039;s EMEA W1 DIVISION 1 (C),Favero Assioma Duo F04.25,Tacx Neo v1,275,268,7
116850,340007,2021-02-17 19:26:36,neo,TDZ Stage 7: Standard Ride,Favero Assioma Duo F04.25,Tacx Neo v1,245,232,13
118453,340007,2021-02-20 13:55:54,neo,Zwift -  Zwift Insider Badge Hunters - The Uber Pretzel Edition (E),Favero Assioma Duo F04.25,Tacx Neo v1,236,235,1
101074,340024,2021-01-21 18:43:15,wahoo,Zwift - BENELIGA 2020-2021 (E),2021-01-21-184314-ELEMNT ROAM 31BC-19-0,`Wahoo Kickr,387,394,-7
104747,340024,2021-01-28 18:47:43,wahoo,Zwift - BENELIGA 2020-2021 (E),2021-01-28-184742-ELEMNT ROAM 31BC-24-0,`Wahoo Kickr,385,398,-13
108984,340024,2021-02-04 18:41:23,wahoo,Zwift - BENELIGA 2020-2021 (E),4iiii,`Wahoo Kickr,394,383,11
113173,340024,2021-02-11 18:44:56,wahoo,Zwift - BENELIGA 2020-2021 (E),4iiii,`Wahoo Kickr,437,430,7
117358,340024,2021-02-18 18:44:18,wahoo,Zwift - BENELIGA 2020-2021 (E),4iiii,`Wahoo Kickr,360,366,-6
121685,340024,2021-02-25 16:03:55,wahoo,Zwift - DBR Friday Race (A),4iiii,`Wahoo Kickr,345,369,-24
122068,340024,2021-02-28 13:41:58,wahoo,Zwift - La Bicicletta Toronto & Toronto Hustle Donut Race (A),4iiii,`Wahoo Kickr,400,392,8
126049,340024,2021-03-09 10:58:05,wahoo,Zwift - KISS Race Series - Americas AM (A),4iiii,`Wahoo Kickr,335,343,-8
119396,341517,2021-02-23 08:40:00,wahoo,Zwift - Zwift Racing League | WTRL - Men&#039;s/Mixed APAC DIVISION 1 (A),Favero Assioma Duo,KICKR V5,312,300,12
57456,416001,2020-09-25 11:19:42,wahoo,Zwift - 3R LaGuardia Loop Reverse Flat Race - 8 Laps (24.5km/15.2mi 216m) (A),Favero Assioma DUO,Wahoo KICKR,362,362,0
59231,416001,2020-10-03 10:43:15,wahoo,Zwift - Into the Red by RELENTLESS (A),Favero Assioma DUO,Wahoo KICKR,373,364,9
62842,416001,2020-10-18 08:54:53,wahoo,Zwift - TugaZ Sunday Cake Ride - Passeio do Pastel de Nata (C),Favero Assioma DUO,Wahoo KICKR,269,264,5
64370,416001,2020-10-23 12:18:56,wahoo,Zwift - Peak-PTY Climb Challenge Fridays (A),Favero Assioma DUO,Wahoo KICKR,371,362,9
64601,416001,2020-10-24 11:13:14,wahoo,Wahoo KICKR,Favero Assioma DUO,Wahoo KICKR,388,379,9
68313,416001,2020-11-05 18:50:58,wahoo,Wahoo KICKR / Favero Assioma DUO,Favero Assioma DUO,Wahoo KICKR,367,359,8
70083,416001,2020-11-06 12:18:27,wahoo,Wahoo KICKR / Favero Assioma DUO,Favero Assioma DUO,Wahoo KICKR,407,404,3
73973,416001,2020-11-21 16:59:12,wahoo,Wahoo KICKR / Favero Assioma DUO,Favero Assioma DUO,Wahoo KICKR,379,368,11
76387,416001,2020-11-24 19:48:12,wahoo,Wahoo KICKR / Favero Assioma DUO,Favero Assioma DUO,Wahoo KICKR,398,389,9
113009,416001,2021-02-11 18:30:12,wahoo,Wahoo KICKR / Favero Assioma DUO,Favero Assioma DUO,Wahoo KICKR,344,344,0
64558,58841,2020-10-23 10:53:34,wahoo,Zwift - FTP Test,Favero Assioma duo,Wahoo Kickr Core,315,333,-18
64898,58841,2020-10-24 12:19:31,wahoo,Zwift - Zwift Racing - Sweet Spot Ramps - 30min,Favero Assioma duo,Wahoo Kickr Core,278,290,-12
95419,176366,2021-01-12 09:25:45,wahoo,Zwift - Ramp Test,Stages,Kickr Core,413,400,13
107250,176366,2021-02-02 15:00:01,wahoo,Zwift - TDZ Stage 6: Longer Ride,Stages,Kickr Core,397,388,9
126118,176366,2021-03-09 14:35:50,wahoo,Zwift - Ramp Test,Stages Gen3,Kickr Core,417,411,6
129436,39215,2021-03-16 23:27:46,wahoo,Zwift - Yorkshire,4iiii podium,wahoo kickr core,258,265,-7
85134,347475,2020-12-19 14:44:59,wahoo,Zwift - OH MY CRIT - Saturday Smash Race (A),2020-12-19-144459-ELEMNT BOLT A5A1-103-0,Wahoo Kickr,404,413,-9
85497,347475,2020-12-20 14:14:54,wahoo,Zwift - KISS 100 Race Series - Americas (A),4iii left crank only,Wahoo Kickr,343,350,-7
86272,347475,2020-12-22 19:30:51,wahoo,Zwift - KISS Race Series - EU PM (A),4iii left crank only,Wahoo Kickr,386,388,-2
86489,347475,2020-12-23 15:40:39,wahoo,Zwift - ZA Tri: TT Race - 20k,4iii left crank only,Wahoo Kickr,349,358,-9
87519,347475,2020-12-26 14:44:48,wahoo,Zwift - OH MY CRIT - Saturday Smash Race (A),4iii left crank only,Wahoo Kickr,394,387,7
87899,347475,2020-12-27 16:01:26,wahoo,Zwift - ZHQ FutureWorks Crit City Race - Anti-sandbagging (A),4iii left crank only,Wahoo Kickr V5,368,358,10
88802,347475,2020-12-29 21:04:08,wahoo,Zwift - Crit City Race (A),4iii left crank only,Wahoo Kickr V5,357,352,5
88803,347475,2020-12-29 22:03:32,wahoo,Zwift - 3R Classique Flat Race - 5 Laps (32.3km/20.1mi 95m) (A),4iii left crank only,Wahoo Kickr V5,328,321,7
89581,347475,2020-12-31 15:45:58,wahoo,Zwift - OH MY CRIT! - The Double Race 1/2 (A),4iii left crank only,Wahoo Kickr V5,363,357,6
89584,347475,2020-12-31 17:01:45,wahoo,Zwift - OH MY CRIT! - The Double Race 2/2 (A),4iii left crank only,Wahoo Kickr V5,354,348,6
90294,347475,2021-01-02 14:46:15,wahoo,Zwift - OH MY CRIT - Saturday Smash Race (A),4iii left crank only,Wahoo Kickr V5,368,369,-1
90802,347475,2021-01-03 16:02:34,wahoo,Zwift - ZHQ FutureWorks Crit City Race - Anti-sandbagging (A),4iii left crank only,Wahoo Kickr V5,384,363,21
91963,347475,2021-01-05 21:57:47,wahoo,Zwift - 3R Classique Flat Race - 5 Laps (32.3km/20.1mi 95m) (A),4iii left crank only,Wahoo Kickr V5,359,347,12
91964,347475,2021-01-05 21:04:12,wahoo,Zwift - Crit City Race (A),4iii left crank only,Wahoo Kickr V5,394,381,13
93931,347475,2021-01-09 14:45:10,wahoo,Zwift - OH MY CRIT - Saturday Smash Race (A),4iii left crank only,Wahoo Kickr V5,352,348,4
94564,347475,2021-01-10 13:57:38,wahoo,Zwift - KISS 100 Race Series - Americas (A),4iii left crank only,Wahoo Kickr V5,399,389,10
96627,347475,2021-01-13 21:07:15,wahoo,Zwift - Upper z2 - v2,4iii left crank only,Wahoo Kickr V5,358,356,2
97973,347475,2021-01-16 12:31:37,wahoo,Zwift - TDZ Stage 3: Longer Ride,4iii left crank only,Wahoo Kickr V5,355,356,-1
98625,347475,2021-01-17 15:03:45,wahoo,Zwift - 3R Watopia 65km Race - 6 laps (40mi 324m) (A),4iii left crank only,Wahoo Kickr V5,352,347,5
100526,347475,2021-01-20 20:59:44,wahoo,Zwift - TDZ Stage 4: Longer Ride,4iii left crank only,Wahoo Kickr V5,342,342,0
100527,347475,2021-01-19 22:04:22,wahoo,Zwift - 3R Classique Flat Race - 5 Laps (32.3km/20.1mi 95m) (A),4iii left crank only,Wahoo Kickr V5,356,365,-9
101933,347475,2021-01-23 15:14:43,wahoo,Zwift - OH MY CRIT!! - Saturday Smash Race (A),4iii left crank only,Wahoo Kickr V5,385,386,-1
105714,347475,2021-01-30 14:49:45,wahoo,Zwift - OH MY CRIT!! - Saturday Smash Race (A),4iii left crank only,Wahoo Kickr V5,363,372,-9
110570,347475,2021-02-07 13:58:36,wahoo,Zwift - KISS 100 Race Series - Americas (A),4iii left crank only,Wahoo Kickr V5,377,377,0
114400,347475,2021-02-13 14:43:44,wahoo,Zwift - OH MY CRIT!! - Saturday Smash Race (A),4iii left crank only,Wahoo Kickr V5,393,391,2
114758,347475,2021-02-14 13:58:39,wahoo,Zwift - KISS 100 Race Series - Americas (A),4iii left crank only,Wahoo Kickr V5,354,358,-4
117209,347475,2021-02-18 15:45:53,wahoo,Zwift - OH MY CRIT!! - The Double Race 1/2 (A),4iii left crank only,Wahoo Kickr V5,350,351,-1
117211,347475,2021-02-18 17:03:49,wahoo,Zwift - OH MY CRIT!! - The Double Race 2/2 (A),4iii left crank only,Wahoo Kickr V5,332,331,1
118351,347475,2021-02-20 14:42:09,wahoo,Zwift - OH MY CRIT!! - Saturday Smash Race (A),4iii left crank only,Wahoo Kickr V5,358,354,4
118768,347475,2021-02-21 13:57:52,wahoo,Zwift - KISS 100 Race Series - Americas (A),4iii left crank only,Wahoo Kickr V5,358,355,3
122137,347475,2021-02-28 13:57:09,wahoo,Zwift - KISS 100 Race Series - Americas (A),4iii left crank only,Wahoo Kickr V5,368,372,-4
125498,347475,2021-03-07 13:57:08,wahoo,Zwift - KISS 100 Race Series (Americas) - The Uber Pretzel Edition (A),4iii left crank only,Wahoo Kickr V5,383,383,0
128057,347475,2021-03-13 14:45:59,wahoo,Zwift - OH MY CRIT!! - Saturday Smash Race (A),4iii left crank only,Wahoo Kickr V5,400,400,0
128452,347475,2021-03-14 14:00:23,wahoo,Zwift - KISS 100 Race Series (Americas) (A),4iii left crank only,Wahoo Kickr V5,366,366,0
58442,347795,2020-09-29 17:21:41,wahoo,Zwift - WTRL Women&#039;s EMPOWERMENT Series - Stage 4 (A),Favero Assioma UNO ,Wahoo Kickr,285,292,-7
59863,347795,2020-10-06 17:25:23,wahoo,WTRL Womens EMPOWERMENT Series - Stage 5,Favero Assioma UNO ,Wahoo Kickr,245,255,-10
61575,347795,2020-10-13 18:05:12,wahoo,Zwift - Zwift Racing League | WTRL,Favero Assioma UNO ,Wahoo Kickr,270,281,-11
75966,347795,2020-11-24 19:12:49,wahoo,Zwift - Zwift Racing League | WTRL - Women&#039;s EMEA W1 DIVISION 1,Favero Assioma UNO ,Wahoo Kickr,278,289,-11
82548,347795,2020-12-12 19:20:29,wahoo,Zwift - Fearless Women&#039;s Team Championships - 2020 (A),Favero Assioma UNO ,Wahoo Kickr,302,299,3
94086,347795,2021-01-09 18:49:33,wahoo,Zwift -  Tour De Boudicca,Favero Assioma UNO ,Wahoo Kickr,288,283,5
107565,347795,2021-02-02 19:08:15,wahoo,Zwift - Zwift Racing League | WTRL - Women&#039;s EMEA W1 DIVISION 1 (A),Favero Assioma UNO ,Wahoo Kickr,283,290,-7
43082,348800,2020-06-22 11:30:02,wahoo,0622,creo,kickr,172,170,2
57882,348800,2020-09-27 11:19:59,wahoo,kickr vs shimano tt(現在BMCについてるやつ,20200927_shimano_TT,20200927_kickr,317,319,-2
58974,348800,2020-10-02 05:33:36,wahoo,20201002 kickr vs shimanoTT170mm,20201002ttshimano,20201002kickr,286,292,-6
60911,348800,2020-10-09 10:05:00,wahoo,20201009kickr vs shimanoBMC,20201009shimanoBMC,20201009kickr,324,327,-3
53030,349154,2020-08-31 19:37:51,wahoo,Zwift - JETT ZWIFT Morning Race (A),SRM,Kicker,294,325,-31
53406,349154,2020-09-03 20:19:36,wahoo,Zwift - 3R LaGuardia Loop Flat Race - 6 Laps (17.5km/10.9 162m) (A),SRM,Kicker,256,250,6
53475,349154,2020-09-03 09:22:40,wahoo,Zwift - Espresso,SRM,Kicker,295,290,5
53476,349154,2020-09-04 22:04:35,wahoo,Zwift - 3R Volcano Flat 50k Race - 4 Laps (48.8km/30.7mi 184m) (A),SRM9100,Kicker,272,265,7
53510,349154,2020-09-05 05:29:34,wahoo,Zwift - XRS Races - The Saturday Classic (A),SRM Science Black,Kicker2018,300,292,8
53603,349154,2020-09-06 04:54:13,wahoo,Zwift - KISS at Race 100 - EU (A),SRM Science Black,Kicker 2018,315,311,4
53699,349154,2020-09-06 20:12:48,wahoo,Zwift - 3R Greater London Flat Race - 3 Laps (40.2km/25mi 135m) (A),SRM Science Black,Kicker2018,284,283,1
53823,349154,2020-09-07 20:39:34,wahoo,Zwift - 3R London Loop Hilly Race - 2 Laps (29km/18mi 440m) (A),SRM Science Black,Kicker 2018,311,306,5
53887,349154,2020-09-08 09:04:30,wahoo,Zwift - 3R Sundown Race Series  (A),SRM Science Black,Kicker 2018,279,277,2
54025,349154,2020-09-08 20:12:38,wahoo,Zwift - JETT ZWIFT Morning Race (A),SRM Science Black,Kicker 2018,305,301,4
54227,349154,2020-09-09 20:19:33,wahoo,Zwift - 3R Classique Flat Race - 5 Laps (32.3km/20.1mi 95m) (A),SRM Science Black,Kicker 2018,297,295,2
54302,349154,2020-09-10 09:07:03,wahoo,Zwift - Espresso,SRM Science Black,Kicker 2018,294,298,-4
54478,349154,2020-09-10 20:17:41,wahoo,Zwift - 3R LaGuardia Loop Flat Race - 6 Laps (17.5km/10.9 162m) (A),SEM Science Black,Kicker 2018,260,255,5
54479,349154,2020-09-10 21:01:22,wahoo,Zwift - 3R Innsbruckring Flat Race - 2 Laps (17.6km/10.9m 154m) (A),SEM Science Black ,Kicker 2018,272,272,0
54643,349154,2020-09-11 22:02:29,wahoo,Zwift - 3R Volcano Flat 50k Race - 4 Laps (48.8km/30.7mi 184m) (A),SRM Science Black,Kickr 2018,310,307,3
54679,349154,2020-09-12 09:00:03,wahoo,Zwift - 3R Hilly Race - NYC - Astoria Line 8 - 3 Laps (A),SRM Science Black,Kickr,280,285,-5
54797,349154,2020-09-12 23:06:28,wahoo,Zwift - 3R 60km Park Perimeter Reverse Loop Flat Race - 6 Laps (58.2km 756m) (A),SRM Science Black,Kickr,278,278,0
54803,349154,2020-09-13 02:01:58,wahoo,Zwift - 3R Innsbruckring Flat Race - 2 Laps (17.6km/10.9m 154m) (A),SRM Science Black,Kickr,276,278,-2
54922,349154,2020-09-13 19:53:59,wahoo,Zwift - 3R Greater London Flat Race - 3 Laps (40.2km/25mi 135m) (A),SRM Science Black,Kicker,256,254,2
55045,349154,2020-09-14 17:15:59,wahoo,Zwift - Invitational League // Qualifying Race #1,SRM Science Black,Kickr 2018,270,262,8
55287,349154,2020-09-15 09:02:49,wahoo,Zwift - 3R Sundown Race Series  (A),SRM Science Black,Kickr 2018,299,302,-3
55435,349154,2020-09-15 20:10:23,wahoo,Zwift - JETT ZWIFT Morning Race (A),SRM Science Black,Kickr 2018,294,291,3
55633,349154,2020-09-16 20:16:14,wahoo,Zwift - 3R Classique Flat Race - 5 Laps (32.3km/20.1mi 95m) (A),SRM Science Black,Kickr 2018,270,272,-2
55832,349154,2020-09-17 17:42:56,wahoo,Zwift - Invitational League // Qualifying Race #2 (Men) ,SRM Science Black,Kickr 2018,298,298,0
56198,349154,2020-09-18 22:03:54,wahoo,Zwift - 3R Volcano Flat 50k Race - 4 Laps (48.8km/30.7mi 184m) (A),SRM Science Black,Kickr 2018,261,260,1
56213,349154,2020-09-19 05:13:37,wahoo,Zwift - XRS Races - The Saturday Classic (A),SRM Science Black,Kickr 2018,270,271,-1
56325,349154,2020-09-19 21:39:39,wahoo,Zwift - 3R Classique Flat Race (A),SRM Science Black,Kickr 2018,284,282,2
56408,349154,2020-09-20 11:28:52,wahoo,Zwift - Invitational League // Qualifying Race #3 (Men) (A),2020_09_20_20_28_49,Kickr 2018,284,289,-5
56420,349154,2020-09-20 11:28:52,wahoo,Zwift - Invitational League // Qualifying Race #3 (Men) (A),SRM Science Black,Kickr 2018,284,289,-5
56722,349154,2020-09-21 23:31:51,wahoo,Zwift - 3R 50km LONDON-Greater London Flat Race (52km/32.4mi) (A),SRM Science Black,Kickr 2018,288,285,3
56772,349154,2020-09-22 07:57:56,wahoo,Zwift - 3R Sundown Race Series  (A),SRM Science Black,Kickr 2018,298,296,2
56892,349154,2020-09-22 20:12:18,wahoo,Zwift - JETT ZWIFT Morning Race (A),SRM Science Black,Kickr 2018,302,301,1
57115,349154,2020-09-23 20:12:21,wahoo,Zwift - 3R Classique Flat Race - 5 Laps (32.3km/20.1mi 95m) (A),SRM Science Black,Kickr 2018,270,270,0
57328,349154,2020-09-24 09:19:09,wahoo,Zwift - Espresso,SRM Science Black,Kickr 2018,281,295,-14
57329,349154,2020-09-24 20:15:46,wahoo,Zwift - 3R LaGuardia Loop Flat Race - 6 Laps (17.5km/10.9 162m) (A),SRM Science Black,Kickr 2018,256,254,2
57347,349154,2020-09-24 21:01:21,wahoo,Zwift - 3R Innsbruckring Flat Race - 2 Laps (17.6km/10.9m 154m) (A),SRM Science Black,Kickr 2018,287,288,-1
57582,349154,2020-09-25 22:03:17,wahoo,Zwift - 3R Volcano Flat 50k Race - 4 Laps (48.8km/30.7mi 184m) (A),SRM Science Black,Kickr 2018,299,301,-2
57605,349154,2020-09-26 05:27:34,wahoo,Zwift - XRS Races - The Saturday Classic (A),SRM Science Black,Kickr 2018,298,295,3
57800,349154,2020-09-26 05:27:34,wahoo,Zwift - 3R Classique Flat Race (A),SRM Science Black,Kickr 2018,298,274,24
57803,349154,2020-09-26 22:14:43,wahoo,Zwift - 3R Classique Flat Race (A),SRM Science Black,Kickr 2018,275,274,1
57832,349154,2020-09-27 04:16:50,wahoo,Zwift - KISS at Race 100 - EU (A),SRM Science Black,Kickr 2018,298,297,1
57960,349154,2020-09-27 20:10:24,wahoo,Zwift - 3R Greater London Flat Race - 3 Laps (40.2km/25mi 135m) (A),SRM Science Black,Kickr 2018,276,279,-3
58180,349154,2020-09-29 09:01:14,wahoo,Zwift - 3R Sundown Race Series  (A),SRM Science Black,Kickr 2018,309,304,5
58353,349154,2020-09-29 20:10:17,wahoo,Zwift - JETT ZWIFT Morning Race (A),SRM Science Black,Kickr 2018,313,314,-1
58644,349154,2020-09-30 05:43:51,wahoo,Zwift - 3R Volcano Circuit Flat Race - 4 Laps (18.9km/11.7mi 80m) (A),SRM Science Black,Kickr 2020 V5,242,238,4
58715,349154,2020-10-01 09:02:40,wahoo,Zwift - Espresso,SRM Science Black,Kickr 2020 V5,276,272,4
59142,349154,2020-10-02 21:29:03,wahoo,ZADA 3Sisters TEST 2020-10-03,SRM Science Black,Kickr 2020 V5,298,287,11
59731,349154,2020-09-10 09:07:03,wahoo,Zwift - 3R Sundown Race Series - iTT (A),SRM Science Black,Kickr v5,294,271,23
59736,349154,2020-10-06 09:03:24,wahoo,Zwift - 3R Sundown Race Series - iTT (A),SRM Science Black,Kickr v5,276,271,5
60174,349154,2020-10-07 20:16:38,wahoo,Zwift - 3R Classique Flat Race - 5 Laps (32.3km/20.1mi 95m) (A),SRM Science Black,Kickr v5,284,265,19
60657,349154,2020-10-09 20:26:16,wahoo,Zwift - 3R LaGuardia Loop Flat Race - 8 Laps (22.9km/14.2mi 216m) (A),SRM Science Black,Kickr v5 ,293,286,7
60768,349154,2020-10-10 10:26:45,wahoo,Zwift - Into the Red by RELENTLESS (A),SRM Science Black,Kickr v5,295,286,9
60879,349154,2020-10-10 22:11:27,wahoo,Zwift - The - GO  TBR / BDCC / SMCC Combine (A),SRM Science Black,Kickr v5,285,281,4
61055,349154,2020-10-11 20:12:40,wahoo,Zwift - 3R Greater London Flat Race - 3 Laps (40.2km/25mi 135m) (A),SRM Science Black,Kicker v5,251,247,4
61336,349154,2020-10-12 18:29:20,wahoo,Zwift - Premier Division // Zwift Racing League (men) ,SRM Science Black,Kickr v5 ,280,269,11
61644,349154,2020-10-13 19:45:35,wahoo,Zwift - JETT ZWIFT Morning Race (A),SRM Science Black,Kickr v5,328,314,14
61984,349154,2020-10-14 20:20:13,wahoo,Zwift - 3R Classique Flat Race - 5 Laps (32.3km/20.1mi 95m) (A),SRM Science Black,Kickr 2020 v5,282,267,15
62061,349154,2020-10-15 09:10:02,wahoo,Zwift - ZHR Up & Down Race (A),SRM Science Black,Kickr v5,318,304,14
62297,349154,2020-10-15 20:18:29,wahoo,Zwift - 3R LaGuardia Loop Flat Race - 6 Laps (17.5km/10.9 162m) (A),SRM Science Black,Kicker v5,266,254,12
62376,349154,2020-10-16 09:58:14,wahoo,Zwift - 3R Innsbruckring Flat Race - 4 Laps (35.2km/21.9mi 308m) (A),SRM Science Black,Kickr v5,280,265,15
62513,349154,2020-10-16 22:03:12,wahoo,Zwift - 3R Volcano Flat 50k Race - 4 Laps (48.8km/30.7mi 184m) (A),SRM Science Black,Kickr v5 ,259,248,11
62540,349154,2020-10-17 06:02:08,wahoo,Zwift - 3R Road To Ruins Hilly Race - 1 Lap (29..2km/18.1mi 275m) (A),SRM Science Black,Kickr v5,279,269,10
62549,349154,2020-10-17 06:53:23,wahoo,Zwift - ZHQ Beta Crit City Race (A),SRM Science Black,Kickr v5 ,245,235,10
62740,349154,2020-10-17 22:12:22,wahoo,Zwift - The - GO  TBR / BDCC / SMCC Combine (A),SRM Science Black,Kickr v5,262,263,-1
62759,349154,2020-10-18 04:46:04,wahoo,Zwift - 3R Volcano Flat Race - 3 Laps (36.6km/22.7mi 138m) (A),SRM Science Black,Kickr V5,271,265,6
62934,349154,2020-10-18 20:09:04,wahoo,Zwift - 3R Greater London Flat Race - 3 Laps (40.2km/25mi 135m) (A),SRM Science Black,Kickr V5,249,246,3
63239,349154,2020-10-19 20:38:43,wahoo,Zwift - 3R London Loop Hilly Race - 2 Laps (29km/18mi 440m) (A),SRM Science Black,Kickr V5,316,316,0
63599,349154,2020-10-20 20:12:10,wahoo,Zwift - JETT ZWIFT Morning Race (A),SRM Science Black,Kickr V5,318,315,3
64272,349154,2020-10-22 20:41:49,wahoo,Zwift - 3R Innsbruckring Flat Race - 2 Laps (17.6km/10.9m 154m) (A),SRM Science Black,Kickr V5,280,272,8
64504,349154,2020-10-23 21:46:01,wahoo,Zwift - 3R Volcano Flat 50k Race - 4 Laps (48.8km/30.7mi 184m) (A),SRM Science Black,Kickr V5,263,261,2
64536,349154,2020-10-24 05:11:16,wahoo,Zwift - 3R Road To Ruins Hilly Race - 1 Lap (29..2km/18.1mi 275m) (A),SRM Science Black,Kickr V5,283,280,3
64537,349154,2020-10-24 06:59:39,wahoo,Zwift - 3R Weekend Race Club - Race 1 (A),SRM Science Black,Kickr V5,277,270,7
64714,349154,2020-10-24 21:58:45,wahoo,Zwift - The - GO  TBR / BDCC / SMCC Combine (A),SRM Science Black,Kickr V5,239,235,4
64747,349154,2020-10-25 04:57:47,wahoo,Zwift - 3R Volcano Flat Race - 3 Laps (36.6km/22.7mi 138m) (A),SRM Science Black,Kickr V5,268,266,2
64939,349154,2020-10-25 19:53:30,wahoo,Zwift - 3R Greater London Flat Race - 3 Laps (40.2km/25mi 135m) (A),SRM Science Black,Kickr V5,257,251,6
65167,349154,2020-10-26 19:25:52,wahoo,Zwift - Premier Division // Zwift Racing League (men) (A),SRM Science Black,Kickr V5,278,272,6
65331,349154,2020-10-27 09:08:55,wahoo,Zwift - 3R Whole Lotta Lava Hilly Race - 2 Laps (28.9km/12.53mi 336m) (A),SRM Science Black,Kickr V5,298,291,7
65574,349154,2020-10-27 19:54:12,wahoo,Zwift - JETT ZWIFT Morning Race (A),SRM Science Black,Kickr V5,293,297,-4
65913,349154,2020-10-28 19:52:49,wahoo,Zwift - 3R Classique Flat Race - 5 Laps (32.3km/20.1mi 95m) (A),SRM Science Black,Kickr V5,300,295,5
66256,349154,2020-10-29 19:49:00,wahoo,Zwift - 3R LaGuardia Loop Flat Race - 6 Laps (17.5km/10.9 162m) (A),SRM Science Black,Kickr V5,280,276,4
66260,349154,2020-10-29 20:53:47,wahoo,Zwift - 3R Innsbruckring Flat Race - 2 Laps (17.6km/10.9m 154m) (A),SRM Science Black,Kickr V5,288,278,10
66502,349154,2020-10-30 19:53:41,wahoo,Zwift - 3R Innsbruckring Flat Race - 4 Laps (35.2km/21.9mi 308m) (A),SRM Science Black,Kickr V5,276,271,5
66782,349154,2020-10-31 21:08:01,wahoo,Zwift - 3R Gotham Grind Flat Race - 3 Laps (27.8km/17.4mi 87m) (A),SRM Science Black,Kickr V5,261,255,6
66843,349154,2020-11-01 05:57:31,wahoo,Zwift - KISS at Race 100 - EU (A),SRM Science Black,Kickr V5,279,273,6
67071,349154,2020-11-01 20:14:18,wahoo,Zwift - 3R Greater London Flat Race - 3 Laps (40.2km/25mi 135m) (A),SRM Science Black,Kickr V5,245,246,-1
67255,349154,2020-11-02 18:17:08,wahoo,Zwift - Premier Division // Zwift Racing League (men) (A),SRM Science Black,Kickr V5,288,288,0
67703,349154,2020-11-03 20:13:59,wahoo,Zwift - JETT ZWIFT Morning Race (A),SRM Science Black,Kickr V5,289,286,3
67845,349154,2020-11-04 09:59:16,wahoo,Zwift - EVR Definitely Not the WTNC (A),SRM Science Black,Kickr V5,270,268,2
67958,349154,2020-11-04 20:17:34,wahoo,Zwift - 3R Classique Flat Race - 5 Laps (32.3km/20.1mi 95m) (A),SRM Science Black,Kickr V5,274,276,-2
68058,349154,2020-11-05 09:25:29,wahoo,Zwift - KISS at Race - Down Under (A),SRM Science Black,Kickr V5,258,258,0
68308,349154,2020-11-05 19:59:13,wahoo,Zwift - KISS at Race - EU PM (A),SRM Science Black,Kickr V5,273,270,3
68644,349154,2020-11-06 21:47:41,wahoo,Zwift - 3R Volcano Flat 50k Race - 4 Laps (48.8km/30.7mi 184m) (A),SRM Science Black,Kickr V5,275,274,1
68711,349154,2020-11-07 06:26:51,wahoo,Zwift - XRS Races - The Saturday Classic (A),SRM Science Black,Kickr V5,293,293,0
68914,349154,2020-11-07 22:14:14,wahoo,Zwift - 3R Classique Flat Race (A),SRM Science Black,Kickr V5,254,254,0
68945,349154,2020-11-08 05:58:01,wahoo,Zwift - KISS at Race 100 - EU (A),SRM Science Black,Kickr V5,290,292,-2
69195,349154,2020-11-08 19:58:24,wahoo,Zwift - KISS at Race - EU PM (A),SRM Science Black,Kickr V5,243,246,-3
69450,349154,2020-11-09 19:18:50,wahoo,Zwift - Premier Division // Zwift Racing League (men) (A),SRM Science Black,Kickr V5,279,276,3
69596,349154,2020-11-10 09:07:17,wahoo,Zwift - 3R Whole Lotta Lava Hilly Race - 2 Laps (28.9km/12.53mi 336m) (A),SRM Science Black,Kickr V5,290,289,1
69920,349154,2020-11-10 20:07:57,wahoo,Zwift - JETT ZWIFT Morning Race (A),SRM Science Black,Kickr V5,292,292,0
70089,349154,2020-11-11 09:01:30,wahoo,Zwift - 3R Watopia Flat Route Race - 3 Laps (30.3km/18.8mi 162m) (A),SRM Science Black,Kickr V5,287,287,0
70373,349154,2020-11-11 20:16:37,wahoo,Zwift - 3R Classique Flat Race - 5 Laps (32.3km/20.1mi 95m) (A),SRM Science Black,Kickr V5,281,280,1
70840,349154,2020-11-12 09:27:44,wahoo,Zwift - KISS at Race - Down Under (A),SRM Science Black,Kickr V5,267,268,-1
70876,349154,2020-11-12 19:59:16,wahoo,Zwift - KISS at Race - EU PM (A),SRM Science Black,Kickr V5,238,239,-1
71203,349154,2020-11-13 22:02:58,wahoo,Zwift - 3R Volcano Flat 50k Race - 4 Laps (48.8km/30.7mi 184m) (A),SRM Science Black,Kickr V5,272,271,1
74886,349154,2020-11-23 19:14:50,wahoo,Zwift - Premier Division // Zwift Racing League (men) (A),SRM Science Black to Garmin Edge 130 plus,Kickr v5 to Zwift ,289,284,5
77717,349154,2020-11-30 18:59:01,wahoo,Zwift - Premier Division // Zwift Racing League (men) (A),SRM Science Black to Garmin Edge 130 plus,Kickr v5 to Zwift ,286,277,9
31417,350154,2020-05-04 21:29:58,wahoo,Zwift - TZR dress rehearsal - Tempus Fugit,P1,Kickr,224,226,-2
31841,350154,2020-05-05 22:02:00,wahoo,Zwift - Zwift Time Trial Tuesday: Tempus Fugit (E),P1,Kickr,342,321,21
33422,350154,2020-05-10 19:14:56,wahoo,Zwift -  TFC Group Sub 2.5 W/Kg Group Ride (C),Uno,Kickr,307,293,14
33742,350154,2020-05-11 22:00:00,wahoo,Zwift - Royce&#039;s Lama Lab Test,Uno,Kickr,256,252,4
35903,350154,2020-05-18 21:25:03,wahoo,Race recon with Grabbin&#039; Poles Knowles,Uno,Kickr,191,205,-14
36257,350154,2020-05-19 23:11:58,wahoo,Zwift - TZR weekly race series #3.  CLIMBY,Uno,Kickr,338,357,-19
39288,350154,2020-06-02 22:01:15,wahoo,Zwift - Zwift Time Trial Tuesday: Tempus Fugit (E),Uno,Kickr,357,378,-21
39692,350154,2020-06-04 23:39:05,wahoo,Zwift - Espresso,Uno,Kickr,359,372,-13
44395,350154,2020-06-30 22:01:33,wahoo,Zwift - Zwift Time Trial Tuesday: Tempus Fugit (E),Duo,Kickr,364,368,-4
78496,350154,2020-12-01 22:04:56,wahoo,3R London Flat race (A),Duo,Kickr,349,355,-6
117519,350154,2021-02-18 22:22:37,wahoo,Duo / Kickr,Duo,Kickr,331,333,-2
6135,350258,2019-12-12 19:55:59,wahoo,Zwift - Lamb Chop Series  (A),Rotor INPower,Wahoo KICKR 18,352,346,6
14962,350258,2020-02-20 18:40:17,wahoo,Zwift - KALAS Cup - Round 4 (A),Rotor INPower,Wahoo KICKR 18,380,372,8
17829,350258,2020-03-12 19:10:15,wahoo,Zwift - Tour of Watopia Pro-Am Men&#039;s Race #1 (A),Rotor INPower,Wahoo KICKR 18,405,402,3
18912,350258,2020-03-20 19:00:00,wahoo,Zwift - Tour of Watopia Pro-Am Men&#039;s Race #2 (A),Rotor INPower,Wahoo KICKR 18,399,401,-2
21504,350258,2020-04-02 17:51:26,wahoo,Zwift - KALAS Cup - Round 10 (A),Rotor INPower,Wahoo KICKR 18,374,374,0
22180,350258,2020-04-05 08:55:20,wahoo,Zwift - Ronde van Zwift (A),Rotor INPower,Wahoo KICKR 18,384,373,11
23304,350258,2020-04-09 17:58:00,wahoo,Zwift - London International // Zwift Classic (A),Rotor INPower,Wahoo KICKR 18,429,423,6
33972,350258,2020-05-12 16:57:09,wahoo,Zwift - NCF Grand Prix 2020 - Runde 2 - Elite Herrer/Kvinner (A),Rotor INPower,Wahoo KICKR 18,414,412,2
34730,350258,2020-05-14 16:09:37,wahoo,Three Sisters for ZADA,Rotor INPower,Wahoo KICKR 18,409,402,7
36683,350258,2020-05-21 18:02:40,wahoo,Zwift - Tour for All Invitational Race // Men (A),Rotor INPower,Wahoo KICKR 18,385,374,11
38360,350258,2020-05-28 17:55:47,wahoo,Zwift - Tour for All Invitational Race // Men (A),Rotor INPower,Wahoo KICKR 18,422,413,9
54187,350258,2020-09-09 18:03:10,wahoo,Zwift - DBR Wednesday Race (A),Rotor INPower,Wahoo Kickr v5,353,350,3
55108,350258,2020-09-14 17:34:29,wahoo,Zwift - Invitational League // Qualifying Race #1,Rotor INPower,Wahoo Kickr v5,401,380,21
57051,350258,2020-09-23 17:39:11,wahoo,Zwift - NCF Vinter Cup 2020 - Runde 1 - Herrer (A),Rotor INPower,Wahoo Kickr v5,343,337,6
57285,350258,2020-09-24 18:03:19,wahoo,Zwift - Espresso,Rotor INPower,Wahoo Kickr v5,358,347,11
57739,350258,2020-09-26 13:58:30,wahoo,5-10-10-10-10-5 terskel,Rotor INPower,Wahoo Kickr v5,357,348,9
58292,350258,2020-09-29 16:57:13,wahoo,Zwift - Oivind Loining Bjerkseth (KALAS eSRT)&#039;s Meetup - Three Sisters,Rotor INPower,Wahoo Kickr v5,394,381,13
58840,350258,2020-10-01 17:22:01,wahoo,Zwift - Espresso,Rotor INPower,Wahoo Kickr v5,356,341,15
60112,350258,2020-10-07 17:29:12,wahoo,Zwift - NCF Vinter Cup 2020 - Runde 3 - Herrer (A),Rotor INPower,Wahoo Kickr v5,369,355,14
60362,350258,2020-10-08 17:21:50,wahoo,Zwift - Espresso,Rotor INPower,Wahoo Kickr v5,378,366,12
61273,350258,2020-10-12 18:49:29,wahoo,Zwift - Premier Division // Zwift Racing League (men) ,Rotor INPower,Wahoo Kickr v5,384,374,10
62165,350258,2020-10-15 17:21:46,wahoo,Zwift - Espresso,Rotor INPower,Wahoo Kickr v5,355,338,17
63123,350258,2020-10-19 18:08:01,wahoo,Zwift - Premier Division // Zwift Racing League (men) ,Rotor INPower,Wahoo Kickr v5,375,357,18
63889,350258,2020-10-21 17:29:33,wahoo,Zwift - NCF Vinter Cup 2020 - Runde 5 - Herrer (A),Rotor INPower,Wahoo Kickr v5,384,368,16
65206,350258,2020-10-26 19:48:54,wahoo,Zwift - Premier Division // Zwift Racing League (men) (A),Rotor INPower,Wahoo Kickr v5,387,371,16
67269,350258,2020-11-02 18:51:02,wahoo,Zwift - Premier Division // Zwift Racing League (men) (A),Rotor INPower,Wahoo Kickr v5,379,363,16
74701,350258,2020-11-23 19:56:28,wahoo,Zwift - Premier Division // Zwift Racing League (men) (A),Rotor INPower,Wahoo Kickr v5,408,400,8
77705,350258,2020-11-30 19:04:09,wahoo,Zwift - Premier Division // Zwift Racing League (men) (A),Rotor INPower,Wahoo Kickr v5,359,351,8
79038,350258,2020-12-03 18:18:44,wahoo,Zwift - FUSION DECEMBER CUP (A),Rotor INPower,Wahoo Kickr v5,368,357,11
95011,350258,2021-01-11 18:43:36,wahoo,Zwift - Premier Division // Zwift Racing League (men) (A),Rotor INPower,Wahoo Kickr v5,382,367,15
96435,350258,2021-01-13 18:20:11,wahoo,Zwift - NCF Vintercup 2021 - Runde 1 - Herrer (A),Rotor INPower,Wahoo Kickr v5,364,350,14
111075,350258,2021-02-08 19:00:31,wahoo,Zwift - Premier Division // Zwift Racing League (men) (A),Rotor INPower,Wahoo Kickr v5,389,373,16
112379,350258,2021-02-10 18:42:42,wahoo,Zwift - Movistar Team Challenge // Round 1 (A),Rotor INPower,Wahoo Kickr v5,375,352,23
113650,350258,2021-02-12 18:57:09,wahoo,Zwift - Movistar Team Challenge // Round 1 (men),Rotor INPower,Wahoo Kickr v5,374,359,15
116749,350258,2021-02-17 18:48:51,wahoo,Zwift - Movistar Team Challenge // Round 2 (men) - Race 3/4,Rotor INPower,Wahoo Kickr v5,358,345,13
117879,350258,2021-02-19 18:49:57,wahoo,Zwift - Movistar Team Challenge // Round 2 (men),Rotor INPower,Wahoo Kickr v5,423,401,22
122590,350258,2021-03-01 20:02:13,wahoo,Zwift - Premier Division // Zwift Racing League (men) (A),Rotor INPower,Wahoo Kickr v5,377,360,17
30344,352998,2020-04-05 04:51:12,wahoo,Zwift - 3R Volcano Flat Race - 3 Laps (36.6km/22.7mi 138m) (B),4iiii,kickr,358,353,5
37475,352998,2020-05-19 05:23:13,wahoo,Zwift - Team PACK&#039;s Choice: Stage 5 Shorter Race A/B,4iiii,kickr,335,350,-15
45341,352998,2020-07-07 06:22:59,wahoo,3r,4iiii,kickr,260,264,-4
95878,359567,2021-01-12 19:31:20,wahoo,Zwift - Zwift Racing League | WTRL - Men&#039;s/Mixed EMEA W2 DIVISION 3 (B),Assioma Duo,wahoo kickr core,311,300,11
99881,359567,2021-01-19 19:21:18,wahoo,Zwift - Zwift Racing League | WTRL - Men&#039;s/Mixed EMEA W2 DIVISION 3 (B),Assioma Duo,wahoo kickr core,273,279,-6
103760,359567,2021-01-26 19:16:59,wahoo,Zwift - Zwift Racing League | WTRL - Men&#039;s/Mixed EMEA W2 DIVISION 3 (B),Assioma Duo,wahoo kickr core,313,321,-8
120489,359567,2021-02-09 19:29:22,wahoo,Zwift - Zwift Racing League | WTRL - Men&#039;s/Mixed EMEA W2 DIVISION 3 (B),Assioma Duo,wahoo kickr core,302,301,1
120491,359567,2021-02-13 08:56:18,wahoo,Zwift - Newbury Velo Weekend TT (E),Assioma Duo,wahoo kickr core,296,301,-5
120495,359567,2021-02-16 19:38:38,wahoo,Zwift - Zwift Racing League | WTRL - Men&#039;s/Mixed EMEA W2 DIVISION 3 (B),Assioma Duo,wahoo kickr core,315,311,4
120497,359567,2021-02-20 08:44:04,wahoo,Zwift - Newbury Velo Weekend TT (E),Assioma Duo,wahoo kickr core,298,295,3
120498,359567,2021-02-23 19:24:35,wahoo,Zwift - Zwift Racing League | WTRL - Men&#039;s/Mixed EMEA W2 DIVISION 3 (B),Assioma Duo,wahoo kickr core,342,325,17
121989,359567,2021-02-27 08:41:27,wahoo,Zwift - Newbury Velo Weekend TT (E),Assioma Duo,wahoo kickr core,321,306,15
123210,359567,2021-03-02 19:26:19,wahoo,Zwift - Zwift Racing League | WTRL - Men&#039;s/Mixed EMEA W2 DIVISION 3 (B),Assioma Duo,wahoo kickr core,294,296,-2
124945,359567,2021-03-06 08:55:34,wahoo,Zwift - Newbury Velo Weekend TT (E),Assioma Duo,wahoo kickr core,306,312,-6
129645,359567,2021-03-10 18:16:55,wahoo,Zwift - UKAF Race night hosting the ACU Champs (B),Assioma Duo,wahoo kickr core,330,312,18
129648,359567,2021-03-13 08:36:13,wahoo,Zwift - Newbury Velo Weekend TT (E),Assioma Duo,wahoo kickr core,270,277,-7
129650,359567,2021-03-17 14:48:51,wahoo,Zwift - UKAF Race night hosting the ACU Champs (B),Assioma Duo,wahoo kickr core,319,312,7
26848,361665,2020-04-22 03:04:25,wahoo,DUAL RECORDING - SETTING UP,Rotor INPower (Secondary),Wahoo KICKR &#039;18 (Primary),223,225,-2
27250,361665,2020-04-23 09:45:00,wahoo,Zwift - Koa Sports League Race (A),Rotor INPower (Secondary),Wahoo KICKR &#039;18 (Primary),327,328,-1
27465,361665,2020-04-23 23:00:00,wahoo,Zwift - Koa Sports League Warrior Race (A),Rotor INPower (Secondary),Wahoo KICKR &#039;18 (Primary),296,302,-6
30339,361665,2020-05-01 23:59:57,wahoo,Zwift - NRS Invitational - Week 1 (B),Rotor INPower (Secondary),Wahoo KICKR &#039;18 (Primary),333,326,7
34980,361665,2020-05-15 09:50:54,wahoo,POST CALIBRATION - MASSIVE WATTS HERE,Rotor INPower (Secondary),Wahoo KICKR &#039;18 (Primary),114,114,0
35159,361665,2020-05-16 00:14:59,wahoo,Zwift - NRS Invitational - Week 2 (B),Rotor INPower (Secondary),Wahoo KICKR &#039;18 (Primary),307,301,6
36526,361665,2020-05-19 09:10:09,wahoo,Zwift - SRAM Send it Series - Race 2 - Men&#039;s (E),Rotor INPower (Secondary),Wahoo KICKR &#039;18 (Primary),321,313,8
36529,361665,2020-05-20 09:44:56,wahoo,Zwift - USA Cycling Race League by Indoor Specialist (A),Rotor INPower (Secondary),Wahoo KICKR &#039;18 (Primary),294,284,10
38356,361665,2020-05-28 18:16:59,wahoo,Zwift - Tour for All Invitational Race // Men (A),Rotor INPower (Secondary),Wahoo KICKR &#039;18 (Primary),367,371,-4
45216,361665,2020-07-07 07:59:58,wahoo,Zwift - KISS at Race - Down Under (A),Rotor INPower (Secondary),Wahoo KICKR &#039;18 (Primary),296,298,-2
45219,361665,2020-07-02 10:00:01,wahoo,Zwift - Koa Sports League Race (A),Rotor INPower (Secondary),Wahoo KICKR &#039;18 (Primary),304,302,2
45222,361665,2020-06-27 00:30:22,wahoo,Zwift - TFC Summer Series (A),Rotor INPower (Secondary),Wahoo KICKR &#039;18 (Primary),314,311,3
45223,361665,2020-06-25 10:00:03,wahoo,Zwift - Koa Sports League Race (A),Rotor INPower (Secondary),Wahoo KICKR &#039;18 (Primary),312,316,-4
45224,361665,2020-06-18 09:59:57,wahoo,Zwift - Koa Sports League Race (A),Rotor INPower (Secondary),Wahoo KICKR &#039;18 (Primary),311,313,-2
45225,361665,2020-06-13 00:00:02,wahoo,Zwift - NRS Invitational - Week 4 (B),Rotor INPower (Secondary),Wahoo KICKR &#039;18 (Primary),311,315,-4
49943,361665,2020-08-14 08:49:55,wahoo,Zwift - Off the MAAP Invitational Race // Stage 1 (Men) (A),Rotor INPower (Secondary),Wahoo KICKR &#039;18 (Primary),329,328,1
50575,361665,2020-08-18 18:40:00,wahoo,Zwift - 3R Turbocharged Team Race Series - Round 6 (A),Rotor INPower (Secondary),Wahoo KICKR &#039;18 (Primary),299,302,-3
50930,361665,2020-08-20 15:15:03,wahoo,Zwift - OH MY CRIT! - The Double Race 1/2 (A),Rotor INPower (Secondary),Wahoo KICKR &#039;18 (Primary),306,311,-5
50931,361665,2020-08-20 16:05:02,wahoo,Zwift - OH MY CRIT! - The Double Race 2/2 (A),Rotor INPower (Secondary),Wahoo KICKR &#039;18 (Primary),261,270,-9
52439,361665,2020-08-29 07:51:55,wahoo,Zwift - Paris,Power2Max NGEco (Secondary),Wahoo KICKR CORE (Primary),213,209,4
53813,361665,2020-09-07 18:19:59,wahoo,Zwift - TFC Mad Monday Summer Series (10 of 10) (A),Rotor INPower (Secondary),Wahoo KICKR &#039;18 (Primary),313,321,-8
54181,361665,2020-09-09 18:05:00,wahoo,Zwift - DBR Wednesday Race (A),Rotor INPower (Secondary),Wahoo KICKR &#039;18 (Primary),345,357,-12
54373,361665,2020-09-10 15:14:54,wahoo,Zwift - OH MY CRIT! - The Double Race 1/2 (A),Rotor INPower (Secondary),Wahoo KICKR &#039;18 (Primary),309,317,-8
54374,361665,2020-09-10 16:04:56,wahoo,Zwift - OH MY CRIT! - The Double Race 2/2 (A),Rotor INPower (Secondary),Wahoo KICKR &#039;18 (Primary),284,290,-6
60517,361665,2020-10-09 05:02:06,wahoo,Zwift - Zwift Fast Fridays: Tempus Fugit Time Trial (E),Rotor INPower (Secondary),Wahoo KICKR &#039;18 (Primary),322,331,-9
65295,361665,2020-10-22 09:59:57,wahoo,Zwift - KISS at Race - Americas AM (A),Rotor INPower (Secondary),Wahoo KICKR &#039;18 (Primary),322,331,-9
65296,361665,2020-10-27 07:09:57,wahoo,Zwift - 3R UCI Worlds Race - 1 Lap (23.7km/14.7mi 494m) (A),Rotor INPower (Secondary),Wahoo KICKR &#039;18 (Primary),317,322,-5
80912,361665,2020-12-08 19:44:58,wahoo,Zwift - Zwift Racing League | WTRL - Men&#039;s EMEA W1 DIVISION 1 (A),Rotor INPower (Secondary),Wahoo KICKR &#039;18 (Primary),300,309,-9
22239,364329,2020-03-21 07:10:01,wahoo,Zwift - Team ZWC Weekend Race  (A),FC-R9100P,Kickr core,271,281,-10
22243,364329,2020-03-14 07:09:57,wahoo,Zwift - Team ZWC Weekend Race  (A),FC-R9100P,Kickr core,278,287,-9
35138,365220,2020-05-15 18:31:32,wahoo,Zwift - Newbury Velo Crit (A),Quarq DZero,Wahoo Kickr,356,376,-20
45147,365220,2020-06-18 11:19:53,wahoo,Zwift - British Cycling Time Trial Series (A),Quarq DZero,Wahoo Kickr,357,382,-25
124346,365220,2021-03-04 18:29:03,wahoo,Zwift - FUSION SPRING CUP (A),Quarq DZero,Wahoo Kickr,348,368,-20
127692,365220,2021-03-11 18:23:27,wahoo,Zwift - FUSION SPRING CUP (A),Quarq DZero,Wahoo Kickr,351,369,-18
36481,369330,2020-05-20 16:10:07,wahoo,Zwift - Team 3R&#039;s Choice: Stage 5 Longer Race A/B,Powertap P2 pedals,Wahoo Kickr4,424,426,-2
36719,369330,2020-05-21 17:15:07,wahoo,Zwift - WTRL Team Time Trial (D),Powertap P2 pedals,Wahoo Kickr4,374,378,-4
38110,369330,2020-05-27 16:25:00,wahoo,Zwift - Tour for All 2020: Stage 3 Longer Race A/B,Powertap P2 pedals,Wahoo Kickr4,428,417,11
38336,369330,2020-05-28 17:13:20,wahoo,Zwift - WTRL Team Time Trial (D),Powertap P2 pedals,Wahoo Kickr4,397,396,1
38523,369330,2020-05-29 05:20:01,wahoo,Zwift - Tour for All 2020: Stage 3 Longer Ride,Powertap P2 pedals,Wahoo Kickr4,363,377,-14
39403,369330,2020-06-03 16:00:14,wahoo,Zwift - SSAT Ace Cycles Virtual Racing Series (A),Powertap P2 pedals,Wahoo Kickr4,372,374,-2
40628,369330,2020-06-09 14:48:14,wahoo,Zwift - ZHR Masters Europe (B),Powertap P2 pedals,Wahoo Kickr4,380,385,-5
41113,369330,2020-06-11 17:14:21,wahoo,Zwift - Frappe,Powertap P2 pedals,Wahoo Kickr4,377,378,-1
42054,369330,2020-06-16 16:30:15,wahoo,Zwift - ZHR Masters Europe (B),Powertap P2 pedals,Wahoo Kickr4,399,401,-2
42187,369330,2020-06-17 15:29:47,wahoo,Zwift - SSAT Ace Cycles Virtual Racing Series (A),Powertap P2 pedals,Wahoo Kickr4,368,371,-3
43291,369330,2020-06-23 15:53:50,wahoo,Zwift - ZHR Masters Europe (B),Powertap P2 pedals,Wahoo Kickr4,395,400,-5
44295,369330,2020-06-30 16:07:45,wahoo,Zwift - ZHR Masters Europe (B),Powertap P2 pedals,Wahoo Kickr4,360,368,-8
45481,369330,2020-07-08 15:42:39,wahoo,Zwift - Support SA Talent Virtual Racing Series (A),Powertap P2 pedals,Wahoo Kickr Core,365,368,-3
45683,369330,2020-07-09 15:34:25,wahoo,Zwift - Mocha,Powertap P2 pedals,Wahoo Kickr4,395,402,-7
46457,369330,2020-07-15 14:00:05,wahoo,Zwift - Support SA Talent Virtual Racing Series (A),Powertap P2 pedals,Wahoo Kickr4,360,367,-7
46847,369330,2020-07-17 13:53:57,wahoo,Zwift - Virtual Tour de France - Open - Stage 3 Discovery Ride,Powertap P2 pedals,Wahoo Kickr4,351,358,-7
46848,369330,2020-07-17 13:53:57,wahoo,Zwift - Virtual Tour de France - Open - Stage 3 Discovery Ride,Powertap P2 pedals,Wahoo Kickr4,315,323,-8
47202,369330,2020-07-21 15:39:42,wahoo,Zwift - ZHR Masters Europe (B),Powertap P2 pedals,Wahoo Kickr4,354,359,-5
47212,369330,2020-07-14 16:13:36,wahoo,Zwift - ZHR Masters Europe (B),Powertap P2 pedals,Wahoo Kickr4,366,378,-12
48177,369330,2020-07-29 16:00:13,wahoo,Zwift - Support SA Talent Virtual Racing Series (A),Powertap P2 pedals,Wahoo Kickr4,324,327,-3
48180,369330,2020-07-29 08:00:20,wahoo,Zwift - SAS - Out & Back (C),Powertap P2 pedals,Wahoo Kickr4,287,290,-3
51266,369330,2020-08-22 04:00:01,wahoo,Zwift - 3R 160 Steady Ride [~3.0w/kg avg] (B),Powertap P2 pedals,Wahoo Kickr4,292,292,0
51267,369330,2020-08-22 04:00:01,wahoo,Zwift - SAS -  Tempus 100km (C),Powertap P2 pedals,Wahoo Kickr4,243,246,-3
52269,369330,2020-08-27 16:50:03,wahoo,Zwift - WTRL Team Time Trial (B),Powertap P2 pedals,Wahoo Kickr4,386,389,-3
52545,369330,2020-08-29 03:00:01,wahoo,Zwift - Murray Craib (Uwe Koetter Z)&#039;s Meetup - Tire-Bouchon,Powertap P2 pedals,Wahoo Kickr4,239,243,-4
60293,369330,2020-10-08 07:00:01,wahoo,Zwift Academy Road: Workout 2 | Sprint Profile,Powertap P2 pedals,Wahoo Kickr4,297,304,-7
60294,369330,2020-10-08 07:00:48,wahoo,Zwift Academy Road: Workout 4 | Anaerobic Resilience,Powertap P2 pedals,Wahoo Kickr4,346,347,-1
61104,369330,2020-10-12 07:15:28,wahoo,Zwift Academy Road: Workout 6 | Alternative Sprints,Powertap P2 pedals,Wahoo Kickr4,319,320,-1
68369,369330,2020-11-05 18:09:38,wahoo,Zwift - Frappe,Powertap P2 pedals,Wahoo Kickr4,396,396,0
123568,369330,2021-03-03 14:36:46,wahoo,Zwift - Zwift Duathlon League - Bike (B),Powertap P2 pedals,Wahoo Kickr4,376,370,6
123576,369330,2021-02-17 14:47:29,wahoo,Zwift - Zwift Duathlon League - Bike,Powertap P2 pedals,Wahoo Kickr4,338,344,-6
127156,369330,2021-03-11 17:08:44,wahoo,Zwift - WTRL Team Time Trial - Zone 3 (D),Powertap P2 pedals,Wahoo Kickr4,363,363,0
127162,369330,2021-03-11 06:40:21,wahoo,Zwift - Zwift Duathlon League - Bike (B),Powertap P2 pedals,Wahoo Kickr4,387,383,4
33219,369571,2020-05-09 08:49:38,wahoo,Zwift - CIZL Rd 7 – Sean Lynch Memorial (A),Rotor 2inpower,Wahoo Kickr,437,451,-14
33680,369571,2020-05-11 16:56:04,wahoo,Zwift - DBR Wahoo League (A),Rotor 2inpower,Wahoo Kickr,400,424,-24
33827,369571,2020-05-12 09:10:16,wahoo,Zwift - SRAM Send it Series - Race 1 - Men&#039;s (E),Rotor 2inpower,Wahoo Kickr,420,439,-19
34254,369571,2020-05-13 08:51:46,wahoo,Zwift - AHDR p/b Giant (B),Rotor 2inpower,Wahoo Kickr,464,481,-17
36001,369571,2020-05-19 09:09:19,wahoo,Zwift - SRAM Send it Series - Race 2 - Men&#039;s (E),Rotor 2inpower,Wahoo Kickr,429,440,-11
38252,369571,2020-05-28 09:12:53,wahoo,Zwift - Cycling Australia&#039;s The Chop by AHDR (A),Rotor 2inpower,Wahoo Kickr,370,384,-14
38575,369571,2020-05-29 17:51:22,wahoo,Zwift - TeamPTz Friday&#039;s Race League (A),Rotor 2inpower,Wahoo Kickr,430,429,1
38958,369571,2020-06-01 17:11:13,wahoo,Zwift - DBR Wahoo League (A) - 3rd,Rotor 2inpower,Wahoo Kickr,385,394,-9
39056,369571,2020-06-02 09:08:39,wahoo,Zwift - SRAM Send it Series - Race 4 - Men&#039;s (E) - 11th,Rotor 2inpower,Wahoo Kickr,437,445,-8
39270,369571,2020-06-03 09:35:38,wahoo,Zwift - USA Cycling Race League by Indoor Specialist (A) 1st,Rotor 2inpower,Wahoo Kickr,361,381,-20
39372,369571,2020-06-03 17:53:20,wahoo,Zwift - USA Cycling Race League by Indoor Specialist (A) evening edition - 14th,Rotor 2inpower,Wahoo Kickr,398,408,-10
39905,369571,2020-06-05 17:49:19,wahoo,Zwift - TeamPTz Friday&#039;s Race League (A) - 7th,Rotor 2inpower,Wahoo Kickr,417,423,-6
40473,369571,2020-06-09 09:02:29,wahoo,Zwift - SRAM Send it Series - Race 5 - Men&#039;s (E),Rotor 2inpower,Wahoo Kickr,419,425,-6
40716,369571,2020-06-10 09:40:51,wahoo,Zwift - USA Cycling Race League by Indoor Specialist (A) - 1st,Rotor 2inpower,Wahoo Kickr,427,432,-5
41026,369571,2020-06-11 15:04:17,wahoo,Zwift - OH CRIT!! - Lockdown Series - Round 2 Race 1 (A),Rotor 2inpower,Wahoo Kickr,426,449,-23
41291,369571,2020-06-12 17:50:28,wahoo,Zwift - TeamPTz Friday&#039;s Race League (A) - 4th,Rotor 2inpower,Wahoo Kickr,414,426,-12
41914,369571,2020-06-16 09:05:28,wahoo,Zwift - SRAM Send it Series - Race 6 - Men&#039;s (E) - 8th,Rotor 2inpower,Wahoo Kickr,400,428,-28
42193,369571,2020-06-17 15:59:52,wahoo,Zwift - SSAT Ace Cycles Virtual Racing Series (A) - 4th,Rotor 2inpower,Wahoo Kickr,402,415,-13
43207,369571,2020-06-23 09:03:19,wahoo,Zwift - SRAM Send it Series - Race 7 - Men&#039;s (E),Rotor 2inpower,Wahoo Kickr,454,459,-5
43346,369571,2020-06-24 09:42:40,wahoo,Zwift - USA Cycling Race League by Indoor Specialist (A) - 1st,Rotor 2inpower,Wahoo Kickr,470,480,-10
43383,369571,2020-06-24 16:51:36,wahoo,Zwift - FutureWorks Boost Mode Test Race (A) - 2nd,Rotor 2inpower,Wahoo Kickr,398,408,-10
43719,369571,2020-06-26 17:51:18,wahoo,Zwift - TeamPTz Friday&#039;s Race League (A),Rotor 2inpower,Wahoo Kickr,381,391,-10
43962,369571,2020-06-28 13:46:15,wahoo,Zwift - Support SA Talent Virtual Racing Series(A) aka Knysna Cycle Tour - 2nd,Rotor 2inpower,Wahoo Kickr,411,422,-11
44199,369571,2020-06-30 09:05:35,wahoo,Zwift - SRAM Send it Series - Race 8 - Men&#039;s (E) - 12th,Rotor 2inpower,Wahoo Kickr,430,432,-2
44432,369571,2020-07-01 17:47:38,wahoo,Zwift - USA Cycling Race League by Indoor Specialist (A),Rotor 2inpower,Wahoo Kickr,434,452,-18
45144,369571,2020-07-06 18:15:32,wahoo,Zwift - TFC Mad Monday Summer Series (1 of 9) (A),Rotor 2inpower,Wahoo Kickr,402,419,-17
45465,369571,2020-07-08 17:45:36,wahoo,Zwift - USA Cycling Race League by Indoor Specialist (A),Rotor 2inpower,Wahoo Kickr,399,408,-9
45808,369571,2020-07-10 17:56:55,wahoo,Zwift - World Elite Zwifters Friday&#039;s Race (A),Rotor 2inpower,Wahoo Kickr,421,417,4
46478,369571,2020-07-15 17:50:21,wahoo,Zwift - USA Cycling Race League by Indoor Specialist (A),Rotor 2inpower,Wahoo Kickr,407,403,4
47191,369571,2020-07-21 18:24:42,wahoo,Zwift - 3R Turbocharged Team Race Series - Round 2 (A),Rotor 2inpower,Wahoo Kickr,374,376,-2
47333,369571,2020-07-22 17:51:08,wahoo,Zwift - USA Cycling Race League by Indoor Specialist (A),Rotor 2inpower,Wahoo Kickr,392,394,-2
49828,369571,2020-08-13 15:11:42,wahoo,Zwift - OH MY CRIT! - The Double Race 1/2 (A),Rotor 2inpower,Wahoo Kickr,380,386,-6
49927,369571,2020-08-14 08:50:14,wahoo,Zwift - Off the MAAP Invitational Race // Stage 1 (Men) (A) - 19th,Rotor 2inpower,Wahoo Kickr,393,405,-12
50847,369571,2020-08-20 08:36:54,wahoo,Zwift - Off the MAAP Invitational Race // Stage 3 (men) ,Rotor 2inpower,Wahoo Kickr,401,407,-6
51466,369571,2020-08-24 09:21:52,wahoo,Zwift - Off the MAAP Invitational Race // Stage 4 (men) ,Rotor 2inpower,Wahoo Kickr,385,390,-5
51669,369571,2020-08-25 14:56:33,wahoo,Zwift - 3R Turbocharged Team Race Series - Bonus Round (A),Rotor 2inpower,Wahoo Kickr,390,404,-14
52772,369571,2020-08-31 18:07:08,wahoo,Zwift - TFC Mad Monday Summer Series (9 of 10) (A),Rotor 2inpower,Wahoo Kickr,384,398,-14
52939,369571,2020-09-01 18:31:47,wahoo,Zwift - 3R Sundown Race Series - Round1 iTT,Rotor 2inpower,Wahoo Kickr,378,395,-17
53774,369571,2020-09-07 18:08:54,wahoo,Zwift - 09/07/2020,Rotor 2inpower,Wahoo Kickr,320,330,-10
54002,369571,2020-09-08 18:32:11,wahoo,Zwift - 3R Sundown Race Series  (E),Rotor 2inpower,Wahoo Kickr,393,400,-7
54177,369571,2020-09-09 17:50:14,wahoo,Zwift - DBR Wednesday Race (A),Rotor 2inpower,Wahoo Kickr,400,415,-15
55099,369571,2020-09-14 17:38:10,wahoo,Zwift - Invitational League // Qualifying Race #1,Rotor 2inpower,Wahoo Kickr,381,388,-7
55947,369571,2020-09-17 18:02:53,wahoo,Zwift - Invitational League // Qualifying Race #2 (Men) ,Rotor 2inpower,Wahoo Kickr,370,388,-18
57250,369571,2020-09-24 16:04:00,wahoo,Zwift - OH MY CRIT! - The Double Race 2/2 (A),Rotor 2inpower,Wahoo Kickr,363,381,-18
62489,369571,2020-10-16 18:05:19,wahoo,Zwift Academy Road: Workout 1 | Aerobic Power,Rotor 2inpower,Wahoo Kickr,353,353,0
63429,369571,2020-10-20 17:19:42,wahoo,Zwift - WTRL Racing (A),Rotor 2inpower,Wahoo Kickr,424,435,-11
65185,369571,2020-10-26 19:36:38,wahoo,Zwift - Premier Division // Zwift Racing League (men) (A),Rotor 2inpower,Wahoo Kickr,389,404,-15
66426,369571,2020-10-30 13:31:56,wahoo,Zwift Academy Tri: Bike Workout 1 | Endurance Strength Development,Rotor 2inpower,Wahoo Kickr,273,270,3
67277,369571,2020-11-02 18:31:05,wahoo,Zwift - Premier Division // Zwift Racing League (men) (A),Rotor 2inpower,Wahoo Kickr,408,422,-14
69458,369571,2020-11-09 19:43:30,wahoo,Zwift - Premier Division // Zwift Racing League (men) (A),Rotor 2inpower,Wahoo Kickr,444,446,-2
72828,369571,2020-11-18 17:39:43,wahoo,Zwift - MIDWEEK Autumn Series by SZR (A),Rotor 2inpower,Wahoo Kickr,389,402,-13
74724,369571,2020-11-23 19:42:33,wahoo,Zwift - Premier Division // Zwift Racing League (men) (A),Rotor 2inpower,Wahoo Kickr,415,435,-20
75546,369571,2020-11-25 17:13:44,wahoo,Zwift - 30-39 years,Rotor 2inpower,Wahoo Kickr,361,385,-24
76095,369571,2020-11-26 17:44:22,wahoo,Zwift - WTRL NOPINZ WORLD TTT CHAMPIONSHIPS - Zone 4 (C),Rotor 2inpower,Wahoo Kickr,388,406,-18
77731,369571,2020-11-30 18:28:55,wahoo,Zwift - Premier Division // Zwift Racing League (men) (A),Rotor 2inpower,Wahoo Kickr,390,405,-15
78568,369571,2020-12-02 17:47:17,wahoo,Zwift - MIDWEEK Winter Series by SZR (A),5904463206_ACTIVITY,Wahoo Kickr,400,418,-18
82018,369571,2020-12-11 17:59:07,wahoo,Zwift - KIRCHMAIR Race Series (A),Rotor 2inpower,Wahoo Kickr,413,425,-12
82020,369571,2020-12-11 17:59:07,wahoo,Zwift - KIRCHMAIR Race Series (A),Rotor 2inpower,Wahoo Kickr,413,426,-13
84307,369571,2020-12-17 16:14:23,wahoo,Zwift - OH MY CRIT! - The Double Race 1/2 (A),Rotor 2inpower,Wahoo Kickr,391,410,-19
94982,369571,2021-01-11 18:47:30,wahoo,Zwift - Premier Division // Zwift Racing League (men) (A),Rotor 2inpower,Wahoo Kickr,391,401,-10
96902,369571,2021-01-14 17:04:43,wahoo,Zwift - OH MY CRIT! - The Double Race 2/2 (A),Rotor 2inpower,Wahoo Kickr,385,395,-10
99221,369571,2021-01-18 19:28:44,wahoo,Zwift - Premier Division // Zwift Racing League (men) (A),Rotor 2inpower,Wahoo Kickr,381,391,-10
100882,369571,2021-01-21 17:01:21,wahoo,Zwift - OH MY CRIT! - The Double Race 2/2 (A),Rotor 2inpower,Wahoo Kickr,393,410,-17
106130,369571,2021-01-31 12:03:01,wahoo,Zwift - 3R Whole Lotta Lava Hilly Race - 1 Lap (16.9km/10.5mi 183m) (A),Rotor 2inpower,Wahoo Kickr,375,392,-17
106941,369571,2021-02-01 20:03:23,wahoo,Zwift - Premier Division // Zwift Racing League (men) (A),Rotor 2inpower,Wahoo Kickr,409,424,-15
111020,369571,2021-02-08 19:24:35,wahoo,Zwift - Premier Division // Zwift Racing League (men) (A),Rotor 2inpower,Wahoo Kickr,410,421,-11
112239,369571,2021-02-10 17:13:56,wahoo,Zwift - Masters SA (A),Rotor 2inpower,Wahoo Kickr,396,412,-16
115393,369571,2021-02-15 19:55:47,wahoo,Zwift - Premier Division // Zwift Racing League (men) (A),Rotor 2inpower,Wahoo Kickr,433,447,-14
119106,369571,2021-02-22 19:09:55,wahoo,Zwift - Premier Division // Zwift Racing League (men) (A),Rotor 2inpower,Wahoo Kickr,353,371,-18
122604,369571,2021-03-01 20:21:11,wahoo,Zwift - Premier Division // Zwift Racing League (men) (A),Rotor 2inpower,Wahoo Kickr,388,406,-18
123538,369571,2021-03-03 18:05:53,wahoo,Zwift - Paris,Rotor 2inpower,Wahoo Kickr,144,143,1
109760,369742,2021-02-06 07:00:29,neo,Zwift - EVO CC 160km Base Ride [3.0-3.2w/kg avg] (B),Vector,Neo,260,275,-15
74198,371455,2020-11-22 12:20:17,wahoo,Zwift - ODZentury Endurance Builder Ride (B),Powertap P1 Doublesided,Wahoo Kickr Axxis,214,219,-5
76837,371455,2020-11-27 18:02:15,wahoo,Zwift - ZRG-CC Falling Leaves Tour (B),Powertap P1 Doublesided,Wahoo Kickr Axxis,271,279,-8
79538,371455,2020-12-04 18:02:20,wahoo,Zwift - ZRG-CC Falling Leaves Tour (B),Powertap P1 Doublesided,Wahoo Kickr V5 Axxis,295,303,-8
122986,372540,2021-03-02 18:24:16,neo,Zwift - Roll with Castelli & Laura Philipp (C),Assioma DUO,Tacx Neo Bike Smart,307,318,-11
123578,372540,2021-03-03 17:57:36,neo,Zwift - MIDWEEK Crit Race Series by SZR (A),Assioma DUO,Tacx Neo Bike Smart,365,354,11
124878,372540,2021-03-06 10:24:56,neo,Zwift - Cycling Weekly Winter Lockdown RR Series (A),Assioma DUO,Tacx Neo Bike Smart,364,364,0
126582,372540,2021-03-10 17:56:48,neo,Zwift - MIDWEEK Crit Race Series by SZR (A),Assioma DUO,Tacx Neo Bike Smart,348,353,-5
126584,372540,2021-03-10 18:20:39,neo,Zwift - UKAF Race night hosting the ACU Champs (A),Assioma DUO,Tacx Neo Bike Smart,319,332,-13
127567,372540,2021-03-12 17:47:16,neo,Zwift - KIRCHMAIR Race Series (A),Assioma DUO,Tacx Neo Bike Smart,350,351,-1
127568,372540,2021-03-12 18:23:32,neo,Zwift - KIRCHMAIR Race Series (A),Assioma DUO,Tacx Neo Bike Smart,356,358,-2
129221,372540,2021-03-12 18:23:32,neo,Zwift - CeramicSpeed Race Series: Open Race (A),Assioma DUO,Tacx Neo Bike Smart,356,364,-8
129234,372540,2021-03-16 18:21:26,neo,Zwift - CeramicSpeed Race Series: Open Race (A),Assioma DUO,Tacx Neo Bike Smart,381,364,17
7712,372588,2019-12-31 05:24:57,wahoo,Zwift - 5 X Under/Overs,Quarq,Wahoo KICKR,278,285,-7
10510,372588,2020-01-22 19:07:15,wahoo,Zwift - DBR HEINO CUP (E),Quarq,Wahoo KICKR,286,285,1
10511,372588,2020-01-22 05:04:57,wahoo,Zwift - Vikings Valhalla Wake-up Ride (C),Quarq,Wahoo KICKR,198,209,-11
11096,372588,2020-01-26 20:43:48,wahoo,Zwift - NYC,Quarq,Wahoo KICKR,158,157,1
49316,372588,2020-08-08 20:43:55,wahoo,Zwift - London,Favero Assioma pedals,Wahoo KICKR,178,182,-4
50330,372588,2020-08-17 08:43:32,wahoo,Zwift - Off the MAAP Invitational Race // Stage 2 (Women) ,Favero Assioma pedals,Wahoo KICKR,295,302,-7
55234,372588,2020-09-14 18:28:37,wahoo,Zwift - Invitational League // Qualifying Race #1 (Women),Favero Assioma pedals,Wahoo KICKR,291,300,-9
55981,372588,2020-09-17 17:57:57,wahoo,Zwift - Invitational League // Qualifying Race #2 (Women) ,Favero Assioma pedals,Wahoo KICKR,266,271,-5
63197,372588,2020-10-19 19:13:31,wahoo,Zwift - Premier Division // Zwift Racing League (women) (A),Favero Assioma pedals,Wahoo KICKR,293,292,1
65142,372588,2020-10-26 19:01:54,wahoo,Zwift - Premier Division // Zwift Racing League (women) ,Favero Assioma pedals,Wahoo KICKR,289,288,1
67341,372588,2020-11-02 20:06:52,wahoo,Zwift - Premier Division // Zwift Racing League (women) (A),Favero Assioma pedals,Wahoo KICKR,298,299,-1
72507,372588,2020-11-16 19:59:09,wahoo,Zwift - Premier Division // Zwift Racing League (women) (A),Favero Assioma pedals,Wahoo KICKR,276,278,-2
74672,372588,2020-11-23 18:51:29,wahoo,Zwift - Premier Division // Zwift Racing League (women) (A),Favero Assioma pedals,Wahoo KICKR,301,303,-2
77759,372588,2020-11-30 20:05:00,wahoo,Zwift - Premier Division // Zwift Racing League (women) (A),Favero Assioma pedals,Wahoo KICKR,292,286,6
79541,372588,2020-12-04 18:51:13,neo,Zwift - Watopia,2020-12-05-05-51-13,Tacx Neo II,195,194,1
82611,372588,2020-12-09 13:42:24,neo,Zwift - Women&#039;s Elite // 2020 UCI Cycling Esports World Championships,Quarq,Tacx Neo II,287,276,11
82612,372588,2020-12-12 19:26:42,wahoo,Zwift - Fearless Women&#039;s Team Championships - 2020 (A),Favero Assioma pedals,Wahoo KICKR,282,279,3
95144,372588,2021-01-11 20:02:13,wahoo,Zwift - Premier Division // Zwift Racing League (women) (A),Favero Assioma pedals,Wahoo KICKR,287,306,-19
99094,372588,2021-01-18 19:09:42,wahoo,PL race 2 TTT,Favero Assioma pedals,Wahoo KICKR,287,289,-2
103097,372588,2021-01-25 20:01:25,wahoo,Zwift - Premier Division // Zwift Racing League (women) (A),Wahoo KICKR,Wahoo KICKR,294,297,-3
103099,372588,2021-01-25 20:01:25,wahoo,Zwift - Premier Division // Zwift Racing League (women) (A),Favero Assioma pedals,Wahoo KICKR,294,297,-3
106845,372588,2021-02-01 19:01:10,wahoo,Zwift - Premier Division // Zwift Racing League (women) (A),Favero Assioma pedals,Wahoo KICKR,304,304,0
111133,372588,2021-02-08 20:00:16,wahoo,Zwift - Premier Division // Zwift Racing League (women) (A),Favero Assioma pedals,Wahoo KICKR,308,306,2
117448,372588,2021-02-18 18:50:26,wahoo,Zwift - Espresso,Favero Assioma pedals,Wahoo KICKR,276,278,-2
119244,372588,2021-02-22 19:55:49,wahoo,Zwift - Premier Division // Zwift Racing League (women) (A),Favero Assioma pedals,Wahoo KICKR,279,288,-9
122518,372588,2021-03-01 19:20:03,wahoo,Zwift - Premier Division // Zwift Racing League (women) (A),Favero Assioma pedals,Wahoo KICKR,275,286,-11
35372,375116,2020-05-16 08:14:45,neo,Zwift - DBR Sufferday League (A),SRM,Tacx Neo,374,367,7
36994,375116,2020-05-23 07:09:30,neo,Zwift - ZWC Weekend Race  (A),SRM,Tacx Neo,357,349,8
106041,375116,2021-01-30 09:08:24,neo,Zwift - DBR SufferDay League III (A),SRM,Zwift - Tacx Neo,327,333,-6
69224,375814,2020-11-09 05:58:01,wahoo,Zwift - 3R Octane Interval Ride [~3.2-3.6 w/kg avg] (B),Garmin Vector 3,Kickr 2018,290,287,3
70058,375814,2020-11-11 05:58:27,wahoo,Zwift - 3R VOLT Interval Ride [~2.6-3.2 w/kg avg] (C),Garmin Vector 3,Kickr 2018,240,235,5
70518,375814,2020-11-12 05:58:04,wahoo,Zwift - 3R VOLT Interval Ride [~2.6-3.2 w/kg avg] (C),Garmin Vector 3,Kickr 2018,299,296,3
83212,376443,2020-12-14 18:15:59,wahoo, DBR Monday Race (B),Assioma Favero Duo,Wahoo Kickr v5,329,328,1
84065,376443,2020-12-16 19:06:00,wahoo,Zwift - DBR Wednesday Race (B),Assioma Favero Duo,Wahoo Kickr v5,325,319,6
85823,376443,2020-12-21 18:16:01,wahoo,DBR Monday Race (B),Assioma Favero Duo,Wahoo Kickr v5,327,315,12
47826,376470,2020-07-26 17:49:29,wahoo,Vector 3 / Kickr Core,Vector 3,Kickr Core,140,142,-2
47989,376470,2020-07-28 13:59:22,wahoo,Vector 3 / Kickr Core,Vector 3,Kickr Core,226,244,-18
49203,376470,2020-08-07 09:24:20,wahoo,Kickr Core / Vector 3,Vector 3,Kickr Core,195,207,-12
49206,376470,2020-08-05 10:40:02,wahoo,Kickr Core / Vector 3,Vector 3,Kickr Core,231,242,-11
49207,376470,2020-08-05 16:13:48,wahoo,Kickr Core / Vector 3,Vector 3,Kickr Core,239,250,-11
51277,376470,2020-08-22 17:45:23,wahoo,Vector 3 / Kickr Core,Vector 3,Kickr Core,210,223,-13
51278,376470,2020-08-22 17:31:19,wahoo,Vector 3 / Kickr Core,Vector 3,Kickr Core,187,186,1
51491,376470,2020-08-24 10:14:19,wahoo,Vector 3 / Kickr Core,Vector 3,Kickr Core,185,192,-7
51538,376470,2020-08-24 17:01:17,wahoo,Vector 3 / Kickr Core,Vector 3,Kickr Core,210,212,-2
51540,376470,2020-08-24 17:34:36,wahoo,Kickr Core / Vector 3,Vector 3,Kickr Core,215,219,-4
51875,376470,2020-08-25 16:29:17,wahoo,Vector 3 / Kickr Core,Vector 3,Kickr Core,247,251,-4
51877,376470,2020-08-25 10:59:16,wahoo,Vector 3 / Kickr Core,Vector 3,Kickr Core,239,247,-8
52060,376470,2020-08-26 15:49:41,wahoo,Kickr Core / Vector 3,Vector 3,Kickr Core,242,250,-8
52332,376470,2020-08-28 09:28:58,wahoo,Kickr Core / Vector 3,Vector 3,Kickr Core,203,204,-1
52385,376470,2020-08-28 15:49:51,wahoo,Vector 3 / Kickr Core,Vector 3,Kickr Core,222,224,-2
52437,376470,2020-08-29 06:29:15,wahoo,Kickr Core / Vector 3,Vector 3,Kickr Core,229,229,0
52664,376470,2020-08-29 14:26:20,wahoo,Kickr Core / Vector 3,Vector 3,Kickr Core,238,254,-16
52826,376470,2020-08-31 18:00:02,wahoo,Kickr Core / Vector 3,Vector 3,Kickr Core,182,193,-11
63500,376470,2020-10-17 16:58:59,wahoo,Kickr Core / Vector 3,Vector 3,Kickr Core,236,242,-6
64453,376470,2020-10-23 15:28:57,wahoo,Kickr Core / Vector 3,Vector 3,Kickr Core,255,265,-10
64455,376470,2020-10-23 14:59:40,wahoo,Kickr Core / Vector 3,Vector 3,Kickr Core,184,191,-7
66371,376470,2020-10-30 10:28:54,wahoo,Kickr Core / Vector 3,Vector 3,Kickr Core,195,209,-14
66858,376470,2020-10-31 05:59:35,wahoo,Kickr Core / Vector 3,Vector 3,Kickr Core,183,199,-16
66863,376470,2020-10-26 16:29:32,wahoo,Kickr Core / Vector 3,Vector 3,Kickr Core,232,247,-15
66864,376470,2020-10-26 17:14:15,wahoo,Kickr Core / Afternoon_Ride (22),Afternoon_Ride (22),Kickr Core,248,265,-17
73523,376470,2020-11-20 15:19:51,wahoo,Kickr Core / Assioma,Assioma,Kickr Core,181,191,-10
73527,376470,2020-11-20 15:58:52,wahoo,Kickr Core / Assioma,Assioma,Kickr Core,162,175,-13
73530,376470,2020-11-20 15:46:08,wahoo,Kickr Core / Assioma,Assioma,Kickr Core,221,234,-13
73994,376470,2020-11-21 15:21:25,wahoo,Kickr Core / Assioma,Assioma,Kickr Core,212,221,-9
75092,376470,2020-11-24 17:29:16,wahoo,Kickr Core / Assioma,Assioma,Kickr Core,285,297,-12
76718,376470,2020-11-25 05:38:53,wahoo,Kickr Core / Assioma,Assioma,Kickr Core,181,191,-10
76723,376470,2020-11-26 05:40:01,wahoo,Kickr Core / Assioma,Assioma,Kickr Core,220,232,-12
76724,376470,2020-11-27 16:30:32,wahoo,Kickr Core / Assioma,Assioma,Kickr Core,181,193,-12
76725,376470,2020-11-27 16:59:35,wahoo,Kickr Core / Assioma,Assioma,Kickr Core,236,249,-13
79920,376470,2020-12-05 07:30:27,wahoo,Kickr Core / Assioma,Assioma,Kickr Core,227,237,-10
79922,376470,2020-12-01 18:28:14,wahoo,Kickr Core / Assioma,Assioma,Kickr Core,277,288,-11
87125,376470,2020-12-24 17:03:48,wahoo,Kickr Core / Assioma,Assioma,Kickr Core,279,291,-12
87126,376470,2020-12-23 18:44:42,wahoo,Kickr Core,Assioma,Kickr Core,287,294,-7
87837,376470,2020-12-26 06:59:15,wahoo,Kickr Core / Assioma,Assioma,Kickr Core,226,237,-11
88589,376470,2020-12-29 12:14:22,wahoo,Kickr Core / Assioma,Assioma,Kickr Core,230,242,-12
113479,376470,2021-02-12 16:35:51,wahoo,New KICKR Cor,Assioma,Kickr Core,196,202,-6
113956,376470,2021-02-13 07:02:07,wahoo,Kickr Core / Assioma,Assioma,Kickr Core,191,194,-3
113966,376470,2021-02-13 07:27:46,wahoo,Assioma / Kickr Core,Assioma,Kickr Core,198,207,-9
114569,376470,2021-02-14 09:56:38,wahoo,Kickr Core / Assioma,Assioma,Kickr Core,179,184,-5
114577,376470,2021-02-14 07:30:53,wahoo,Kickr Core / Assioma,Assioma,Kickr Core,273,280,-7
116069,376470,2021-02-16 07:03:25,wahoo,Kickr Core / Assioma,Assioma,Kickr Core,237,249,-12
117017,376470,2021-02-18 07:04:09,wahoo,Kickr Core / Assioma,Assioma,Kickr Core,224,238,-14
117020,376470,2021-02-18 05:59:25,wahoo,Kickr Core / Assioma,Assioma,Kickr Core,278,290,-12
31905,377249,2020-05-06 05:09:50,wahoo,Tour for All 2020: Stage 1 Race,Quarq,Kickr,361,356,5
32886,377249,2020-05-09 08:09:58,wahoo,Tour 4 All 2020: Stage 2 Race,Quarq DZero,Kickr Core,383,385,-2
34120,377249,2020-05-12 19:10:18,wahoo,Kickr Core,Quarq DZero (Zwift),Kickr Core,407,402,5
37000,377249,2020-05-23 08:09:59,wahoo,Kickr Core / Quarq DZero (Zwift),Quarq DZero (Zwift),Kickr Core,388,382,6
38423,377249,2020-05-28 17:15:51,wahoo,Quarq DZero (Zwift) / Kickr Core,Quarq DZero (Zwift),Kickr Core,388,372,16
49919,377249,2020-08-14 08:30:47,wahoo,Zwift - Longer Ride - 7 Days of Tarmac SL7: Stage 3 with Sofiane Behraoui,Quarq DZero (Zwift),Kickr Core,394,404,-10
59092,377249,2020-10-02 15:00:02,wahoo,Zwift - ZA Road Group Ride (A),Quarq DZero (Zwift),Kickr Core,307,307,0
59374,377249,2020-10-04 07:00:05,wahoo,Zwift - FIETS Weekend Warriors - Special guest ride - Long,Quarq DZero (Zwift),Kickr Core,281,275,6
75198,377249,2020-11-24 19:44:57,wahoo,Zwift - Zwift Racing League | WTRL - Men&#039;s EMEA W1 DIVISION 1,Quarq DZero (Zwift),Kickr Core,394,386,8
93232,377249,2021-01-08 08:00:00,wahoo,Zwift - TDZ Stage 1: Longer Ride,Quarq DZero (Zwift),Kickr Core,372,375,-3
96850,377249,2021-01-12 19:51:53,wahoo,Zwift - Zwift Racing League | WTRL - Men&#039;s/Mixed EMEA W2 DIVISION 1 (A),Quarq DZero,Kickr Core (Zwift),412,380,32
100173,377249,2021-01-19 19:56:49,wahoo,Zwift - Zwift Racing League | WTRL - Men&#039;s/Mixed EMEA W2 DIVISION 1 (A),Quarq DZero,Kickr Core (Zwift),362,363,-1
104209,377249,2021-01-26 19:51:55,wahoo,Zwift - Zwift Racing League | WTRL - Men&#039;s/Mixed EMEA W2 DIVISION 1 (A),Quarq DZero,Kickr Core (Zwift),395,392,3
121043,377249,2021-02-23 19:51:53,wahoo,Zwift - Zwift Racing League | WTRL - Men&#039;s/Mixed EMEA W2 DIVISION 1 (A),Quarq DZero,Kickr Core (Zwift),397,385,12
31691,379204,2020-05-05 16:36:59,neo,Power Meter Verification/Comparison,S-Works Quarq Power Spider,Tacx NEO ,339,335,4
90054,379764,2021-01-02 07:12:06,wahoo,Zada test - three sisters,Favero assimao,Wahoo Kickr,363,369,-6
93480,379764,2021-01-08 18:45:55,wahoo,Zwift - Team CLS Racing - Hills &#039;n&#039; Thrills S5 (E),Favero assimao,Wahoo Kickr,403,380,23
95008,379764,2021-01-11 18:49:03,wahoo,Zwift - Premier Division // Zwift Racing League (men) (A),Favero assimao,Wahoo Kickr,407,419,-12
96266,379764,2021-01-13 14:34:56,wahoo,Zwift - 3R Sand & Sequoias - 1 Lap (20km/12.5mi 173m) (A),Favero assimao,Wahoo Kickr,355,362,-7
96938,379764,2021-01-14 18:17:07,wahoo,Zwift - Vienna,Favero assimao,Wahoo Kickr,385,395,-10
98364,379764,2021-01-17 06:30:21,wahoo,Zwift - XRS Races: a Longer and Hard race (A),Favero assimao,Wahoo Kickr,352,359,-7
100250,379764,2021-01-20 12:00:15,wahoo,Zwift - TDZ Stage 4: Longer Ride,Favero assimao,Wahoo Kickr,361,379,-18
102929,379764,2021-01-25 19:04:23,wahoo,Zwift - Premier Division // Zwift Racing League (men) (A),Favero assimao,Wahoo Kickr,404,416,-12
104008,379764,2021-01-27 12:59:53,wahoo,Zwift - TDZ Stage 5: Longer Ride,Favero assimao,Wahoo Kickr,406,426,-20
105414,379764,2021-01-30 08:29:55,wahoo,Zwift - London Lockdown eRace Series: Race 1 (A) 38th ATL,Favero assimao,Wahoo Kickr,397,409,-12
106239,379764,2021-01-31 14:59:20,wahoo,Zwift - TDZ Stage 6: Longer Ride,Favero assimao,Wahoo Kickr,418,418,0
108071,379764,2021-02-03 14:58:59,wahoo,Zwift - Cat A - 4.0 w/kg and above,Favero assimao,Wahoo Kickr,393,408,-15
112396,379764,2021-02-10 18:55:15,wahoo,Zwift - Movistar Team Challenge // Round 1 (A),Favero assimao,Wahoo Kickr,374,380,-6
113601,379764,2021-02-12 18:59:14,wahoo,Zwift - Movistar Team Challenge // Round 1 (men),Favero assimao,Wahoo Kickr,428,432,-4
116732,379764,2021-02-17 18:59:03,wahoo,Zwift - Movistar Team Challenge // Round 2 (men) - Race 3/4,Favero assimao,Wahoo Kickr,371,373,-2
117907,379764,2021-02-19 18:58:00,wahoo,Zwift - Movistar Team Challenge // Round 2 (men),Favero assimao,Wahoo Kickr,436,439,-3
118051,379764,2021-02-20 08:02:56,wahoo,Zwift - 3R Weekend Race Club - Race 1 (A),Favero assimao,Wahoo Kickr,346,348,-2
119116,379764,2021-02-22 19:08:28,wahoo,Zwift - Premier Division // Zwift Racing League (men) (A),Favero assimao,Wahoo Kickr,375,385,-10
120361,379764,2021-02-24 18:29:32,wahoo,Zwift - UKAFC Race Night (A),Favero assimao,Wahoo Kickr,376,383,-7
123575,379764,2021-03-03 14:59:09,wahoo,Zwift - UKAFC Race Night (A),Favero assimao,Wahoo Kickr,416,424,-8
129270,379764,2021-03-16 18:28:23,wahoo,Zwift - CeramicSpeed Race Series: Open Race (A),Favero assimao,Wahoo Kickr,416,409,7
1021,380080,2019-08-30 23:49:58,wahoo,Zwift - Japan Weekend Hill Climb Race - Richmond Hilly 8laps (A),Favero Assioma DUO Right Axle Replaced,Wahoo Kickr Core (without ANT+ Control),281,278,3
2605,380080,2019-09-26 10:34:59,wahoo,Zwift - Japan ZWIFT Hillclimb Race (A),Favero Assioma DUO New One,Wahoo Kickr Core (without ANT+ Control),325,323,2
10957,380080,2020-01-26 05:59:06,wahoo,Zwift - 01/26/2020,Favero Assioma DUO New One,Wahoo Kickr Core (without ANT+ Control),337,335,2
18095,380080,2020-03-15 08:07:56,wahoo,Zwift - 03/15/2020,Favero Assioma DUO New One,Wahoo Kickr Core (without ANT+ Control),337,338,-1
21657,380080,2020-04-03 08:59:56,wahoo,Zwift -  Haute Route Watopia Stage 1 (E),Favero Assioma DUO New One,Wahoo Kickr Core (without ANT+ Control),331,331,0
21926,380080,2020-04-04 08:59:55,wahoo, Haute Route Watopia Stage 2,Favero Assioma DUO New One,Wahoo Kickr Core (without ANT+ Control),322,322,0
22184,380080,2020-04-05 08:59:56,wahoo,Zwift -  Haute Route Watopia Stage 3 (E),Favero Assioma DUO New One,Wahoo Kickr Core (without ANT+ Control),340,334,6
25801,380080,2020-04-18 07:59:56,wahoo,Zwift - Matando O Corpo ZESP by SARIS (A),Favero Assioma DUO New One,Wahoo Kickr Core (without ANT+ Control),324,324,0
40113,380080,2020-06-07 06:59:53,wahoo,Zwift - Virtual Mt.Fuji Hill Climb Race ,Favero Assioma DUO New One,Wahoo Kickr Core (without ANT+ Control),311,314,-3
43882,380080,2020-06-28 01:29:56,wahoo,Zwift - Clubteam Weekend Race (A),Favero Assioma DUO New One,Wahoo Kickr Core (without ANT+ Control),328,330,-2
61435,380080,2020-10-13 08:44:59,wahoo,Zwift - 10/13/2020,Favero Assioma DUO New One,Wahoo Kickr Core (without ANT+ Control),322,322,0
63323,380080,2020-10-20 08:49:41,wahoo,Zwift - Zwift Racing League | WTRL - APAC (MEN) - TTT (A),Favero Assioma DUO New One,Wahoo Kickr Core (without ANT+ Control),322,323,-1
65318,380080,2020-10-27 08:44:38,wahoo,Zwift - 10/27/2020,Favero Assioma DUO New One,Wahoo Kickr Core (without ANT+ Control),301,311,-10
67497,380080,2020-11-03 09:03:54,wahoo,Zwift - Zwift Racing League | WTRL - Men&#039;s APAC DIVISION 1 (A),Favero Assioma DUO New One,Wahoo Kickr Core (without ANT+ Control),322,343,-21
68926,380080,2020-11-08 01:00:01,wahoo,Zwift - Road to Okinawa Race (A),Favero Assioma DUO New One,Wahoo Kickr Core (without ANT+ Control),315,329,-14
69586,380080,2020-11-10 08:44:54,wahoo,Zwift - Zwift Racing League | WTRL - APAC (MEN) -  Division 1 (A),Favero Assioma DUO New One,Wahoo Kickr Core (without ANT+ Control),329,342,-13
72070,380080,2020-11-17 08:55:14,wahoo,Zwift - Zwift Racing League | WTRL - Men&#039;s APAC DIVISION 1 (A),Favero Assioma DUO New One,Wahoo Kickr Core (without ANT+ Control),322,327,-5
74847,380080,2020-11-24 08:44:59,wahoo,Zwift - Zwift Racing League | WTRL - Men&#039;s APAC DIVISION 1,Favero Assioma DUO New One,Wahoo Kickr Core (without ANT+ Control),351,365,-14
77888,380080,2020-12-01 08:55:13,wahoo,Zwift - Zwift Racing League | WTRL - Men&#039;s APAC DIVISION 1 (A),Favero Assioma DUO New One,Wahoo Kickr Core (without ANT+ Control),322,333,-11
80651,380080,2020-12-08 08:44:56,wahoo,Zwift - Zwift Racing League | WTRL - Men&#039;s APAC DIVISION 1 (A),Favero Assioma DUO New One,Wahoo Kickr Core (without ANT+ Control),333,346,-13
83359,380080,2020-12-15 08:49:48,wahoo,Zwift - Zwift Racing League | WTRL - Men&#039;s APAC DIVISION 1 (A),Favero Assioma DUO New One,Wahoo Kickr Core (without ANT+ Control),310,328,-18
87711,380080,2020-12-27 09:01:54,wahoo,ZADA Three Sisters Test,Favero Assioma DUO New One,Wahoo Kickr Core,319,315,4
88106,380080,2020-12-28 10:50:36,wahoo,Zwift - Watopia,Favero Assioma DUO New One (Dirty Chain),Wahoo Kickr Core,226,225,1
88116,380080,2020-12-28 11:26:45,wahoo,Zwift - Watopia,Favero Assioma DUO New One,Wahoo Kickr Core,239,236,3
88447,380080,2020-12-29 08:59:44,wahoo,Zwift - I PIROSHIKI�(c i)&#039;s Meetup - Road to Sky,Favero Assioma DUO New One,Wahoo Kickr Core,313,308,5
88916,380080,2020-12-30 09:57:24,wahoo,Zwift - Watopia,Favero Assioma DUO New One,Wahoo Kickr Core,208,209,-1
89277,380080,2020-12-31 06:44:43,wahoo,Zwift - Kanji Abeki STINGER [ZWC]&#039;s Meetup - Three Sisters,Favero Assioma DUO New One,Wahoo Kickr Core,336,328,8
89323,380080,2020-12-31 07:38:18,wahoo,Zwift - Watopia,Favero Assioma DUO New One,Wahoo Kickr Core,292,289,3
89741,380080,2021-01-01 09:07:31,wahoo,Zwift - Watopia,Favero Assioma DUO New One,Wahoo Kickr Core,228,228,0
92701,380080,2021-01-07 10:33:27,wahoo,Zwift - Japan ZWIFT Hill Climb Race (A),Favero Assioma DUO New One,Wahoo Kickr Core,308,306,2
94978,380080,2021-01-11 18:45:47,wahoo,Zwift - Premier Division // Zwift Racing League (men) (A),Favero Assioma DUO New One,Wahoo Kickr Core,319,309,10
97346,380080,2021-01-15 10:22:06,wahoo,Zwift - Watopia,Favero Assioma DUO New One,Wahoo Kickr Core,215,215,0
99190,380080,2021-01-18 19:53:51,wahoo,Zwift - Premier Division // Zwift Racing League (men) (A),Favero Assioma DUO New One,Wahoo Kickr Core,315,321,-6
101633,380080,2021-01-23 06:30:17,wahoo,Zwift - XRS Races - The Saturday Classic (A),Favero Assioma DUO New One,Wahoo Kickr Core,340,335,5
102885,380080,2021-01-25 19:04:45,wahoo,Zwift - Premier Division // Zwift Racing League (men) (A),Favero Assioma DUO New One,Wahoo Kickr Core,334,345,-11
104442,380080,2021-01-28 09:21:21,wahoo,Zwift - London,Favero Assioma DUO New One,Wahoo Kickr Core,365,368,-3
106884,380080,2021-02-01 20:06:58,wahoo,Zwift - 02/02/2021,Favero Assioma DUO New One,Wahoo Kickr Core,307,314,-7
112414,380080,2021-02-10 19:00:01,wahoo,Zwift - Movistar Team Challenge // Round 1 (A),Favero Assioma DUO New One,Wahoo Kickr Core,280,281,-1
113634,380080,2021-02-12 18:59:56,wahoo,Zwift - Movistar Team Challenge // Round 1 (men),Favero Assioma DUO New One,Wahoo Kickr Core,341,340,1
115365,380080,2021-02-15 20:01:53,wahoo,Zwift - Premier Division // Zwift Racing League (men) (A),Favero Assioma DUO New One,Wahoo Kickr Core,317,318,-1
116782,380080,2021-02-17 18:59:59,wahoo,Zwift - Movistar Team Challenge // Round 2 (men) - Race 3/4,Favero Assioma DUO New One,Wahoo Kickr Core,277,280,-3
117898,380080,2021-02-19 18:59:51,wahoo,Zwift - Movistar Team Challenge // Round 2 (men),Favero Assioma DUO New One,Wahoo Kickr Core,336,331,5
119131,380080,2021-02-22 19:09:56,wahoo,Zwift - Premier Division // Zwift Racing League (men) (A),Favero Assioma DUO New One,Wahoo Kickr Core,274,277,-3
122691,380080,2021-03-01 20:18:56,wahoo,Zwift - Premier Division // Zwift Racing League (men) (A),Favero Assioma DUO New One,Wahoo Kickr Core,326,315,11
123788,380080,2021-03-04 03:11:00,wahoo,Zwift - Watopia,Favero Assioma DUO New One,Wahoo Kickr Core,209,208,1
124104,380080,2021-03-04 18:59:40,wahoo,Zwift - Ramp Test,Favero Assioma DUO New One,Wahoo Kickr Core,367,359,8
124125,380080,2021-03-04 19:39:45,wahoo,Zwift - Movistar Team Challenge // Points Race (men),Favero Assioma DUO New One,Wahoo Kickr Core,299,293,6
125689,380080,2021-03-08 10:40:45,wahoo,Zwift - ZWC Hill Climb Battle (A),4iiii Precision Dual Sided,Wahoo Kickr Core,332,336,-4
6060,381136,2019-12-11 19:05:00,neo,Zwift - DBR HEINO CUP (A),Favero Assioma Duo,Tacx Neo,379,357,22
6652,381136,2019-12-18 19:05:00,neo,Zwift - DBR HEINO CUP (A),Favero Assioma Duo,Tacx Neo,382,372,10
8117,381136,2020-01-05 09:00:00,neo,Zwift - Zwift Gran Fondo,Favero Assioma Duo,Tacx Neo,373,360,13
8340,381136,2020-01-07 19:39:59,neo,Zwift - 3R Ultimate Racing League - Round 1 (A),Favero Assioma Duo,Tacx Neo,367,360,7
9379,381136,2020-01-14 19:39:59,neo,Zwift - 3R Ultimate Racing League - Round 2 (A),Favero Assioma Duo,Tacx Neo,364,351,13
10328,381136,2020-01-21 19:34:02,neo,Zwift - 3R Ultimate Racing League - Round 3 (A),Favero Assioma Duo,Tacx Neo,382,371,11
10495,381136,2020-01-22 19:05:00,neo,Zwift - DBR HEINO CUP (A),Favero Assioma Duo,Tacx Neo,394,377,17
11386,381136,2020-01-28 19:40:00,neo,Zwift - 3R Ultimate Racing League - Round 4 (A),Favero Assioma Duo,Tacx Neo,385,378,7
12810,381136,2020-02-06 19:00:00,neo,Zwift - KALAS Cup - Round 2 (A),Favero Assioma Duo,Tacx Neo,415,411,4
13443,381136,2020-02-11 19:39:59,neo,Zwift - 3R Ultimate Racing League - Round 6 (A),Favero Assioma Duo,Tacx Neo,356,346,10
13755,381136,2020-02-13 19:00:00,neo,Zwift - KALAS Cup - Round 3 (A),Favero Assioma Duo,Tacx Neo,366,358,8
14984,381136,2020-02-20 18:59:59,neo,Zwift - KALAS Cup - Round 4 (A),Favero Assioma Duo,Tacx Neo,376,366,10
15939,381136,2020-02-27 19:00:00,neo,Zwift - KALAS Cup - Round 5 (A),Favero Assioma Duo,Tacx Neo,361,345,16
16971,381136,2020-03-05 18:59:58,neo,Zwift - KALAS Cup - Round 6 (A),Favero Assioma Duo,Tacx Neo,370,368,2
17524,381136,2020-03-10 19:14:59,neo,Zwift - Feltet.dk Race Series (A),Favero Assioma Duo,Tacx Neo,364,354,10
20073,381136,2020-03-28 09:00:00,neo,Zwift -  KALAS Indoor EFCT race series #Crit (A),Favero Assioma Duo,Tacx Neo,357,347,10
20311,381136,2020-03-29 07:59:57,neo,Zwift -  KALAS Indoor EFCT race series #Road race (A),Favero Assioma Duo,Tacx Neo,368,360,8
20905,381136,2020-03-31 18:00:00,neo,Zwift - NCF Spring Cup (A),Favero Assioma Duo,Tacx Neo,376,366,10
21526,381136,2020-04-02 18:00:00,neo,Zwift - KALAS Cup - Round 10 (A),Favero Assioma Duo,Tacx Neo,377,376,1
22845,381136,2020-04-07 18:00:00,neo,Zwift - NCF Spring Cup (A),Favero Assioma Duo,Tacx Neo,411,391,20
23323,381136,2020-04-09 18:10:00,neo,Zwift - London International // Zwift Classic (A),Favero Assioma Duo,Tacx Neo,389,380,9
24685,381136,2020-04-14 18:00:00,neo,Zwift - NCF Spring Cup (A),Favero Assioma Duo,Tacx Neo,371,361,10
28066,381136,2020-04-25 18:10:00,neo,Zwift - Crit City Slam // Zwift Classic,Favero Assioma Duo,Tacx Neo,402,394,8
28865,381136,2020-04-28 18:00:00,neo,Zwift - NCF Spring Cup (A),Favero Assioma Duo,Tacx Neo,380,364,16
31733,381136,2020-05-05 16:59:59,neo,Zwift - NCF Grand Prix 2020 - Runde 1 - Elite (A),Favero Assioma Duo,Tacx Neo,395,381,14
34001,381136,2020-05-12 17:00:01,neo,Zwift - NCF Grand Prix 2020 - Runde 2 - Elite Herrer/Kvinner (A),Favero Assioma Duo,Tacx Neo,375,367,8
34004,381136,2020-05-12 18:00:00,neo,Zwift - NCF Grand Prix 2020 - Runde 2 - Aldersbestemt (C),Favero Assioma Duo,Tacx Neo,373,355,18
36189,381136,2020-05-19 18:05:00,neo,Zwift - NCF Grand Prix 2020 - Runde 3 - Aldersbestemt (C),Favero Assioma Duo,Tacx Neo,411,405,6
37917,381136,2020-05-26 17:00:01,neo,Zwift - NCF Grand Prix 2020 - Runde 4 - Elite Herrer/Kvinner (A),Favero Assioma Duo,Tacx Neo,348,339,9
39179,381136,2020-06-02 18:05:00,neo,Zwift - NCF Grand Prix 2020 - Runde 5 - Aldersbestemt (C),Favero Assioma Duo,Tacx Neo,369,358,11
47896,381136,2020-07-27 18:20:00,neo,Zwift - TFC Mad Monday Summer Series (4 of 10) (A),New Favero Assioma Duo,Tacx Neo,353,339,14
51871,381136,2020-08-25 18:40:00,neo,Zwift - 3R Turbocharged Team Race Series - Bonus Round (A),New Favero Assioma Duo,Tacx Neo,348,334,14
52100,381136,2020-08-26 17:00:00,neo,Zwift - MIDWEEK Summer Series by SZR (A),New Favero Assioma Duo,Tacx Neo,358,345,13
52456,381136,2020-08-29 08:30:01,neo,Zwift - DBR Saturday Race  (A),New Favero Assioma Duo,Tacx Neo,364,360,4
52774,381136,2020-08-31 18:20:00,neo,Zwift - TFC Mad Monday Summer Series (9 of 10) (A),New Favero Assioma Duo,Tacx Neo,369,356,13
53374,381136,2020-09-01 17:55:01,neo,Zwift - Team Italy & Frenchy Fuzion League (A),New Favero Assioma Duo,Tacx Neo,414,405,9
53375,381136,2020-09-01 19:00:00,neo,Zwift - KISS at Race - EU PM (A),New Favero Assioma Duo,Tacx Neo,355,345,10
53376,381136,2020-09-03 17:30:01,neo,Zwift - FUSION ECT BEUNSTOPPABLE Racing Series (A),New Favero Assioma Duo,Tacx Neo,372,365,7
53762,381136,2020-09-07 17:15:02,neo,Zwift - DBR Ride´N´Roll League (A),New Favero Assioma Duo,Tacx Neo,402,393,9
54201,381136,2020-09-09 18:05:00,neo,DBR Wednesday Race,New Favero Assioma Duo,Tacx Neo,374,358,16
54699,381136,2020-09-12 08:30:00,neo,Zwift - DBR SufferDay League II (A),New Favero Assioma Duo,Tacx Neo,400,405,-5
55205,381136,2020-09-14 18:00:02,neo,Zwift - Invitational League // Qualifying Race #1,New Favero Assioma Duo,Tacx Neo,385,372,13
56136,381136,2020-09-17 17:55:43,neo,Zwift - Test up Alpe,New Favero Assioma Duo,Tacx Neo,382,375,7
56482,381136,2020-09-20 13:00:02,neo,Zwift - Invitational League // Qualifying Race #3 (Men) (A),New Favero Assioma Duo,Tacx Neo,394,392,2
57682,381136,2020-09-26 08:30:01,neo,Zwift - DBR SufferDay League II (A),New Favero Assioma Duo,Tacx Neo,387,383,4
58552,381136,2020-09-30 17:30:02,neo,Zwift - NCF Vinter Cup 2020 - Runde 2 - Herrer (A),New Favero Assioma Duo,Tacx Neo,384,376,8
59651,381136,2020-10-05 18:20:02,neo,Zwift - TFC Mad Monday Autumn Series (A),New Favero Assioma Duo,Tacx Neo,364,360,4
60424,381136,2020-10-07 17:30:01,neo,Zwift - NCF Vinter Cup 2020 - Runde 3 - Herrer (A),New Favero Assioma Duo,Tacx Neo,362,363,-1
60431,381136,2020-10-08 17:30:14,neo,Zwift - FUSION ECT BEUNSTOPPABLE Racing Series (A),New Favero Assioma Duo,Tacx Neo,386,372,14
61591,381136,2020-10-13 17:15:02,neo,Zwift - Zwift Racing League | WTRL,New Favero Assioma Duo,Tacx Neo,398,387,11
61935,381136,2020-10-14 17:30:03,neo,Zwift - NCF Vinter Cup 2020 - Runde 4 - Herrer (A),New Favero Assioma Duo,Tacx Neo,401,385,16
92871,382994,2021-01-07 18:36:05,neo,Tacx Neo 1 / Quarq Dzero,Quarq Dzero,Tacx Neo 1,438,427,11
103467,382994,2021-01-26 18:20:21,neo,Zwift - Zwift Racing League | WTRL - Men&#039;s/Mixed EMEA E1 DIVISION 6 (A) ,Quarq Dzero,Tacx Neo 1,432,422,10
107318,382994,2021-02-02 18:20:22,neo,Zwift - Zwift Racing League | WTRL - Men&#039;s/Mixed EMEA E1 DIVISION 6 (A),Quarq Dzero,Tacx Neo 1,411,398,13
111537,382994,2021-02-09 18:27:19,neo,Zwift - Zwift Racing League | WTRL - Men&#039;s/Mixed EMEA E1 DIVISION 6 (A),Quarq Dzero,Tacx Neo 1,437,423,14
115857,382994,2021-02-16 18:20:21,neo,Zwift - Zwift Racing League | WTRL - Men&#039;s/Mixed EMEA E1 DIVISION 6 (A),Quarq Dzero,Tacx Neo 1,452,438,14
5482,384313,2019-12-04 17:27:25,wahoo,Zwift - Downward Spiral,Power2Max NG,Kickr 4,304,296,8
5567,384313,2019-12-05 16:23:48,wahoo,Zwift - OH CRIT!! - The Double Race - Race 2/2 (A),Power2Max NG,Kickr 4,301,298,3
6120,384313,2019-12-12 16:35:48,wahoo,Zwift - OH CRIT!! - The Double Race - Race 2/2 (A),Power2Max NG,Kickr 4,295,296,-1
6730,384313,2019-12-19 16:47:28,wahoo,Zwift - OH CRIT!! - The Double Race - Race 2/2 (A),Power2Max NG,Kickr 4,297,299,-2
7122,384313,2019-12-23 13:13:03,wahoo,Crit City Race (A),Power2Max NG,Kickr 4,296,295,1
7301,384313,2019-12-26 10:09:41,wahoo,Zwift - Crit City Race (A),Power2Max NG,Kickr 4,300,310,-10
89368,384313,2020-12-31 11:44:52,wahoo,Zwift - DIRT Doozy Race (A),Powertap P1,Kickr 5,286,283,3
90272,384313,2021-01-02 08:35:30,wahoo,Zwift - Herd Beginner Racing Series (E),Powertap P1,Kickr 5,308,300,8
93876,384313,2021-01-09 08:35:15,wahoo,Zwift - Herd Beginner Racing Series (E),Powertap P1,Kickr 5,302,293,9
97934,384313,2021-01-16 08:28:23,wahoo,Zwift - Herd Beginner Racing Series,Powertap P1,Kickr 5,306,299,7
102261,384313,2021-01-24 08:58:14,wahoo,Pushing Limits TT-Race,Powertap P1,Kickr 5,276,273,3
102457,384313,2021-01-24 14:16:37,wahoo,Zwift - Herd Beginner Racing Series (E),Powertap P1,Kickr 5,278,276,2
105503,384313,2021-01-30 11:52:24,wahoo,Zwift - Herd Beginner Racing Series (E),Powertap P1,Kickr 5,287,283,4
109589,384313,2021-02-05 18:35:17,wahoo,Herd Beginner Racing Series (E),Powertap P1,Kickr 5,292,291,1
114032,384313,2021-02-13 08:41:58,wahoo,Zwift - Herd Beginner Racing Series (E),Powertap P1,Kickr 5,282,277,5
128321,384313,2021-03-13 08:42:16,wahoo,Zwift - Herd Beginner Racing Series - TT (E),Powertap P1,Kickr 5,276,273,3
120332,385207,2021-02-24 16:27:28,wahoo,Zwift - NYC,stages,kickr,385,382,3
61722,385268,2020-10-13 18:11:38,wahoo,4iiii left crank PM,4iiii left crank PM,Wahoo Kickr,239,249,-10
62665,385268,2020-10-17 14:36:09,wahoo,Fearless Women&#039;s weekend race,4iiii left crank PM,Wahoo Kickr,227,240,-13
76437,385268,2020-11-26 17:44:14,wahoo,4iiii left crank PM,4iiii left crank PM,Wahoo Kickr,246,260,-14
13916,385769,2020-02-14 13:21:35,wahoo,Tour de Zwift: Stage 6 Group Ride,Assioma Duo Pedals,Wahoo KICKR v2,369,381,-12
14038,385769,2020-02-15 06:58:28,wahoo,Zwift - 3R Mountain Madness Steady Ride [~3.0w/kg avg] (B),Assioma Duo Pedals,Wahoo KICKR v2,348,343,5
14039,385769,2020-02-15 07:59:45,wahoo,Zwift NL Mega Pretzel - Lekker tochtje hoor!,Assioma Duo Pedals,Wahoo KICKR v2,346,351,-5
15039,385769,2020-02-21 13:20:32,wahoo,Zwift - Tour of Innsbruck // Stage 1,Assioma Duo Pedals,Wahoo KICKR v2,379,374,5
15066,385769,2020-02-21 17:25:28,wahoo,Zwift - 3R PedalPlay Interval Ride [~3.5-4+w/kg avg] (B),Assioma Duo Pedals,Wahoo KICKR v2,296,298,-2
15145,385769,2020-02-22 07:45:01,wahoo,Zwift - 3R 160 Steady Ride [~3.0w/kg avg] (B),Assioma Duo Pedals,Wahoo KICKR v2,258,261,-3
41054,385769,2020-06-11 17:00:27,wahoo,Zwift - Espresso,Assioma Duo Pedals,Wahoo KICKR 2018,381,388,-7
41353,385769,2020-06-13 06:55:54,wahoo,Zwift - 3R Hilly Race - Yorkshire Tour of Tewit Well - 3 Laps (A),Assioma Duo Pedals,Wahoo KICKR 2018,403,411,-8
41454,385769,2020-06-13 14:04:11,wahoo,Zwift - OH CRIT!! - Saturday Smash Series (A),Assioma Duo Pedals,Wahoo KICKR 2018,406,410,-4
42018,385769,2020-06-16 18:18:29,wahoo,Zwift - 3R & Wahoo Ride Real Race Series - Round 5 of 7 (A),Assioma Duo Pedals,Wahoo KICKR 2018,401,407,-6
51543,385769,2020-08-24 18:14:43,wahoo,Zwift - TFC Mad Monday Summer Series (8 of 10) (A),Assioma Duo Pedals,Wahoo KICKR 2018,414,418,-4
52203,385769,2020-08-27 17:35:56,wahoo,Zwift - WTRL Team Time Trial (C),Assioma Duo Pedals,Wahoo KICKR 2018,386,397,-11
52342,385769,2020-08-28 07:24:48,wahoo,Zwift - Off The MAAP Stage 4 - Longer Ride,Assioma Duo Pedals,Wahoo KICKR 2018,312,314,-2
55062,385769,2020-09-14 17:43:22,wahoo,Zwift - Invitational League // Qualifying Race #1,Assioma Duo Pedals,Wahoo KICKR 2018,390,408,-18
55402,385769,2020-09-15 18:22:42,wahoo,Zwift - 3R Sundown Race Series  (E),Assioma Duo Pedals,Wahoo KICKR 2018,390,397,-7
56454,385769,2020-09-20 12:37:44,wahoo,Zwift - Invitational League // Qualifying Race #3 (Men) (A),Assioma Duo Pedals,Wahoo KICKR 2018,410,413,-3
56969,385769,2020-09-23 09:34:39,wahoo,Zwift - USA Cycling Race League by Indoor Specialist (A),Assioma Duo Pedals,Wahoo KICKR 2018,368,373,-5
57846,385769,2020-09-27 07:51:30,wahoo,Zwift - Erik Haugen [R3R]&#039;s Meetup - Three Sisters,Assioma Duo Pedals,Wahoo KICKR 2018,400,408,-8
58019,385769,2020-09-28 12:12:35,wahoo,Zwift - Zach Harner [R3R]&#039;s Meetup - Three Sisters,Assioma Duo Pedals,Wahoo KICKR 2018,384,380,4
61310,385769,2020-10-12 18:38:51,wahoo,Zwift - Premier Division // Zwift Racing League (men) ,Assioma Duo Pedals,Wahoo KICKR 2018,407,405,2
61446,385769,2020-10-13 09:55:27,wahoo,Zwift - KISS at Race - Americas AM (A),Assioma Duo Pedals,Wahoo KICKR 2018,357,355,2
63120,385769,2020-10-19 17:49:19,wahoo,Zwift - Premier Division // Zwift Racing League (men) ,Assioma Duo Pedals,Wahoo KICKR 2018,399,393,6
65171,385769,2020-10-26 19:33:32,wahoo,Zwift - Premier Division // Zwift Racing League (men) (A),Assioma Duo Pedals,Wahoo KICKR 2018,394,388,6
67284,385769,2020-11-02 18:44:07,wahoo,Zwift - Premier Division // Zwift Racing League (men) (A),Assioma Duo Pedals,Wahoo KICKR 2018,409,399,10
74708,385769,2020-11-23 19:36:52,wahoo,Zwift - Premier Division // Zwift Racing League (men) (A),Assioma Duo Pedals,Wahoo KICKR 2018,374,368,6
76052,385769,2020-11-26 18:15:15,wahoo,Zwift - WTRL NOPINZ WORLD TTT CHAMPIONSHIPS - Zone 6 (C),Assioma Duo Pedals,Wahoo KICKR 2018,378,377,1
77676,385769,2020-11-30 18:39:22,wahoo,Zwift - Premier Division // Zwift Racing League (men) (A),Assioma Duo Pedals,Wahoo KICKR 2018,376,370,6
115434,385769,2021-02-15 19:34:26,wahoo,Zwift - Premier Division // Zwift Racing League (men) (A),Assioma Duo Pedals,Wahoo KICKR 2018,358,350,8
122563,385769,2021-03-01 19:50:58,wahoo,Zwift - Premier Division // Zwift Racing League (men) (A),Assioma Duo Pedals,Wahoo KICKR 2018,412,405,7
52047,390505,2020-08-26 18:40:04,wahoo,Zwift - France,Assioma,Kickr Core,301,291,10
60353,390505,2020-10-08 17:19:06,wahoo,Zwift - Frappe,Assioma Duo,Kickr Core,329,326,3
64303,390505,2020-10-23 05:00:00,wahoo,Zwift - 3R VOLT Interval Ride [~2.6-3.2 w/kg avg] (C),Assioma Duo,Kickr Core,309,301,8
93307,390505,2021-01-08 13:00:01,wahoo,Zwift - TDZ Stage 1: Longer Ride,Assioma Duo,Kickr Core,367,363,4
95825,390505,2021-01-12 19:47:57,wahoo,Zwift - Zwift Racing League | WTRL - Men&#039;s/Mixed EMEA W1 DIVISION 4 (A),Assioma Duo,Kickr Core,349,338,11
97552,390505,2021-01-15 19:37:22,wahoo,Zwift - Light Spin,Assioma Duo,Kickr Core,238,252,-14
98141,390505,2021-01-16 16:29:58,wahoo,TEAM VEGAN Tofu Tornado - Veganuary STAGE 3,Assioma Duo,Kickr Core,353,354,-1
99826,390505,2021-01-19 19:54:22,wahoo,Zwift Racing League | WTRL - Men&#039;s/Mixed EMEA W1 DIVISION 4 (A),Assioma Duo,Kickr Core,347,328,19
101955,390505,2021-01-23 16:30:27,wahoo,TEAM VEGAN Tofu Tornado - Veganuary STAGE 4,Assioma Duo,Kickr Core,360,342,18
105366,390505,2021-01-30 08:04:59,wahoo,3R Weekend Race Club - Race 1,Assioma Duo,Kickr Core,384,371,13
107544,390505,2021-02-02 19:47:53,wahoo,Zwift Racing League | WTRL - Mens/Mixed EMEA W1 DIVISION 4,Assioma Duo,Kickr Core,390,393,-3
109637,390505,2021-02-06 08:04:57,wahoo,Zwift - 3R Weekend Race Club - Race 1 (A),Assioma Duo,Kickr Core,353,371,-18
110250,390505,2021-02-07 06:34:23,wahoo,Zwift - Watopia - Z2,Assioma Duo,Kickr Core,249,244,5
111751,390505,2021-02-09 19:53:54,wahoo,Zwift Racing League | WTRL - Mens/Mixed EMEA W1 DIVISION 4,Assioma Duo,Kickr Core,370,358,12
116018,390505,2021-02-16 19:47:54,wahoo,Zwift - Zwift Racing League | WTRL - Men&#039;s/Mixed EMEA W1 DIVISION 4 (A),Assioma Duo,Kickr Core,365,354,11
118455,390505,2021-02-20 19:30:48,wahoo,3R Endurance Series p/b OTE Sports- Stage 1,Assioma Duo,Kickr Core,340,334,6
119768,390505,2021-02-23 19:47:10,wahoo,Zwift - Zwift Racing League | WTRL - Men&#039;s/Mixed EMEA W1 DIVISION 4 (A),Assioma Duo,Kickr Core,371,376,-5
119772,390505,2021-02-23 19:47:10,wahoo,Zwift Racing League | WTRL - Mens/Mixed EMEA W1 DIVISION 4,Assioma Duo,Kickr Core,371,376,-5
125842,390505,2021-03-08 19:21:21,wahoo,Team TFC Mad Monday Race Series (high-end categories),Assioma Duo,Kickr Core,359,355,4
7853,391189,2020-01-02 12:37:25,wahoo,2020-01-02-06-37-25 / Kickr_2020-01-02-06-38-32,2020-01-02-06-37-25,Kickr_2020-01-02-06-38-32,345,319,26
8738,391189,2020-01-10 00:28:50,wahoo,2020-01-09-18-28-50 / Kickr_2020-01-09-18-29-15,2020-01-09-18-28-50,Kickr_2020-01-09-18-29-15,320,303,17
9410,391189,2020-01-13 12:15:17,wahoo,2020-01-13-06-15-17 / 2020-01-13-06-15-38,2020-01-13-06-15-17,Kickr_2020-01-13-06-15-38,354,327,27
10705,391189,2020-01-23 13:24:55,wahoo,Zwift - Crit City Race (A),Zwift,Kickr_2020-01-23-07-24-55,347,329,18
18388,391189,2020-03-17 11:48:54,wahoo,Zwift - London,Zwift,Kickr_2020-03-17-05-54-26,241,232,9
21858,391189,2020-04-03 11:44:50,wahoo,tt bike (power2max),Plasma (P2Max),Kickr,303,293,10
22021,391189,2020-04-04 13:32:25,wahoo,"Kickr, Canyon, race effort",Canyon DZero,Kickr2018,365,355,10
22272,391189,2020-04-05 13:41:42,wahoo,easy Sunday,Foil (DZero),Kickr,309,311,-2
23905,391189,2020-04-11 13:43:52,wahoo,Climbing race (last 47min Alpe du Zwift),Canyon_DZero,Kickr2018,364,346,18
25692,391189,2020-04-17 12:26:34,wahoo,Tempus Fugit TT plus w-up and w-d,CanyonDZero,Kickr,362,344,18
26300,391189,2020-04-19 13:03:09,wahoo,Richmond Challenge UCI course x 3 in middle,CanyonDZ,Kickr,368,351,17
58674,392608,2020-09-30 09:58:54,wahoo,Three Sister 30/09/2020,Quarq Power Crank,Kickr18,269,259,10
68991,392946,2020-11-08 08:59:55,wahoo,Rotor SL6 / Kickr ,Rotor SL6,Kickr ,361,361,0
69912,392946,2020-11-10 18:19:53,wahoo,Kickr  / Rotor SL6,Rotor SL6,Kickr ,423,423,0
71697,392946,2020-11-15 10:04:51,wahoo,Rotor SL6 / Kickr ,Rotor SL6,Kickr ,366,371,-5
103582,392946,2021-01-26 17:59:33,wahoo,Kickr  / Rotor SL6,Rotor SL6,Kickr ,394,384,10
103587,392946,2021-01-26 17:59:33,wahoo,Rotor SL6 / Kickr ,Rotor SL6,Kickr ,394,384,10
114910,392946,2021-02-13 17:37:38,wahoo,Zwift - Chasing Cancellara Time Trial,Allez (Old) ,Kickr ,376,376,0
114913,392946,2021-02-12 09:58:19,wahoo,Zwift - TDZ Stage 8: Group Ride,Rotor SL6 ( New) ,Kickr ,307,325,-18
114914,392946,2021-02-09 18:23:50,wahoo,Zwift - Zwift Racing League | WTRL - Men&#039;s/Mixed EMEA E1 DIVISION 5 (A),Rotor SL6 (Old) ,Kickr ,386,386,0
115111,392946,2021-02-13 17:37:12,wahoo,Zwift - Chasing Cancellara Time Trial,Allez (Old) ,Kickr ,376,355,21
115112,392946,2021-02-09 17:55:16,wahoo,Zwift - Zwift Racing League | WTRL - Men&#039;s/Mixed EMEA E1 DIVISION 5 (A),Rotor SL6 (Old) ,Kickr ,386,374,12
115932,392946,2021-02-16 18:18:48,wahoo,Zwift - Zwift Racing League | WTRL - Men&#039;s/Mixed EMEA E1 DIVISION 5 (A),Allez (Old) ,Kickr ,408,400,8
119416,392946,2021-02-11 11:00:21,wahoo,Zwift - KISS Race Series - Americas AM (A),Rotor SL6 ( New) ,Kickr ,381,381,0
119657,392946,2021-02-23 18:18:43,wahoo,Zwift - Zwift Racing League | WTRL - Men&#039;s/Mixed EMEA E1 DIVISION 5 (A),Allez (Old) ,Kickr ,373,382,-9
122987,392946,2021-03-02 18:22:24,wahoo,Zwift - Zwift Racing League | WTRL - Men&#039;s/Mixed EMEA E1 DIVISION 5 (A),Rotor SL6 ( New) ,Kickr ,400,379,21
127486,392946,2021-03-12 15:29:57,wahoo,Zwift - DBR Friday Race (A),Rotor SL6 ( New) ,Kickr ,356,361,-5
128747,392946,2021-03-15 17:59:57,wahoo,Zwift - SZR Evening Joyride,Rotor SL6 ( New) ,Kickr ,346,342,4
129693,392946,2021-03-16 17:46:19,wahoo,Zwift - Watopia,Rotor SL6 ( New) ,Kickr ,325,318,7
129695,392946,2021-03-17 09:32:51,wahoo,Zwift - Yorkshire,Rotor SL6 ( New) ,Kickr ,322,317,5
99138,393323,2021-01-18 19:05:19,wahoo,Premier Division // Zwift Racing League (women) (A),stages powermeter,wahoo kickr,268,270,-2
101702,393323,2021-01-23 08:36:22,wahoo,stages powermeter,stages powermeter,wahoo kickr,273,279,-6
103057,393323,2021-01-25 19:13:33,wahoo,Premier Division // Zwift Racing League (women) (A),stages powermeter,wahoo kickr,271,271,0
111149,393323,2021-02-08 19:27:16,wahoo,Zwift - Premier Division // Zwift Racing League (women) (A),stages powermeter,wahoo kickr,279,284,-5
118095,393323,2021-02-20 08:24:15,wahoo,wahoo kickr / stages powermeter,stages powermeter,wahoo kickr,266,261,5
119254,393323,2021-02-08 20:02:41,wahoo,Zwift - Premier Division // Zwift Racing League (women) (A),stages powermeter,wahoo kickr,275,284,-9
119261,393323,2021-02-22 19:13:07,wahoo,wahoo kickr / stages powermeter,stages powermeter,wahoo kickr,275,268,7
124851,393323,2021-03-06 08:47:42,wahoo,wahoo kickr / stages powermeter,stages powermeter,wahoo kickr,262,258,4
127767,393323,2021-03-13 08:36:09,wahoo,wahoo kickr / stages powermeter,stages powermeter,wahoo kickr,252,250,2
77853,393598,2020-11-29 09:31:12,wahoo,Zwift -  SloZl - Slovenian Zwift League - Weekly Race  (B),Garmin Vector 3S,Kickr Core 2020,325,326,-1
80375,393598,2020-12-06 09:30:20,wahoo,Zwift -  SloZl - Slovenian Zwift League - Weekly Race  (B),Garmin Vector 3S,Kickr Core 2020,338,337,1
111301,393598,2021-02-04 18:08:26,wahoo,Zwift - WTRL Team Time Trial - Zone 4 (C),Garmin Vector 3S,Kickr Core 2020,328,343,-15
124193,393598,2021-03-04 18:12:39,wahoo,Zwift - Espresso,Garmin Vector 3S,Kickr Core 2020,319,329,-10
32775,393829,2020-05-08 17:05:11,wahoo,Zwift - Zwift Fast Fridays: Bologna Time Trial (E),Garmin Vector 3,Wahoo Kickr,284,284,0
35112,393829,2020-05-15 18:21:05,wahoo,Zwift - GGCC GlasgowGreen CC TT  (B),Garmin Vector 3,Wahoo Kickr,304,287,17
96493,393829,2021-01-13 19:19:50,wahoo,Zwift - 3R & Triathlon Ireland iTT Race (C),Garmin Vector 3,Wahoo Kickr,248,249,-1
108310,393829,2021-02-03 19:20:00,wahoo,Zwift - 3R & Triathlon Ireland Race (C),Garmin Vector 3,Wahoo Kickr,252,246,6
116555,395827,2021-02-17 16:30:59,wahoo,Zwift - ZHQ FutureWorks Crit City Race - Anti-sandbagging (B),Favero Assiomas,Wahoo Kickr 2017,319,319,0
15025,396557,2020-02-20 09:58:04,wahoo,WTRL Team Time Trial - Zone1,Stage Left crank,kickr,380,367,13
17787,396557,2020-03-12 08:48:32,wahoo,WTRL Team Time Trial - Zone1,Stage Left crank,kickr,362,341,21
19967,396557,2020-03-27 10:51:58,wahoo,Zwift - Stage 5 - Longer Ride - Tour of Watopia 2020,stages left crank,kickr,399,368,31
20115,396557,2020-03-28 11:10:39,wahoo,Zwift - 3R Tick Tock Flat Race - 2 Lap (36km/22.4mi 100m) (A),stages left crank,kickr,413,378,35
20571,396557,2020-03-30 11:01:08,wahoo,Zwift - Watopia,4715457794,kickr,337,325,12
20787,396557,2020-03-31 09:56:19,wahoo,Zwift - KISS at Race - Americas AM (A),Stages Dual,kickr,367,359,8
21675,396557,2020-04-02 09:18:27,wahoo,Zwift -  Haute Route Watopia Stage 1 (E),Stages Dual,kickr,358,344,14
27698,396557,2020-04-24 10:48:40,wahoo,Zwift - 3R LaGuardia Loop Reverse Flat Race - 8 Laps (24.5km/15.2mi 216m) (A),Stages Dual,kickr,374,356,18
33287,396557,2020-05-10 11:39:18,wahoo,Zwift - Crit City Race (A),Stages Dual,kickr,380,366,14
33863,396557,2020-05-12 09:59:27,wahoo,Zwift - KISS at Race - Americas AM (A),Stages Dual,kickr,379,363,16
41003,396557,2020-06-11 09:54:06,wahoo,Zwift - Koa Sports League Race (A),Stages Dual,kickr,384,369,15
41004,396557,2020-06-11 10:39:40,wahoo,Zwift - DIRT Doozy Race (A),Stages Dual,kickr,353,338,15
58460,396557,2020-09-30 09:14:33,wahoo,Zwift - Watopia,Stages Dual,kickr,275,287,-12
59813,396557,2020-10-06 08:12:00,wahoo,Zwift - VO2 30/15 for 75,Stages Dual,kickr,275,279,-4
66006,396557,2020-10-29 09:29:03,wahoo,Zwift - Frappe,Stages Dual,kickr,354,354,0
67171,396557,2020-11-02 09:36:06,wahoo,Zwift - Build Me Up - Red Unicorn,Stages Dual,kickr,279,283,-4
67524,396557,2020-11-03 10:59:47,wahoo,Zwift - KISS at Race - Americas AM (B),Stages Dual,kickr,344,344,0
68072,396557,2020-11-05 10:31:59,wahoo,Zwift - WTRL Team Time Trial - Zone 2 (D),Stages Dual,kickr,357,361,-4
69630,396557,2020-11-10 11:00:56,wahoo,Zwift - KISS at Race - Americas AM (B),Stages Dual,kickr,373,370,3
70153,396557,2020-11-11 10:51:06,wahoo,Zwift - KISS at Base Training Ride (C),Stages Dual,kickr,332,329,3
70547,396557,2020-11-12 10:24:57,wahoo,Zwift - WTRL TTT ,Stages Dual,kickr,367,356,11
72132,396557,2020-11-17 11:01:02,wahoo,Zwift - ZA Road 2020 - Segment Ride #1: Sand and Sequoias Course,Stages Dual,kickr,359,358,1
72929,396557,2020-11-19 10:29:59,wahoo,Zwift - Frappe ,Stages Dual,kickr,377,358,19
72933,396557,2020-11-19 11:50:34,wahoo,Zwift Academy Road: Workout 4 | Anaerobic Resilience,Stages Dual,kickr,286,278,8
75412,396557,2020-11-25 11:00:01,wahoo,Zwift - ZA Road Group Ride (A),Stages Dual,kickr,315,316,-1
75826,396557,2020-11-26 10:31:00,wahoo,Zwift - WTRL NOPINZ WORLD TTT CHAMPIONSHIPS - Zone 2 (C),Stages Dual,kickr,357,359,-2
77971,396557,2020-12-01 11:10:01,wahoo,Zwift - Japan Zwift Tuesday Race (B),Stages Dual,kickr,374,359,15
78849,396557,2020-12-03 10:29:01,wahoo,Zwift - WTRL Team Time Trial - Zone 2 (C),Stages Dual,kickr,380,365,15
78850,396557,2020-12-03 11:55:00,wahoo,Zwift - DIRT Doozy Race (B),Stages Dual,kickr,358,341,17
80716,396557,2020-12-08 11:10:02,wahoo,Zwift - Japan Zwift Tuesday Race (B),Stages Dual,kickr,352,337,15
81438,396557,2020-12-10 10:40:09,wahoo,Zwift - Frappe,Stages Dual,kickr,354,349,5
86080,396557,2020-12-22 11:01:51,wahoo,Zwift - Watopia,Stages Dual,kickr,294,303,-9
86084,396557,2020-12-22 11:58:38,wahoo,Zwift - Watopia,Stages Dual,kickr,242,245,-3
86889,396557,2020-12-24 11:01:02,wahoo,Zwift - KISS Race Series - Americas AM (B),Stages Dual,kickr,378,383,-5
87885,396557,2020-12-27 10:30:02,wahoo,Zwift - The PRL Full,Stages Dual,kickr,315,316,-1
89360,396557,2020-12-31 11:01:02,wahoo,Zwift - KISS Race Series - Americas AM (B),Stages Dual,kickr,339,342,-3
89364,396557,2020-12-31 11:55:01,wahoo,Zwift - DIRT Doozy Race (B),Stages Dual,kickr,354,365,-11
91660,396557,2021-01-05 11:00:54,wahoo,Zwift - KISS Race Series - Americas AM (B),Stages Dual,kickr,383,384,-1
92744,396557,2021-01-07 10:24:57,wahoo,Zwift - WTRL Team Time Trial - Zone 2 (C),Stages Dual,kickr,382,369,13
97437,396557,2021-01-15 10:25:02,wahoo,Zwift - DIRT Friday Morning Sprintapalooza (C),Stages Dual,kickr,255,256,-1
100740,396557,2021-01-21 10:25:00,wahoo,Zwift - WTRL Team Time Trial - Zone 2 (C),Stages Dual,kickr,382,371,11
101834,396557,2021-01-23 10:45:02,wahoo,Zwift - Into the Red by RELENTLESS (B),Stages Dual,kickr,392,387,5
101836,396557,2021-01-23 12:08:02,wahoo,Zwift - DIRT Dadurday Chase Race  (B),Stages Dual,kickr,367,367,0
113450,396557,2021-02-12 10:51:01,wahoo,KISS at Base Training Ride,Stages Dual,kickr,354,348,6
117808,396557,2021-02-17 00:50:02,wahoo,Zwift - Zwift Racing League | WTRL - Men&#039;s/Mixed AMERICAS E DIVISION 5 (B),Stages Dual,kickr,404,398,6
120049,396557,2021-02-24 00:50:02,wahoo,Zwift - Zwift Racing League | WTRL - Men&#039;s/Mixed AMERICAS E DIVISION 5 (B),Stages Dual,kickr,357,359,-2
123360,396557,2021-03-03 00:56:31,wahoo,Zwift - Zwift Racing League | WTRL - Men&#039;s/Mixed AMERICAS E DIVISION 5 (B),Stages Dual,kickr,370,364,6
124973,396557,2021-03-06 10:45:16,wahoo,Zwift - Into the Red by RELENTLESS (B),Stages Dual,kickr,395,393,2
60444,399087,2020-10-08 19:49:12,wahoo,Zwift - France freeRide,Garmin 2,KickR2018,294,287,7
97201,399880,2021-01-14 18:30:21,wahoo,Zwift - WTRL Team Time Trial - Zone 5 (D),4iii left crank unit,Wahoo Kickr V5,270,283,-13
97641,399880,2021-01-15 17:00:32,wahoo,ZHQ FutureWorks Crit City Race - Boost mode,4iii left crank unit,Wahoo Kickr V5,321,306,15
98401,399880,2021-01-17 07:59:48,wahoo,Zwift - TDZ Stage 3: Longer Ride,4iii left crank unit,Wahoo Kickr V5,297,295,2
99769,399880,2021-01-19 18:32:56,wahoo,Zwift - Zwift Racing League | WTRL - Men&#039;s/Mixed EMEA E2 DIVISION 2 (B),4iii left crank unit,Wahoo Kickr V5,293,296,-3
100961,399880,2021-01-21 18:28:41,wahoo,Zwift - WTRL Team Time Trial - Zone 5 (D),4iii left crank unit,Wahoo Kickr V5,276,277,-1
101407,399880,2021-01-22 13:58:23,wahoo,Zwift - TDZ Stage 4: Longer Ride,4iii left crank unit,Wahoo Kickr V5,291,291,0
102256,399880,2021-01-24 09:00:22,wahoo,Zwift - TDZ Stage 5: Longer Ride,4iii left crank unit,Wahoo Kickr V5,284,288,-4
103569,399880,2021-01-26 18:20:07,wahoo,Zwift - Zwift Racing League | WTRL - Men&#039;s/Mixed EMEA E2 DIVISION 2 (B),4iii left crank unit,Wahoo Kickr V5,303,302,1
104716,399880,2021-01-28 18:20:46,wahoo,Zwift - WTRL Team Time Trial - Zone 5 (D),4iii left crank unit,Wahoo Kickr V5,303,301,2
106295,399880,2021-01-31 08:56:07,wahoo,Zwift - TDZ Stage 6: Longer Ride,4iii left crank unit,Wahoo Kickr V5,295,299,-4
107677,399880,2021-02-02 18:19:38,wahoo,Zwift - Zwift Racing League | WTRL - Men&#039;s/Mixed EMEA E2 DIVISION 1 - Gastspiel im KC-B1,4iii left crank unit,Wahoo Kickr V5,311,312,-1
108961,399880,2021-02-04 18:17:38,wahoo,Zwift - WTRL Team Time Trial Z5(D)- im phantastischen KC-F2 Team,4iii left crank unit,Wahoo Kickr V5,320,320,0
109438,399880,2021-02-05 18:01:16,wahoo,Zwift - KIRCHMAIR Race Series (B),4iii left crank unit,Wahoo Kickr V5,322,320,2
111362,399880,2021-02-07 13:00:17,wahoo,Zwift - TDZ Stage 7: Longer Ride,4iii left crank unit,Wahoo Kickr V5,306,304,2
112031,399880,2021-02-09 18:26:32,wahoo,Zwift - ZRL | WTRL - Men&#039;s/Mixed EMEA E2 DIV 2 (B) fataler Dropout bei Km 13.2,4iii left crank unit,Wahoo Kickr V5,314,313,1
113319,399880,2021-02-11 18:23:12,wahoo,Zwift - WTRL Team Time Trial - Zone 5 (D),4iii left crank unit,Wahoo Kickr V5,306,301,5
113379,399880,2021-02-12 10:57:09,wahoo,Zwift - TDZ Stage 8: Group Ride,4iii left crank unit,Wahoo Kickr V5,312,309,3
115939,399880,2021-02-16 18:22:29,wahoo,Zwift - Zwift Racing League | WTRL - Men&#039;s/Mixed EMEA E2 DIVISION 2 (B),Assioma Duo,Wahoo Kickr V5,323,322,1
123182,399880,2021-03-02 18:29:39,wahoo,Zwift - Zwift Racing League | WTRL - Men&#039;s/Mixed EMEA E2 DIVISION 2 (B),4iiii left crank unit,Wahoo Kickr V5,289,290,-1
124204,399880,2021-03-04 18:27:57,wahoo,Kirchmair Cycling Team Frappe 2 - WTRL Team Time Trial - Zone 5 (D),4iiii left crank unit,Wahoo Kickr V5,299,294,5
127163,399880,2021-03-11 18:28:17,wahoo,Zwift - WTRL Team Time Trial - Zone 5 (D) i am in &lt;3 with F2,4iiii left crank unit,Wahoo Kickr V5,291,286,5
3157,400349,2019-10-03 17:43:36,neo,Zwift - FUSION ECT BEUNSTOPPABLE Racing Series (B),P1 DUO PEDALS,NEO ,273,263,10
4302,400349,2019-11-15 19:00:56,neo,Zwift - The Friday Criterium Autumn  Series (27 mi / 44 km) (B),P1 DUO PEDALS,NEO ,292,284,8
5671,400349,2019-12-06 18:10:03,neo,Zwift - 3R Lutscher CCW Climbing Race - 1 Lap (22.1km/13.9mi 827m) (B),P1 DUO PEDALS,NEO ,286,284,2
6250,400349,2019-12-14 13:44:56,neo,Zwift - WTRL Alpe du Zwift Series (E),P1 DUO PEDALS,NEO ,292,294,-2
6493,400349,2019-12-17 17:43:38,neo,Zwift - 45 mins as hard as possible :(,P1 DUO PEDALS,NEO ,264,266,-2
6660,400349,2019-12-18 10:51:10,neo,Zwift - KISS at Base Training Ride (C),P1 DUO PEDALS,NEO ,202,188,14
6738,400349,2019-12-19 18:39:39,neo,Zwift - New Workout,P1 DUO PEDALS,NEO ,170,164,6
6937,400349,2019-12-21 15:14:51,neo,Zwift - OH CRIT!! - Saturday Smash Series (A),P1 DUO PEDALS,NEO ,280,283,-3
7408,400349,2019-12-27 13:59:57,neo,Zwift - Stage 1 ITT: Toronto Hustle Holiday Classic Stage Race p/b Elite (B),P1 DUO PEDALS,NEO ,276,268,8
8049,400349,2020-01-04 13:44:54,neo,Zwift - WTRL Winter Racing League,P1 DUO PEDALS,NEO ,267,260,7
9859,400349,2020-01-18 08:59:57,neo,Zwift - Danmarks Cykle Union 2020 Cup (A),P1 DUO PEDALS,NEO ,281,285,-4
40121,400349,2020-06-07 07:19:59,neo,Zwift - Team Italy & Frenchy Fuzion Endurance Race (A),P1 DUO PEDALS,NEO ,272,277,-5
44587,400349,2020-07-02 18:29:54,neo,Zwift - pre race warm up,P1 DUO PEDALS,NEO ,292,283,9
45017,400349,2020-07-05 16:00:53,neo,Zwift - L&#039;Etape du Tour Stage 1 - Open,P1 DUO PEDALS,NEO ,296,293,3
45187,400349,2020-07-07 06:00:01,neo,Zwift - 07/07/2020,P1 DUO PEDALS,NEO ,314,303,11
48926,400349,2020-08-05 17:03:48,neo,Zwift -  Cycling Weekly Club Ten (E),P1 DUO PEDALS,NEO ,286,277,9
54379,400349,2020-09-10 16:04:50,neo,Zwift - OH MY CRIT! - The Double Race 2/2 (A),P1 DUO PEDALS,NEO ,292,278,14
59849,400349,2020-10-06 18:03:58,neo,Zwift - Zwift Time Trial Tuesday: Bologna (E),P1 DUO PEDALS,NEO ,297,302,-5
60398,400349,2020-10-08 17:59:51,neo,Zwift - Pre zwift race activation ,P1 DUO PEDALS,NEO ,297,289,8
60703,400349,2020-10-10 08:00:53,neo,Zwift -  Flanders Toeristenkoers (B),P1 DUO PEDALS,NEO ,291,289,2
61545,400349,2020-10-13 17:14:51,neo,Zwift - Zwift Racing League | WTRL,P1 DUO PEDALS,NEO ,291,276,15
63388,400349,2020-10-20 15:59:48,neo,Zwift - BST Happy Mountaingoats&#039; Hill Climb TT (A),P1 DUO PEDALS,NEO ,288,272,16
65437,400349,2020-10-27 18:15:28,neo,Zwift - Zwift Racing League | WTRL - EMEA E (MEN) -  Division 2 (A),P1 DUO PEDALS,NEO ,293,279,14
68579,400349,2020-11-06 19:05:53,neo,Zwift -  Tour De Spartacus  (A),P1 DUO PEDALS,NEO ,293,280,13
72204,400349,2020-11-17 17:29:50,neo,Zwift - ZHR Masters Europe (B),P1 DUO PEDALS,NEO ,265,258,7
75051,400349,2020-11-24 18:15:51,neo,Zwift - Zwift Racing League | WTRL - Men&#039;s EMEA E1 DIVISION 2,P1 DUO PEDALS,NEO ,286,282,4
78044,400349,2020-12-01 18:29:46,neo,Zwift - ZTPL.CC Classic Race (E),P1 DUO PEDALS,NEO ,288,277,11
80869,400349,2020-12-08 18:29:55,neo,Zwift - ZTPL.CC Classic Race (E),P1 DUO PEDALS,NEO ,300,291,9
82623,400349,2020-12-13 09:40:34,neo,Zwift - TugaZ Sunday Cake Ride - Passeio do Pastel de Nata (C),rotor inpower ,NEO ,173,159,14
83495,400349,2020-12-15 17:13:15,neo,Zwift - Pre zwift race activation ,rotor inpower ,NEO ,208,199,9
83548,400349,2020-12-15 18:29:50,neo,Zwift - ZTPL.CC Classic Race (E),rotor inpower ,NEO ,297,278,19
85438,400349,2020-12-20 15:00:03,neo,Zwift - 3R Endurance Steady Ride [~3.0//2.5w/kg avg] (B),rotor inpower ,NEO ,207,189,18
12346,401098,2020-02-04 10:05:59,wahoo,3R_Ultimate_Racing_League_Bound_5_B_4iii,3R_Ultimate_Racing_League_Bound_5_B_4iii,3R_Ultimate_Racing_League_Round_5_B_KickCore,313,291,22
12701,401098,2020-02-06 10:59:58,wahoo,Tour_de_Zwift_Stage_7_Long_Distance,TdZ_stage7_LD_4iii,TdZ_stage7_LD_KickCore,319,304,15
13085,401098,2020-02-09 06:59:59,wahoo,Zwift Grand Fondo (A),Zwift_Grand_Fondo_A_4iii,Zwift_Grand_Fondo_A_KickrCore,307,289,18
16240,401098,2020-03-01 10:00:20,wahoo,Zwift_Gran_Fondo_KickCOre / Zwift_Gran_Fondo_4iiiLeft,Zwift_Gran_Fondo_4iiiLeft,Zwift_Gran_Fondo_KickCOre,294,282,12
16542,401098,2020-03-03 08:32:48,wahoo,FuegoFlat_TT_4iiiiDual / FuegoFlat_TT_KickCore,FuegoFlat_TT_4iiiiDual,FuegoFlat_TT_KickCore,274,281,-7
17123,401098,2020-03-07 08:04:59,wahoo,3R_Crit_City_Downtown_Dolphin_Race_18_Laps_B_KickrCore / 3R_Crit_City_Downtown_Dolphin_Race_18_Laps_B_4iiiiDual,3R_Crit_City_Downtown_Dolphin_Race_18_Laps_B_4iiiiDual,3R_Crit_City_Downtown_Dolphin_Race_18_Laps_B_KickrCore,298,294,4
17124,401098,2020-03-07 08:04:59,wahoo,3R_Crit_City_Downtown_Dolphin_Race_18_Laps_B,3R_Crit_City_Downtown_Dolphin_Race_18_Laps_B_4iiiiDual,3R_Crit_City_Downtown_Dolphin_Race_18_Laps_B_KickrCore,287,294,-7
44777,401098,2020-07-04 07:00:59,wahoo,5 minute Test 2020-07-04 Epic KOM,5minTest_4iii_EpicKom,5minTEst_KickrCore_EpicKOM_20200704,339,342,-3
44946,401098,2020-07-05 08:00:58,wahoo,20 minute Test 2020-07-05 Epic KOM,4iiii,Kickr core,300,301,-1
75472,401098,2020-11-25 14:55:20,wahoo,recovery 25 nov 2020,4iii,Kickr core,166,169,-3
76709,401098,2020-11-28 08:04:59,wahoo,Kickr core / 4iii,4iii,Kickr core,285,288,-3
82215,401098,2020-12-12 09:39:59,wahoo,Zwift - ZA Tri: TT Race - 40k ,4iii dual crank,Kickr core,276,277,-1
93993,401098,2021-01-09 16:28:05,wahoo,Zwift - TEAM VEGAN Tofu Tornado (A),4iii dual crank,Kickr core,309,310,-1
95070,401098,2021-01-11 19:44:53,wahoo,Zwift - D anno (R3R Dev)&#039;s Meetup - 2015 UCI Worlds Course,4iii dual crank,Kickr core,218,224,-6
95798,401098,2021-01-12 19:46:27,wahoo,Zwift - Zwift Racing League | WTRL - Men&#039;s/Mixed EMEA W1 DIVISION 3 (A),4iii dual crank,Kickr core,319,323,-4
97057,401098,2021-01-14 19:01:56,wahoo,Zwift - WTRL Team Time Trial - Zone 7 (C),4iii dual crank,Kickr core,304,307,-3
98155,401098,2021-01-16 16:28:38,wahoo,Zwift - TEAM VEGAN Tofu Tornado (A),4iii dual crank,Kickr core,312,318,-6
99811,401098,2021-01-19 19:47:09,wahoo,Zwift - Zwift Racing League | WTRL - Men&#039;s/Mixed EMEA W1 DIVISION 3 (A),4iii dual crank,Kickr core,301,308,-7
100990,401098,2021-01-21 19:15:36,wahoo,Zwift - WTRL Team Time Trial - Zone 7 (C),4iii dual crank,Kickr core,287,296,-9
101964,401098,2021-01-23 16:28:49,wahoo,TEAM VEGAN Tofu Tornado - Veganuary STAGE 4,4iii dual crank,Kickr core,322,334,-12
103672,401098,2021-01-26 19:45:08,wahoo,Zwift - Zwift Racing League | WTRL - Men&#039;s/Mixed EMEA W1 DIVISION 3 (A),4iii dual crank,Kickr core,317,329,-12
104745,401098,2021-01-28 19:06:46,wahoo,Zwift - WTRL Team Time Trial - Zone 7 (C),4iii dual crank,Kickr core,291,304,-13
105107,401098,2021-01-29 14:16:51,wahoo,Zwift - Watopia recovery,4iii dual crank,Kickr core,226,234,-8
105686,401098,2021-01-30 16:27:18,wahoo,Veganuary21 Stage 5 iTT,4iii dual crank,Kickr core,298,306,-8
107815,401098,2021-02-02 19:47:23,wahoo,Zwift - Zwift Racing League | WTRL - Men&#039;s/Mixed EMEA W1 DIVISION 3 (A),4iii dual crank,Kickr core,293,302,-9
111725,401098,2021-02-09 19:47:04,wahoo,Zwift - Zwift Racing League | WTRL - Men&#039;s/Mixed EMEA W1 DIVISION 3 (A),4iii dual crank,Kickr core,298,305,-7
113004,401098,2021-02-11 19:07:24,wahoo,Zwift - WTRL Team Time Trial - Zone 9 (C),4iii dual crank,Kickr core,294,298,-4
116040,401098,2021-02-16 19:43:27,wahoo,Zwift - Zwift Racing League | WTRL - Men&#039;s/Mixed EMEA W1 DIVISION 3 (A),4iii dual crank,Kickr core,322,330,-8
118094,401098,2021-02-20 09:03:54,wahoo,Zwift - 3R Endurance Series p/b OTE Sports- Stage 1 (A),4iii dual crank,Kickr core,291,295,-4
119784,401098,2021-02-23 19:44:36,wahoo,Zwift - Zwift Racing League | WTRL - Men&#039;s/Mixed EMEA W1 DIVISION 3 (A),4iii dual crank,Kickr core,325,328,-3
121439,401098,2021-02-27 09:03:09,wahoo,Zwift - 3R Endurance Series p/b OTE Sports (A),4iii dual crank,Kickr core,304,307,-3
4480,401735,2019-11-19 19:09:59,wahoo,Zwift - WORLDOFFUSION Racing Series (A),FSA powerbox ,Wahoo Kick18,366,375,-9
4913,401735,2019-11-26 19:10:00,wahoo,Zwift - WORLDOFFUSION Racing Series (A),FSA powerbox ,Wahoo Kick18,375,374,1
5249,401735,2019-12-01 08:00:14,wahoo,Zwift - Giro di Castelli // Stage 3 (A),FSA powerbox ,Wahoo Kick18,430,422,8
5486,401735,2019-12-04 19:05:11,wahoo,Zwift - Watopia,FSA powerbox ,Wahoo Kick18,365,368,-3
5932,401735,2019-12-10 19:10:11,wahoo,Zwift - WORLDOFFUSION Racing Series (A),FSA powerbox ,Wahoo Kick18,388,382,6
5961,401735,2019-12-11 06:44:51,wahoo,Zwift - Watopia,FSA powerbox ,Wahoo Kick18,353,343,10
6016,401735,2019-12-11 19:05:00,wahoo,Zwift - DBR HEINO CUP (A),FSA powerbox ,Wahoo Kick18,403,400,3
6451,401735,2019-12-16 23:04:41,wahoo,Zwift - ,FSA powerbox ,Wahoo Kick18,250,246,4
6554,401735,2019-12-18 01:04:23,wahoo,Zwift - London,FSA powerbox ,Wahoo Kick18,264,266,-2
6628,401735,2019-12-18 19:05:15,wahoo,Zwift - DBR HEINO CUP (A),FSA powerbox ,Wahoo Kick18,386,384,2
6786,401735,2019-12-20 06:48:32,wahoo,Zwift - Watopia,FSA powerbox ,Wahoo Kick18,340,333,7
6889,401735,2019-12-21 06:32:47,wahoo,Zwift - Watopia,FSA powerbox ,Wahoo Kick18,348,341,7
6992,401735,2019-12-22 06:55:15,wahoo,Zwift - SZR Aktivitus 2h v5,FSA powerbox ,Wahoo Kick18,380,374,6
7220,401735,2019-12-25 05:35:17,wahoo,Zwift - 3R Igniter Interval Ride [~3-3.5w/kg avg] (B),FSA powerbox ,Wahoo Kick18,339,336,3
7616,401735,2019-12-30 07:16:07,wahoo,2x 20 @ 375w,FSA powerbox ,Kick18 to Garmin,385,385,0
7772,401735,2020-01-01 06:51:00,wahoo,Zwift - NYC,FSA powerbox ,Wahoo Kick18,346,347,-1
8013,401735,2020-01-04 07:03:24,wahoo,MAP 1 on 1 off x 12,FSA powerbox ,Wahoo Kick18,378,382,-4
8801,401735,2020-01-11 06:42:21,wahoo,Zwift - Watopia,FSA powerbox ,Wahoo Kick18,399,398,1
9062,401735,2020-01-12 19:10:01,wahoo,Zwift - Tour de Zwift: Stage 1 Race (A),FSA powerbox ,Wahoo Kick18,363,357,6
9402,401735,2020-01-14 22:36:38,wahoo,openers,FSA powerbox ,Wahoo Kick18,312,311,1
9519,401735,2020-01-15 19:14:58,wahoo,Zwift - Tour de Zwift // Pro-Am Invitational (A),FSA powerbox ,Wahoo Kick18,420,416,4
9849,401735,2020-01-18 06:48:34,wahoo,Zwift,FSA powerbox ,Wahoo Kick18,418,412,6
9961,401735,2020-01-19 04:01:34,wahoo,Zwift - crisscross + vo2 max,FSA powerbox ,Wahoo Kick18,372,368,4
10473,401735,2020-01-22 18:53:41,wahoo,Zwift - Watopia,FSA powerbox ,Wahoo Kick18,316,315,1
10648,401735,2020-01-23 19:14:59,wahoo,Zwift - Tour de Zwift // Pro-Am Invitational,FSA powerbox ,Wahoo Kick18,468,461,7
10727,401735,2020-01-24 07:11:25,wahoo,Zwift - Watopia,FSA powerbox ,Wahoo Kick18,301,292,9
10833,401735,2020-01-25 06:20:32,wahoo,Zwift - Watopia,FSA powerbox ,Kick18 to Garmin,329,319,10
10952,401735,2020-01-26 05:37:52,wahoo,Zwift - crisscross + vo2 max,FSA powerbox ,Wahoo Kick18,416,412,4
11698,401735,2020-01-30 18:58:23,wahoo,openers,FSA powerbox ,Kick18 to Garmin,353,350,3
11851,401735,2020-01-31 19:15:00,wahoo,Tour de Zwift // Pro-Am Invitational,FSA powerbox ,Kick18 to Garmin,425,413,12
12210,401735,2020-02-03 07:37:18,wahoo,Zwift - Richmond,FSA powerbox ,Kick18 to Garmin,291,292,-1
12417,401735,2020-02-04 19:14:55,wahoo,Tour de Zwift // Pro-Am Invitational,FSA powerbox ,Kick18 to Garmin,426,428,-2
12666,401735,2020-02-06 03:54:48,wahoo,Zwift - Watopia,FSA powerbox ,Kick18 to Garmin,271,273,-2
12867,401735,2020-02-07 07:00:54,wahoo,Zwift - Ramp Test,FSA powerbox ,Wahoo Kick18,477,479,-2
13735,401735,2020-02-13 18:43:06,wahoo,KALAS Cup - Round 3,FSA powerbox ,Kick18 to Garmin,397,397,0
14124,401735,2020-02-15 19:12:03,wahoo,Zwift - New Workout,FSA powerbox ,Wahoo Kick18,405,413,-8
17438,401735,2020-03-10 09:19:55,wahoo,Zwift - Eat The Pain Race (A),FSA powerbox ,wahoo kickr gen 1 (overseas),418,426,-8
18936,401735,2020-03-20 19:14:17,wahoo,Zwift - Tour of Watopia Pro-Am Men&#039;s Race #2 (A),FSA powerbox ,Kick18 to Garmin,431,425,6
19337,401735,2020-03-24 02:01:20,wahoo,Zwift - Stage 4 - Shorter Ride - Tour of Watopia 2020,FSA powerbox ,Kick18 to Garmin,238,242,-4
19655,401735,2020-03-24 19:14:52,wahoo,Zwift - Tour of Watopia Pro-Am Men&#039;s Race #3 (A),FSA powerbox ,Kick18 to Garmin,384,385,-1
20245,401735,2020-03-28 22:59:40,wahoo,NZ champs ,FSA powerbox (primary),Wahoo Kickr 18 (secondary),355,355,0
21626,401735,2020-04-03 06:58:48,wahoo,Zwift -  Haute Route Watopia Stage 1 (E),FSA powerbox (primary),Wahoo Kickr 18 (secondary),431,437,-6
22171,401735,2020-04-05 08:59:11,wahoo,Zwift - Ronde van Zwift (A),FSA powerbox (primary),Wahoo Kickr 18 (secondary),395,402,-7
23299,401735,2020-04-09 18:08:42,wahoo,Zwift - London International // Zwift Classic (A),FSA powerbox (primary),Wahoo Kickr 18 (secondary),458,461,-3
25104,401735,2020-04-16 09:45:13,wahoo,Zwift - Koa Sports League Race (A),FSA powerbox (primary),Wahoo Kickr 18 (secondary),389,388,1
25597,401735,2020-04-17 18:10:42,wahoo,Zwift - Richmond Challenge // Zwift Classic (A),FSA powerbox secondary ,wahoo kickr 18 primary ,422,428,-6
27207,401735,2020-04-23 09:45:12,wahoo,Zwift - Koa Sports League Race (A),Verve Infocrank (primary),Wahoo Kickr 18 (secondary),391,374,17
27781,401735,2020-04-25 04:00:30,wahoo,Zwift - SAS -  Centurion 100km (C),Verve Infocrank (primary),Wahoo Kickr 18 (secondary),269,259,10
28011,401735,2020-04-25 18:10:14,wahoo,Zwift - Crit City Slam // Zwift Classic (A),Verve Infocrank (primary),Wahoo Kickr 18 (secondary),429,418,11
28363,401735,2020-04-27 04:38:58,wahoo,Zwift - Over-unders,Verve Infocrank (primary),Wahoo Kickr 18 (secondary),412,405,7
28575,401735,2020-04-28 03:44:50,wahoo,Zwift - London,Verve Infocrank (primary),Wahoo Kickr 18 (secondary),455,451,4
30608,401735,2020-05-02 16:00:18,wahoo,Zwift - YANA Pro/AM Invitiational (A),Verve Infocrank (primary),Wahoo Kickr 18 (secondary),457,446,11
30792,401735,2020-05-03 05:12:38,wahoo,Zwift - Tempo with short spikes,Verve Infocrank (primary),Wahoo Kickr 18 (secondary),361,351,10
31462,401735,2020-05-05 05:12:36,wahoo,Zwift - Ramp ups,Verve Infocrank (primary),Wahoo Kickr 18 (secondary),413,405,8
32218,401735,2020-05-07 01:32:53,wahoo,Zwift - Bicicletta Vancouver Group Ride (C),Infocrank garmin ,wahoo kickr 18 primary ,329,335,-6
32318,401735,2020-05-07 09:45:14,wahoo,Zwift - Koa Sports League Race (A),Infocrank garmin ,wahoo kickr 18 primary ,402,391,11
33822,401735,2020-05-12 09:09:56,wahoo,Zwift - SRAM Send it Series - Race 1 - Men&#039;s (E),Verve Infocrank (primary),Wahoo Kickr 18 (secondary),433,421,12
34578,401735,2020-05-14 09:45:13,wahoo,Zwift - Koa Sports League Race (A),Verve Infocrank (primary),Wahoo Kickr 18 (secondary),377,367,10
35969,401735,2020-05-19 09:10:22,wahoo,Zwift - SRAM Send it Series - Race 2 - Men&#039;s (E),Verve Infocrank (primary),Wahoo Kickr 18 (secondary),440,428,12
36695,401735,2020-05-21 18:17:14,wahoo,Zwift - Tour for All Invitational Race // Men (A),Verve Infocrank (primary),Wahoo Kickr 18 (secondary),431,425,6
37734,401735,2020-05-26 09:10:19,wahoo,Zwift - Ramp ups,Verve Infocrank (primary),Wahoo Kickr 18 (secondary),433,425,8
38387,401735,2020-05-28 18:17:13,wahoo,Zwift - Tour for All Invitational Race // Men (A),Verve Infocrank (primary),Wahoo Kickr 18 (secondary),454,455,-1
39030,401735,2020-06-02 09:10:20,wahoo,SRAM send it series ,Verve Infocrank (primary),Wahoo Kickr 18 (secondary),455,448,7
39497,401735,2020-06-04 09:35:34,wahoo,KOA Sports warrior race ,Infocrank garmin ,wahoo kickr 18 primary ,390,382,8
40671,401735,2020-06-10 04:53:17,wahoo,Zwift - Watopia,Infocrank garmin ,wahoo kickr 18 primary ,469,458,11
46226,401735,2020-07-14 08:00:39,wahoo,Zwift - Virtual Tour de France - Open - Stage 3 Discovery Ride,Infocrank garmin ,wahoo kickr 18 primary ,388,378,10
49797,401735,2020-08-13 07:55:53,wahoo,Zwift - Paris,Infocrank garmin ,wahoo kickr 18 primary ,339,330,9
49941,401735,2020-08-14 08:50:13,wahoo,Zwift - Off the MAAP Invitational Race // Stage 1 (Men) (A),Infocrank garmin ,wahoo kickr 18 primary ,429,422,7
50372,401735,2020-08-17 09:50:12,wahoo,Zwift - Off the MAAP Invitational Race // Stage 2 (Men) (A),Infocrank garmin ,wahoo kickr 18 primary ,473,464,9
50842,401735,2020-08-20 08:50:13,wahoo,Zwift - Off the MAAP Invitational Race // Stage 3 (men) ,Infocrank garmin ,wahoo kickr 18 primary ,450,435,15
51328,401735,2020-08-23 08:02:21,wahoo,Zwift -  KRT/KISS 100km Endurance Ride (C),Infocrank garmin ,wahoo kickr 18 primary ,334,325,9
51485,401735,2020-08-24 09:35:12,wahoo,Zwift - Off the MAAP Invitational Race // Stage 4 (men) ,Infocrank garmin ,wahoo kickr 18 primary ,430,421,9
52473,401735,2020-08-29 08:08:53,wahoo,Zwift,Infocrank garmin ,wahoo kickr 18 primary ,349,343,6
54677,401735,2020-09-12 08:15:16,wahoo,Zwift - ZHR Audax (E),Infocrank garmin ,wahoo kickr 18 primary ,325,323,2
54953,401735,2020-09-14 08:08:25,wahoo,Zwift - Watopia,Evening_Ride (2),wahoo kickr 18 primary ,352,353,-1
55056,401735,2020-09-14 17:45:03,wahoo,Zwift - Invitational League // Qualifying Race #1,Infocrank garmin ,wahoo kickr 18 primary ,402,401,1
55916,401735,2020-09-17 18:13:59,wahoo,Zwift - Invitational League // Qualifying Race #2 (Men) ,Infocrank garmin ,wahoo kickr 18 primary ,399,392,7
56468,401735,2020-09-20 12:41:03,wahoo,Zwift - Invitational League // Qualifying Race #3 (Men) (A),Infocrank garmin ,wahoo kickr 18 primary ,428,422,6
61291,401735,2020-10-12 18:50:10,wahoo,Zwift - Premier Division // Zwift Racing League (men) ,Infocrank garmin ,wahoo kickr 18 primary ,441,439,2
63121,401735,2020-10-19 18:16:33,wahoo,Zwift - Premier Division // Zwift Racing League (men) ,Morning_Ride (2),Wahoo Kickr 18 (secondary),423,425,-2
65192,401735,2020-10-26 19:56:45,wahoo,Zwift - Premier Division // Zwift Racing League (men) (A),Infocrank garmin ,wahoo kickr 18 primary ,429,426,3
67311,401735,2020-11-02 18:58:24,wahoo,Zwift - Premier Division // Zwift Racing League (men) (A),Infocrank garmin ,wahoo kickr 18 primary ,430,432,-2
69424,401735,2020-11-09 19:59:54,wahoo,Zwift - Premier Division // Zwift Racing League (men) (A),Infocrank garmin ,wahoo kickr 18 primary ,445,448,-3
74690,401735,2020-11-23 20:00:03,wahoo,Zwift - Premier Division // Zwift Racing League (men) (A),Infocrank garmin ,wahoo kickr 18 primary ,461,460,1
76364,401735,2020-11-26 18:12:28,wahoo,Zwift - WTRL NOPINZ WORLD TTT CHAMPIONSHIPS - Zone 4 (C),Infocrank garmin ,wahoo kickr 18 primary ,431,431,0
77710,401735,2020-11-30 19:15:11,wahoo,Zwift - Premier Division // Zwift Racing League (men) (A),Infocrank garmin ,wahoo kickr 18 primary ,419,419,0
95010,401735,2021-01-11 19:15:07,wahoo,Zwift - Premier Division // Zwift Racing League (men) (A),Infocrank garmin ,wahoo kickr 18 primary ,385,378,7
99327,401735,2021-01-18 19:57:54,wahoo,Zwift - Premier Division // Zwift Racing League (men) (A),Infocrank garmin ,wahoo kickr 18 primary ,400,402,-2
111038,401735,2021-02-08 19:24:40,wahoo,Zwift - Premier Division // Zwift Racing League (men) (A),Infocrank garmin 520,wahoo kickr 18 primary ,425,424,1
115332,401735,2021-02-15 20:01:27,wahoo,Zwift - Premier Division // Zwift Racing League (men) (A),Infocrank garmin ,wahoo kickr 18 primary ,434,434,0
119098,401735,2021-02-22 19:06:56,wahoo,Zwift - Premier Division // Zwift Racing League (men) (A),Infocrank garmin ,wahoo kickr 18 primary ,369,361,8
122600,401735,2021-03-01 20:20:42,wahoo,Zwift - Premier Division // Zwift Racing League (men) (A),Infocrank garmin ,wahoo kickr 18 primary ,412,403,9
8326,402078,2020-01-07 18:38:12,wahoo,Zwift - Team Italy Gladiators Race (A),Shimano Dura Ace PowerMeter,Wahoo Kickr18,366,354,12
9374,402078,2020-01-14 18:40:31,wahoo,Zwift - Team Italy Gladiators Race (A),Shimano Dura Ace PowerMeter,Wahoo Kickr18,343,345,-2
9706,402078,2020-01-16 18:25:28,wahoo,Zwift - FUSION ECT BEUNSTOPPABLE Racing Series (A),Shimano Dura Ace PowerMeter,Wahoo Kickr18,350,347,3
10016,402078,2020-01-19 13:53:15,wahoo,Zwift - KISS at Race 100 - Americas (A),Shimano Dura Ace PowerMeter,Wahoo Kickr18,333,331,2
11400,402078,2020-01-28 18:51:21,wahoo,Zwift - pyramiden,Shimano Dura Ace PowerMeter,Wahoo Kickr18,353,353,0
11740,402078,2020-01-30 19:45:25,wahoo,Zwift - WTRL Team Time Trial (C),Shimano Dura Ace PowerMeter,Wahoo Kickr18,341,343,-2
12420,402078,2020-02-04 19:00:27,wahoo,Zwift - pyramiden,Shimano Dura Ace PowerMeter,Wahoo Kickr18,324,325,-1
12803,402078,2020-02-06 19:16:54,wahoo,Zwift - WTRL Team Time Trial (C),Shimano Dura Ace PowerMeter,Wahoo Kickr18,344,343,1
13083,402078,2020-02-09 05:55:44,wahoo,Zwift - 3R Watopia Flat Route Race - 4 Laps (40.5km/25.1mi 216m) (A),Shimano Dura Ace PowerMeter,Wahoo Kickr18,336,336,0
13447,402078,2020-02-11 19:03:45,wahoo,Zwift race + tirsdagspyramiden,Shimano Dura Ace PowerMeter,Wahoo Kickr18,353,353,0
13757,402078,2020-02-13 19:20:44,wahoo,Zwift - WTRL Team Time Trial (C),Shimano Dura Ace PowerMeter,Wahoo Kickr18,359,358,1
15625,402078,2020-02-25 19:07:20,wahoo,Zwift - Feltet.dk Race Series (A),Shimano Dura Ace PowerMeter,Wahoo Kickr18,355,355,0
15917,402078,2020-02-27 19:25:33,wahoo,Zwift - WTRL Team Time Trial (C),Shimano Dura Ace PowerMeter,Wahoo Kickr18,344,342,2
16071,402078,2020-02-29 07:28:58,wahoo,Zwift - 3R Watopia Seaside Sprint Race - 5 Laps (A),Shimano Dura Ace PowerMeter,Wahoo Kickr18,351,346,5
16073,402078,2020-02-29 08:56:29,wahoo,Zwift - Danmarks Cykle Union 2020 Cup (A),Shimano Dura Ace PowerMeter,Wahoo Kickr18,316,315,1
16661,402078,2020-03-03 19:04:25,wahoo,Zwift - No Pain No Gain Transparency Racing Series (A),Shimano Dura Ace PowerMeter,Wahoo Kickr18,349,346,3
16820,402078,2020-03-04 18:53:37,wahoo,Zwift - Zwift Beta Race (A),Shimano Dura Ace PowerMeter,Wahoo Kickr18,376,381,-5
16982,402078,2020-03-05 19:05:48,wahoo,Zwift - 03/05/2020,Shimano Dura Ace PowerMeter,Wahoo Kickr18,348,352,-4
17870,402078,2020-03-12 19:07:38,wahoo,Zwift - WTRL Team Time Trial (C),Shimano Dura Ace PowerMeter,Wahoo Kickr18,350,357,-7
20273,402078,2020-03-29 06:36:55,wahoo,Zwift - No Pain No Gain Endurance Racing Series (A),Shimano Dura Ace PowerMeter,Wahoo Kickr18,338,342,-4
34020,402078,2020-05-12 18:02:45,wahoo,Zwift - UNO X CUP powered by DCU & Feltet.dk (A),Shimano Dura Ace PowerMeter,Wahoo Kickr18,349,344,5
36985,402078,2020-05-23 06:56:07,wahoo,Zwift - 3R Crit City - Downtown Dolphin (26k/16.2 120m) (A),Shimano Dura Ace PowerMeter,Wahoo Kickr18,320,323,-3
37292,402078,2020-05-24 04:49:26,wahoo,Kiss 100 race,Shimano Dura Ace PowerMeter,Wahoo Kickr18,313,312,1
37855,402078,2020-05-26 18:06:30,wahoo,Zwift - UNO X CUP powered by DCU & Feltet.dk (A),Shimano Dura Ace PowerMeter,Wahoo Kickr18,361,378,-17
38358,402078,2020-05-28 18:02:48,wahoo,Zwift - WTRL Team Time Trial (C),Shimano Dura Ace PowerMeter,Wahoo Kickr18,336,337,-1
39636,402078,2020-06-04 18:44:27,wahoo,Zwift-ttt-av,Shimano Dura Ace PowerMeter,Wahoo Kickr18,326,317,9
54199,402078,2020-09-09 18:38:07,wahoo,Zwift - ZHR Hare & Hounds Race (A),Shimano Dura Ace PowerMeter,Wahoo KickrV5,346,356,-10
55382,402078,2020-09-15 18:00:44,wahoo,Zwift - 3R Sundown Race Series  (A),Shimano Dura Ace PowerMeter,Wahoo KickrV5,341,352,-11
55590,402078,2020-09-16 18:14:16,wahoo,Zwift - Deeside Thistle and Moray Firth Race (A),Shimano Dura Ace PowerMeter,Wahoo KickrV5,332,331,1
55835,402078,2020-09-17 18:19:42,wahoo,Zwift - ZHR Up & Down Race (A),Shimano Dura Ace PowerMeter,Wahoo KickrV5,348,352,-4
56845,402078,2020-09-22 18:33:46,wahoo,Zwift - 3R Sundown Race Series  (A),Shimano Dura Ace PowerMeter,Wahoo KickrV5,344,345,-1
57308,402078,2020-09-24 18:16:16,wahoo,Zwift - ZHR Up & Down Race (A),Shimano Dura Ace PowerMeter,Wahoo KickrV5,370,375,-5
59176,402078,2020-10-03 08:48:44,wahoo,Zwift - 3R Hilly Race (A),Shimano Dura Ace PowerMeter,Wahoo KickrV5,338,342,-4
59853,402078,2020-10-06 17:48:29,wahoo,Zwift - Team Italy & Frenchy Fuzion League (A),Shimano Dura Ace PowerMeter,Wahoo KickrV5,347,342,5
60423,402078,2020-10-06 17:48:29,wahoo,FUSION DEV - Team Time Trial,Shimano Dura Ace PowerMeter,Wahoo KickrV5,318,317,1
60907,402078,2020-10-11 04:52:32,wahoo,Zwift - KISS at Race 100 - EU (A),Shimano Dura Ace PowerMeter,Wahoo KickrV5,323,323,0
61583,402078,2020-10-13 18:29:18,wahoo,Zwift - Zwift Racing League | WTRL (A),Shimano Dura Ace PowerMeter,Wahoo KickrV5,367,375,-8
65508,402078,2020-10-27 19:17:52,wahoo,Zwift wtrl,Shimano Dura Ace PowerMeter,Wahoo KickrV5,356,363,-7
68291,402078,2020-11-03 19:22:02,wahoo,Zwift - ZHR Masters Britain (A),Shimano Dura Ace PowerMeter,Wahoo KickrV5,345,344,1
68294,402078,2020-11-04 19:26:12,wahoo,Zwift - British Cycling Crit City Series (A),Shimano Dura Ace PowerMeter,Wahoo KickrV5,330,332,-2
68296,402078,2020-11-05 19:17:29,wahoo,Zwift - BRT Criterium Racing League (A),Shimano Dura Ace PowerMeter,Wahoo KickrV5,317,314,3
70698,402078,2020-11-10 19:31:11,wahoo,Zwift - Zwift Racing League | WTRL - EMEA W1 (MEN) -  Division 1 (A),Shimano Dura Ace PowerMeter,Wahoo KickrV5,380,384,-4
73736,402078,2020-11-21 08:04:19,wahoo,Zwift - 3R Weekend Race Club - Race 1 (A),Shimano Dura Ace PowerMeter,Wahoo KickrV5,363,368,-5
75105,402078,2020-11-24 19:25:48,wahoo,Zwift - ZHR Masters Britain (A),Shimano Dura Ace PowerMeter,Wahoo KickrV5,352,362,-10
76115,402078,2020-11-26 19:15:32,wahoo,Zwift - BRT Criterium Racing League (A),Shimano Dura Ace PowerMeter,Wahoo KickrV5,336,330,6
78227,402078,2020-12-01 19:30:54,wahoo,Zwift - Zwift Racing League | TTT - Men&#039;s EMEA W1 DIVISION 1 (A),Shimano Dura Ace PowerMeter,Wahoo KickrV5,338,335,3
78641,402078,2020-12-02 19:21:50,wahoo,Zwift - Deeside Thistle and Moray Firth Race (A),Shimano Dura Ace PowerMeter,Wahoo KickrV5,358,359,-1
79914,402078,2020-12-05 18:57:38,wahoo,Zwift - EVR Summer Series (A),Shimano Dura Ace PowerMeter,Wahoo KickrV5,383,389,-6
81625,402078,2020-12-10 19:16:16,wahoo,#9 BRT Criterium Racing League (A),Shimano Dura Ace PowerMeter,Wahoo KickrV5,344,339,5
81630,402078,2020-12-09 15:55:24,wahoo,Sydkysten / KST Race (A),Shimano Dura Ace PowerMeter,Wahoo KickrV5,368,363,5
83627,402078,2020-12-15 19:40:47,wahoo,Zwift - Zwift Racing League | WTRL - Men&#039;s EMEA W1 DIVISION 1 (A),Shimano Dura Ace PowerMeter,Wahoo KickrV5,325,321,4
86651,402078,2020-12-23 19:01:50,wahoo,#3 Zwift - 3R Tick Tock Flat Race - 2 Lap (36km/22.4mi 100m) (A),Shimano Dura Ace PowerMeter,Wahoo KickrV5,355,351,4
90839,402078,2021-01-03 13:42:52,wahoo,Race!,Shimano Dura Ace PowerMeter,Wahoo KickrV5,363,368,-5
91828,402078,2021-01-05 18:52:33,wahoo,Zwift - Team Italy & Frenchy Fuzion League (A),Shimano Dura Ace PowerMeter,Wahoo KickrV5,349,352,-3
91832,402078,2021-01-05 18:52:33,wahoo,Zwift - Team Italy & Frenchy Fuzion League (A),Shimano Dura Ace PowerMeter,Wahoo KickrV5,340,352,-12
92929,402078,2021-01-07 19:16:46,wahoo,Zwift - BRT Criterium Racing League (A),Shimano Dura Ace PowerMeter,Wahoo KickrV5,326,327,-1
95904,402078,2021-01-12 19:42:26,wahoo,WTRL A: #26,Shimano Dura Ace PowerMeter,Wahoo KickrV5,356,357,-1
97441,402078,2021-01-15 15:11:15,wahoo,#11 - 3R Sand and Sequoias Race (A),Shimano Dura Ace PowerMeter,Wahoo KickrV5,339,347,-8
100644,402078,2021-01-19 19:48:35,wahoo,Zwift - Zwift Racing League | WTRL - Men&#039;s/Mixed EMEA W2 DIVISION 1 (A),Shimano Dura Ace PowerMeter,Wahoo KickrV5,329,329,0
107487,402078,2021-02-02 19:45:07,wahoo,Zwift - Zwift Racing League | WTRL - Men&#039;s/Mixed EMEA W2 DIVISION 1 (A),Shimano Dura Ace PowerMeter,Wahoo KickrV5,357,363,-6
111713,402078,2021-02-09 19:46:37,wahoo,Zwift - Zwift Racing League | WTRL - Men&#039;s/Mixed EMEA W2 DIVISION 1 (A),Shimano Dura Ace PowerMeter,Wahoo KickrV5,361,372,-11
116021,402078,2021-02-16 19:48:53,wahoo,Zwift - Zwift Racing League | WTRL - Men&#039;s/Mixed EMEA W2 DIVISION 1 (A),Shimano Dura Ace PowerMeter,Wahoo KickrV5,367,382,-15
117291,402078,2021-02-18 18:26:34,wahoo,Zwift - FUSION WINTER CUP (A),Shimano Dura Ace PowerMeter Ver2,Wahoo KickrV5,322,328,-6
48718,402664,2020-08-03 17:15:46,wahoo,Zwift - DBR Monday Race  (B),FSA PowerBox,Kickr,290,293,-3
54527,402664,2020-09-11 06:00:02,wahoo,Zwift - SAS - French Fries (C),FSA PowerBox,Kickr,250,252,-2
73409,403098,2020-11-19 19:53:26,wahoo,Zwift - KISS Race Series - EU PM (A),Favero Assioma Duo,Wahoo KICKR Smart V4,313,304,9
75303,403098,2020-11-24 20:14:47,wahoo,Zwift - JETT ZWIFT Morning Race (A),Favero Assioma Duo,Wahoo KICKR Smart V4,309,305,4
76299,403098,2020-11-26 19:39:34,wahoo,Zwift - KISS Race Series - EU PM (A),Favero Assioma Duo,Wahoo KICKR Smart V4,315,305,10
78301,403098,2020-12-01 20:00:43,wahoo,Zwift - JETT ZWIFT Morning Race (A),Favero Assioma Duo,Wahoo KICKR Smart V4,311,304,7
79170,403098,2020-12-03 19:29:37,wahoo,Zwift - Crit City Race (A),Favero Assioma Duo,Wahoo KICKR Smart V4,324,314,10
79175,403098,2020-12-03 20:19:44,wahoo,Zwift - 3R LaGuardia Loop Flat Race - 6 Laps (17.5km/10.9 162m) (A),Favero Assioma Duo,Wahoo KICKR Smart V4,302,297,5
81793,403098,2020-12-06 21:46:01,wahoo,Zwift - 3R Watopia Flat Route Reverse Race - 2 Laps (20.5km/12.7mi 108m) (A),Favero Assioma Duo,Wahoo KICKR Smart V4,413,405,8
81797,403098,2020-12-10 22:37:38,wahoo,Zwift - Koa Sports League Warrior Race (A),Favero Assioma Duo,Wahoo KICKR Smart V4,346,340,6
84582,403098,2020-12-17 23:00:55,wahoo,Zwift - Koa Sports League Warrior Race (A),Favero Assioma Duo,Wahoo KICKR Smart V4,292,287,5
84585,403098,2020-12-16 23:05:01,wahoo,Zwift - 3R Volcano Flat Reverse 50k Race - 4 Laps (48.8km/30.7mi 184m) (A),Favero Assioma Duo,Wahoo KICKR Smart V4,294,288,6
88813,403098,2020-12-29 10:43:11,wahoo,Zwift - KISS Race Series - Americas AM (A),Favero Assioma Duo,Wahoo KICKR Smart V4,330,322,8
88815,403098,2020-12-29 12:13:44,wahoo,Zwift - EMU Japan Race (A),Favero Assioma Duo,Wahoo KICKR Smart V4,318,308,10
89246,403098,2020-12-30 20:49:23,wahoo,Zwift - I Tsan 555&#039;s Meetup - Quatch Quest,Favero Assioma Duo,Wahoo KICKR Smart V4,330,326,4
94377,403098,2021-01-10 08:59:57,wahoo,Zwift - Paceheads Race (A),Favero Assioma Duo,Wahoo KICKR Smart V4,346,339,7
95452,403098,2021-01-12 08:01:28,wahoo,Zwift - Zwift Racing League | WTRL - Men&#039;s/Mixed APAC DIVISION 2 (A),Favero Assioma Duo,Wahoo KICKR Smart V4,319,312,7
96848,403098,2021-01-14 10:34:33,wahoo,Zwift - KISS Race Series - Americas AM (A),Favero Assioma Duo,Wahoo KICKR Smart V4,295,296,-1
96853,403098,2021-01-14 12:24:56,wahoo,EMU - Carson,Favero Assioma Duo,Wahoo KICKR Smart V4,319,310,9
97938,403098,2021-01-15 21:26:07,wahoo,Zwift - JETT TT Race (E),Favero Assioma Duo,Wahoo KICKR Smart V4,390,387,3
98344,403098,2021-01-16 23:59:06,wahoo,Zwift - 3R & ZID Merdeka Classique Flat Race Series - Round 4 of 4 (A),Favero Assioma Duo,Wahoo KICKR Smart V4,334,322,12
99572,403098,2021-01-19 08:26:50,wahoo,Zwift - Zwift Racing League | WTRL - Men&#039;s/Mixed APAC DIVISION 2 (A),Favero Assioma Duo,Wahoo KICKR Smart V4,312,307,5
99575,403098,2021-01-19 10:34:27,wahoo,Zwift - KISS Race Series - Americas AM (A),Favero Assioma Duo,Wahoo KICKR Smart V4,365,363,2
99578,403098,2021-01-19 12:22:30,wahoo,Zwift - EMU Japan Race (A),Favero Assioma Duo,Wahoo KICKR Smart V4,331,327,4
100775,403098,2021-01-21 10:33:20,wahoo,Zwift - KISS Race Series - Americas AM (A),Favero Assioma Duo,Wahoo KICKR Smart V4,335,330,5
100776,403098,2021-01-21 12:13:00,wahoo,Zwift - EMU Japan Race (A),Favero Assioma Duo,Wahoo KICKR Smart V4,334,330,4
103335,403098,2021-01-26 08:21:41,wahoo,Zwift - Zwift Racing League | WTRL - Men&#039;s/Mixed APAC DIVISION 2 (A),Favero Assioma Duo,Wahoo KICKR Smart V4,324,321,3
103339,403098,2021-01-26 10:56:08,wahoo,Zwift - Japan Zwift Tuesday Race (A),Favero Assioma Duo,Wahoo KICKR Smart V4,341,331,10
104541,403098,2021-01-28 10:33:40,wahoo,Zwift - KISS Race Series - Americas AM (A),Favero Assioma Duo,Wahoo KICKR Smart V4,336,341,-5
104542,403098,2021-01-28 12:04:28,wahoo,Zwift - EMU Japan Race (A),Favero Assioma Duo,Wahoo KICKR Smart V4,328,325,3
116120,403098,2021-02-16 08:03:05,wahoo,Zwift - Zwift Racing League | WTRL - Men&#039;s/Mixed APAC DIVISION 2 (A),Favero Assioma Duo,Wahoo KICKR Smart V4,371,368,3
116139,403098,2021-02-16 11:05:02,wahoo,Zwift - Japan Zwift Tuesday Race (A),Favero Assioma Duo,Wahoo KICKR Smart V4,292,284,8
120208,403098,2021-02-24 10:11:54,wahoo,Zwift - The Morning Grind by STPC (A),Favero Assioma Duo,Wahoo KICKR Smart V4,343,342,1
120210,403098,2021-02-23 08:19:12,wahoo,Zwift - Zwift Racing League | WTRL - Men&#039;s/Mixed APAC DIVISION 2 (A),Favero Assioma Duo,Wahoo KICKR Smart V4,286,286,0
120664,403098,2021-02-25 10:21:19,wahoo,Zwift - KISS Race Series - Americas AM (New Pack Dynamics) (A),Favero Assioma Duo,Wahoo KICKR Smart V4,322,321,1
121938,403098,2021-02-27 21:49:41,wahoo,Zwift - Haute Route Watopia 2021 Stage 2 (A),Favero Assioma Duo (Venge),Wahoo KICKR Smart V4,363,358,5
122794,403098,2021-03-02 08:06:57,wahoo,Zwift - Zwift Racing League | WTRL - Men&#039;s/Mixed APAC DIVISION 2 (A),Favero Assioma Duo (Venge),Wahoo KICKR Smart V4,318,309,9
123411,403098,2021-03-03 10:26:47,wahoo,Zwift - The Morning Grind by STPC (A),Favero Assioma Duo (Venge),Wahoo KICKR Smart V4,314,311,3
123883,403098,2021-03-04 10:42:44,wahoo,Zwift - KISS Race Series - Americas AM (New Pack Dynamics) (A),Favero Assioma Duo (Venge),Wahoo KICKR Smart V4,320,314,6
11001,404187,2020-01-26 05:53:58,wahoo,Assioma Duo / Kickr Core,Assioma Duo,Kickr Core,361,370,-9
13023,404187,2020-02-08 13:44:50,wahoo,Assioma Duo / Kickr Core,Assioma Duo,Kickr Core,365,359,6
82202,404187,2020-12-12 08:50:49,wahoo,Assioma Duo / Kickr Core,Assioma Duo,Kickr Core,381,374,7
123018,404187,2021-03-02 18:07:51,wahoo,Zwift Racing League | WTRL - Mens/Mixed EMEA E2 DIVISION 1,Assioma Duo,Kickr Core,368,363,5
3338,405588,2019-10-27 06:30:33,wahoo,Zwift - 3R 100 Steady Ride [~3.0/2.5w/kg avg] (C),Garmin Vector 3,Wahoo Kickr Powertrainer,193,190,3
8819,405588,2020-01-11 06:54:50,wahoo,Zwift - SZR  Endurance Ride (C),Garmin Vector 3,Wahoo Kickr Powertrainer,183,182,1
9011,405588,2020-01-12 15:00:51,wahoo,Zwift - Tour de Zwift: Stage 1 Short Distance,Garmin Vector 3,Wahoo Kickr Powertrainer,212,210,2
17908,405588,2020-03-12 15:59:58,wahoo,Zwift - Stage 1 - Longer Ride - Tour of Watopia 2020,Garmin Vector 3,Wahoo Kickr Powertrainer,183,179,4
48782,405588,2020-08-04 17:04:51,wahoo,Zwift - Watopia,Garmin Vector 3,Wahoo Kickr Powertrainer,179,178,1
58754,405588,2020-10-01 14:00:02,wahoo,Zwift Academy Road: Workout 1 | Aerobic Power,Garmin Vector 3,Wahoo Kickr Powertrainer,202,199,3
6502,407084,2019-12-17 17:45:11,neo,Zwift - Crit City Race (B),Favero Assioma Duo,Tacx Neo Smart 1,315,308,7
8667,407084,2020-01-09 17:59:53,neo,Zwift - SCF SWE Cup Racing League (A),Favero Assioma Duo,Tacx Neo Smart 1,325,323,2
9318,407084,2020-01-14 17:58:38,neo,Zwift - VO2 Short intervals 60-20/20,Favero Assioma Duo,Tacx Neo Smart 1,303,306,-3
9548,407084,2020-01-15 17:41:01,neo,Zwift - Tour de Zwift: Stage 1 Race (B),Favero Assioma Duo,Tacx Neo Smart 1,320,324,-4
9725,407084,2020-01-16 18:39:38,neo,Zwift - Tour de Zwift: Stage 2 Race (A),Favero Assioma Duo,Tacx Neo Smart 1,325,328,-3
12965,407084,2020-02-08 08:05:14,neo,Morning ride,Favero Assioma Duo,Tacx Neo Smart 1,262,270,-8
16799,407084,2020-03-04 17:48:52,neo,Zwift - Team Italy Gladiators Race (A),Favero Assioma Duo,Tacx Neo Smart 1,333,334,-1
17925,407084,2020-03-13 10:10:00,neo,Zwift - Stage 2 Race (A) - Tour of Watopia 2020,Favero Assioma Duo,Tacx Neo Smart 1,336,333,3
23034,407084,2020-04-08 17:00:01,neo,Zwift - Swedish Zwift Racing Cup by SZR (A),Favero Assioma Duo,Tacx Neo Smart 1,349,347,2
38503,407084,2020-05-29 07:37:55,neo,Zwift - Innsbruck,Favero Assioma Duo,Tacx Neo Smart 1,243,242,1
54304,407084,2020-09-10 09:15:41,neo,Zwift - Cycling Australia&#039;s The Chop by AHDR (A),Favero Assioma Duo,Tacx Neo Smart 1,343,341,2
71772,407084,2020-11-15 08:05:23,neo,Zwift - Open: 2020 El Giro de Rigo - Shorter Route,Favero Assioma Duo,Tacx Neo Smart 1,345,349,-4
75819,407084,2020-11-26 10:50:36,neo,Zwift - Richmond,Favero Assioma Duo,Tacx Neo Smart 1,306,306,0
78877,407084,2020-12-03 10:06:25,neo,Zwift - Ven-Top,Favero Assioma Duo,Tacx Neo Smart 1,308,312,-4
119584,407084,2021-02-23 10:33:25,neo,4x10min sub-t Two Bridges Loop,Favero Assioma Duo,Tacx Neo Smart 1,313,303,10
122813,407084,2021-03-02 10:28:53,neo,Zwift - Richmond,Favero Assioma Duo,Tacx Neo Smart 1,311,305,6
126713,407084,2021-03-10 19:39:58,neo,Zwift - The Knights Race Series - Series XI (A),Favero Assioma Duo,Tacx Neo Smart 1,341,340,1
63682,407158,2020-10-20 18:15:09,wahoo,Zwift Academy Road: Workout 2 | Sprint Profile,4iii power meter,kickr,254,237,17
65967,407158,2020-10-28 16:10:00,wahoo,Zwift - 3R Tick Tock Flat Race - 2 Lap (36km/22.4mi 100m) (B),4iii power meter,kickr,354,352,2
118932,407158,2021-02-22 11:21:01,wahoo,Zwift - Crit City Race (B),4iii power meter,kickr,349,346,3
6757,407425,2019-12-19 19:43:19,wahoo,Zwift - Lamb Chop Series  (A),SRM Powermeter ,Wahoo Kickr 18,351,348,3
12447,407425,2020-02-04 19:40:04,wahoo,3R Ultimate Racing League - Round 5,SRM Powermeter ,Wahoo Kickr 18,377,377,0
19510,407425,2020-03-24 19:15:05,wahoo,Zwift - Tour of Watopia Pro-Am Men&#039;s Race #3 (A),SRM Powermeter ,Wahoo Kickr 18,344,346,-2
58548,407425,2020-09-30 17:29:58,wahoo,Zwift - NCF Vinter Cup 2020 - Runde 2 - Herrer (A),SRM Powermeter ,Wahoo Kickr V5,343,348,-5
60200,407425,2020-10-07 17:29:59,wahoo,Zwift - NCF Vinter Cup 2020 - Runde 3 - Herrer (A),SRM Powermeter ,Wahoo Kickr V5,371,377,-6
62026,407425,2020-10-14 17:29:58,wahoo,Zwift - NCF Vinter Cup 2020 - Runde 4 - Herrer (A),SRM Powermeter ,Wahoo Kickr V5,373,384,-11
63292,407425,2020-10-19 18:12:44,wahoo,Zwift - Premier Division // Zwift Racing League (men) ,SRM Powermeter ,Wahoo Kickr V5,380,391,-11
63872,407425,2020-10-21 17:30:06,wahoo,Zwift - NCF Vinter Cup 2020 - Runde 5 - Herrer (A),SRM Powermeter ,Wahoo Kickr V5,368,374,-6
65199,407425,2020-10-26 20:00:00,wahoo,Zwift - Premier Division // Zwift Racing League (men) (A),SRM Powermeter ,Wahoo Kickr 18,374,388,-14
65863,407425,2020-10-28 18:30:00,wahoo,Zwift - NCF Vinter Cup 2020 - Runde 6 - Herrer (A),SRM Powermeter ,Wahoo Kickr V5,395,417,-22
67268,407425,2020-11-02 19:12:00,wahoo,Zwift - Premier Division // Zwift Racing League (men) (A),SRM Powermeter ,Wahoo Kickr V5,383,404,-21
67960,407425,2020-11-04 18:30:27,wahoo,Zwift - NCF Vinter Cup 2020 - Runde 7 - Herrer (A),SRM Powermeter ,Wahoo Kickr V5,354,371,-17
70489,407425,2020-11-11 18:29:26,wahoo,Zwift - NCF Vinter Cup 2020 - Runde 8 - Herrer (A),SRM Powermeter ,Wahoo Kickr V5,369,376,-7
70490,407425,2020-11-09 19:59:59,wahoo,Zwift - Premier Division // Zwift Racing League (men) (A),SRM Powermeter ,Wahoo Kickr V5,397,419,-22
71960,407425,2020-11-16 19:06:42,wahoo,Zwift - Premier Division // Zwift Racing League (men) (A),SRM Powermeter ,Wahoo Kickr V5,378,396,-18
73578,407425,2020-11-20 18:29:51,wahoo,Zwift - Team WEZ Friday Race,SRM Powermeter ,Wahoo Kickr V5,374,391,-17
75996,407425,2020-11-26 18:13:40,wahoo,Zwift - WTRL NOPINZ WORLD TTT CHAMPIONSHIPS - Zone 4 (C),SRM Powermeter ,Wahoo Kickr V5,366,378,-12
76792,407425,2020-11-28 10:44:57,wahoo,Into the Red by RELENTLESS,SRM Powermeter ,Wahoo Kickr V5,385,396,-11
77675,407425,2020-11-30 19:11:55,wahoo,Zwift - Premier Division // Zwift Racing League (men) (A),SRM Powermeter ,Wahoo Kickr V5,385,397,-12
80065,407425,2020-12-06 11:30:20,wahoo,Zwift - Stages of DIRT (A),SRM Powermeter ,Wahoo Kickr V5,372,375,-3
92741,407425,2021-01-07 16:15:22,wahoo,Zwift,SRM Powermeter ,Wahoo Kickr V5,316,319,-3
96420,407425,2021-01-13 18:30:04,wahoo,Zwift - NCF Vintercup 2021 - Runde 1 - Herrer (A),SRM Powermeter ,Wahoo Kickr V5,368,373,-5
100363,407425,2021-01-20 18:30:23,wahoo,Zwift - NCF Vintercup 2021 - Runde 2 - Herrer (A),SRM Powermeter ,Wahoo Kickr 18,318,325,-7
100645,407425,2020-09-27 12:10:20,wahoo,ZADA test,SRM Powermeter ,Wahoo Kickr 18,397,404,-7
100944,407425,2021-01-21 19:12:34,wahoo,Zwift - Richmond,SRM Powermeter ,Wahoo Kickr 18,222,226,-4
112341,407425,2021-02-10 18:58:52,wahoo,Movistar Team Challenge // Round 1,SRM Powermeter ,Wahoo Kickr V5,326,332,-6
116649,407425,2021-02-17 18:20:58,wahoo,Zwift - NCF Vintercup 2021 - Runde 6 - Herrer (A),SRM Powermeter ,Wahoo Kickr V5,337,346,-9
117280,407425,2021-02-18 18:26:15,wahoo,Zwift - FUSION WINTER CUP (A),SRM Powermeter ,Wahoo Kickr V5,335,340,-5
119095,407425,2021-02-22 19:09:51,wahoo,Zwift - Premier Division // Zwift Racing League (men) (A),Wahoo Kickr V5,Wahoo Kickr V5,349,346,3
120352,407425,2021-02-24 18:43:35,wahoo,Zwift - Scandinavian Cup 2021 - Round 1 - Men (A),SRM Powermeter ,Wahoo Kickr V5,379,383,-4
122581,407425,2021-03-01 20:19:57,wahoo,Zwift - Premier Division // Zwift Racing League (men) (A),SRM Powermeter ,Wahoo Kickr V5,372,383,-11
123607,407425,2021-03-03 18:45:01,wahoo,Zwift - Scandinavian Cup 2021 - Round 2 - Men (A),SRM Powermeter ,Wahoo Kickr V5,354,368,-14
124096,407425,2021-03-04 18:28:42,wahoo,Zwift - FUSION SPRING CUP (A),SRM Powermeter ,Wahoo Kickr V5,354,367,-13
126643,407425,2021-03-10 18:43:35,wahoo,Zwift - Scandinavian Cup 2021 - Round 3 - Men (A),SRM Powermeter ,Wahoo Kickr V5,377,383,-6
129510,407425,2021-03-16 18:08:37,wahoo,Zwift - CeramicSpeed Race Series: Open Race (A),SRM Powermeter ,Wahoo Kickr V5,369,381,-12
45417,407882,2020-07-07 18:01:02,neo,Zwift - Virtual Tour de France - Open - Stage 2 Discovery Ride,Assioma UNO,Tacx Neo,339,366,-27
117727,407882,2021-02-18 19:00:57,neo,FLANDERS The BZR Ronde Watopian League (B),Tacx Neo,Tacx Neo,348,363,-15
127230,407882,2021-03-11 18:59:59,neo,Flanders The BZR Ronde Spring Classics League (B),Assioma UNO,Tacx Neo,353,366,-13
47952,410707,2020-07-28 09:05:40,wahoo,Zwift - 3R Turbocharged Team Race Series - Round 3 (B),Watteam Powerbeat Right,Wahoo Kickr Core,268,272,-4
48269,410707,2020-07-30 09:29:40,wahoo,Zwift - WTRL Team Time Trial (D),Watteam Powerbeat Right,Wahoo Kickr Core,271,273,-2
48394,410707,2020-07-31 04:29:39,wahoo,Zwift - EVO CC Vortex Interval Ride [~3-3.8w/kg avg] (B),Watteam Powerbeat Right,Wahoo Kickr Core,285,278,7
48561,410707,2020-08-02 09:46:39,wahoo,Zwift - Stages of DIRT (B),Watteam Powerbeat Dual,Wahoo Kickr Core,239,243,-4
48739,410707,2020-08-03 08:34:38,wahoo,Zwift - EVO CC Sweet Sirocco Interval Ride [~3.0-3.5w/kg avg] (B),Watteam Powerbeat Dual,Wahoo Kickr Core,239,241,-2
48740,410707,2020-08-04 09:05:36,wahoo,Zwift - 3R Turbocharged Team Race Series - Round 4 (B),Watteam Powerbeat Dual,Wahoo Kickr Core,274,249,25
48882,410707,2020-08-05 10:01:52,wahoo,Zwift - Maximus Shootout Time Trial (E),Watteam Powerbeat Dual,Wahoo Kickr Core,275,261,14
49020,410707,2020-08-06 09:14:35,wahoo,Zwift - The Lamb Chop p/b Black Sheep (B),Watteam Powerbeat Dual,Wahoo Kickr Core,254,257,-3
49174,410707,2020-08-07 08:45:35,wahoo,Zwift - Crit City Race (B),Watteam Powerbeat Dual,Wahoo Kickr Core,263,255,8
49255,410707,2020-08-08 04:59:35,wahoo,Zwift - EVO CC Vortex Interval Ride [~3-3.8w/kg avg] (B),Watteam Powerbeat Dual,Wahoo Kickr Core,255,266,-11
49358,410707,2020-08-09 09:45:34,wahoo,Zwift - Stages of DIRT (A),Watteam Powerbeat Dual,Wahoo Kickr Core,275,293,-18
49539,410707,2020-08-11 09:05:32,wahoo,Zwift - 3R Turbocharged Team Race Series - Round 5 (B),Watteam Powerbeat Dual,Wahoo Kickr Core,275,274,1
49968,410707,2020-08-14 08:29:30,wahoo,Zwift - Longer Ride - 7 Days of Tarmac SL7: Stage 3 with Sofiane Behraoui,Watteam Powerbeat Right,Wahoo Kickr Core,212,204,8
50087,410707,2020-08-15 04:59:31,wahoo,Zwift - EVO CC Vortex Interval Ride [~3-3.8w/kg avg] (B),Watteam Powerbeat Right,Wahoo Kickr Core,280,295,-15
50500,410707,2020-08-18 09:05:29,wahoo,Zwift - 3R Turbocharged Team Race Series - Round 6 (B),Watteam Powerbeat Right,Wahoo Kickr Core,282,258,24
50662,410707,2020-08-19 09:59:28,wahoo,Zwift - Off The MAAP Stage 2 Race (A),Watteam Powerbeat Right,Wahoo Kickr Core,287,260,27
51629,410707,2020-08-25 09:05:24,wahoo,Zwift - 3R Turbocharged Team Race Series - Bonus Round (B),Watteam Powerbeat Right,Wahoo Kickr Core,247,266,-19
52588,410707,2020-08-25 09:59:59,wahoo,Zwift - Zwift Time Trial Tuesday: Bologna (E),Watteam Powerbeat Right,Wahoo Kickr Core,268,280,-12
69602,410707,2020-11-10 08:44:56,wahoo,Zwift - Zwift Racing League | WTRL - APAC (MEN) -  Division 1 (A),Watteam Powerbeat Dual,Wahoo Kickr Core,284,296,-12
77188,410707,2020-11-29 07:00:01,wahoo,Zwift - Focus: Colours of PARI - Longer Ride,Watteam Powerbeat Dual,Wahoo Kickr Core,265,249,16
74467,411944,2020-11-23 10:22:04,wahoo,Zwift - DIRTy Dozen Sprint League (A),Stages Left PM,Kickr,420,426,-6
75080,411944,2020-11-24 18:06:14,wahoo,Zwift - Zwift Racing League | WTRL - Men&#039;s EMEA E2 DIVISION 2,Stages Left PM,Kickr,428,444,-16
75718,411944,2020-11-26 01:33:45,wahoo,Zwift - 4wk FTP Booster Week 1 Day 6 - Tempo with accelerations #1,Stages Left PM,Kickr,341,348,-7
82581,411944,2020-12-13 00:51:41,wahoo,Zwift - ZHQ FutureWorks Crit City Race - Anti-sandbagging (B),Stages Left PM,Kickr,430,435,-5
85163,411944,2020-12-19 14:57:57,wahoo,Zwift - 3R Steady Ride - In memory of Nipton Loop Cyclists (C),Stages Left PM,Kickr,330,318,12
86331,411944,2020-12-23 02:27:04,wahoo,Zwift - Dutch Diesel Cycling Group Ride (B),Stages Left PM,Kickr,287,282,5
86575,411944,2020-12-23 16:49:36,wahoo,Zwift - Guayaba Race by PETA-Z (A),Stages Left PM,Kickr,425,419,6
87297,411944,2020-12-26 01:01:51,wahoo,Zwift - DIRT Friday Night Battle (B),Stages Left PM,Kickr,413,406,7
92297,411944,2021-01-06 16:58:27,wahoo,Zwift - TDZ Stage 1: Longer Ride,Stages Left PM,Kickr,353,339,14
96350,411944,2021-01-13 16:59:27,wahoo,Zwift - Zwift Riders Germany Gruppenfahrt (D),Stages Left PM,Kickr,307,299,8
100702,411944,2021-01-21 10:45:17,wahoo,Zwift - TDZ Stage 4: Longer Ride,Stages Left PM,Kickr,410,394,16
116454,411944,2021-02-17 10:36:35,wahoo,Zwift - The Morning Grind by STPC (B),Stages Left PM,Kickr,388,378,10
122844,411944,2021-03-01 16:17:35,wahoo,Zwift - ZHQ FutureWorks Crit City Race - Anti-sandbagging (A),Stages Left PM,Kickr,401,405,-4
81365,413551,2020-12-08 18:17:55,neo,Zwift - Zwift Racing League | WTRL - Men&#039;s EMEA E1 DIVISION 2 (C),ASSIOMA PEDALS,TAXC NEO,266,270,-4
81369,413551,2020-12-08 18:17:55,neo,Zwift - Zwift Racing League | WTRL - Men&#039;s EMEA E1 DIVISION 2 (C),ASSIOMA PEDALS,TAXC NEO,270,270,0
81738,413551,2020-12-10 19:05:27,neo,Zwift - Frappe,ASSIOMA PEDALS,TAXC NEO,257,254,3
92217,414024,2021-01-06 09:40:57,wahoo,Zwift - KolieMoore baseline test mFTP,quarq,Kickr,347,343,4
99360,414438,2021-01-18 21:28:16,wahoo,Zwift - The Kraken by TeamODZ (B),Garmin Vector 3s,Wahoo Kickr Core,275,285,-10
53995,415493,2020-09-08 18:40:58,neo,Zwift - 3R Sundown Series - Round 2 - Crit City,4iii 105 Single Side,Tacx Neo,291,290,1
54414,415493,2020-09-10 17:40:56,neo,Zwift - WTRL TTT - Harrogate UCI with 3R Steps,4iii 105 Single Side,Tacx Neo,303,304,-1
58328,415493,2020-09-29 18:41:16,neo,Zwift - 3R Sundown Race Series  (B),4iii 105 Single Side,Tacx Neo,292,295,-3
66222,415493,2020-10-29 19:50:25,neo,Zwift - WTRL Team Time Trial - Zone 6 (B),4iii 105 Single Side,Tacx Neo,275,276,-1
66573,415493,2020-10-31 08:05:07,neo,Zwift - 3R Weekend Race Club - Race 1,4iii 105 Single Side,Tacx Neo,296,290,6
67670,415493,2020-11-03 19:56:48,neo,Zwift - Zwift Racing League | WTRL - Men&#039;s EMEA W1 DIVISION 1,4iii 105 Single Side,Tacx Neo,301,304,-3
68244,415493,2020-11-05 19:10:13,neo,Zwift - WTRL Team Time Trial - Zone 7 - Richmond UCI,4iii 105 Single Side,Tacx Neo,297,296,1
69861,415493,2020-11-10 18:17:36,neo,Zwift - Zwift Racing League | WTRL - EMEA E1 (MEN) - Division 4	,4iii 105 Single Side,Tacx Neo,333,323,10
70756,415493,2020-11-12 19:17:50,neo,Zwift - WTRL Team Time Trial - Zone 7 - Zwift crash so solo for 3/4 :(,4iii 105 Single Side,Tacx Neo,285,275,10
71646,415493,2020-11-15 13:04:55,neo,Zwift - Rigo Urán: 2020 El Giro de Rigo - Official Route,4iii 105 Single Side,Tacx Neo,300,285,15
74102,415493,2020-11-22 09:05:10,neo,Zwift - Newbury Velo Road Race (B),4iii 105 Single Side,Tacx Neo,300,297,3
75029,415493,2020-11-24 18:17:02,neo,Zwift - Zwift Racing League | WTRL - Men&#039;s EMEA E1 DIVISION 2,4iii 105 Single Side,Tacx Neo,306,294,12
76712,415493,2020-11-28 08:05:07,neo,Zwift - 3R Weekend Race Club - Race 1 - awful!!,4iii 105 Single Side,Tacx Neo,304,283,21
78164,415493,2020-12-01 18:20:58,neo,Zwift - Zwift Racing League | WTRL - Men&#039;s EMEA E1 DIVISION 2 (B),4iii 105 Single Side,Tacx Neo,285,281,4
80040,415493,2020-12-06 09:15:31,neo,Zwift - Nutrinovex Open Rice by PETA-Z - Trainer Troubles at the start!!,4iii 105 Single Side,Tacx Neo,272,275,-3
80803,415493,2020-12-08 18:17:21,neo,Zwift - Zwift Racing League | WTRL - Men&#039;s EMEA E1 DIVISION 2 (B),4iii 105 Single Side,Tacx Neo,283,311,-28
90337,415493,2021-01-02 16:30:20,neo,Zwift - TEAM VEGAN Tofu Tornado - Veganuary STAGE 1,4iii 105 Single Side,Tacx Neo,317,306,11
90339,415493,2021-01-02 17:30:28,neo,Zwift - ZHQ FutureWorks Circuit Race - Anti-sandbagging,4iii 105 Single Side,Tacx Neo,304,294,10
94005,415493,2021-01-09 16:29:41,neo,Zwift - TEAM VEGAN Tofu Tornado - Veganuary STAGE 2,4iii 105 Single Side,Tacx Neo,305,305,0
95806,415493,2021-01-12 19:47:40,neo,Zwift - Zwift Racing League | WTRL - Men&#039;s/Mixed EMEA W1 DIVISION A4,4iii 105 Single Side,Tacx Neo,324,315,9
98138,415493,2021-01-16 16:29:58,neo,Zwift - TEAM VEGAN Tofu Tornado - Veganuary STAGE 3	,4iii 105 Single Side,Tacx Neo,290,313,-23
103658,415493,2021-01-26 19:47:29,neo,Zwift - 01/26/2021,4iii 105 Single Side,Tacx Neo,319,315,4
107525,415493,2021-02-02 19:47:42,neo,Zwift - Zwift Racing League | WTRL - Men&#039;s/Mixed EMEA W1 DIVISION 4,4iii 105 Single Side,Tacx Neo,323,316,7
116028,415493,2021-02-16 19:48:18,neo,Zwift - Zwift Racing League | WTRL - Men&#039;s/Mixed EMEA W1 DIVISION 4,4iii 105 Single Side,Tacx Neo,299,300,-1
118318,415493,2021-02-20 16:05:36,neo,Zwift - 	3R Endurance Series p/b OTE Sports- Stage 1,4iii 105 Single Side,Tacx Neo,294,292,2
119770,415493,2021-02-23 19:47:35,neo,Zwift - Zwift Racing League | WTRL - Men&#039;s/Mixed EMEA W1 DIVISION 4,2021-02-23-194735-ELEMNT_BOLT_DC26-132-0[1],Tacx Neo,325,326,-1
123089,415493,2021-03-02 19:50:52,neo,Zwift - Zwift Racing League | WTRL - Men&#039;s/Mixed EMEA W1 DIVISION 4,4iii 105 Single Side,Tacx Neo,293,283,10
124975,415493,2021-03-06 14:30:28,neo,Zwift - VACA Saturday Smackdown (B),4iii 105 Single Side,Tacx Neo,301,295,6
125862,415493,2021-03-08 19:20:29,neo,Zwift - Team TFC Mad Monday Race Series (high-end categories),4iii 105 Single Side,Tacx Neo,308,297,11
128037,415493,2021-03-13 16:31:12,neo,Zwift - TEAM VEGAN Tofu Tornado (B),2021-03-13-163112-ELEMNT_BOLT_DC26-138-0[1],Tacx Neo,297,298,-1
128801,415493,2021-03-15 19:20:47,neo,Zwift - Team TFC Mad Monday Race Series (high-end categories) (B),4iii 105 Single Side,Tacx Neo,304,302,2
33298,415790,2020-05-10 07:59:54,wahoo,Zwift - ZTS x Paceheads | Etappe III 39.6km | 507hm (A),GARMIN Vector 3,Wahoo Fitness KICKR 4.0,321,309,12
15674,416887,2020-02-26 06:59:57,wahoo,Zwift - SAS - Out and Back (C),Stages,Zwift C Group ride_Kickr power source,256,242,14
15967,416887,2020-02-27 08:17:51,wahoo,Zwift - AHDR The Chop (B),Stages,Kickr,269,253,16
16083,416887,2020-02-29 07:59:19,wahoo,Xert - Ride the Lightning W/O - Stages PM via Zwift,Stages,Kickr,245,250,-5
16423,416887,2020-03-01 07:24:59,wahoo,Zwift - 3R 100 B Group Ride - Stages vs Kickr,Stages,Kickr,244,245,-1
16543,416887,2020-03-03 07:47:28,wahoo,Kickr / Stages,Stages,Kickr,237,220,17
16739,416887,2020-03-04 08:07:33,wahoo,Xert W/O Higher Ground - Zwift Rec. Kickr Pwr,Stages,Kickr,266,262,4
17342,416887,2020-03-09 07:54:04,wahoo,Tour of Watopia Stage 1 - Zwift.fit Stages Pwr,Stages,Kickr,279,262,17
17434,416887,2020-03-10 06:43:27,wahoo,Zwift - Watopia,Stages,Kickr,245,227,18
17768,416887,2020-03-12 07:04:58,wahoo,Zwift - SZR Sunrise Ride (C),Stages,Kickr,280,265,15
17769,416887,2020-03-12 07:04:58,wahoo,Zwift - AHDR The Chop (C),Stages,Kickr,270,265,5
80388,416887,2020-12-07 08:38:41,wahoo,RGT_Race_071220V2,Stages,Kickr,236,262,-26
85993,416887,2020-12-22 07:01:04,wahoo,SZR Sunrise Group Ride _ Kickr Vs Stages,Stages,Kickr,280,252,28
86837,416887,2020-12-24 08:13:00,wahoo,Zwift - The Chop by AHDR (C),Stages,Kickr,274,249,25
106177,416887,2021-01-31 09:23:05,wahoo,RGT_Pedalare_Huntingdon Classic,Stages,Kickr,247,266,-19
107123,416887,2021-02-02 08:09:04,wahoo,Kickr / Stages,Stages,Kickr,235,213,22
123916,418452,2021-03-03 22:30:00,wahoo,Zwift - Low Key Endurance,Stages to Garmin Edge,Wahoo Kickr v5 to Zwift,201,192,9
125412,418452,2021-03-06 18:00:48,wahoo,Zwift - 40/20 x3 + Badge Grab,Stages to Garmin Edge,Wahoo Kickr v5 to Zwift,311,315,-4
67596,419595,2020-11-03 17:39:16,wahoo,Zwift - Zwift Racing League | WTRL - Men&#039;s EMEA E1 DIVISION 1 (B),Favero Assioma Duo,Wahoo Kickr,366,355,11
78065,419595,2020-12-01 17:48:35,wahoo,Zwift - Zwift Racing League | WTRL - Men&#039;s EMEA E1 DIVISION 1 (B),Favero Assioma Duo,Wahoo Kickr,358,358,0
83566,419595,2020-12-15 17:27:35,wahoo,Zwift - Zwift Racing League | WTRL - Men&#039;s EMEA E1 DIVISION 1 (B),Favero Assioma Duo,Wahoo Kickr,364,359,5
115143,419595,2021-02-15 15:32:30,wahoo,Zwift - Team Sportslab UK Hard Riders (B),Favero Assioma Duo,Wahoo Kickr,353,355,-2
117797,419595,2021-02-19 16:27:55,wahoo,Zwift - SZ AW Party by SZR (A),Favero Assioma Duo,Wahoo Kickr,362,344,18
121201,419595,2021-02-26 16:35:04,wahoo,Zwift - SZ AW Party by SZR (A),Favero Assioma Duo,Wahoo Kickr,406,396,10
127206,419921,2021-03-11 20:00:37,wahoo,Zwift - Breaking in a KickrV5,P2M NGeco Dual,KickrV5,278,279,-1
127588,419921,2021-03-12 18:41:42,wahoo,Zwift - Jepson,P2M NGeco Dual,KickrV5,382,376,6
128131,419921,2021-03-13 17:00:54,wahoo,Zwift - Carpathian Peak +2 (heading for the slow death),P2M NGeco Dual,KickrV5,383,376,7
128787,419921,2021-03-15 18:51:56,wahoo,Zwift - Mills,P2M NGeco Dual,KickrV5,311,313,-2
129722,419921,2021-03-17 18:03:50,wahoo,Zwift - Cycling Weekly Club 10 (D),P2M NGeco Dual,KickrV5,406,406,0
129726,419921,2021-03-17 19:09:56,wahoo,Zwift - Newbury Velo Midweek TT (D),P2M NGeco Dual,KickrV5,402,398,4
32401,425177,2020-04-26 16:04:59,wahoo,Zwift - 3R Tick Tock Flat Race - 1 Lap (19km/11.8mi 50m) (C),4iiii sigle sided Power Meter,Wahoo Kickr Core,339,345,-6
33066,425177,2020-05-09 09:01:50,wahoo,Zwift - CIZL Rd 7 – Sean Lynch Memorial (C),4iiii Podium Power Meter,Kickr Core,316,327,-11
34050,425177,2020-05-12 18:16:54,wahoo,Zwift - Watopia,4iiii Podium Power Meter,Kickr Core,334,343,-9
37031,425177,2020-05-23 09:02:00,wahoo,Zwift - Cycling Ireland Zwift League Rd 9 (C),4iiii Podium Power Meter,Kickr Core,322,315,7
38663,425177,2020-05-30 09:01:58,wahoo,Zwift - Cycling Ireland Zwift League Rd 10 (C),4iiii Podium Power Meter,Kickr Core,326,333,-7
39974,425177,2020-06-06 09:02:09,wahoo,Zwift - Cycling Ireland Zwift League Rd 11 (C),4iiii Podium Power Meter,Kickr Core,318,325,-7
41372,425177,2020-06-13 09:02:04,wahoo,Zwift - Cycling Ireland Zwift League Rd 12 (C),4iiii Podium Power Meter,Wahoo Kickr Core,336,346,-10
36168,427078,2020-05-19 18:15:29,wahoo,Zwift - Tour for All Invitational Race // Women (A),Quarq,Wahoo Kickr,290,301,-11
37860,427078,2020-05-26 18:15:27,wahoo,Zwift - Tour for All Invitational Race // Women (A),Quarq,Wahoo Kickr,301,311,-10
58421,427078,2020-09-30 07:50:45,wahoo,Zwift - Giant Crit Crushers Race 1 (A),SRM,Wahoo Kickr,289,290,-1
58424,427078,2020-09-30 07:50:45,wahoo,Zwift - Giant Crit Crushers Race 2 (A),SRM,Wahoo Kickr,297,297,0
58997,427078,2020-10-02 06:40:37,wahoo,Zwift - 3R Innsbruckring Race - 33.2km (A),SRM,Wahoo Kickr,277,276,1
59369,427078,2020-10-04 07:20:32,wahoo,Zwift - 3R & Cannondale Super Six Series - Make Up Series Race (A),SRM,Wahoo Kickr,286,295,-9
61219,427078,2020-10-12 17:39:58,wahoo,Zwift - Premier Division // Zwift Racing League (women) (A),SRM,Wahoo Kickr,298,308,-10
61597,427078,2020-10-13 18:04:18,wahoo,Three Sisters,SRM,Wahoo Kickr,284,283,1
65158,427078,2020-10-26 19:01:08,wahoo,Zwift - Premier Division // Zwift Racing League (women) ,SRM,Wahoo Kickr,283,266,17
67367,427078,2020-11-02 19:55:40,wahoo,Zwift - Premier Division // Zwift Racing League (women) (A),SRM,Wahoo Kickr,279,261,18
69379,427078,2020-11-09 19:00:23,wahoo,Zwift - Premier Division // Zwift Racing League (women) (A),SRM,Wahoo Kickr,319,301,18
70212,427078,2020-11-11 16:55:47,wahoo,Zwift - Kerstin Pöhl&#039;s Meetup - Greatest London Flat,SRM,Wahoo Kickr,232,221,11
72010,427078,2020-11-16 19:56:08,wahoo,Zwift - Premier Division // Zwift Racing League (women) (A),SRM,Wahoo Kickr,285,272,13
74628,427078,2020-11-23 18:52:07,wahoo,Zwift - Premier Division // Zwift Racing League (women) (A),SRM,Wahoo Kickr,301,292,9
77755,427078,2020-11-30 20:01:42,wahoo,Zwift - Premier Division // Zwift Racing League (women) (A),SRM,Wahoo Kickr,273,261,12
82615,427078,2020-12-12 19:28:04,wahoo,Zwift - Fearless Women&#039;s Team Championships - 2020 (A),Quarq,Wahoo Kickr,268,263,5
83861,427078,2020-12-16 10:00:37,wahoo,Three Sisters,Quarq,Wahoo Kickr,292,283,9
93238,427078,2021-01-08 08:48:10,wahoo,Zwift ,Quarq,Wahoo Kickr,236,233,3
93705,427078,2021-01-09 07:59:57,wahoo,Zwift - Dan Fox (R&K Gazelles)&#039;s Meetup - Out And Back Again,Quarq,Wahoo Kickr,291,286,5
95118,427078,2021-01-11 20:02:45,wahoo,Zwift - Premier Division // Zwift Racing League (women) (A),Quarq,Wahoo Kickr,304,295,9
99079,427078,2021-01-18 19:05:18,wahoo,Zwift - Premier Division // Zwift Racing League (women) (A),Quarq,Wahoo Kickr,275,265,10
103010,427078,2021-01-25 20:01:57,wahoo,Zwift - Premier Division // Zwift Racing League (women) (A),Quarq,Wahoo Kickr,283,279,4
106782,427078,2021-02-01 19:01:55,wahoo,Zwift - Premier Division // Zwift Racing League (women) (A),Quarq,Wahoo Kickr,299,288,11
109263,427078,2021-02-05 08:16:45,wahoo,Zwift - 3R Whole Lotta Lava Hilly Race - 2 Laps (28.9km/12.53mi 336m) (A),Quarq,Wahoo Kickr,280,270,10
109695,427078,2021-02-06 08:32:33,wahoo,Zwift - KRT/KISS 80 km Endurance Ride (B),Quarq,Wahoo Kickr,223,210,13
111121,427078,2021-02-08 19:57:06,wahoo,Zwift - Premier Division // Zwift Racing League (women) (A),Quarq,Wahoo Kickr,284,273,11
115237,427078,2021-02-15 19:02:02,wahoo,Zwift - Premier Division // Zwift Racing League (women) (A),Quarq,Wahoo Kickr,292,285,7
119183,427078,2021-02-22 19:58:06,wahoo,Zwift - Premier Division // Zwift Racing League (women) (A),Quarq,Wahoo Kickr,286,274,12
122456,427078,2021-03-01 19:18:06,wahoo,Zwift - Premier Division // Zwift Racing League (women) (A),Quarq,Wahoo Kickr,280,268,12
34865,428409,2020-05-14 17:15:42,wahoo,WTRL Team Time Trial Premier League,Quarg to Zwift,Wahoo Kickr to Wahoo Bolt,406,391,15
36667,428409,2020-05-21 17:19:00,wahoo,WTRL Team Time Trial Premier League,Quarg to Zwift,Wahoo Kickr to Wahoo App,416,409,7
38694,428409,2020-05-30 08:52:46,wahoo,Cycling Ireland Zwift League Rd 10,Favero Assioma Duos to Zwift,Wahoo Kickr to Wahoo App,435,427,8
39601,428409,2020-06-04 17:11:56,wahoo,WTRL TTT Premier League,Favero Assioma Duos to Zwift,Wahoo Kickr to Wahoo App,404,383,21
39946,428409,2020-06-06 08:58:37,wahoo,Cycling Ireland Round 11,Assioma Duo to Zwift,Wahoo Kickr to Wahoo App,399,388,11
43773,428409,2020-06-27 08:54:50,wahoo,Cycling Ireland Watopia Classic,Quarg to Zwift,Wahoo Kickr to Wahoo App,418,407,11
44575,428409,2020-07-02 16:30:15,wahoo,OTAKAM Race Series,Quarg to Zwift,Wahoo Kickr to Wahoo App,407,401,6
47039,428409,2020-07-19 15:24:10,wahoo,3R Watopia,Quarg to Zwift,Wahoo Kickr to Wahoo App,362,360,2
47041,428409,2020-07-11 15:59:24,wahoo,LEtape Du Tour Stage 2,Quarg to Zwift,Wahoo Kickr to Wahoo App,406,395,11
44701,429749,2020-07-03 15:14:59,wahoo,Zwift - 3R Sand and Sequoias Race (A),Power 2 Max,Kickr 18.,342,332,10
125975,429749,2021-03-08 10:53:41,wahoo,Zwift - TT Tune-Up - 30/30sec Anaerobic #1,4iiii,Kickr 18.,319,321,-2
126043,429749,2021-03-09 10:24:41,wahoo,Zwift - TT Tune-Up - Aerobic 12s #1,4iiii,Kickr 18.,278,273,5
127139,429749,2021-03-11 17:55:41,wahoo,Zwift - TT Tune-Up - Tempo 15min / Target RPM #1,4iiii,Kickr 18.,293,288,5
128826,429749,2021-03-15 19:29:57,wahoo,Zwift - Aero Army Wyn TT Series (A),4iiii,Kickr 18.,433,463,-30
128829,429749,2021-03-15 19:56:34,wahoo,Zwift - TT Tune-Up - 30/30sec Anaerobic #2,4iiii,Kickr 18.,287,289,-2
12872,430075,2020-02-06 17:59:30,wahoo,Zwift - SCF SWE Cup Racing League (B),FSA PowerBox,Wahoo Kickr Core,301,319,-18
19615,430075,2020-03-25 17:58:02,wahoo,Zwift - Swedish Zwift Racing Cup by SZR (B),FSA PowerBox,Wahoo Kickr Core,327,323,4
41963,430075,2020-06-16 15:00:32,wahoo,Zwift - 3R & Wahoo Ride Real Race Series - Round 5 of 7 (B),FSA PowerBox,Wahoo Kickr Core,321,322,-1
73337,430075,2020-11-19 19:27:03,wahoo,Zwift - World Championships Experience // Danish Cycling Federation,FSA PowerBox,Wahoo Kickr Core,325,325,0
28547,430482,2020-04-27 22:56:03,wahoo,Zwift - 04/27/2020,Quarq,kickr,361,346,15
118521,436545,2021-02-20 23:49:03,wahoo,Zwift - 3R & ZID Merdeka Classique Flat Race Series - Round 4 of 4 (A),vector3デュオ,wahoo kickr core,317,322,-5
119324,436545,2021-02-22 23:48:54,wahoo,Zwift - EVR Americas Race (A),vector3 duo,wahoo kickr core,285,302,-17
121345,436545,2021-02-26 23:36:31,wahoo,Zwift - EVR Americas (A),vector3 duo,wahoo kickr core,280,299,-19
121924,436545,2021-02-27 23:48:41,wahoo,Zwift - 3R & ZID Merdeka Classique Flat Race Series - Round 4 of 4 (A),vector3 duo,wahoo kickr core,295,303,-8
123234,436545,2021-03-03 00:01:25,wahoo,Zwift - Bike Surgeon Cycling Chasing Daylight Series (A),vector3 duo,wahoo kickr core,281,296,-15
124763,436545,2021-03-06 07:42:44,wahoo,Zwift - 3R Weekend Race Club - Race 1 (A),vector3 duo,wahoo kickr core,279,292,-13
125262,436545,2021-03-07 01:03:53,wahoo,Zwift - 3R Volcano Circuit Flat Race - 4 Laps (18.9km/11.7mi 80m) (A),vector3 duo,wahoo kickr core,286,298,-12
126324,436545,2021-03-10 00:19:22,wahoo,Zwift - WTRL Racing (A),vector3 duo,wahoo kickr core,331,342,-11
126360,436545,2021-03-10 06:07:00,wahoo,Zwift - British Cycling Crit City Series (A),vector3 duo,wahoo kickr core,287,307,-20
127655,436545,2021-03-13 00:59:47,wahoo,Zwift - DIRT Friday Night Battle (A),vector3 duo,wahoo kickr core,282,292,-10
128878,436545,2021-03-15 23:20:31,wahoo,Zwift - 3R 50km LONDON-Greater London Flat Race (52km/32.4mi) (A),vector3 duo,wahoo kickr core,284,298,-14
128925,436545,2021-03-16 06:53:07,wahoo,Zwift - 3R UCI Worlds Race - 1 Lap (23.7km/14.7mi 494m) (A),vector3 duo,wahoo kickr core,304,321,-17
46257,436922,2020-07-07 10:00:50,wahoo,Zwift - Virtual Tour de France - Open - Stage 1 Discovery Ride,stages L,kickr,290,297,-7
116998,436999,2021-02-17 18:20:53,wahoo,Zwift - Danmarks Cykle Union & Partners 6/6 (A),Garmin Vector 3s,Wahoo Kickr,357,339,18
117152,436999,2021-02-18 11:27:02,wahoo,Zwift - London,Garmin Vector 3s,Wahoo Kickr 5.0,220,204,16
118168,436999,2021-02-20 09:06:07,wahoo,Zwift - 3R Endurance Series p/b OTE Sports- Stage 1 (A),Garmin Vector 3s,Wahoo Kickr 5.0,319,310,9
120655,436999,2021-02-24 18:13:52,wahoo,Zwift - Scandinavian Cup 2021 - Round 1 - Men (A),Garmin Vector 3s,Wahoo Kickr 5.0,312,326,-14
121484,436999,2021-02-27 09:05:55,wahoo,Zwift - 3R Endurance Series p/b OTE Sports (A),Garmin Vector 3s,Wahoo Kickr 5.0,332,319,13
124022,436999,2021-03-03 18:16:50,wahoo,Zwift - Scandinavian Cup 2021 - Round 2 - Men (A),Garmin Vector 3s,Wahoo Kickr 5.0,318,315,3
124911,436999,2021-03-06 08:31:20,wahoo,Zwift - 3R Endurance Series p/b OTE Sports (A),Garmin Vector 3s,Wahoo Kickr 5.0,322,315,7
117025,437013,2021-02-17 18:22:38,wahoo,Zwift - Danmarks Cykle Union & Partners 6/6 (B),Vector 3s,Wahoo Kickr 5.0,292,320,-28
120557,437013,2021-02-24 18:43:50,wahoo,Zwift - Scandinavian Cup 2021 - Round 1 - Men (B),Vector 3s,Wahoo Kickr 5.0,340,347,-7
10360,437837,2020-01-21 18:30:14,wahoo,Zwift - Flanders De Ronde Race (A),KICKR Core,KICKR Core,313,313,0
123997,439480,2021-03-04 17:07:50,wahoo,"Zwift - Para-cycling Virtual Time Trial Series, hosted by U.S. Paralympics Cycling",P2M,Kickr,372,353,19
124028,439480,2021-03-04 18:01:51,wahoo,Zwift - Hudik Triathlon Time Trial,P2M,Kickr,339,324,15
124194,439480,2021-03-04 20:59:29,wahoo,Test1 new setup,P2M,Kickr,154,149,5
124196,439480,2021-03-04 21:18:11,wahoo,test2,P2M,Kickr,179,172,7
124345,439480,2021-03-05 07:44:16,wahoo,test3,P2M,Kickr,175,172,3
124652,439480,2021-03-05 19:04:33,wahoo,Zwift - Zwift Racing League | WTRL Battle Royale Playoff - Men&#039;s Points Race (A),P2M,Kickr,410,400,10
125213,439480,2021-03-06 19:09:15,wahoo,Zwift - Zwift Racing League | WTRL Battle Royale Playoff - Men&#039;s TTT (A),P2M,Kickr,406,392,14
60191,443581,2020-10-07 23:30:01,wahoo,Zwift - Alex TenElshof [Finesse Wahoo]&#039;s Meetup - Big Foot Hills,Quarq SRAM Red,Wahoo Kickr,333,325,8
60811,443581,2020-10-10 14:14:58,wahoo,Zwift - OH MY CRIT - Saturday Smash Race (A),Quarq SRAM Red,Wahoo Kickr,346,338,8
61678,443581,2020-10-13 23:44:51,wahoo,Zwift - Zwift Racing League | WTRL (A),Quarq DZero AXS,Wahoo Kickr (Zwift),382,377,5
62002,443581,2020-10-14 23:29:55,wahoo,Zwift - Austin Driveway Series Criterium (A),Quarq DZero AXS,Wahoo Kickr (Zwift),356,347,9
62635,443581,2020-10-17 14:14:56,wahoo,OH MY CRIT - Saturday Smash Race,Quarq DZero AXS,Wahoo Kickr (Zwift),352,349,3
63996,443581,2020-10-21 23:18:35,wahoo,Zwift - Austin Driveway Series Criterium (A),Quarq DZero AXS,Wahoo Kickr (Zwift),364,355,9
64638,443581,2020-10-24 13:58:59,wahoo,Zwift - The P Race (A),Quarq DZero AXS,Wahoo Kickr (Zwift),365,354,11
66057,443581,2020-10-28 23:21:57,wahoo,Zwift - Austin Driveway Series Criterium (A),Quarq DZero AXS,Wahoo Kickr (Zwift),347,343,4
66709,443581,2020-10-31 15:12:28,wahoo,Zwift - OH MY CRIT - Saturday Smash Race (A),Quarq DZero AXS,Wahoo Kickr (Zwift),350,340,10
66972,443581,2020-11-01 13:14:39,wahoo,Zwift - KISS at Race 100 - Americas (A),Quarq DZero AXS,Wahoo Kickr (Zwift),344,337,7
67761,443581,2020-11-04 00:58:09,wahoo,Zwift - Zwift Racing League | WTRL - Men&#039;s AMERICAS E DIVISION 1 (A),Quarq DZero AXS,Wahoo Kickr (Zwift),358,353,5
68807,443581,2020-11-07 15:13:55,wahoo,Zwift - OH MY CRIT - Saturday Smash Race (A),Quarq DZero AXS,Wahoo Kickr (Zwift),359,350,9
70005,443581,2020-11-11 00:43:57,wahoo,Zwift - Zwift Racing League | WTRL - AMERICAS E (MEN) -  Division 1 (A),Quarq DZero AXS,Wahoo Kickr (Zwift),418,409,9
75288,443581,2020-11-25 00:44:28,wahoo,Zwift - Zwift Racing League | WTRL - Men&#039;s AMERICAS E DIVISION 1,Quarq DZero AXS,Wahoo Kickr (Zwift),352,343,9
75943,443581,2020-11-26 16:10:04,wahoo,Zwift - OH MY CRIT! - The Double Race 1/2 (A),Quarq DZero AXS,Wahoo Kickr (Zwift),372,361,11
75944,443581,2020-11-26 16:10:04,wahoo,Zwift - OH MY CRIT! - The Double Race 2/2 (A),Quarq DZero AXS,Wahoo Kickr (Zwift),345,337,8
78292,443581,2020-12-02 00:51:50,wahoo,Zwift - Zwift Racing League | WTRL - Men&#039;s AMERICAS E DIVISION 1 (A),Quarq DZero AXS,Wahoo Kickr (Zwift),349,346,3
78936,443581,2020-12-03 16:13:57,wahoo,Zwift - OH MY CRIT! - The Double Race 1/2 (A),Quarq DZero AXS,Wahoo Kickr (Zwift),360,355,5
78937,443581,2020-12-03 16:13:57,wahoo,Zwift - OH MY CRIT! - The Double Race 2/2 (A),Quarq DZero AXS,Wahoo Kickr (Zwift),358,355,3
81068,443581,2020-12-09 00:43:59,wahoo,Zwift - Zwift Racing League | WTRL - Men&#039;s AMERICAS E DIVISION 1 (A),Quarq DZero AXS,Wahoo Kickr (Zwift),358,350,8
81785,443581,2020-12-10 23:44:00,wahoo,Zwift - Crit City Race (A),Quarq DZero AXS,Wahoo Kickr (Zwift),342,334,8
82417,443581,2020-12-12 15:13:58,wahoo,Zwift - OH MY CRIT - Saturday Smash Race (A),Quarq DZero AXS,Wahoo Kickr (Zwift),410,403,7
83759,443581,2020-12-16 00:51:42,wahoo,Zwift - Zwift Racing League | WTRL - Men&#039;s AMERICAS E DIVISION 1 (A),Quarq DZero AXS,Wahoo Kickr (Zwift),349,344,5
84783,443581,2020-12-18 17:59:31,wahoo,Zwift - KIRCHMAIR Race Series (A),Quarq DZero AXS,Wahoo Kickr (Zwift),363,348,15
84784,443581,2020-12-18 18:29:32,wahoo,Zwift - KIRCHMAIR Race Series (A),Quarq DZero AXS,Wahoo Kickr (Zwift),377,356,21
85490,443581,2020-12-20 16:35:01,wahoo,Data comparison tests,Quarq DZero AXS,Wahoo Kickr (Zwift),316,311,5
85881,443581,2020-12-21 19:19:45,wahoo,Zwift - Team TFC Mad Monday Winter Series (A),Quarq DZero AXS,Wahoo Kickr (Zwift),370,360,10
86567,443581,2020-12-23 17:59:26,wahoo,Zwift - MIDWEEK Winter Series by SZR (A),Quarq DZero AXS,Wahoo Kickr (Zwift),358,348,10
87541,443581,2020-12-26 17:10:24,wahoo,Three Sisters ZADA Test 12/26/20,Quarq DZero AXS,Wahoo Kickr (Zwift),389,380,9
89112,443581,2020-12-30 17:59:47,wahoo,Zwift - MIDWEEK Winter Series by SZR (A),Quarq DZero AXS,Wahoo Kickr (Zwift),375,363,12
89523,443581,2020-12-31 16:14:29,wahoo,Zwift - OH MY CRIT! - The Double Race 1/2 (A),Quarq DZero AXS,Wahoo Kickr (Zwift),356,344,12
90308,443581,2021-01-02 16:29:36,wahoo,Zwift - TEAM VEGAN Tofu Tornado (A),Quarq DZero AXS,Wahoo Kickr (Zwift),381,369,12
93936,443581,2021-01-09 15:14:26,wahoo,Zwift - OH MY CRIT - Saturday Smash Race (A),Quarq DZero AXS,Wahoo Kickr (Zwift),387,373,14
96497,443581,2021-01-13 17:59:26,wahoo,Zwift - MIDWEEK Winter Series by SZR (A),Quarq DZero AXS,Wahoo Kickr (Zwift),390,377,13
96875,443581,2021-01-14 16:14:33,wahoo,Zwift - OH MY CRIT! - The Double Race 1/2 (A),Quarq DZero AXS,Wahoo Kickr (Zwift),403,391,12
98054,443581,2021-01-16 15:14:30,wahoo,Zwift - OH MY CRIT - Saturday Smash Race (A),Quarq DZero AXS,Wahoo Kickr (Zwift),374,361,13
98597,443581,2021-01-17 14:14:39,wahoo,Zwift - KISS 100 Race Series - Americas (A),Quarq DZero AXS,Wahoo Kickr (Zwift),372,361,11
100292,443581,2021-01-20 17:59:27,wahoo,Zwift - MIDWEEK Winter Series by SZR (A),Quarq DZero AXS,Wahoo Kickr (Zwift),369,360,9
100811,443581,2021-01-21 16:14:49,wahoo,Zwift - OH MY CRIT! - The Double Race 1/2 (A),Quarq DZero AXS,Wahoo Kickr (Zwift),378,368,10
104131,443581,2021-01-27 17:59:38,wahoo,Zwift - MIDWEEK Winter Series by SZR (A),Quarq DZero AXS,Wahoo Kickr (Zwift),376,368,8
104615,443581,2021-01-28 17:04:19,wahoo,Zwift - NYC,Quarq DZero AXS,Wahoo Kickr (Zwift),375,363,12
105664,443581,2021-01-30 15:14:36,wahoo,Zwift - OH MY CRIT!! - Saturday Smash Race (A),Quarq DZero AXS,Wahoo Kickr (Zwift),387,375,12
108181,443581,2021-02-03 17:59:29,wahoo,Zwift - NYC,Quarq DZero AXS,Wahoo Kickr (Zwift),351,341,10
108764,443581,2021-02-04 16:14:30,wahoo,Zwift - OH MY CRIT!! - The Double Race 1/2 (A),Quarq DZero AXS,Wahoo Kickr (Zwift),384,375,9
63966,445785,2020-10-21 17:33:27,wahoo,Zwift - NCF Vinter Cup 2020 - Runde 5 - Kvinner (A),Rotor inspider,Kickr 18,257,260,-3
65836,445785,2020-10-28 18:33:23,wahoo,Zwift - NCF Vinter Cup 2020 - Runde 6 - Kvinner (A),Rotor inspider,Kickr 18,289,289,0
70269,445785,2020-11-11 18:28:27,wahoo,Zwift - NCF Vinter Cup 2020 - Runde 8 - Kvinner (A),Rotor inspider,Kickr 18,286,286,0
63528,447517,2020-10-20 18:18:36,wahoo,Zwift - Zwift Racing League | WTRL - EMEA (WOMEN) - TTT Grp 1 (C),Pioneer Dura-Ace R9100,Wahoo Kickr,204,208,-4
21339,450066,2020-04-02 10:09:56,wahoo,Zwift - Women Only - Cervelo Jungle Rush Series Rd 2 - Cervelo Aspero,Powertap Pedals,Wahoo Kickr,269,263,6
26708,450066,2020-04-21 18:09:58,wahoo,Zwift - Watopia Cup // Zwift Classic (A),Powertap Pedals,Wahoo Kickr,278,268,10
55170,450066,2020-09-14 18:29:57,wahoo,Zwift - Invitational League // Qualifying Race #1 (Women),Powertap Pedals,Wahoo Kickr,284,278,6
55801,450066,2020-09-17 17:59:58,wahoo,Invitational League // Qualifying Race #2 (Women),Powertap Pedals,Wahoo Kickr,263,262,1
69509,450066,2020-11-09 19:05:00,wahoo,Zwift - Premier Division // Zwift Racing League (women) (A),Powertap Pedals,Wahoo Kickr,320,313,7
69510,450066,2020-10-12 17:44:57,wahoo,Zwift - Premier Division // Zwift Racing League (women) (A),Powertap Pedals,Wahoo Kickr,296,291,5
74639,450066,2020-11-23 18:54:57,wahoo,Zwift - Premier Division // Zwift Racing League (women) (A),Powertap Pedals,Wahoo Kickr,281,280,1
95120,450066,2021-01-11 20:06:54,wahoo,Zwift - Premier Division // Zwift Racing League (women) (A),Powertap Pedals,Wahoo Kickr,305,287,18
103086,450066,2021-01-25 20:04:54,wahoo,Zwift - Premier Division // Zwift Racing League (women) (A),Powertap Pedals,Wahoo Kickr,277,283,-6
119243,450066,2021-02-22 20:00:33,wahoo,Zwift - Premier Division // Zwift Racing League (women) (A),Powertap Pedals,Wahoo Kickr,278,277,1
73725,453042,2020-11-21 06:00:02,wahoo,Zwift - EVO CC Vortex Interval Ride [~3-3.8w/kg avg] (B),Assioma duo,wahoo kickr core,358,350,8
73908,453042,2020-11-21 15:02:02,wahoo,Zwift - 3R Endurance Steady Ride [~3.0//2.5w/kg avg] (C),Assioma duo,wahoo kickr core,207,207,0
74068,453042,2020-11-22 05:45:01,wahoo,Zwift - Surrey Sunday – p/b TBR (C),Assioma duo,wahoo kickr core,286,281,5
74552,453042,2020-11-23 16:46:01,wahoo,Zwift - FZR Segment Killer Race (B),Assioma duo,wahoo kickr core,407,403,4
76861,453042,2020-11-28 05:59:42,wahoo,Zwift - SAS - CENTURION 100km (C),Assioma duo,wahoo kickr core,311,311,0
78058,453042,2020-12-01 18:26:30,wahoo,Zwift Racing League | WTRL - Mens EMEA E1 DIVISION 3,Assioma duo,wahoo kickr core,345,343,2
78772,453042,2020-12-03 06:00:01,wahoo,Zwift - MAAP In The Field: UK Group Ride  (C),Assioma duo,wahoo kickr core,241,243,-2
80849,453042,2020-12-08 18:18:00,wahoo,Zwift - Zwift Racing League | WTRL - Men&#039;s EMEA E1 DIVISION 3 (B),Assioma duo,wahoo kickr core,366,355,11
81508,453042,2020-12-10 15:30:00,wahoo,Applewood Cycling Group Ride,Assioma duo,wahoo kickr core,349,342,7
82194,453042,2020-12-12 07:30:03,wahoo,3R 100 Steady Ride [~2.5w/kg avg],Assioma duo,wahoo kickr core,234,235,-1
82667,453042,2020-12-13 09:00:00,wahoo,Zwift Fondo Series 2020/21,Assioma duo,wahoo kickr core,345,339,6
83981,453042,2020-12-16 16:10:02,wahoo,3R Tick Tock Flat Race - 2 Lap (36km/22.4mi 100m),Assioma duo,wahoo kickr core,341,341,0
84594,453042,2020-12-18 06:00:01,wahoo,Zwift - 3R VOLT Interval Ride [~2.6-3.2 w/kg avg] (C),Assioma duo,wahoo kickr core,322,312,10
85662,453042,2020-12-21 06:00:00,wahoo,Zwift - 3R Octane Interval Ride [~3.2-3.6 w/kg avg] (B),Assioma duo,wahoo kickr core,350,340,10
86345,453042,2020-12-23 06:00:01,wahoo,3R VOLT Interval Ride [~2.6-3.2 w/kg avg],Assioma duo,wahoo kickr core,335,330,5
86446,453042,2020-12-23 13:31:00,wahoo,Zwift - ZHQ FutureWorks Circuit Race - Anti-sandbagging (B),Assioma duo,wahoo kickr core,362,360,2
87108,453042,2020-12-25 06:00:00,wahoo,Zwift - 3R VOLT Interval Ride [~2.6-3.2 w/kg avg] (C),Assioma duo,wahoo kickr core,340,333,7
87694,453042,2020-12-27 06:01:01,wahoo,Zwift - KISS 100 Race Series - EU (B),Assioma duo,wahoo kickr core,335,335,0
88276,453042,2020-12-28 17:00:02,wahoo,Zwift - EVO CC Vamos! 90min Ride [3.5-4w/kg avg] (B),Assioma duo,wahoo kickr core,304,303,1
90593,453042,2021-01-03 07:00:01,wahoo,EVO CC 160km Base Ride [3.0-3.2w/kg avg],Assioma duo,wahoo kickr core,286,286,0
94445,453042,2021-01-10 15:02:02,wahoo,Zwift - TDZ Stage 2: Standard Ride,Assioma duo,wahoo kickr core,360,351,9
98610,453042,2021-01-17 16:00:01,wahoo,Zwift - Sunday Session with Team Giant (C),Assioma duo,wahoo kickr core,250,251,-1
99740,453042,2021-01-19 18:25:31,wahoo,Zwift - Zwift Racing League | WTRL - Men&#039;s/Mixed EMEA E1 DIVISION 3 (B),Assioma duo,wahoo kickr core,326,322,4
100259,453042,2021-01-20 16:02:01,wahoo,Zwift - TDZ Stage 4: Standard Ride,Assioma duo,wahoo kickr core,357,345,12
101487,453042,2021-01-22 18:01:00,wahoo,Zwift - KIRCHMAIR Race Series (B),Assioma duo,wahoo kickr core,339,339,0
101490,453042,2021-01-22 18:31:00,wahoo,Zwift - KIRCHMAIR Race Series (B),Assioma duo,wahoo kickr core,355,347,8
106655,453042,2021-02-01 15:02:00,wahoo,Zwift - TDZ Stage 6: Standard Ride,Assioma duo,wahoo kickr core,321,328,-7
106657,453042,2021-01-30 14:45:01,wahoo,Zwift - Team CLS Drum &#039;n&#039; Base Club Ride (C),Assioma duo,wahoo kickr core,254,260,-6
107346,453042,2021-02-02 18:18:01,wahoo,Zwift Racing League | WTRL - Mens/Mixed EMEA E1 DIVISION 3,Assioma duo,wahoo kickr core,362,364,-2
109389,453042,2021-02-05 15:31:02,wahoo,DBR Friday Race,Assioma duo,wahoo kickr core,355,358,-3
111629,453042,2021-02-09 18:25:30,wahoo,Zwift - Zwift Racing League | WTRL - Men&#039;s/Mixed EMEA E1 DIVISION 3 (B),Assioma duo,wahoo kickr core,335,337,-2
112829,453042,2021-02-11 15:30:01,wahoo,Zwift - Applewood Cycling Group Ride (B),Assioma duo,wahoo kickr core,344,343,1
114734,453042,2021-02-13 07:15:00,wahoo,FZR Masters Race,Assioma duo,wahoo kickr core,314,315,-1
115877,453042,2021-02-16 18:18:02,wahoo,Zwift Racing League | WTRL - Mens/Mixed EMEA E1 DIVISION 3,Assioma duo,wahoo kickr core,374,379,-5
116550,453042,2021-02-17 14:59:59,wahoo,Zwift - UKAFC Race Night (A),Assioma duo,wahoo kickr core,327,325,2
118142,453042,2021-02-20 09:06:01,wahoo,Zwift - 3R Endurance Series p/b OTE Sports- Stage 1 (A),Assioma duo,wahoo kickr core,326,328,-2
119617,453042,2021-02-23 18:18:01,wahoo,Zwift - Zwift Racing League | WTRL - Men&#039;s/Mixed EMEA E1 DIVISION 3 (B),Assioma duo,wahoo kickr core,338,341,-3
121193,453042,2021-02-26 15:00:00,wahoo,Zwift - Haute Route Watopia 2021 Stage 1 (A),Assioma duo,wahoo kickr core,345,343,2
121523,453042,2021-02-27 07:00:00,wahoo,Zwift - Haute Route Watopia 2021 Stage 2 (A),Assioma duo,wahoo kickr core,321,315,6
122008,453042,2021-02-28 06:59:59,wahoo,Zwift - Haute Route Watopia 2021 Stage 3 (A),Assioma duo,wahoo kickr core,336,335,1
123007,453042,2021-03-02 18:25:00,wahoo,Zwift - Zwift Racing League | WTRL - Men&#039;s/Mixed EMEA E1 DIVISION 3 (B),Assioma duo,wahoo kickr core,328,330,-2
127044,453042,2021-03-11 17:30:02,wahoo,Zwift - Absa Cape Epic Stage 3 pb ABUS - Open	 (A),Assioma duo,wahoo kickr core,330,328,2
93484,453334,2021-01-08 17:53:48,wahoo,Test 5min - Zwift - Watopia,Quarq DZero ,Wahoo Kickr Core,488,478,10
93946,453334,2021-01-09 14:48:44,wahoo,Zwift - Watopia,Quarq DZero ,Wahoo Kickr Core,407,395,12
99841,453334,2021-01-19 17:42:21,wahoo,Zwift - Zwift Racing League | WTRL - Men&#039;s/Mixed EMEA E1 DIVISION 6 (A),Quarq DZero ,Wahoo Kickr Core,404,396,8
25133,454399,2020-04-16 11:50:10,wahoo,Test Kickr vs Quarq,Quarq xx1,Kickr 2019,210,199,11
28269,454399,2020-04-26 16:18:23,wahoo,Test Kickr vs Stages,Stages,Kickr 2019,307,303,4
28484,454399,2020-04-27 18:19:58,wahoo,Zwift - TFC Mad Monday World Series iTT (3 of 6) (A),Stages,Kickr 2019,487,485,2
31333,454399,2020-05-04 18:19:59,wahoo,Zwift - TFC Mad Monday World Series (4 of 6) (A),Stages,Kickr 2019,448,448,0
33340,454399,2020-05-10 15:53:39,wahoo,Test Kickr vs Quarq with slope minus 5%,Quarq xx1,Kickr 2019,292,298,-6
33690,454399,2020-05-11 18:19:58,wahoo,Zwift - TFC Mad Monday World Series (5 of 6) (A),Stages,Kickr 2019,418,418,0
40383,454399,2020-06-08 18:20:18,wahoo,Zwift - TFC Mad Monday Series (3 of 6) (A),Stages,Kickr 2019,427,425,2
44079,454399,2020-06-29 18:20:00,wahoo,Zwift - TFC Mad Monday Series (6 of 6) (A),Stages,Kickr 2019,428,427,1
44415,454399,2020-07-01 17:00:15,wahoo,Zwift - MIDWEEK Summer Series by SZR (A),Stages,Kickr 2019,421,418,3
48161,454399,2020-07-29 17:00:00,wahoo,Zwift - MIDWEEK Summer Series by SZR (A),Stages,Kickr 2019,406,398,8
80161,454399,2020-12-06 15:13:33,wahoo,8wk Race Day Prep Week 3 Strength Training,Quarq xx1,Kickr 2019,415,413,2
81896,454399,2020-12-11 11:34:59,wahoo,Ramp test 30w/2&#039;,Quarq xx1,Kickr 2019,473,471,2
83004,454399,2020-12-14 06:00:33,wahoo,Zwift - Zwift Time Trial Tuesday: Tempus Fugit (E),Quarq xx1,Kickr 2019,413,407,6
83555,454399,2020-12-15 18:24:56,wahoo,Zwift - Zwift Racing League | WTRL - Men&#039;s EMEA E1 DIVISION 1 (A),Quarq xx1,Kickr 2019,406,397,9
85484,454399,2020-12-20 15:25:02,wahoo,Zwift - 3R Watopia 65km Race - 6 laps (40mi 324m) (A),Quarq xx1,Kickr 2019,432,414,18
85488,454399,2020-12-18 16:30:13,wahoo,Zwift - ZHQ FutureWorks Crit City Race - Anti-sandbagging (A),Quarq xx1,Kickr 2019,396,388,8
86894,454399,2020-12-24 10:36:31,wahoo,Zwift - WTRL Team Time Trial - Zone 2 (C),Quarq xx1,Kickr 2019,360,346,14
29191,456188,2020-04-29 17:00:00,neo,Favero / NEO,Favero,NEO,375,367,8
29629,456188,2020-04-30 13:36:20,neo,Favero / NEO,Favero,NEO,348,332,16
117373,457942,2021-02-18 19:19:58,wahoo,Zwift - BRT Criterium Racing League (A),Favero Assioma,Kickr core,334,329,5
117402,457942,2021-02-18 18:48:21,wahoo,Zwift - Watopia,2021-02-18-184820-ELEMNT ROAM 666D-116-0,Kickr core,236,240,-4
123061,457942,2021-03-02 18:29:22,wahoo,Zwift - Zwift Racing League | WTRL - Men&#039;s/Mixed EMEA E2 DIVISION 1 (A),Favero Assioma,Kickr core,316,336,-20
126695,457942,2021-03-10 18:50:01,wahoo,Zwift - ATR Clubhouse Bash 4WAY (A),Favero Assioma,Kickr core,362,334,28
127487,457942,2021-03-12 15:30:14,wahoo,Zwift - DBR Friday Race (A),Favero Assioma,Kickr core,322,318,4
33775,458121,2020-05-11 17:43:20,neo,Zwift - Rachael Elliott [KRT/NV]&#039;s Meetup - Three Sisters,SRM Exakt,Tacx Neo,276,274,2
36176,458121,2020-05-19 18:16:30,neo,Zwift - Tour for All Invitational Race // Women (A),SRM Exakt,Tacx Neo,279,274,5
37888,458121,2020-05-26 18:16:30,neo,Zwift - Tour for All Invitational Race // Women (A),SRM Exakt,Tacx Neo,285,273,12
40052,458121,2020-06-06 16:04:30,neo,Zwift - GCA Klassiker #1,SRM Exakt,Tacx Neo,287,284,3
41490,458121,2020-06-13 16:04:30,neo,Zwift - GCA Klassiker #2 (B),SRM Exakt,Tacx Neo,261,263,-2
42861,458121,2020-06-20 16:04:30,neo,Zwift - GCA Klassiker #3 (B),SRM Exakt,Tacx Neo,246,245,1
46659,458121,2020-07-16 17:28:51,neo,Zwift - Vienna,SRM Exakt,Tacx Neo,268,267,1
55221,458121,2020-09-14 18:29:15,neo,Zwift - Invitational League // Qualifying Race #1 (Women),SRM Exakt,Tacx Neo,268,268,0
55914,458121,2020-09-17 17:32:13,neo,Zwift - Invitational League // Qualifying Race #2 (Women) (A),SRM Exakt,Tacx Neo,260,258,2
61350,458121,2020-10-12 17:44:29,neo,Zwift - Premier Division // Zwift Racing League (women) (A),SRM Exakt,Tacx Neo,269,265,4
63242,458121,2020-10-19 19:12:51,neo,Zwift - Premier Division // Zwift Racing League (women) (A),SRM Exakt,Tacx Neo,254,249,5
65252,458121,2020-10-26 19:04:05,neo,Zwift - Premier Division // Zwift Racing League (women) ,SRM Exakt,Tacx Neo,265,263,2
67733,458121,2020-11-02 19:19:32,neo,Zwift - Premier Division // Zwift Racing League (women) (A),SRM Exakt,Tacx Neo,264,262,2
69457,458121,2020-11-09 19:02:09,neo,Zwift - Premier Division // Zwift Racing League (women) (A),SRM Exakt,Tacx Neo,282,284,-2
70858,458121,2020-11-12 18:21:19,neo,Zwift - Vienna,SRM Exakt,Tacx Neo,266,262,4
71998,458121,2020-11-16 19:19:03,neo,Zwift - Premier Division // Zwift Racing League (women) (A),SRM Exakt,Tacx Neo,257,254,3
73258,458121,2020-11-19 18:20:59,neo,Zwift - Vienna,SRM Exakt,Tacx Neo,273,268,5
74015,458121,2020-11-21 15:57:39,neo,Zwift - ZA Road 2020 - Segment Ride #2: Three Sisters Course,SRM Exakt,Tacx Neo,277,266,11
74751,458121,2020-11-23 18:18:10,neo,Zwift - Premier Division // Zwift Racing League (women) (A),SRM Exakt,Tacx Neo,273,276,-3
76145,458121,2020-11-26 18:21:16,neo,Zwift - WTRL NOPINZ WORLD TTT CHAMPIONSHIPS - Zone 7 (E),SRM Exakt,Tacx Neo,270,264,6
78885,458121,2020-11-30 19:35:28,neo,Zwift - Premier Division // Zwift Racing League (women) (A),SRM Exakt,Tacx Neo,256,252,4
45460,458147,2020-07-08 17:29:30,wahoo,Kickr_core vs P2M_Test,P2M,Kickr Core,237,241,-4
46569,458147,2020-07-16 09:58:20,wahoo,Zwift - Koa Sports League Race (A),Favero Assioma uno,Kickr Core (Zwift source),323,327,-4
77600,458147,2020-11-30 13:38:54,wahoo,Zwift - Watopia_test,P2M,Kickr Core (Zwift source),192,193,-1
77933,458147,2020-12-01 11:09:52,wahoo,Zwift - Japan Zwift Tuesday Race (A),P2M,Kickr Core (Zwift source),311,313,-2
78580,458147,2020-12-02 17:59:51,wahoo,Zwift - MIDWEEK Winter Series by SZR (A) - DNF,P2M,Kickr Core (Zwift source),363,366,-3
79039,458147,2020-12-03 18:47:59,wahoo,WTRL TTT Platinum League - Frappe,P2M,Kickr Core (Zwift source),343,345,-2
79679,458147,2020-12-05 09:57:59,wahoo,Zwift - Nations Challenge // Germany (E),P2M,Kickr Core (Zwift source),332,333,-1
81815,458147,2020-12-10 18:47:59,wahoo,Zwift - Frappe,P2M,Kickr Core (Zwift source),342,342,0
82345,458147,2020-12-12 13:59:45,wahoo,Zwift - MGCC hosts Ontario Cycling Association Virtual Challenge #1,P2M--&gt;Garmin,Kickr Core--&gt;Zwift,342,344,-2
82700,458147,2020-12-13 10:30:39,wahoo,Zwift - ODZentury Sunday Endurance Ride,P2M--&gt;Garmin,Kickr Core--&gt;Zwift,256,253,3
86157,458147,2020-12-22 17:35:31,wahoo,Zwift - KIRCHMAIR TT Race (A),P2M--&gt;Garmin,Kickr Core--&gt;Zwift,367,369,-2
56744,458986,2020-09-22 04:05:00,neo,Zwift - 3R Innsbruckring Flat Race - 3 Laps (26.4km/16.4mi 231m) (A),Garmin Vector2→Ant+→Garmin Fenix 5X,Tacx Neo→BT→AppleTV,327,320,7
56945,458986,2020-09-23 04:05:00,neo,Zwift - 3R Watopia Flat Route Reverse Race - 3 Laps (30.8km/19.1mi 162m) (A),Garmin Vector2→Ant+→Garmin Fenix 5X,Tacx Neo→BT→AppleTV,332,322,10
24215,459227,2020-04-12 07:50:47,wahoo,Zwift - UKZwifters 100km Sportive (B),Stages,Wahoo Kickr,249,245,4
24216,459227,2020-04-05 08:45:53,wahoo,Zwift -  Haute Route Watopia Stage 3 (E),Stages measured by Wahoo App,Wahoo Kickr,238,250,-12
24350,459227,2020-04-04 08:38:32,wahoo,Zwift -  Haute Route Watopia Stage 2 (E),Stages measured by Wahoo App,Wahoo Kickr,227,245,-18
24353,459227,2020-04-03 08:43:39,wahoo,Zwift -  Haute Route Watopia Stage 1 (E),Stages measured by Wahoo App,Wahoo Kickr,240,256,-16
24557,459227,2020-04-14 09:48:57,wahoo,Zwift - Trofeo Bologna Race (B),Stages measured by Wahoo App,Wahoo Kickr,297,285,12
25142,459227,2020-04-16 10:53:11,wahoo,British cycling TT (B),Stages measured by Wahoo App,Wahoo Kickr,274,278,-4
26177,459227,2020-04-19 08:43:34,wahoo,Zwift - Newbury Velo Road Race (B),Stages measured by Wahoo App,Wahoo Kickr,269,271,-2
26629,459227,2020-04-21 07:42:02,wahoo,Zwift - 04/21/2020,Stages from Zwift,Kickr from Wahoo App,264,263,1
27286,459227,2020-04-23 10:53:48,wahoo,Zwift - British Cycling Time Trial Series (B),Stages measured by Wahoo App,Kickr from Wahoo App,266,267,-1
33371,459227,2020-05-10 14:17:43,wahoo,Zwift - Tower 26/USA Duathlon Virtual 40K Time Trial (E),Stages measured by Wahoo App,Wahoo Kickr,251,254,-3
15542,460142,2020-02-24 16:10:15,neo,Zwift - 3R Classique Reverse Flat Race - 4 Laps (26.9km/16.7mi 57m) (B),Assioma,Neo,297,296,1
16438,460142,2020-03-01 19:45:15,neo,Zwift - The Alpe Dash by Herd Racing League (B),Assiomas,Neo,292,294,-2
8772,460177,2020-01-10 18:59:56,wahoo,Zwift - The Friday Criterium Winter Race Series  (24 mi / 38 km) (A),FSA Powerbox (p2max),Kickr Core,330,336,-6
18913,460177,2020-03-20 19:15:20,wahoo,Zwift - Tour of Watopia Pro-Am Men&#039;s Race #2 (A),FSA Powerbox (p2max),Kickr Core,363,368,-5
19480,460177,2020-03-24 19:15:16,wahoo,Zwift - Tour of Watopia Pro-Am Men&#039;s Race #3 (A),FSA Powerbox (p2max),Kickr Core,324,325,-1
20018,460177,2020-03-27 19:08:26,wahoo,Zwift - 03/27/2020,FSA Powerbox (p2max),Kickr Core,303,328,-25
20717,460177,2020-03-28 18:26:37,wahoo,TFC & WTRL Mad Monday London Series (5 of 6),FSA Powerbox (p2max),Kickr Core,323,329,-6
21213,460177,2020-04-01 19:20:41,wahoo,Zwift - 3 x 8 min criss cross intervals,FSA Powerbox (p2max),Kickr Core,311,316,-5
21810,460177,2020-04-03 18:00:18,wahoo,Zwift -  Haute Route Watopia Stage 1 (E),FSA Powerbox (p2max),Kickr Core,313,318,-5
23150,460177,2020-04-08 16:44:56,wahoo,Zwift - 3R 100 Steady Ride [~3.0w/kg avg] (B),Assioma Uno,Kickr Core,234,236,-2
24327,460177,2020-04-13 18:20:12,wahoo,TFC Mad Monday World Series (1 of 6),Assioma Uno,Kickr Core,333,339,-6
25622,460177,2020-04-17 18:10:45,wahoo,Richmond Challenge // Zwift Classic,FSA Powerbox (p2max),Kickr Core,348,362,-14
26511,460177,2020-04-20 18:19:51,wahoo,Zwift - TFC Mad Monday World Series (2 of 6) (A),FSA Powerbox (p2max),Kickr Core,356,348,8
31430,460177,2020-05-04 18:20:02,wahoo,Zwift - TFC Mad Monday World Series (4 of 6) (A),FSA Powerbox (p2max),Kickr Core,343,355,-12
32475,460177,2020-05-07 17:44:53,wahoo,WTRL Team Time Trial - Zone3,FSA Powerbox (p2max),Kickr Core,331,336,-5
32915,460177,2020-05-09 09:24:02,wahoo,ZADA Test Protocol - Three Sisters,FSA Powerbox (p2max),Kickr Core,320,328,-8
35851,460177,2020-05-18 18:20:00,wahoo,Zwift - TFC Mad Monday World Series (6 of 6) (A),FSA Powerbox (p2max),Kickr Core,331,342,-11
36696,460177,2020-05-21 18:16:49,wahoo,Zwift - Tour for All Invitational Race // Men (A),FSA Powerbox (p2max),Kickr Core,350,359,-9
40386,460177,2020-06-08 18:19:54,wahoo,Zwift - TFC Mad Monday Series (3 of 6) (A),FSA Powerbox (p2max),Kickr Core,355,364,-9
42453,460177,2020-06-18 17:21:40,wahoo,Zwift - WTRL Team Time Trial Premier League - Frappe,Assioma Duo,Kickr Core,327,332,-5
45148,460177,2020-07-06 18:19:49,wahoo,Zwift - TFC Mad Monday Summer Series (1 of 9) (A),FSA Powerbox (p2max),Kickr Core,324,326,-2
50441,460177,2020-08-17 18:20:02,wahoo,Zwift - TFC Mad Monday Summer Series (7 of 10) (A),FSA Powerbox (p2max),Kickr Core,348,352,-4
53787,460177,2020-09-07 18:19:47,wahoo,TFC Mad Monday Summer Series (10 of 10) (A),FSA Powerbox (p2max),Kickr Core,331,329,2
53994,460177,2020-09-08 18:43:26,wahoo,Zwift - 3R Sundown Race Series  (A+),FSA Powerbox (p2max),Kickr Core,327,324,3
55910,460177,2020-09-17 18:29:35,wahoo,Zwift - Invitational League // Qualifying Race #2,FSA Powerbox (p2max),Kickr Core,352,348,4
59893,460177,2020-10-06 18:59:40,wahoo,Zwift - KISS at Race - EU PM (A),FSA Powerbox (p2max),Kickr Core,327,332,-5
61743,460177,2020-10-13 18:44:34,wahoo,Zwift - Zwift Racing League | WTRL,FSA Powerbox (p2max),Kickr Core,342,339,3
65514,460177,2020-10-27 19:46:50,wahoo,Zwift - Zwift Racing League | WTRL - EMEA W (MEN) -  Division 3 (A),FSA Powerbox (p2max),Kickr Core,336,337,-1
76142,460177,2020-11-26 19:19:31,wahoo,Zwift - BRT Criterium Racing League (A),FSA Powerbox (p2max),Kickr Core,326,322,4
85473,460177,2020-12-20 14:14:05,wahoo,Zwift - KISS 100 Race Series - Americas (A),FSA Powerbox (p2max),Kickr Core,326,325,1
98580,460177,2021-01-17 14:14:16,wahoo,Zwift - KISS 100 Race Series - Americas,FSA Powerbox (p2max),Kickr Core,338,342,-4
103623,460177,2021-01-26 19:45:46,wahoo,Zwift - Zwift Racing League | WTRL - Men&#039;s/Mixed EMEA W1 DIVISION 2 (A),FSA Powerbox (p2max),Kickr Core,342,363,-21
104245,460177,2021-01-27 19:31:52,wahoo,Zwift - Active Recovery,FSA Powerbox (p2max),Kickr Core,201,202,-1
105731,460177,2021-01-30 16:59:22,wahoo,Zwift - GCA Liga 2021 #1,FSA Powerbox (p2max),Kickr Core,366,372,-6
107474,460177,2021-02-02 19:45:49,wahoo,Zwift - 02/02/2021,FSA Powerbox (p2max),Kickr Core,354,356,-2
110004,460177,2021-02-06 16:59:09,wahoo,GCA Liga 2021 #2,FSA Powerbox (p2max),Kickr Core,344,343,1
114257,460177,2021-02-13 16:59:07,wahoo,Zwift - GCA Liga 2021 #3,FSA Powerbox (p2max),Kickr Core,363,364,-1
118346,460177,2021-02-20 16:59:59,wahoo,Zwift - 02/20/2021,FSA Powerbox (p2max),Kickr 5,346,356,-10
9168,462143,2020-01-13 16:45:16,wahoo,Zwift - Crit City Race (A) 5th Place,Assioma Favero Duo,kickr17,322,317,5
9313,462143,2020-01-14 16:05:14,wahoo,Zwift - 3R Ultimate Racing League - Round 2 (A) + 2 easy laps,Assioma Favero Duo,kickr17,330,326,4
9544,462143,2020-01-15 19:15:14,wahoo,Zwift - Tour de Zwift // Pro-Am Invitational (A) 70th Place,Assioma Favero Duo,kickr17,355,345,10
10680,462143,2020-01-23 19:15:01,wahoo,Zwift - Tour de Zwift // Pro-Am Invitational 70th Place,Assioma Favero Duo,kickr17,349,351,-2
12156,462143,2020-02-02 14:15:01,wahoo,"Zwift - KISS at Race 100 - Americas (A) 25th Place, Ouch....",Assioma Favero Duo,kickr17,333,329,4
14248,462143,2020-02-16 14:15:02,wahoo,Zwift - KISS at Race 100 - Americas (A),Assioma Favero Duo,kickr17,339,335,4
15207,462143,2020-02-22 13:45:01,wahoo,Zwift - WTRL Winter Racing League - Series 2 STAGE 2 (A),Assioma Favero Duo,kickr17,341,333,8
15326,462143,2020-02-23 14:15:02,wahoo,Zwift - KISS at Race 100 - Americas (A) Jurassic Park,Assioma Favero Duo,kickr17,316,310,6
16303,462143,2020-03-01 14:00:01,wahoo,Zwift - Zwift Gran Fondo 12th Place,Assioma Favero Duo,kickr17,333,327,6
16600,462143,2020-03-03 16:05:00,wahoo,Zwift - 3R SuperCRITical Race Series - Round 3of4 (A) 13th Place,Assioma Favero Duo,kickr17,325,319,6
31014,462143,2020-05-03 13:15:14,wahoo,Zwift - KISS at Race 100 - Americas (A),Assioma Favero Duo,kickr17,318,313,5
41466,462143,2020-06-13 16:00:14,wahoo,Zwift - 4a Etapa Fasttriatlon Virtual Tour Powered by ADZteam.eu (A),Assioma Favero Duo,kickr17,325,320,5
46051,462143,2020-07-12 13:15:14,wahoo,Zwift - KISS at Race 100 - Americas (A) 7th Place ,Assioma Favero Duo,kickr17,325,323,2
2488,462221,2019-09-24 18:10:51,neo,Zwift - FUSION ECT Racing League (B),Favero Assioma Duo - Zwift,Tacx Neo - Garmin 830,304,296,8
3088,462221,2019-10-02 17:30:58,neo,Zwift - MVW Winter League (B),Favero Assioma Duo - Zwift,Tacx Neo - Garmin 830,307,299,8
3483,462221,2019-10-29 19:10:58,neo,Zwift - WORLDOFFUSION Racing League (B),Favero Assioma Duo - Zwift,Tacx Neo - Garmin 830,298,290,8
3834,462221,2019-11-05 19:41:00,neo,Zwift - Ultimate Racing League by 3R & WTRL (B),Favero Assioma Duo - Zwift,Tacx Neo - Garmin 830,288,280,8
112680,462221,2021-02-10 17:29:57,neo,Zwift - LEQP Provence Rose Ride (C) - Tire Bouchon,Favero Assioma Duo - Zwift,Tacx Neo - Garmin 830,235,227,8
118326,462221,2021-02-20 16:06:59,neo,Zwift - 3R Endurance Series p/b OTE Sports- Stage 1 (B),Favero Assioma Duo - Zwift,Tacx Neo - Garmin 830,290,278,12
119777,462221,2021-02-23 19:50:54,neo,Zwift - Zwift Racing League | WTRL - Men&#039;s/Mixed EMEA W1 DIVISION 7 (B),Favero Assioma Duo - Zwift,Tacx Neo - Garmin 830,296,288,8
121714,462221,2021-02-27 16:06:49,neo,Zwift - 3R Endurance Series p/b OTE Sports (B),Favero Assioma Duo - Zwift,Tacx Neo - Garmin 830,295,286,9
128836,462221,2021-03-15 19:20:59,neo,Zwift - Team TFC Mad Monday Race Series (high-end categories) (B),Favero Assioma Duo - Zwift,Tacx Neo - Garmin 830,283,269,14
25798,463243,2020-04-18 09:05:01,wahoo,Zwift - 3R Innsbruckring Flat Race - 5 Laps (44km/27.3mi 385m) (A),Favero Assioma,Kickr 2017,344,343,1
31628,463243,2020-05-05 09:04:53,wahoo,Zwift - 3R Spring Loaded Race Series - Round 6of6 (A),Favero Assioma,Kickr 2017,346,345,1
34699,463243,2020-05-14 14:42:55,wahoo,TR: Beech,Favero Assioma Duo,Kickr 2017,244,239,5
35295,463243,2020-05-16 08:30:48,wahoo,TR: Laurel pt 1,Favero Assioma Duo,Kickr 2017,285,287,-2
35300,463243,2020-05-16 09:19:16,wahoo,Top End Tuning Workout,Favero Assioma Duo,Kickr 2017,310,308,2
35306,463243,2020-05-16 10:29:15,wahoo,Zwift - 3R Volcano Climb Race - 1 Lap (22.4km/14mi 204m) (A),Favero Assioma Duo,Kickr 2017,343,345,-2
36458,463243,2020-05-20 18:00:02,wahoo,Zwift - Zwift NL League - Woensdagavond Competitie (A),Favero Assioma Duo,Kickr 2017,346,349,-3
37107,463243,2020-05-23 09:04:59,wahoo,Zwift - 3R Watopia Out and Back Again - 1 Lap (42k/26.1mi 334m) (A),Favero Assioma Duo,Kickr 2017,352,355,-3
42257,463243,2020-06-17 18:00:15,wahoo,Zwift - Zwift NL League - The Watopia Series  (A),Favero Assioma Duo (Garmin),Kickr 2017,322,330,-8
43806,463243,2020-06-27 08:30:00,wahoo,Zwift - DBR Saturday Race  (A),Favero Assioma Duo (Garmin),Kickr 2017 (Zwift),350,350,0
44821,463243,2020-07-04 09:50:48,wahoo,TR: Carpathian Peak +3,Favero Assioma Duo (via Zwift),"Kickr 2017 (TR, Wahoo Powermatch)",331,316,15
45286,463243,2020-07-07 16:34:59,wahoo,Zwift - Team Sportslab UK Road Race League (A),Favero Assioma Duo (Garmin),"Kickr 2017 (Zwift, PM disabled)",350,341,9
45903,463243,2020-07-11 08:29:46,wahoo,Zwift - DBR Saturday Race  (A),Favero Assioma Duo (Garmin),"Kickr 2017 (Zwift, PM enabled)",345,342,3
51339,463243,2020-08-23 09:00:17,wahoo,Zwift - Climbers Day p/b dPAC.fit & Precision Hydration (A),Favero Assioma Duo (Garmin),"Kickr 2017 (Zwift, PM disabled)",311,302,9
55194,463243,2020-09-14 17:59:53,wahoo,Zwift - Invitational League // Qualifying Race #1,Favero Assioma Duo (Garmin),"Kickr 2017 (Zwift, PM disabled)",359,364,-5
59401,463243,2020-10-04 09:04:41,wahoo,Zwift - Newbury Velo Road Race (A),Favero Assioma Duo (Garmin),"Kickr 2017 (Zwift, PM disabled)",347,345,2
60776,463243,2020-10-10 11:09:46,wahoo,Zwift - ZA Road Race #1: 4 - 5 w/kg,Favero Assioma Duo (Garmin),"Kickr 2017 (Zwift, PM disabled)",364,364,0
61019,463243,2020-10-11 07:45:03,wahoo,Zwift - 100km ZESP Fondo (A),Favero Assioma Duo (Garmin),"Kickr 2017 (Zwift, PM disabled)",358,358,0
62158,463243,2020-10-15 15:59:59,wahoo,Zwift Academy Road: Workout 3 | VO2 Capacity,Favero Assioma Duo (Garmin),"Kickr 2017 (Zwift, PM disabled)",353,349,4
62610,463243,2020-10-17 12:00:20,wahoo,Zwift - ZA Road 2020 - Segment Ride #1: Innsbruck Course,Favero Assioma Duo (Garmin),"Kickr 2017 (Zwift, PM enabled)",343,337,6
62806,463243,2020-10-18 07:45:25,wahoo,Zwift - 100km ZESP Fondo (A),Favero Assioma Duo (Garmin),"Kickr 2017 (Zwift, PM enabled)",333,336,-3
64608,463243,2020-10-24 09:59:40,wahoo,Zwift - Anaerobic Resilience,Favero Assioma Duo (Garmin),"Kickr 2017 (Zwift, PM enabled)",277,279,-2
64851,463243,2020-10-25 11:09:54,wahoo,Zwift - ZA Road - Race #2 (A),Favero Assioma Duo (Garmin),"Kickr 2017 (Zwift, PM enabled)",342,343,-1
66731,463243,2020-10-31 12:14:46,wahoo,Zwift - Team ODZ RACE (A),Favero Assioma Duo (Garmin),"Kickr 2017 (Zwift, PM enabled)",316,316,0
67147,463243,2020-11-02 10:00:18,wahoo,Zwift - ZA Road 2020 - Segment Ride #1: Three Sisters Course,Favero Assioma Duo (Garmin),"Kickr 2017 (Zwift, PM enabled)",365,368,-3
71393,463243,2020-11-14 14:00:02,wahoo,Zwift Academy Road: Workout 7 | VO2 Development,Favero Assioma Duo (Garmin),"Kickr 2017 (Zwift, PM enabled)",333,326,7
71606,463243,2020-11-15 10:04:55,wahoo,Zwift - Open: 2020 El Giro de Rigo - Official Route,Favero Assioma Duo (Garmin),"Kickr 2017 (Zwift, PM enabled)",354,352,2
72709,463243,2020-11-18 18:59:47,wahoo,Zwift - Zwift NL Race Day (A),Favero Assioma Duo (Garmin),"Kickr 2017 (Zwift, PM enabled)",350,350,0
73841,463243,2020-11-21 13:59:53,wahoo,Zwift Academy Road: Workout 8 | Anaerobic Depletion (no spindown),Favero Assioma Duo (Garmin),"Kickr 2017 (Zwift, PM enabled)",279,268,11
74215,463243,2020-11-22 09:05:15,wahoo,Zwift - Newbury Velo Road Race (A),Favero Assioma Duo (Garmin),"Kickr 2017 (Zwift, PM enabled)",350,348,2
77047,463243,2020-11-28 15:14:59,wahoo,OH MY CRIT - Saturday Smash Race,Favero Assioma Duo (Garmin),"Kickr 2017 (Zwift, PM enabled)",345,339,6
85368,463243,2020-12-19 09:59:37,wahoo,Tour of New York Stage 2,Favero Assioma Duo (Garmin),"Kickr 2017 (Zwift, PM enabled)",356,348,8
115091,463243,2021-02-15 11:55:34,wahoo,Zwift achter Brevet 3.2W/kg,Favero Assioma Duo (Garmin),"Kickr 2017 (Zwift, PM enabled)",255,247,8
121527,463243,2021-02-27 10:00:14,wahoo,Zwift - Haute Route Watopia 2021 Stage 2 (A),Favero Assioma Duo (Garmin),"Kickr 2017 (Zwift, PM enabled)",353,354,-1
128299,463243,2021-03-14 08:30:19,wahoo,Zwift - Flanders Endurance Race League Giro Di Grinta! (A).  Een doosje lucifers afstrijken. ,Favero Assioma Duo (Garmin),"Kickr 2017 (Zwift, PM disabled)",346,348,-2
73459,463308,2020-11-20 13:30:59,wahoo,Zwift - Race 2 // Men // Z Pro Tri // Community (B),Quarq Powermeter,Wahoo Kickr v5,312,303,9
79738,463308,2020-12-05 09:59:59,wahoo,Zwift - Nations Challenge // Germany (E),Quarq Powermeter,Wahoo Kickr v5,321,324,-3
81109,463308,2020-12-08 18:15:58,wahoo,Zwift - Zwift Racing League | WTRL - Men&#039;s EMEA E1 DIVISION 1 (B),Quarq Powermeter,Wahoo Kickr v5,372,370,2
84983,463308,2020-12-19 10:00:58,wahoo,Zwift - Tour of New York Stage 2 - Open Shorter,Quarq Powermeter,Wahoo Kickr v5,316,321,-5
108809,463308,2021-02-04 17:29:59,wahoo,Zwift - Ryzon Days of Dedication: Stage 1 ,Quarq Powermeter,Wahoo Kickr v5,334,341,-7
113705,463308,2021-02-12 18:31:01,wahoo,Zwift - KIRCHMAIR Race Series (B),Quarq Powermeter,Wahoo Kickr v5,352,343,9
117818,463308,2021-02-19 18:31:00,wahoo,Zwift - KIRCHMAIR Race Series (B),Quarq Powermeter,Wahoo Kickr v5,363,354,9
112438,463598,2021-02-10 18:29:59,wahoo,Zwift - NCF Vintercup 2021 - Runde 5 - Herrer (A),Quarq DFour to Wahoo Elment Bolt,Wahoo Kickr V5 ,367,353,14
116696,463598,2021-02-17 18:29:59,wahoo,Zwift - NCF Vintercup 2021 - Runde 6 - Herrer (A),Quarq DFour to Wahoo Elment Bolt,Wahoo Kickr V5 ,367,366,1
120392,463598,2021-02-24 18:44:58,wahoo,Zwift - Scandinavian Cup 2021 - Round 1 - Men (A),Quarq DFour to Wahoo Elment Bolt,Wahoo Kickr V5 ,379,364,15
126635,463598,2021-03-10 18:44:58,wahoo,Zwift - Scandinavian Cup 2021 - Round 3 - Men (A),Stages to Wahoo Elment Bolt,Wahoo Kickr V5 ,367,360,7
5080,465607,2019-11-28 11:58:52,wahoo,Wahoo kickr 2018 / Garmin V3 - 530,Garmin V3 - 530,Wahoo kickr 2018,282,304,-22
21565,465607,2020-04-02 18:57:58,wahoo,Garmin V3 - 530 / Wahoo kickr 2018,Garmin V3 - 530,Wahoo kickr 2018,349,350,-1
22750,465607,2020-04-06 16:51:32,wahoo,Garmin V3 - 530 / Wahoo kickr 2018,Garmin V3 - 530,Wahoo kickr 2018,325,334,-9
35876,465695,2020-05-18 19:10:15,wahoo,Zwift - Tour for All 2020: Stage 4 Longer Race A/B,Assioma Duo,KICKR Core,381,368,13
37170,465695,2020-05-23 14:30:15,wahoo,Zwift - OCA Indoor Race Series (A),Assioma Duo,KICKR Core,350,328,22
38706,465695,2020-05-30 14:28:51,wahoo,Zwift - OCA Indoor Race Series (A),Assioma Duo,KICKR Core,386,392,-6
39207,465695,2020-06-02 23:29:21,wahoo,Zwift - Midweek Criterium Race (A),Assioma Duo,KICKR Core,357,357,0
40067,465695,2020-06-06 14:28:20,wahoo,Zwift - OCA Indoor Race Series (A),Assioma Duo,KICKR Core,355,340,15
42845,465695,2020-06-20 14:27:08,wahoo,Zwift - OCA Indoor Race Series (EVR) (A),Assioma Duo,KICKR Core,368,371,-3
44623,465695,2020-07-02 22:57:30,wahoo,Zwift - Koa Sports League Warrior Race (A),Assioma Duo,KICKR Core,374,370,4
74339,465695,2020-11-22 17:17:34,wahoo,Zwift - 3R Racing (A),Assioma Duo,KICKR Core,365,370,-5
75721,465695,2020-11-26 01:03:31,wahoo,Zwift - Cycling Canada Wednesday Night Race Series (A),Assioma Duo,KICKR Core,388,378,10
103806,465695,2021-01-27 00:29:27,wahoo,Zwift - Midweek Crit: Around the World (Two Bridges Loop) (A),Assioma Duo,KICKR Core,353,349,4
22322,466870,2020-04-05 16:04:01,wahoo,Zwift - 3R Tick Tock Flat Race - 1 Lap (A) ,Garmin Vector 3 pedals,Wahoo Kickr,341,349,-8
25107,466870,2020-04-16 09:29:50,wahoo,Trofeo Bologna Race (A) top 4....,Garmin Vector 3 pedals,Wahoo Kickr,372,377,-5
25761,466870,2020-04-18 08:29:09,wahoo,Richmond Challenge Race // Zwift Classic (A) DNF,Garmin Vector 3 pedals,Wahoo Kickr,324,303,21
26343,466870,2020-04-19 08:31:40,wahoo,Richmond Challenge Race // Zwift Classic (1 Lap) Winner,Garmin Vector 3 pedals,Wahoo Kickr,344,344,0
29967,466870,2020-04-29 08:03:45,wahoo,Aussie Crit Crushers Race 1 of 2,Garmin Vector 3 pedals,Wahoo Kickr,359,359,0
30441,466870,2020-05-02 10:29:38,wahoo,3R Volcano Climb Race - 1 Lap (A) ,Garmin Vector 3 pedals,Wahoo Kickr,361,360,1
31668,466870,2020-05-05 17:27:57,wahoo,WTRL Sprint Race (A) :(,Garmin Vector 3 pedals,Wahoo Kickr,352,353,-1
32668,466870,2020-05-08 08:09:00,wahoo,Tour for All 2020: Stage 2 - top 15,Garmin Vector 3 pedals,Wahoo Kickr,346,346,0
33824,466870,2020-05-12 08:09:01,wahoo,Tour for All 2020: Stage 3 - NY Reverse KOM Attempt (then died),Garmin Vector 3 - Wahoo Bolt,Wahoo Kickr,367,366,1
35271,466870,2020-05-16 08:08:02,wahoo,Tour for All 2020: Stage 4 Hangover sufferfest,Vector 3 / Wahoo Bolt,Wahoo Kickr / Zwift,335,334,1
37830,466870,2020-05-26 17:29:08,wahoo,WTRL Empowerment Series,Garmin Vector 3 / Wahoo Bolt,Wahoo Kickr / Zwift,364,364,0
42009,466870,2020-06-16 18:59:02,wahoo,KISS at Race,Garmin Vector 3 / Wahoo Bolt,Wahoo Kickr / Zwift,339,339,0
43237,466870,2020-06-23 17:29:13,wahoo,WTRL Empowerment Series- 2nd,Garmin Vector 3 / Wahoo Bolt,Wahoo Kickr / Zwift,363,363,0
45110,466870,2020-07-06 15:14:53,wahoo,3R Volcano Circuit Sprint Flat Race - 2nd,Garmin Vector 3 / Wahoo Bolt,Wahoo Kickr / Zwift,321,321,0
45237,466870,2020-07-02 16:58:47,wahoo,Zwift - Donny Chain Gang ,Garmin Vector 3 / Wahoo Bolt,Wahoo Kickr / Zwift,326,326,0
50421,466870,2020-08-17 17:45:09,wahoo,KATT Race by WKG - Winner,Garmin Vector 3 / Wahoo Bolt,Wahoo Kickr / Zwift,305,305,0
51676,466870,2020-08-25 15:02:42,wahoo,3R Turbocharged Team Race Series - Bonus Round,Garmin Vector 3 / Wahoo Bolt,Wahoo Kickr / Zwift,374,374,0
55133,466870,2020-09-14 17:55:50,wahoo,Zwift - Invitational League // Qualifying Race #1,Garmin Vector 3 / Wahoo Bolt,Wahoo Kickr v5/ Zwift,360,333,27
56113,466870,2020-09-18 10:57:24,wahoo,Zwift -  Stage 1 // Virtual Haute Route Ventoux - 4th,Garmin Vector 3 / Wahoo Bolt,Wahoo Kickr v5/ Zwift,359,358,1
56439,466870,2020-09-20 12:59:04,wahoo,Zwift - Invitational League // Qualifying Race #3 (Men) (A),Garmin Vector 3 / Wahoo Bolt,Wahoo Kickr v5/ Zwift,344,341,3
57016,466870,2020-09-23 16:59:00,wahoo,Zwift - MIDWEEK Autumn Series by SZR - 22nd,Garmin Vector 3 / Wahoo Bolt,Wahoo Kickr v5/ Zwift,362,371,-9
18426,467396,2020-03-17 16:00:00,wahoo,Zwift - Stage 3 - Longer Ride - Tour of Watopia 2020,Power Pedals ,Kickr Core ,301,302,-1
19834,468226,2020-03-26 19:00:35,wahoo,Zwift - 12wk Winter plan (advanced) Week 6 HIIT VO2,Team Zwatt,Wahoo kickr ,293,291,2
20282,468226,2020-03-28 08:59:32,wahoo,Zwift - Matando O Corpo ZESP (A),Team Zwatt,Wahoo kickr ,346,352,-6
20960,468226,2020-03-31 17:14:46,wahoo,Zwift - ZESP Hamsters (A),Team Zwatt,Wahoo kickr,330,328,2
23224,468226,2020-04-09 11:05:05,wahoo,prueba esfuerzo Wahoo Kickr kore. / Team Zwatt,Team Zwatt,Wahoo Kickr kore.,379,368,11
23837,468226,2020-04-11 07:59:58,wahoo,Zwift - Matando O Corpo ZESP (A),Team Zwatt- Zwift,Wahoo Kickr + Garmin 1030,333,330,3
25983,468226,2020-04-18 08:00:00,wahoo,Matando O Corpo ZESP by SARIS,Team Zwatt + Garmin 1030,Wahoo Kickr + Zwift,357,361,-4
27967,468226,2020-04-25 07:59:57,wahoo,Matando O Corpo ZESP by SARIS,Team Zwatt + Garmin 1030,Wahoo Kickr + Zwift,333,333,0
104392,470984,2021-01-28 02:45:56,neo,Flux1 vs Neo1,Flux 1,Neo 1,230,237,-7
51885,473969,2020-08-25 18:40:07,wahoo,Zwift - 3R Turbocharged Team Race Series - Bonus Round (A),Quarq AXS to ZWIFT,KICKR 2020 via Wahoo App,347,330,17
52027,473969,2020-08-26 16:59:52,wahoo,Zwift - MIDWEEK Summer Series by SZR (A),Quarq DUB (Zwift),KICKR V5 2020 (Wahoo App),346,327,19
52507,473969,2020-08-29 14:14:54,wahoo,Zwift - OH MY CRIT - Saturday Smash Race* (A),Quarq DUB (Zwift),KICKR V5 2020 (Wahoo App),327,310,17
53652,473969,2020-09-06 13:14:54,wahoo,Zwift - KISS at Race 100 - Americas (A),Quarq DUB (Zwift),KICKR V5 2020 (Wahoo App),379,370,9
53769,473969,2020-09-07 18:19:52,wahoo,Zwift - TFC Mad Monday Summer Series (10 of 10) (A),Quarq DUB (Zwift),KICKR V5 2020 (Wahoo App),371,351,20
54370,473969,2020-09-10 16:04:55,wahoo,Zwift - OH MY CRIT! - The Double Race 2/2 (A),Quarq DUB (Zwift),KICKR V5 2020 (Wahoo App),339,327,12
54847,473969,2020-09-13 10:09:54,wahoo,Zwift - 3R Sand & Sequoias - 1 Lap (20km/12.5mi 173m) (A),Quarq DUB (Wahoo App),KICKR v5 2020 (Zwift),334,326,8
55071,473969,2020-09-14 17:59:52,wahoo,Zwift - Invitational League // Qualifying Race #1,Quarq DUB (Wahoo App),KICKR v5 2020 (Zwift),380,353,27
55990,473969,2020-09-17 18:29:54,wahoo,Zwift - Invitational League // Qualifying Race #2 (Men) ,Quarq DUB (Wahoo App),KICKR v5 2020 (Zwift),361,348,13
56698,473969,2020-09-21 17:15:03,wahoo,Zwift - DBR Ride´N´Roll League (A),Quarq DUB (Zwift),KICKR V5 2020 (Wahoo App),323,323,0
56699,473969,2020-09-21 18:19:51,wahoo,Zwift - TFC Mad Monday Autumn Series (A),Quarq DUB (Zwift),KICKR V5 2020 (Wahoo App),374,369,5
58509,473969,2020-09-30 16:59:52,wahoo,Zwift - MIDWEEK Autumn Series by SZR (A),Quarq DUB (Zwift),KICKR V5 2020 (Wahoo App),337,314,23
60103,473969,2020-10-07 16:59:54,wahoo,Zwift - MIDWEEK Autumn Series by SZR (A),Quarq DUB (Zwift),KICKR V5 2020 (Wahoo App),358,345,13
60311,473969,2020-10-08 15:14:51,wahoo,Zwift - OH MY CRIT! - The Double Race 1/2 (A),Quarq DUB (Zwift),KICKR V5 2020 (Wahoo App),341,325,16
60313,473969,2020-10-08 16:04:47,wahoo,Zwift - OH MY CRIT! - The Double Race 2/2 (A),Quarq DUB (Zwift),KICKR V5 2020 (Wahoo App),357,341,16
61612,473969,2020-10-13 18:44:53,wahoo,Zwift - Zwift Racing League | WTRL,Quarq DUB (Zwift),KICKR V5 2020 (Wahoo App),358,337,21
61931,473969,2020-10-14 16:59:52,wahoo,Zwift - MIDWEEK Autumn Series by SZR (A),Quarq DUB (Zwift),KICKR V5 2020 (Wahoo App),366,337,29
62123,473969,2020-10-15 16:04:52,wahoo,Zwift - OH MY CRIT! - The Double Race 2/2 (A),Quarq DUB (Zwift),KICKR V5 2020 (Wahoo App),346,329,17
62630,473969,2020-10-17 14:14:55,wahoo,Zwift - OH MY CRIT - Saturday Smash Race (A),Quarq DUB (Zwift),KICKR V5 2020 (Wahoo App),339,326,13
66092,473969,2020-10-29 17:04:52,wahoo,Zwift - OH MY CRIT! - The Double Race 2/2 (A),Quarq AXS (Zwift),KICKR V5 2020 (Wahoo App),342,322,20
66969,473969,2020-11-01 13:14:52,wahoo,Zwift - KISS at Race 100 - Americas (A),Quarq DUB (Zwift),KICKR V5 2020 (Wahoo App),323,317,6
68181,473969,2020-11-05 17:04:55,wahoo,Zwift - OH MY CRIT! - The Double Race 2/2 (A),Quarq DUB (Zwift),KICKR v5 2020 (Zwift),334,325,9
71268,473969,2020-11-14 09:59:48,wahoo,Zwift - Cycling Ireland Zwift League Rd 1 (A),Quarq DUB (Zwift),KICKR V5 2020 (Wahoo App),335,327,8
71679,473969,2020-11-15 14:14:56,wahoo,Zwift - KISS 100 Race Series - Americas (A),Quarq DUB (Zwift),KICKR V5 2020 (Wahoo App),299,277,22
72630,473969,2020-11-18 17:59:53,wahoo,Zwift - MIDWEEK Autumn Series by SZR (A),Quarq DUB (Zwift),KICKR V5 2020 (Wahoo App),361,355,6
73765,473969,2020-11-21 09:59:53,wahoo,Zwift - Cycling Ireland Zwift League Rd 2,Quarq DUB (Zwift),KICKR V5 2020 (Wahoo App),341,327,14
75517,473969,2020-11-25 17:59:53,wahoo,Zwift - MIDWEEK Autumn Series by SZR (A),Quarq DUB (Zwift),KICKR V5 2020 (Wahoo App),347,333,14
76775,473969,2020-11-28 09:59:53,wahoo,Zwift - Cycling Ireland Zwift League Rd 3 (A),Quarq DUB (Zwift),KICKR V5 2020 (Wahoo App),344,337,7
84415,473969,2020-12-17 18:59:34,wahoo,Zwift - Cycling Ireland Zwift Social Ride (D),Quarq DUB (Zwift),KICKR V5 2020 (Wahoo App),163,158,5
84745,473969,2020-12-18 16:43:15,wahoo,Zwift - Watopia,Quarq DUB (Zwift),KICKR V5 2020 (Wahoo App),207,203,4
84803,473969,2020-12-18 17:53:04,wahoo,Zwift - Watopia,Quarq DUB (Zwift),KICKR V5 2020 (Wahoo App),210,206,4
86617,473969,2020-12-23 19:24:50,wahoo,Zwift - Watopia,Quarq DUB (Wahoo App),KICKR v5 2020 (Zwift),205,200,5
86897,473969,2020-12-24 12:24:55,wahoo,Zwift - Watopia,Quarq DUB (ELEMNT ROAM),KICKR v5 2020 (Zwift),381,379,2
86936,473969,2020-12-24 13:34:56,wahoo,Zwift - Crit City Race (A),Quarq DUB (Zwift),KICKR V5 2020 (Wahoo App),356,325,31
88561,473969,2020-12-29 13:12:46,wahoo,ZADA Test - Three Sisters - Watopia,Quarq DUB (ELEMNT ROAM),KICKR v5 2020 (Zwift),376,375,1
89569,473969,2020-12-31 17:04:58,wahoo,Wifi took a day OFF - Zwift - OH MY CRIT! - The Double Race 2/2 (A),Quarq DUB (Zwift),KICKR V5 2020 (Wahoo App),359,355,4
90684,473969,2021-01-03 13:04:28,wahoo,Ventoux Strength efforts,Quarq DUB (ELEMNT ROAM),KICKR v5 2020 (Zwift),321,314,7
91604,473969,2021-01-05 10:59:52,wahoo,Zwift - KISS Race Series - Americas AM (A),Quarq DUB (Zwift),KICKR V5 2020 (Wahoo App),387,384,3
91848,473969,2021-01-05 18:59:31,wahoo,Zwift - SST (Mixed Cadence),Quarq DUB (Zwift),KICKR V5 2020 (Wahoo App),266,266,0
92309,473969,2021-01-06 17:59:51,wahoo,Quarq DUB (Zwift) / KICKR V5 2020 (Wahoo App),Quarq DUB (Zwift),KICKR V5 2020 (Wahoo App),347,325,22
92743,473969,2021-01-07 16:14:47,wahoo,Zwift - OH MY CRIT! - The Double Race 1/2 (A),Quarq DUB (Zwift),KICKR V5 2020 (Wahoo App),358,343,15
92770,473969,2021-01-07 17:05:05,wahoo,Zwift - OH MY CRIT! - The Double Race 2/2 (A),Quarq DUB (Zwift),KICKR V5 2020 (Wahoo App),352,345,7
93036,473969,2021-01-07 19:00:01,wahoo,Zwift - Cycling Ireland Zwift Social Ride (D),Quarq DUB (ELEMNT ROAM),KICKR v5 2020 (Zwift),206,201,5
93702,473969,2021-01-09 09:59:57,wahoo,Zwift - Cycling Ireland Zwift League Rd 7 (A),Quarq DUB (ELEMNT ROAM),KICKR v5 2020 (Zwift),341,330,11
95005,473969,2021-01-11 19:14:54,wahoo,Zwift - Premier Division // Zwift Racing League (men) (A),Quarq DUB (ELEMNT ROAM),KICKR v5 2020 (Zwift),365,354,11
96355,473969,2021-01-13 17:59:54,wahoo,Zwift - MIDWEEK Winter Series by SZR (A),Quarq DUB (Zwift),KICKR V5 2020 (Wahoo App),371,355,16
96867,473969,2021-01-14 16:14:53,wahoo,Zwift - OH MY CRIT! - The Double Race 1/2 (A),Quarq DUB (Zwift),KICKR V5 2020 (Wahoo App),356,347,9
96892,473969,2021-01-14 17:04:54,wahoo,Zwift - OH MY CRIT! - The Double Race 2/2 (A),Quarq DUB (Zwift),KICKR V5 2020 (Wahoo App),348,337,11
97786,473969,2021-01-16 09:59:56,wahoo,Zwift - Cycling Ireland Zwift League Rd 8 (A),Quarq DUB (ELEMNT ROAM),KICKR v5 2020 (Zwift),331,327,4
97858,473969,2021-01-16 11:33:32,wahoo,Zwift - Yorkshire,Quarq DUB (ELEMNT ROAM),KICKR v5 2020 (Zwift),184,185,-1
99170,473969,2021-01-18 19:55:57,wahoo,Zwift - Premier Division // Zwift Racing League (men) (A),Quarq DUB (ELEMNT ROAM),KICKR v5 2020 (Zwift),370,370,0
100325,473969,2021-01-20 18:44:09,wahoo,Zwift - Danmarks Cykle Union & Partners 2/6 (A),Quarq DUB (Zwift),KICKR V5 2020 (Wahoo App),384,384,0
100807,473969,2021-01-21 16:14:52,wahoo,Zwift - OH MY CRIT! - The Double Race 1/2 (A),Quarq DUB (Zwift),KICKR V5 2020 (Wahoo App),364,357,7
100843,473969,2021-01-21 17:04:52,wahoo,Zwift - OH MY CRIT! - The Double Race 2/2 (A),Quarq DUB (Zwift),KICKR V5 2020 (Wahoo App),368,366,2
101919,473969,2021-01-23 15:14:56,wahoo,Zwift - OH MY CRIT!! - Saturday Smash Race (A),Quarq DUB (Zwift),KICKR V5 2020 (Wahoo App),365,365,0
102470,473969,2021-01-24 16:00:12,wahoo,Zwift - TDZ Stage 5: Longer Ride,Quarq DUB (ELEMNT ROAM),KICKR v5 2020 (Zwift),375,380,-5
102902,473969,2021-01-25 19:04:42,wahoo,Zwift - Premier Division // Zwift Racing League (men) (A),Quarq DUB (ELEMNT ROAM),KICKR v5 2020 (Zwift),386,388,-2
104575,473969,2021-01-28 16:14:58,wahoo,Zwift - OH MY CRIT!! - The Double Race 1/2 (A),Quarq DUB (Zwift),KICKR V5 2020 (Wahoo App),367,350,17
104599,473969,2021-01-28 17:04:58,wahoo,Zwift - OH MY CRIT!! - The Double Race 2/2 (A),Quarq DUB (Zwift),KICKR V5 2020 (Wahoo App),353,338,15
104715,473969,2021-01-28 19:00:02,wahoo,Zwift - Cycling Ireland Zwift Social Ride (D),Quarq DUB (Zwift),KICKR V5 2020 (ELEMNT RIVAL WATCH),208,198,10
105671,473969,2021-01-30 15:59:23,wahoo,Zwift - TDZ Stage 6: Longer Ride,Quarq DUB (Zwift),KICKR V5 2020 (ELEMNT RIVAL WATCH),403,391,12
106273,473969,2021-01-31 16:20:00,wahoo,Zwift - Matteo CIGALA&#039;s Meetup - 2019 UCI Worlds Harrogate Circuit,Quarq DUB (ELEMNT ROAM),KICKR v5 2020 (Zwift),292,286,6
106882,473969,2021-02-01 20:06:06,wahoo,Zwift - Premier Division // Zwift Racing League (men) (A),Quarq DUB (ELEMNT ROAM),KICKR v5 2020 (Zwift),378,364,14
108169,473969,2021-02-03 17:59:32,wahoo,Zwift - MIDWEEK Winter Series by SZR (A),Quarq DUB (Zwift),KICKR V5 2020 (ELEMNT RIVAL WATCH),331,328,3
108758,473969,2021-02-04 16:14:40,wahoo,Zwift - OH MY CRIT!! - The Double Race 1/2 (A),Quarq DUB (Zwift),KICKR V5 2020 (ELEMNT RIVAL WATCH),371,357,14
108767,473969,2021-02-04 17:04:52,wahoo,Zwift - OH MY CRIT!! - The Double Race 2/2 (A),Quarq DUB (Zwift),KICKR V5 2020 (ELEMNT RIVAL WATCH),370,359,11
108943,473969,2021-02-04 19:00:02,wahoo,Zwift - Cycling Ireland Zwift Social Ride (D),Quarq DUB (ELEMNT ROAM),KICKR v5 2020 (Zwift),204,203,1
109925,473969,2021-02-06 15:14:46,wahoo,Zwift - OH MY CRIT!! - Saturday Smash Race (A),Quarq DUB (Zwift),KICKR V5 2020 (ELEMNT RIVAL WATCH),395,396,-1
111011,473969,2021-02-08 19:16:59,wahoo,Zwift - Premier Division // Zwift Racing League (men) (A),Quarq DUB (ELEMNT ROAM),KICKR v5 2020 (Zwift),391,373,18
112234,473969,2021-02-10 17:59:39,wahoo,Zwift - MIDWEEK Winter Series by SZR (A),Quarq DUB (Zwift),KICKR V5 2020 (ELEMNT RIVAL WATCH),341,352,-11
112819,473969,2021-02-11 16:14:54,wahoo,Zwift - OH MY CRIT!! - The Double Race 1/2 (A),Quarq DUB (Zwift),KICKR V5 2020 (ELEMNT RIVAL WATCH),328,339,-11
112848,473969,2021-02-11 17:04:52,wahoo,Zwift - OH MY CRIT!! - The Double Race 2/2 (A),Quarq DUB (Zwift),KICKR V5 2020 (ELEMNT RIVAL WATCH),360,355,5
114160,473969,2021-02-13 15:14:48,wahoo,Zwift - OH MY CRIT!! - Saturday Smash Race (A),Quarq DUB (Zwift),KICKR V5 2020 (ELEMNT RIVAL WATCH),410,404,6
114817,473969,2021-02-14 17:22:56,wahoo,Zwift - Watopia,Quarq DUB (ELEMNT ROAM),KICKR v5 2020 (Zwift),283,282,1
115414,473969,2021-02-15 20:00:36,wahoo,Zwift - Premier Division // Zwift Racing League (men) (A),Quarq DUB (ELEMNT ROAM),KICKR v5 2020 (Zwift),402,398,4
117169,473969,2021-02-18 16:14:42,wahoo,Zwift - OH MY CRIT!! - The Double Race 1/2 (A),Quarq DUB (Zwift),KICKR V5 2020 (ELEMNT RIVAL WATCH),361,341,20
117185,473969,2021-02-18 17:04:50,wahoo,Zwift - OH MY CRIT!! - The Double Race 2/2 (A),Quarq DUB (Zwift),KICKR V5 2020 (ELEMNT RIVAL WATCH),362,348,14
118097,473969,2021-02-20 10:09:29,wahoo,Zwift - Cycling Ireland Spring Australian Handicap Race (A),Quarq DUB (Zwift),KICKR V5 2020 (ELEMNT RIVAL WATCH),347,346,1
119081,473969,2021-02-22 19:09:13,wahoo,Zwift - Premier Division // Zwift Racing League (men) (A),Quarq DUB (ELEMNT ROAM),KICKR v5 2020 (Zwift),355,349,6
120254,473969,2021-02-23 18:59:50,wahoo,Zwift - 30/30s VO2Max,Quarq DUB (ELEMNT ROAM),KICKR v5 2020 (Zwift),257,249,8
120255,473969,2021-02-24 17:59:24,wahoo,Zwift - MIDWEEK Winter Series by SZR (A),Quarq DUB (Zwift),KICKR V5 2020 (ELEMNT RIVAL WATCH),354,352,2
120704,473969,2021-02-25 17:04:18,wahoo,Zwift - OH MY CRIT!! - The Double Race 2/2 (A),Quarq DUB (Zwift),KICKR V5 2020 (ELEMNT RIVAL WATCH),360,359,1
126531,473969,2021-03-10 17:59:45,wahoo,Zwift - MIDWEEK Crit Race Series by SZR (A),Quarq DUB (Zwift),KICKR V5 2020 (ELEMNT RIVAL WATCH),334,327,7
127010,473969,2021-03-11 17:04:49,wahoo,Zwift - OH MY CRIT!! - The Double Race 2/2 (A),Quarq DUB (Zwift),KICKR V5 2020 (ELEMNT RIVAL WATCH),354,341,13
127966,473969,2021-03-13 15:14:22,wahoo,Zwift - OH MY CRIT!! - Saturday Smash Race (A),Quarq DUB (Zwift),KICKR V5 2020 (ELEMNT RIVAL WATCH),423,417,6
22053,478249,2020-04-02 19:22:40,wahoo,Zwift - Leith Hill venganza,Assioma,Kickr Core,387,395,-8
22179,478249,2020-04-04 17:59:33,wahoo,Zwift -  Haute Route Watopia Stage 2 (E),Assioma,Kickr Core,346,358,-12
22354,478249,2020-04-05 16:04:37,wahoo,Zwift -  Haute Route Watopia Stage 3,Assioma,Kickr Core,336,329,7
23318,478249,2020-04-09 10:59:34,wahoo,Zwift - Team ODZ Thursday Morning Throwdown (E),Assioma Uno,Kickr Core,353,363,-10
101862,478249,2021-01-23 14:01:58,wahoo,Zwift - TDZ Stage 4: Standard Ride,Assioma Uno,Kickr Core,325,345,-20
50020,478303,2020-08-14 09:44:05,wahoo,Zwift - Off the MAAP Invitational Race // Stage 1 (Women) (A),vector3,Kickr,275,266,9
50902,478303,2020-08-20 09:29:48,wahoo,Zwift - Off the MAAP Invitational Race // Stage 3 (women) ,vector3,Kickr,279,279,0
76333,478303,2020-11-26 19:17:40,wahoo,Zwift - WTRL NOPINZ WORLD TTT CHAMPIONSHIPS - Zone 9 (E),vector3,Kickr,265,281,-16
4165,478707,2019-11-13 00:29:09,wahoo,Zwift - Midweek Criterium Race (A),Quarq DZero (Zwift),Wahoo kickr (phone),350,355,-5
5425,478707,2019-12-04 00:57:54,wahoo,Zwift - KISS at Race - Americas PM (A),Quarq DZero (Zwift),Wahoo kickr (phone),327,319,8
5776,478707,2019-12-08 14:13:05,wahoo,Zwift - KISS at Race 100 - Americas (A),Quarq DZero (Zwift),Wahoo kickr (phone),340,338,2
6362,478707,2019-12-15 14:09:29,wahoo,Zwift - KISS at Race 100 - Americas (A),Quarq DZero (Zwift),Wahoo kickr (phone),325,319,6
6946,478707,2019-12-21 15:10:49,wahoo,Zwift - OH CRIT!! - Saturday Smash Series (A),Quarq DZero (Zwift),Wahoo Kickr (Zwift),316,319,-3
7049,478707,2019-12-22 14:11:41,wahoo,Zwift - KISS at Race 100 - Americas (A),Quarq DZero (Zwift),Wahoo kickr (phone),321,321,0
7361,478707,2019-12-26 18:54:14,wahoo,Zwift - Team Italy Superveloce Race (A),Quarq DZero (Zwift),Wahoo kickr (phone),325,319,6
7501,478707,2019-12-28 18:03:42,wahoo,Zwift - 3R Three Sisters Hilly Race (47km/29.2mi 879m) (A),Quarq DZero (Zwift),Wahoo kickr (phone),333,332,1
7571,478707,2019-12-29 14:14:20,wahoo,Zwift - KISS at Race 100 - Americas (A),Quarq DZero (Zwift),Wahoo kickr (phone),331,332,-1
7816,478707,2020-01-01 14:27:21,wahoo,Zwift - Imperial Century ,Quarq DZero (Zwift),Wahoo kickr (phone),323,312,11
8098,478707,2020-01-04 18:00:22,wahoo,Zwift - The Vegan Cyclist 100 + 1 Ride (C),Quarq DZero (Zwift),Wahoo kickr (phone),331,312,19
8524,478707,2020-01-09 02:28:51,wahoo,Zwift - SweatFest West Winter Race Series (A),Quarq DZero (Zwift),Wahoo kickr (phone),319,311,8
9020,478707,2020-01-12 14:11:01,wahoo,Zwift - KISS at Race 100 - Americas (A),Quarq Dzero (Phone),Wahoo Kickr (Zwift),320,316,4
9411,478707,2020-01-15 00:58:28,wahoo,Zwift - KISS at Race - Americas PM (A),Quarq DZero (Zwift),Wahoo kickr (phone),331,313,18
9952,478707,2020-01-18 19:58:22,wahoo,Zwift - Tour de Zwift: Stage 2 Long Distance,Quarq DZero (Zwift),Wahoo kickr (phone),324,307,17
10013,478707,2020-01-19 14:13:25,wahoo,Zwift - KISS at Race 100 - Americas (A),Quarq DZero (Zwift),Wahoo kickr (phone),319,299,20
10154,478707,2020-01-20 16:59:15,wahoo,Zwift - Tour de Zwift: Stage 3 Group Ride - Long Distance,Quarq DZero (Zwift),Wahoo kickr (phone),315,315,0
10704,478707,2020-01-24 00:38:32,wahoo,Zwift - ZHR Hare & Hounds Race (A),Quarq DZero (Zwift),Wahoo kickr (phone),308,306,2
11437,478707,2020-01-29 02:07:07,wahoo,Zwift - Tour de Zwift: Stage 5 Race (A),Quarq DZero (Zwift),Wahoo kickr (phone),319,322,-3
12013,478707,2020-02-01 14:58:31,wahoo,Zwift - Tour de Zwift: Stage 6 Group Ride - Long Distance,Quarq DZero (Zwift),Wahoo kickr (phone),325,315,10
13187,478707,2020-02-09 00:56:58,wahoo,Zwift - Tour de Zwift: Stage 7 - Long Distance,Quarq DZero (Zwift),Wahoo kickr (phone),314,314,0
13339,478707,2020-02-09 17:00:15,wahoo,Zwift - Tour de Zwift: Stage 1 Race (A),Quarq DZero (Zwift),Wahoo kickr (phone),335,333,2
61661,478707,2020-10-12 23:00:02,wahoo,Zwift - Giant Monday Motivation Ride Series  (D),Quarq Dzero (Phone),Wahoo Kickr (Zwift),298,299,-1
67084,478707,2020-11-01 21:05:13,wahoo,Zwift - 3R Gotham Grind Flat Race - 3 Laps (27.8km/17.4mi 87m) (B),Quarq Dzero (Phone),Wahoo Kickr (Zwift),285,293,-8
107347,480996,2021-02-02 18:15:57,neo,Zwift - Zwift Racing League | WTRL - Men&#039;s/Mixed EMEA E1 DIVISION 1 (B),Favero Assioma Duo dual recording,Tacx Neo to Zwift,368,365,3
55250,481674,2020-09-15 00:45:59,wahoo,Zwift - Crit City Race (B),Assioma duo to wahoo app-iphone,Kickr Core,315,310,5
56912,481674,2020-09-22 23:31:57,wahoo,Zwift - Midweek Criterium Race (B),Assioma duo to wahoo app-iphone,Kickr Core-Zwift,313,310,3
88028,481674,2020-12-28 00:34:27,wahoo,Zwift - Toronto Hustle Holiday Classic Stage  Race: Stage One,Assioma duo to wahoo app-iphone,kickr og,301,307,-6
95977,481674,2021-01-13 00:48:51,wahoo,Zwift - Zwift Racing League | WTRL - Men&#039;s/Mixed AMERICAS E DIVISION 3 (B),Assioma duo to wahoo app-iphone,kickr og,334,318,16
120989,481674,2021-02-26 00:21:43,wahoo,Zwift - Zwift Academy 2016 Month 2 Session 10: Extended Zone 3,Assioma duo to wahoo app-iphone,kickr og,209,208,1
129051,481674,2021-03-16 14:31:01,wahoo,Zwift - DBR Tuesday Race (B),Assioma duo to wahoo app-iphone,kickr og,338,334,4
97344,482685,2021-01-11 17:44:57,wahoo,Zwift - SCF SWE Cup (A),Stages Gen 2 (left) Ultegra 6800,Kickr Core,376,364,12
110956,482685,2021-02-08 17:30:23,wahoo,Zwift -  SCF SWE Cup Men (A),Stages Gen 2 (left) Ultegra 6800 (2nd),Kickr Core,371,383,-12
115236,482685,2021-02-15 18:59:55,wahoo,Zwift -  SCF SWE Cup Men (A),Stages Gen 2 (left) Ultegra 6800 (2nd),Kickr Core,396,401,-5
122511,482685,2021-03-01 18:59:55,wahoo,Zwift -  SCF SWE Cup Men (A),Stages Gen 2 (left) Ultegra 6800 (2nd),Kickr Core,387,387,0
128779,482685,2021-03-15 18:59:51,wahoo,Zwift -  SCF SWE Cup Men (A),Stages Gen 2 (left) Ultegra 6800 (2nd),Kickr Core,387,385,2
25979,482869,2020-03-27 12:09:59,wahoo,Zwift - Stage 5 Race (A) - Tour of Watopia 2020,Garmin Vector 3,Wahoo Kickr 2017,353,361,-8
26327,482869,2020-03-28 12:00:18,wahoo,Zwift - Stage 5 - Longer Ride - Tour of Watopia 2020,Garmin Vector 3,Wahoo Kickr 2017,356,370,-14
26328,482869,2020-03-26 02:41:57,wahoo,Zwift - ZHR Hare & Hounds Race (A),Garmin Vector 3,Wahoo Kickr 2017,351,360,-9
48293,482869,2020-07-30 12:04:56,wahoo,Zwift - 3R Volcano Circuit Flat Race - 8 Laps (35.2km/21.9mi 160m) (A),Garmin Vector 3,Wahoo Kickr 2017,342,356,-14
51254,482869,2020-08-22 14:14:46,wahoo,Zwift - OH MY CRIT - Saturday Smash Race* (A),Garmin Vector 3,Wahoo Kickr 2017,350,367,-17
55061,482869,2020-09-14 17:56:42,wahoo,Zwift - Invitational League // Qualifying Race #1,Garmin Vector 3,Wahoo Kickr 2017,377,381,-4
61063,482869,2020-10-11 14:10:10,wahoo,Zwift - ZA Road Race #1: 4 - 5 w/kg,Garmin Vector 3,Wahoo Kickr 2017,369,384,-15
61257,482869,2020-10-12 18:49:56,wahoo,Zwift - Premier Division // Zwift Racing League (men) ,Garmin Vector 3,Wahoo Kickr 2017,391,401,-10
67090,482869,2020-11-01 20:32:01,wahoo,Zwift,Garmin Vector 3,Wahoo Kickr 2017,372,374,-2
67538,482869,2020-11-03 13:13:16,wahoo,3R Figure 8 Hilly Race,Garmin Vector 3,Wahoo Kickr 2017,380,384,-4
109531,482869,2021-02-05 20:47:52,wahoo,Zwift - TDZ Stage 7: Longer Ride,4iiii Precision Dual,Wahoo Kickr V5,351,369,-18
109955,482869,2021-02-06 15:09:30,wahoo,Zwift - OH MY CRIT!! - Saturday Smash Race (A),4iiii Precision Dual,Wahoo Kickr V5,413,424,-11
112500,482869,2021-02-10 20:23:30,wahoo,Zwift - Tri Aus TT (E),Garmin Vector 3,Wahoo Kickr V5,383,377,6
112852,482869,2021-02-11 16:14:15,wahoo,Zwift - OH MY CRIT!! - The Double Race 1/2 (A),Garmin Vector 3,Wahoo Kickr V5,368,363,5
112855,482869,2021-02-11 16:14:15,wahoo,Zwift - OH MY CRIT!! - The Double Race 2/2 (A),Garmin Vector 3,Wahoo Kickr V5,370,369,1
113543,482869,2021-02-12 17:51:48,wahoo,Zwift - KIRCHMAIR Race Series (A),Garmin Vector 3,Wahoo Kickr V5,391,383,8
113544,482869,2021-02-12 17:51:48,wahoo,Zwift - KIRCHMAIR Race Series (A),Garmin Vector 3,Wahoo Kickr V5,400,392,8
121286,482869,2021-02-26 12:57:39,wahoo,Zwift - Haute Route Watopia 2021 Stage 1 (A),4iiii Precision Dual,Wahoo Kickr V5,359,369,-10
123985,482869,2021-03-04 16:00:57,wahoo,Zwift - OH MY CRIT!! - The Double Race 2/2 (A),4iiii Precision Dual,Wahoo Kickr V5,394,403,-9
128000,482869,2021-03-13 15:12:00,wahoo,Zwift - OH MY CRIT!! - Saturday Smash Race (A),4iiii Precision Dual,Wahoo Kickr V5,377,388,-11
6046,482899,2019-12-11 19:05:02,wahoo,Zwift - DBR HEINO CUP (A),quarq ,Wahoo Kickr 2018,394,390,4
9587,482899,2020-01-15 19:15:03,wahoo,Kickr18 Primary Source Zwift - Tour de Zwift // Pro-Am Invitational (A),quarq ,Wahoo Kickr 2018,426,419,7
10184,482899,2020-01-20 19:40:01,wahoo,Zwift - Tour de Zwift: Stage 3 Race (A),Infocrank,Wahoo Kickr 2018,444,467,-23
10670,482899,2020-01-23 19:15:00,wahoo,Zwift - Tour de Zwift // Pro-Am Invitational,Infocrank secondary,Wahoo kickr 18 primary ,401,393,8
11897,482899,2020-01-31 19:15:21,wahoo,Zwift - Tour de Zwift // Pro-Am Invitational (A),Infocrank secondary,Wahoo kickr 18 primary ,391,420,-29
13087,482899,2020-02-04 19:59:58,wahoo,KISS at Race - EU PM (A) 1st,Infocrank secondary,Wahoo kickr 18 primary ,319,339,-20
14764,482899,2020-02-19 16:29:59,wahoo,Sydkysten Cycling - Carl Ras Race (A) 2nd,Infocrank secondary,Wahoo kickr 18 primary ,364,381,-17
15310,482899,2020-02-23 12:49:57,wahoo,Rats,Infocrank secondary,Wahoo kickr 18 primary ,347,349,-2
15882,482899,2020-02-27 19:00:02,wahoo,KALAS Cup - Round 5,Infocrank secondary,Wahoo kickr 18 primary ,409,404,5
16822,482899,2020-03-04 19:30:00,wahoo,Zwift - Zwift Beta Race (A),Infocrank secondary,Wahoo kickr 18 primary ,403,404,-1
16939,482899,2020-03-05 19:00:00,wahoo,Zwift - KALAS Cup - Round 6 (A),Infocrank,kickr 18 primary ,400,405,-5
18729,482899,2020-03-19 19:00:01,wahoo,Zwift - KALAS Cup - Round 8 (A),Infocrank secondary,kickr 18 primary ,378,402,-24
19423,482899,2020-03-24 19:14:59,wahoo,Zwift - Tour of Watopia Pro-Am Men&#039;s Race #3 (A),Infocrank secondary,kickr 18 primary ,381,377,4
19969,482899,2020-03-27 17:00:00,wahoo,Zwift -  KALAS Indoor EFCT race series #iTT (A),Infocrank secondary,Wahoo kickr 18 primary ,395,374,21
20070,482899,2020-03-28 08:59:58,wahoo,Zwift -  KALAS Indoor EFCT race series #Crit (A),Infocrank secondary,kickr 18 primary ,387,371,16
40148,482899,2020-06-07 10:10:00,wahoo,Zwift - 3R Sand & Sequoias - 1 Lap (20km/12.5mi 173m) (A),Infocrank secondary,kickr 18 primary ,359,356,3
40536,482899,2020-06-09 17:30:00,wahoo,Zwift - UKAF Cycling Community Race Night,Infocrank secondary,kickr 18 primary ,363,362,1
49098,482899,2020-08-06 09:16:59,wahoo,Zwift - The Lamb Chop p/b Black Sheep (A) 8th,Infocrank,Wahoo Kickr 2018,413,382,31
50707,482899,2020-08-19 13:35:00,wahoo,Zwift - Crit City Race (A),Infocrank secondary,kickr 18 primary ,349,344,5
51060,482899,2020-08-21 09:35:00,wahoo,Zwift - TBR Burrito Race (A),Infocrank,Wahoo Kickr 2018,357,345,12
51461,482899,2020-08-24 09:35:00,wahoo,Off the MAAP Invitational Race // Stage 4 (men),Infocrank secondary,kickr 18 primary ,395,394,1
52943,482899,2020-09-01 17:59:54,wahoo,Zwift - RHYS HOWELL [CANYON]&#039;s Meetup - Astoria Line 8,Infocrank,Wahoo Kickr 2018,389,385,4
55060,482899,2020-09-14 17:59:58,wahoo,Zwift - Invitational League // Qualifying Race #1,Infocrank secondary,Wahoo kickr 18 primary ,405,394,11
55850,482899,2020-09-17 18:29:59,wahoo,Zwift - Invitational League // Qualifying Race #2 (Men) ,Infocrank secondary,Wahoo kickr 18 primary ,386,373,13
61241,482899,2020-10-12 19:00:00,wahoo,Zwift - EVR Europe Race (A),Infocrank secondary,Wahoo kickr 18 primary ,323,318,5
61764,482899,2020-10-14 09:04:59,wahoo,Zwift - 3R Watopia Flat Route Race - 3 Laps (30.3km/18.8mi 162m) (A) rat,Infocrank secondary,Wahoo kickr 18 primary ,364,356,8
62815,482899,2020-10-18 07:06:53,wahoo,3 sisters zada test,Infocrank secondary,Wahoo kickr 18 primary ,388,384,4
63022,482899,2020-10-19 15:44:59,wahoo,Zwift - FZR Segment Killer Race (A),Infocrank secondary,kickr 18 primary ,356,351,5
64435,482899,2020-10-23 18:35:01,wahoo,Zwift - Newbury Velo Crit (A),Infocrank secondary,kickr 18 primary ,333,330,3
65219,482899,2020-10-26 19:59:59,wahoo,Premier Division // Zwift Racing League (men),Infocrank,Wahoo Kickr 2018,376,365,11
67533,482899,2020-11-03 13:14:59,wahoo,Zwift - 3R Figure 8 Hilly Reverse Race - 1 Lap (29.2km/18.1mi 234m ) (A),Infocrank,Wahoo Kickr 2018,366,358,8
72511,482899,2020-11-18 10:45:00,wahoo,Zwift - USA Cycling Race League by Indoor Specialist (A),Infocrank,Wahoo Kickr 2018,401,386,15
73421,482899,2020-11-20 11:19:59,wahoo,Zwift - 3R LaGuardia Loop Reverse Flat Race - 8 Laps (24.5km/15.2mi 216m) (A),Infocrank,Wahoo Kickr 2018,376,360,16
74440,482899,2020-11-23 08:04:59,wahoo,Zwift - 3R Sand & Sequoias - 1 Lap (20km/12.5mi 173m) (A),Infocrank,Wahoo Kickr 2018,338,331,7
77502,482899,2020-11-30 07:04:59,wahoo,Zwift - 3R Watopia Flat Route Race - 3 Laps (30.3km/18.8mi 162m) (A),Infocrank,Wahoo Kickr 2018,362,344,18
77916,482899,2020-12-01 11:19:59,wahoo,Zwift - British Cycling Race Series (A),Infocrank,Wahoo Kickr 2018,343,325,18
78945,482899,2020-12-03 17:55:00,wahoo,Zwift - Team Italy Superveloce Race (A),Infocrank,Wahoo Kickr 2018,371,369,2
82825,482899,2020-12-13 15:24:59,wahoo,Zwift - 3R Watopia 65km Race - 6 laps (40mi 324m) (A),Infocrank,Wahoo Kickr 2018,331,324,7
84351,482899,2020-12-17 16:15:01,wahoo,Zwift - OH MY CRIT! - The Double Race 1/2 (A),Infocrank,Wahoo Kickr 2018,413,410,3
84354,482899,2020-12-17 17:04:59,wahoo,Zwift - OH MY CRIT! - The Double Race 2/2 (A),Infocrank,Wahoo Kickr 2018,404,401,3
88481,482899,2020-12-29 11:00:00,wahoo,Zwift - KISS Race Series - Americas AM (A),quarq ,Wahoo Kickr 2018,361,369,-8
89651,482899,2020-12-31 16:14:58,wahoo,Zwift - OH MY CRIT! - The Double Race 1/2 (A),quarq ,Wahoo Kickr 2018,353,369,-16
89652,482899,2020-12-31 17:05:00,wahoo,Zwift - OH MY CRIT! - The Double Race 2/2 (A),quarq ,Wahoo Kickr 2018,378,393,-15
129246,483111,2021-03-16 18:30:15,wahoo,Zwift - CeramicSpeed Race Series: Open Race (A),Assioma Favero Duo,Wahoo Kickr,407,420,-13
20438,483647,2020-03-29 12:11:17,wahoo,Zwift - KISS at Race 100 - Americas (A),Favero Assioma Duo (Garmin Edge 530),Wahoo Kickr 2017 (Zwift),359,354,5
55757,483647,2020-09-17 15:15:05,wahoo,Zwift - OH MY CRIT! - The Double Race 1/2 (A),Favero Assioma Duo (Garmin Edge 530),Wahoo KICKR Core ,361,360,1
55760,483647,2020-09-17 16:05:04,wahoo,Zwift - OH MY CRIT! - The Double Race 2/2 (A),Favero Assioma Duo (Garmin Edge 530),Wahoo KICKR Core ,360,358,2
35589,484241,2020-05-02 07:34:00,neo,Zwift - e-liga FINALE - eCycling Austria (C),Assioma,Taxc Neo,369,370,-1
40909,485822,2020-06-11 00:45:12,wahoo,Zwift - USA Cycling Race League by Indoor Specialist (A),SRAM Force AXS Quarq ,2019 Wahoo Kickr Power,450,443,7
50793,485822,2020-08-19 23:30:11,wahoo,Zwift - Austin Driveway Series Criterium (A),SRAM Force AXS Quarq to Wahoo ,2019 Wahoo Kickr Power to Zwift,413,403,10
51387,485822,2020-08-23 13:15:12,wahoo,Zwift - KISS at Race 100 - Americas (A),SRAM Force AXS Quarq to Wahoo ,2019 Wahoo Kickr Power to Zwift,334,328,6
52083,485822,2020-08-26 23:30:26,wahoo,Zwift - Austin Driveway Series Criterium (A),SRAM Force AXS Quarq to Wahoo ,2019 Wahoo Kickr Power to Zwift,387,380,7
53158,485822,2020-09-02 23:30:13,wahoo,Zwift - Austin Driveway Series Criterium (A),SRAM Force AXS Quarq to Wahoo ,2019 Wahoo Kickr Power to Zwift,402,392,10
53159,485822,2020-09-03 00:40:16,wahoo,Zwift - 3R Volcano Circuit Flat Race - 4 Laps (18.9km/11.7mi 80m) (A),SRAM Force AXS Quarq to Wahoo ,2019 Wahoo Kickr Power to Zwift,395,384,11
53215,485822,2020-09-03 15:15:13,wahoo,Zwift - OH MY CRIT! - The Double Race 1/2 (A),SRAM Force AXS Quarq to Wahoo ,2019 Wahoo Kickr Power to Zwift,389,385,4
53324,485822,2020-09-03 23:00:13,wahoo,Zwift - Koa Sports League Warrior Race (A),SRAM Force AXS Quarq to Wahoo ,2019 Wahoo Kickr Power to Zwift,352,342,10
54255,485822,2020-09-09 23:30:12,wahoo,Austin Driveway Series Criterium :: Finesse Wahoo DUB + SOME (5 in top 7),SRAM Force AXS Quarq to Wahoo ,2019 Wahoo Kickr Power to Zwift,349,339,10
54256,485822,2020-09-10 00:45:23,wahoo,Zwift - USA Cycling Race League by Indoor Specialist (A),SRAM Force AXS Quarq to Wahoo ,2019 Wahoo Kickr Power to Zwift,396,384,12
54882,485822,2020-09-13 13:15:13,wahoo,Zwift - KISS at Race 100 - Americas (A),SRAM Force AXS Quarq to Wahoo ,2019 Wahoo Kickr Power to Zwift,422,411,11
57131,485822,2020-09-23 23:30:13,wahoo,Zwift - Austin Driveway Series Criterium (A),SRAM Force AXS Quarq to Wahoo ,2019 Wahoo Kickr Power to Zwift,384,370,14
58655,485822,2020-09-30 23:30:16,wahoo,Zwift - Austin Driveway Series Criterium (A),SRAM Force AXS Quarq to Wahoo ,2019 Wahoo Kickr Power to Zwift,377,364,13
61677,485822,2020-10-13 23:45:15,wahoo,Zwift - Zwift Racing League | WTRL (A),SRAM Force AXS Quarq to Wahoo ,2019 Wahoo Kickr Power to Zwift,437,421,16
61701,485822,2020-10-14 02:00:19,wahoo,Zwift - Zwift Racing League | WTRL,SRAM Force AXS Quarq to Wahoo ,2019 Wahoo Kickr Power to Zwift,377,374,3
63993,485822,2020-10-21 23:30:17,wahoo,Zwift - Austin Driveway Series Criterium (A),SRAM Force AXS Quarq to Wahoo ,2019 Wahoo Kickr Power to Zwift,392,379,13
65616,485822,2020-10-27 23:45:17,wahoo,Zwift - Zwift Racing League | WTRL - AMERICAS E (MEN) -  Division 1 (A),SRAM Force AXS Quarq to Wahoo ,2019 Wahoo Kickr Power to Zwift,415,403,12
67851,485822,2020-11-04 01:05:19,wahoo,Zwift - Zwift Racing League | WTRL - Men&#039;s AMERICAS E DIVISION 1 (A),SRAM Force AXS Quarq to Wahoo ,2019 Wahoo Kickr Power to Zwift,395,383,12
70017,485822,2020-11-11 00:45:11,wahoo,Zwift - Zwift Racing League | WTRL - AMERICAS E (MEN) -  Division 1 (A),SRAM Force AXS Quarq to Wahoo ,2019 Wahoo Kickr Power to Zwift,450,432,18
70919,485822,2020-11-12 23:15:22,wahoo,Zwift - Koa Sports League Warrior Race (A),SRAM Force AXS Quarq to Wahoo ,2019 Wahoo Kickr Power to Zwift,344,334,10
72787,485822,2020-11-19 01:05:12,wahoo,Zwift - Cycling Canada Wednesday Night Race Series (A),SRAM Force AXS Quarq to Wahoo ,2019 Wahoo Kickr Power to Zwift,413,403,10
75286,485822,2020-11-25 00:45:23,wahoo,Zwift - Zwift Racing League | WTRL - Men&#039;s AMERICAS E DIVISION 1,SRAM Force AXS Quarq to Wahoo ,2019 Wahoo Kickr Power to Zwift,419,409,10
75708,485822,2020-11-26 00:30:13,wahoo,Zwift - Austin Driveway Series Criterium (A),SRAM Force AXS Quarq to Wahoo ,2019 Wahoo Kickr Power to Zwift,354,337,17
76472,485822,2020-11-27 13:50:13,wahoo,Zwift - KISS Race Series - Pacific AM (A),SRAM Force AXS Quarq to Wahoo ,2019 Wahoo Kickr Power to Zwift,395,385,10
78309,485822,2020-12-02 00:55:10,wahoo,Zwift - Zwift Racing League | WTRL - Men&#039;s AMERICAS E DIVISION 1 (A),SRAM Force AXS Quarq to Wahoo ,2019 Wahoo Kickr Power to Zwift,395,387,8
78723,485822,2020-12-02 23:30:13,wahoo,Zwift - ZHQ FutureWorks Circuit Race - Anti-sandbagging (A),SRAM Force AXS Quarq to Wahoo ,2019 Wahoo Kickr Power to Zwift,358,344,14
78752,485822,2020-12-03 01:45:19,wahoo,Zwift - USA Cycling Race League by Indoor Specialist (A),SRAM Force AXS Quarq to Wahoo ,2019 Wahoo Kickr Power to Zwift,391,378,13
81051,485822,2020-12-09 00:45:20,wahoo,Zwift - Zwift Racing League | WTRL - Men&#039;s AMERICAS E DIVISION 1 (A),SRAM Force AXS Quarq to Wahoo ,2019 Wahoo Kickr Power to Zwift,423,412,11
85105,485822,2020-12-19 15:15:24,wahoo,Zwift - OH MY CRIT - Saturday Smash Race (A),SRAM Force AXS Quarq to Wahoo ,2019 Wahoo Kickr Power to Zwift,434,423,11
85405,485822,2020-12-20 13:00:14,wahoo,Zwift - Tour of New York Stage 3 - Open Longer,SRAM Force AXS Quarq to Wahoo ,2019 Wahoo Kickr Power to Zwift,364,354,10
86318,485822,2020-12-23 00:30:16,wahoo,Zwift - Midweek Criterium Race (A),SRAM Force AXS Quarq to Wahoo ,2019 Wahoo Kickr Power to Zwift,369,358,11
86732,485822,2020-12-24 01:05:13,wahoo,Zwift - Cycling Canada Wednesday Night Race Series (A),SRAM Force AXS Quarq to Wahoo ,2019 Wahoo Kickr Power to Zwift,445,434,11
87578,485822,2020-12-26 18:28:52,wahoo,Kickr V5 Testing ,SRAM Force AXS Quarq to Wahoo ,Wahoo Kickr V5 to Zwift,260,250,10
87958,485822,2020-12-27 18:00:02,wahoo,ZADA Three Sisters Test,SRAM Force AXS Quarq to Wahoo ,Wahoo Kickr V5 to Zwift,446,434,12
88535,485822,2020-12-29 12:00:02,wahoo,Z2 V5 Testing ,SRAM Force AXS Quarq to Wahoo ,Wahoo Kickr V5 to Zwift,309,306,3
89238,485822,2020-12-30 23:20:02,wahoo,The Rocket Ride ,SRAM Force AXS Quarq to Wahoo ,Wahoo Kickr V5 to Zwift,368,363,5
89517,485822,2020-12-31 16:15:21,wahoo,Zwift - OH MY CRIT! - The Double Race 1/2 (A),SRAM Force AXS Quarq to Wahoo ,Wahoo Kickr V5 to Zwift,397,386,11
89541,485822,2020-12-31 17:05:17,wahoo,Zwift - OH MY CRIT! - The Double Race 2/2 (A),SRAM Force AXS Quarq to Wahoo ,Wahoo Kickr V5 to Zwift,404,389,15
89576,485822,2020-12-31 17:55:13,wahoo,Zwift - Team Italy Superveloce Race (A),SRAM Force AXS Quarq to Wahoo ,Wahoo Kickr V5 to Zwift,354,340,14
89848,485822,2021-01-01 13:10:18,wahoo,Zwift - BMTR New Year&#039;s Day 100 - Riding For Alzheimer&#039;s (A),SRAM Force AXS Quarq to Wahoo ,Wahoo Kickr V5 to Zwift,307,303,4
90298,485822,2021-01-02 16:30:00,wahoo,Zwift - TEAM VEGAN Tofu Tornado (A),SRAM Force AXS Quarq to Wahoo ,Wahoo Kickr V5 to Zwift,412,404,8
90778,485822,2021-01-03 14:01:20,wahoo,Zwift - Zwift Fondo Series 2020/21 (B),SRAM Force AXS Quarq to Wahoo ,Wahoo Kickr V5 to Zwift,407,398,9
92639,485822,2021-01-07 00:40:16,wahoo,Zwift - 3R Volcano Circuit Flat Race - 4 Laps (18.9km/11.7mi 80m) (A),SRAM Quarq AXS to Wahoo,Wahoo Kickr V5 to Zwift ,372,362,10
93093,485822,2021-01-07 22:15:12,wahoo,Zwift - 3R Alpe Du Zwift KOM Race (20km 1444m) (A),SRAM Quarq AXS to Wahoo,Wahoo Kickr V5 to Zwift ,423,410,13
93987,485822,2021-01-09 16:30:27,wahoo,Zwift - TEAM VEGAN Tofu Tornado (A),SRAM Quarq AXS to Wahoo,Wahoo Kickr V5 to Zwift ,393,386,7
95032,485822,2021-01-11 19:14:56,wahoo,Zwift - Premier Division // Zwift Racing League (men) (A),SRAM Quarq AXS to Wahoo,Wahoo Kickr V5 to Zwift ,425,395,30
97250,485822,2021-01-15 01:00:22,wahoo,Zwift - KISS Race Series - Americas PM (A),SRAM Quarq AXS to Wahoo,Wahoo Kickr V5 to Zwift ,383,368,15
99247,485822,2021-01-18 19:52:20,wahoo,Zwift - Premier Division // Zwift Racing League (men) (A),SRAM Quarq AXS to Wahoo,Wahoo Kickr V5 to Zwift ,416,403,13
100572,485822,2021-01-21 01:05:14,wahoo,Zwift - Cycling Canada Wednesday Night Race Series (A),SRAM Quarq AXS to Wahoo,Wahoo Kickr V5 to Zwift ,414,403,11
101165,485822,2021-01-21 23:00:02,wahoo,Zwift - Alex TenElshof &#039;s Meetup - Ven-Top,SRAM Quarq AXS to Wahoo,Wahoo Kickr V5 to Zwift ,301,285,16
8859,486826,2020-01-11 15:14:59,wahoo,Zwift - OH CRIT!! - Saturday Smash Series (A),Garmin Vector3,kickr,355,353,2
9516,486826,2020-01-15 19:14:49,wahoo,Zwift - Tour de Zwift // Pro-Am Invitational (A),Garmin Vector3,kickr,365,365,0
9947,486826,2020-01-18 15:14:57,wahoo,Zwift - OH CRIT!! - Saturday Smash Series (A),Garmin Vector3,kickr,338,339,-1
10369,486826,2020-01-21 22:04:57,wahoo,Zwift - 3R Classique Flat Race - 5 Laps (32.3km/20.1mi 95m) (A),Garmin Vector3,kickr,319,319,0
10905,486826,2020-01-25 15:14:53,wahoo,Zwift - OH CRIT!! - Saturday Smash Series (A),4477015403,kickr,343,346,-3
11893,486826,2020-01-31 19:14:49,wahoo,Zwift - Tour de Zwift // Pro-Am Invitational (A),Garmin Vector3,kickr,382,380,2
12468,486826,2020-02-04 19:14:39,wahoo,Zwift - Tour de Zwift // Pro-Am Invitational (A),Garmin Vector3,kickr,380,381,-1
12784,486826,2020-02-06 18:59:54,wahoo,Zwift - KALAS Cup - Round 2 (A),Garmin Vector3,kickr,396,399,-3
48206,486826,2020-07-29 00:24:44,wahoo,Zwift - Eldo Crit Series  (A),Garmin Vector3,kickr,327,327,0
48325,486826,2020-07-29 23:21:30,wahoo,Zwift - Austin Driveway Series Criterium (A),Garmin Vector3,kickr,323,324,-1
48593,486826,2020-08-02 00:12:41,wahoo,Zwift - 3R Volcano Climb Race - 1 Lap (22.4km/14mi 204m) (A),Garmin Vector3,kickr,364,365,-1
48622,486826,2020-08-02 23:07:01,wahoo,Zwift - The Bump Sprint Race (A),Garmin Vector3,kickr,348,331,17
48839,486826,2020-08-05 00:27:25,wahoo,Zwift - Eldo Crit Series  (A),Garmin Vector3,kickr,343,343,0
49615,486826,2020-08-11 23:14:06,wahoo,Zwift - Velocious Sport Tue Night Criterium (Race) (A),Garmin Vector3,kickr,329,331,-2
49752,486826,2020-08-12 16:07:15,wahoo,Zwift - 3R Tick Tock Flat Race - 2 Lap (36km/22.4mi 100m) (A),Garmin Vector3,kickr,333,333,0
49933,486826,2020-08-14 08:45:00,wahoo,Zwift - Off the MAAP Invitational Race // Stage 1 (Men) (A),Garmin Vector3,kickr,365,349,16
50747,486826,2020-08-19 16:59:46,wahoo,Zwift - MIDWEEK Summer Series by SZR (A),Garmin Vector3,kickr,338,342,-4
51132,486826,2020-08-21 23:04:14,wahoo,Zwift - 3R Innsbruckring Flat Race - 2 Laps (17.6km/10.9m 154m) (A),Garmin Vector3,kickr,344,343,1
51417,486826,2020-08-23 23:09:30,wahoo,Zwift - The Bump Sprint Race (A),Garmin Vector3,kickr,317,306,11
52021,486826,2020-08-25 22:59:03,wahoo,Zwift - ZHR Masters Atlantic (A),Garmin Vector3,kickr,369,361,8
53320,486826,2020-09-03 22:59:37,wahoo,Zwift - Koa Sports League Warrior Race (A),Garmin Vector3,kickr,347,347,0
54614,486826,2020-09-11 17:59:37,wahoo,Zwift - TFC Summer Series  (A),Garmin Vector3,kickr,311,316,-5
54615,486826,2020-09-09 23:29:43,wahoo,Zwift - Austin Driveway Series Criterium (A),Garmin Vector3,kickr,314,314,0
55911,486826,2020-09-17 18:29:19,wahoo,Zwift - Invitational League // Qualifying Race #2 (Men) ,Garmin Vector3,kickr,348,348,0
59101,486826,2020-10-02 17:59:50,wahoo,Zwift - TFC Autumn Race Series (A),Garmin Vector3,kickr,342,348,-6
59941,486826,2020-10-06 23:15:15,wahoo,Zwift - Velocious Sport Tue Night Criterium (Race) (A),Garmin Vector3,kickr,331,330,1
62001,486826,2020-10-14 23:29:49,wahoo,Zwift - Austin Driveway Series Criterium (A),Garmin Vector3,kickr,304,306,-2
65238,486826,2020-10-26 19:59:14,wahoo,Zwift - Premier Division // Zwift Racing League (men) (A),Garmin Vector3,kickr,363,353,10
68636,486826,2020-11-06 18:59:54,wahoo,Zwift -  Tour De Spartacus  (E),Garmin Vector3,kickr,357,347,10
69156,486826,2020-11-07 19:00:11,wahoo,Zwift -  Tour De Spartacus  (E),Garmin Vector3,kickr,332,321,11
69158,486826,2020-11-08 19:01:37,wahoo,Zwift -  Tour De Spartacus  (E),Stages,kickr,398,373,25
77076,486826,2020-11-28 17:00:22,wahoo,Zwift - Cycling Canada Pre-Worlds Showdown Series (A),Garmin Vector3,kickr,346,344,2
86967,486826,2020-12-24 16:14:48,wahoo,Zwift - OH MY CRIT! - The Double Race 1/2 (A),Garmin Vector3,kickr,343,347,-4
95620,486826,2021-01-12 18:26:55,wahoo,Zwift - Zwift Racing League | WTRL - Men&#039;s/Mixed EMEA E2 DIVISION 4 (A),Garmin Vector3,kickr,360,340,20
99928,486826,2021-01-19 18:32:57,wahoo,Zwift - Zwift Racing League | WTRL - Men&#039;s/Mixed EMEA E2 DIVISION 4 (A),Garmin Vector3,kickr,354,348,6
103495,486826,2021-01-26 18:27:02,wahoo,Zwift - Zwift Racing League | WTRL - Men&#039;s/Mixed EMEA E2 DIVISION 4 (A),Garmin Vector3,kickr,347,348,-1
107372,486826,2021-02-02 18:26:51,wahoo,Zwift - Zwift Racing League | WTRL - Men&#039;s/Mixed EMEA E2 DIVISION 4 (A),Garmin Vector3,kickr,364,364,0
115835,486826,2021-02-16 18:26:39,wahoo,Zwift - Zwift Racing League | WTRL - Men&#039;s/Mixed EMEA E2 DIVISION 4 (A),Garmin Vector3,kickr,369,371,-2
119589,486826,2021-02-23 18:26:41,wahoo,Zwift - Zwift Racing League | WTRL - Men&#039;s/Mixed EMEA E2 DIVISION 4 (A),Garmin Vector3,kickr,343,342,1
123174,486826,2021-03-02 18:33:03,wahoo,Zwift - Zwift Racing League | WTRL - Men&#039;s/Mixed EMEA E2 DIVISION 4 (A),Garmin Vector3,kickr,323,307,16
105535,490665,2021-01-30 10:50:13,wahoo,Zwift - DIRT Badge Hunts (B),P1 Power Pedals,Wahoo Kickr Core,336,343,-7
106240,490665,2021-01-31 12:01:52,wahoo,Zwift - ODZentury Endurance Builder Ride (B),P1 Power Pedals,Wahoo Kickr Core,305,318,-13
111919,490665,2021-02-09 23:54:30,wahoo,Zwift - Zwift Racing League | WTRL - Men&#039;s/Mixed AMERICAS E DIVISION 2 (B),P1 Power Pedals,Wahoo Kickr Core,353,372,-19
119975,490665,2021-02-24 00:02:54,wahoo,Zwift - Zwift Racing League | WTRL - Men&#039;s/Mixed AMERICAS E DIVISION 2 (B),P1 Power Pedals,Kickr v5,367,363,4
123292,490665,2021-03-03 00:00:48,wahoo,Zwift - Zwift Racing League | WTRL - Men&#039;s/Mixed AMERICAS E DIVISION 2 (B),P1 Power Pedals,Kickr v5,348,344,4
39351,495535,2020-06-03 15:59:57,neo,Zwift - SSAT Ace Cycles Virtual Racing Series (B),Garmin Vector 3 pedals,Tacx Neo Trainer,339,340,-1
49005,495535,2020-08-01 05:59:53,neo,Zwift - FNB W2W Challenge,Garmin Vector 3 pedals,Tacx Neo Trainer,332,333,-1
82267,504950,2020-12-12 10:44:39,neo,Into the Red by RELENTLESS,Quarq Dzero ,Old Overheating Neo,447,432,15
82952,504950,2020-12-13 18:59:33,neo,Zwift Fondo Series 2020/21,Quarq Dzero ,Old Overheating Neo,440,425,15
83673,504950,2020-12-15 19:51:38,neo,Zwift Racing League | WTRL - Mens EMEA W1 DIVISION 1,Quarq Dzero ,Old Overheating Neo,430,418,12
87817,504950,2020-12-27 12:19:05,neo,Ottawa TopSpeed Race,Quarq Dzero ,Old Overheating Neo,421,413,8
88324,504950,2020-12-28 19:18:54,neo,Team TFC Mad Monday Winter Series,Quarq Dzero ,Old Overheating Neo,400,389,11
88325,504950,2020-12-28 20:08:58,neo,GGCC Glasgow Green Cycle Club Race Series,Quarq Dzero ,Old Overheating Neo,352,344,8
90259,504950,2021-01-02 13:49:05,neo,XRS Races: Saturday Climbing Series,Quarq Dzero ,Old Overheating Neo,411,405,6
90876,504950,2021-01-03 14:12:15,neo,KISS 100 Race Series - Americas,Quarq Dzero ,Old Overheating Neo,392,384,8
91402,504950,2021-01-04 19:09:54,neo,Team TFC Mad Monday Winter Series,Quarq Dzero ,Old Overheating Neo,386,381,5
91407,504950,2021-01-04 20:09:00,neo,GGCC Glasgow Green CC Race Series,Quarq Dzero ,Old Overheating Neo,351,347,4
92445,504950,2021-01-06 19:56:43,neo,TDZ Stage 1: Group Ride,Quarq Dzero ,Old Overheating Neo,399,393,6
94647,504950,2021-01-10 19:34:22,neo,Zwift - KISS Race Series - EU PM (A),Quarq Dzero ,Neo OG,425,417,8
96268,504950,2021-01-13 10:13:24,neo,Calibration check,Quarq Dzero ,Neo OG,258,258,0
96547,504950,2021-01-13 19:48:07,neo,Zwift - TDZ Stage 2: Standard Ride,Quarq Dzero ,Neo OG,383,376,7
97459,504950,2021-01-15 13:39:06,neo,Z2/Z3 Session,Quarq Dzero ,Neo OG,328,327,1
98743,504950,2021-01-17 18:49:08,neo,Zwift - BRT Iron Goat Racing League (A),Quarq Dzero ,Neo OG,437,429,8
99914,504950,2021-01-19 19:31:55,neo,Zwift - Zwift Racing League | WTRL - Men&#039;s/Mixed EMEA W2 DIVISION 1 (A),Quarq Dzero ,Neo OG,402,402,0
99926,504950,2021-01-19 19:31:55,neo,Zwift - 3R Volcano Flat Reverse Race - 3 Laps (36.6km/22.7mi 138m) (A),Quarq Dzero ,Neo OG,422,415,7
81133,508874,2020-12-08 17:42:40,neo,Zwift - Zwift Racing League | WTRL - Men&#039;s EMEA E1 DIVISION 1 (A),Power2Max type2,Tacx NEO,406,390,16
82399,508874,2020-12-12 08:15:04,neo,Zwift - Matando o Corpo® by PETA-Z (A),Power2Max type2,Tacx NEO,389,375,14
82670,508874,2020-12-13 08:19:52,neo,Zwift - Team Italy & Frenchy Fuzion Endurance Race (A),Power2Max type2,Tacx NEO,379,367,12
90221,508874,2021-01-02 09:30:12,neo,Zwift - DBR SufferDay League III (A),Power2Max type2,Tacx NEO,422,403,19
95769,508874,2021-01-12 19:43:52,neo,Zwift - Zwift Racing League | WTRL - Men&#039;s/Mixed EMEA W1 DIVISION 1 (A),Power2Max type2,Tacx NEO,382,366,16
94000,510474,2021-01-09 16:28:12,wahoo,Zwift - TEAM VEGAN Tofu Tornado (A),Stages,Wahoo Kick18,272,268,4
75993,512169,2020-11-26 18:26:13,wahoo,Zwift - WTRL NOPINZ WORLD TTT CHAMPIONSHIPS - Zone 5 (C),rotor 2inpower,wahoo kickr,430,432,-2
92421,512169,2021-01-06 19:10:00,wahoo,Zwift - XRS Races: Wednesday iTT series (A),rotor 2inpower,wahoo kickr,329,313,16
93055,512169,2021-01-07 18:59:36,wahoo,BENELIGA 2020-2021,rotor 2inpower,wahoo kickr,494,493,1
97145,512169,2021-01-14 18:59:39,wahoo,BENELIGA 2020-2021,rotor 2inpower,wahoo kickr,461,460,1
97518,512169,2021-01-15 17:54:31,wahoo,Zwift - KIRCHMAIR Race Series (A),rotor 2inpower,wahoo kickr,411,379,32
98520,512169,2021-01-17 14:35:49,wahoo,Zwift - Herd Beginner Racing Series,rotor 2inpower,wahoo kickr,487,464,23
99014,512169,2021-01-18 18:15:46,wahoo,Zwift - TRI247 Manic Monday Time Trial (E),rotor 2inpower,wahoo kickr,446,467,-21
99732,512169,2021-01-19 18:50:04,wahoo,Zwift - AHDR Bacon Rolls with Caffeine  (B),rotor 2inpower,wahoo kickr,261,251,10
100286,512169,2021-01-20 17:50:13,wahoo,"Zwift - 3R 100 Steady Ride [~3.0w/kg, ~2.5w/kg, ~2w/kg avg] (C)",rotor 2inpower,wahoo kickr,250,237,13
100962,512169,2021-01-21 18:31:07,wahoo,BENELIGA 2020-2021,rotor 2inpower,wahoo kickr,455,448,7
101494,512169,2021-01-22 18:13:14,wahoo,Zwift - KIRCHMAIR Race Series (A),rotor 2inpower,wahoo kickr,454,442,12
105213,512169,2021-01-29 18:29:35,wahoo,Zwift - KIRCHMAIR Race Series (A),rotor 2inpower,wahoo kickr,453,459,-6
105220,512169,2021-01-29 17:59:38,wahoo,Zwift - KIRCHMAIR Race Series (A),rotor 2inpower,wahoo kickr,422,414,8
113505,512169,2021-02-12 17:47:13,wahoo,Zwift - KIRCHMAIR Race Series (A),rotor 2inpower,wahoo kickr,470,462,8
115150,512169,2021-02-15 15:25:30,wahoo,zada three sisterst stest,rotor 2inpower,wahoo kickr V5,475,441,34
35121,513078,2020-05-15 09:03:00,neo,Zwift Fast Fridays: Bologna Time Trial,Power2Max NG ECO to Zwift,Tacx Neo to Garmin,317,315,2
118485,513078,2021-02-20 16:59:54,neo,Stages to Zwift / Tacx Neo to Garmin,Stages to Zwift,Tacx Neo to Garmin,348,344,4
48486,50458,2020-08-01 11:10:18,neo,Herd Summer Racing League Race 8,Assioma,Neo,382,381,1
48676,50458,2020-08-03 18:06:16,neo,Summer Stampede (ITT) Race 2 by Herd Racing League,Assioma,Neo,337,337,0
49549,50458,2020-08-11 11:02:07,neo,Zwift - Shorter Ride - 7 Days of Tarmac SL7: Stage 1,Assioma,Neo,309,311,-2
50128,50458,2020-08-15 11:10:17,neo,Zwift - Herd Summer Racing League Race 10 (B),Assioma,Neo,353,352,1
50745,50458,2020-08-19 17:40:15,neo,Zwift - Bullseye Points Race Event 2 by Herd Racing League (B),Assioma,Neo,331,329,2
51285,50458,2020-08-22 19:04:05,neo,Zwift - Herd Summer Racing League Race 1 (B),Assioma,Neo,333,330,3
53008,50458,2020-09-02 08:09:49,neo,Zwift - Bullseye Points Race Event 4 by Herd Racing League (B),Assioma,Neo,342,341,1
54120,50458,2020-09-07 18:05:39,neo,Zwift - Summer Stampede (ITT) Race 7 by Herd Racing League (B),Assioma,Neo,342,337,5
56675,50458,2020-09-21 18:05:44,neo,Zwift - The Stampede (ITT) by Herd Racing League (B),Assioma,Neo,340,342,-2
58093,50458,2020-09-28 18:06:15,neo,The Stampede (ITT) by Herd Racing League,Assioma,Neo,340,341,-1
60251,50458,2020-10-08 10:00:02,neo,ZA Road WO #2 - Sprint Profile,Assioma,Neo,261,260,1
68750,50458,2020-11-07 12:00:26,neo,Herd Beginner Racing Series,Assioma,Neo,338,337,1
69053,50458,2020-11-08 14:28:24,neo,Zwift - Herd Beginner Racing Series (E),Assioma,Neo,339,340,-1
69232,50458,2020-11-09 09:01:01,neo,Zwift - The Stampede (ITT) by Herd Racing League (B),Assioma,Neo,340,341,-1
115217,50458,2021-02-15 18:17:43,neo,Zwift - TRI247 Manic Monday Time Trial (E),Assioma,Neo,318,319,-1
117013,50458,2021-02-18 08:29:54,neo,Zwift - Ryzon Days of Dedication: Stage 3,Assioma,Neo,315,310,5
125207,50458,2021-03-06 19:31:23,neo,3R Endurance Series p/b OTE Sports,Assioma,Neo,340,335,5
125394,50458,2021-03-07 14:29:52,neo,Zwift - Herd Beginner Racing Series (E),Assioma,Neo,329,329,0
125817,50458,2021-03-08 19:06:36,neo,Zwift - The Stampede (ITT) by Herd Racing League (C),Assioma,Neo,339,339,0
127581,50458,2021-03-12 19:00:02,neo,Herd Beginner Racing Series - TT,Assioma,Neo,335,336,-1
27803,475631,2020-04-23 18:45:01,wahoo,Zwift - XRS - ZTR Thursday Night Race (A),Dura-Ace R9100-P,Wahoo Kickr ,363,350,13
97177,475631,2021-01-14 18:59:55,wahoo,Zwift - BENELIGA 2020-2021 (E),Dura-Ace R9100-P,Wahoo Kickr ,419,401,18
91640,513210,2021-01-05 11:07:31,wahoo,Zwift - Ramp Test,FA pedals dual,Wahoo Kickr 5 ,323,319,4
92156,513210,2021-01-06 11:03:00,wahoo,FA pedals dual,FA pedals dual,Wahoo Kickr 5 ,239,228,11
92642,513210,2021-01-07 10:28:05,wahoo,Zwift - WTRL Team Time Trial - Zone 2 (D),FA pedals dual,Wahoo Kickr 5 ,302,289,13
95480,513210,2021-01-12 10:02:29,wahoo,Zwift - TDZ Stage 2: Standard Ride,FA pedals dual,Wahoo Kickr 5 ,208,200,8
96560,513210,2021-01-13 10:30:23,wahoo,Zwift - USA Cycling Coffee with Hot Espresso Presented by Team ODZ (C),FA pedals dual,Wahoo Kickr 5 ,301,298,3
97383,513210,2021-01-14 23:03:31,wahoo,Zwift - TDZ Stage 3: Shorter Ride,FA pedals dual,Wahoo Kickr 5 ,283,270,13
99547,513210,2021-01-16 11:00:27,wahoo,Zwift - DIRT Badge Hunts (B),FA pedals dual,Wahoo Kickr 5 ,296,284,12
99550,513210,2021-01-19 10:06:27,wahoo,Zwift - TDZ Stage 4: Standard Ride,FA pedals dual,Wahoo Kickr 5 ,255,258,-3
100760,513210,2021-01-21 10:25:13,wahoo,Zwift - WTRL Team Time Trial - Zone 2 (D),FA pedals dual,Wahoo Kickr 5 ,292,286,6
102746,513210,2021-01-24 11:59:59,wahoo,Dirt XLR Sunday ,FA pedals dual,Wahoo Kickr 5 ,201,201,0
115791,513210,2021-02-13 12:08:09,wahoo,Zwift - DIRT Dadurday Chase Race  (B),FA pedals dual,Wahoo Kickr 5 ,293,285,8
122261,513210,2021-02-28 12:02:06,wahoo,Zwift - Haute Route Watopia 2021 Stage 3 (B),FA pedals dual,Wahoo Kickr 5 ,264,254,10
123898,513210,2021-03-04 10:28:02,wahoo,Zwift - WTRL Team Time Trial - Zone 2 (D),FA pedals dual,Wahoo Kickr 5 ,291,284,7
54510,473320,2020-09-10 17:27:24,wahoo,Zwift - Vienna,S-Works Power Cranks,Wahoo Kickr 2018 Smart Trainer,230,218,12
54925,473320,2020-09-13 19:50:02,neo,Zwift - AHDR Bacon Rolls (B),garmin pedals V3,Tacx Neo Smart Trainer,174,177,-3
55373,473320,2020-09-15 17:29:52,wahoo,Zwift - WTRL Women&#039;s EMPOWERMENT Series - Stage 2 (A),garmin pedals V3,Wahoo Kickr 2018 Smart Trainer,217,232,-15
56512,473320,2020-09-20 13:29:55,wahoo,Zwift - Invitational League // Qualifying Race #3 (Women) (A),garmin pedals V3 compare power(2nd source),Wahoo Kickr ,239,236,3
56883,473320,2020-09-22 17:29:51,wahoo,WTRL Womens EMPOWERMENT Series-Stage 3,garmin pedals V3,Wahoo Kickr ,232,230,2
56918,473320,2020-09-23 00:29:53,wahoo,Zwift - WTRL Women&#039;s EMPOWERMENT Series - Stage 3 (A),garmin pedals V3,Wahoo Kickr ,242,240,2
57788,473320,2020-09-26 17:45:35,wahoo,ZADA Test-3 sisters,garmin pedals V3,Wahoo Kickr ,239,238,1
60457,473320,2020-10-08 17:27:18,wahoo,Zwift - Vienna,S-Works Power Cranks,Wahoo Kickr ,235,226,9
61234,473320,2020-10-12 17:44:56,wahoo,Zwift - Premier Division // Zwift Racing League (women) (A),garmin pedals V3,Wahoo Kickr ,231,236,-5
75731,473320,2020-11-26 01:04:55,wahoo,Wahoo Kickr to Zwift / S-Works Power Cranks,S-Works Power Cranks,Wahoo Kickr to Zwift,220,220,0
76011,473320,2020-11-26 17:50:32,wahoo,WTRL NOPINZ WORLD TTT CHAMPIONSHIPS - Zone 3 (E),S-Works Power Cranks,Wahoo Kickr ,250,240,10
82537,473320,2020-12-12 19:30:01,wahoo,Fearless Women&#039;s Team Championships - 2020 (A),S-Works Power Cranks,Wahoo Kickr ,227,214,13
92917,473320,2021-01-07 18:37:57,wahoo,WTRL Team Time Trial - Zone 6 (E),garmin pedals V3,Wahoo Kickr ,226,223,3
93606,473320,2021-01-09 01:01:56,wahoo,Tour De Boudicca,S-Works Power Cranks,Wahoo Kickr ,232,230,2
94438,473320,2021-01-09 19:02:55,wahoo, Tour De Boudicca,S-Works Power Cranks,Wahoo Kickr ,227,226,1
94637,473320,2021-01-10 19:03:54,wahoo, Tour De Boudicca,S-Works Power Cranks,Wahoo Kickr ,233,229,4
112398,473320,2021-02-10 19:01:54,wahoo,Movistar Team Challenge // Round 1 (B),S-Works Power Cranks,Wahoo Kickr ,248,236,12
113633,473320,2021-02-12 19:01:56,wahoo,Zwift - Movistar Team Challenge // Round 1 (women),S-Works Power Cranks,Wahoo Kickr ,251,249,2
117925,473320,2021-02-19 19:01:54,wahoo,Zwift - Movistar Team Challenge // Round 2 (women),garmin pedals V3,Wahoo Kickr ,242,244,-2
122526,473320,2021-03-01 19:21:21,wahoo,Zwift - Premier Division // Zwift Racing League (women) (A),garmin pedals V3,Wahoo Kickr ,239,234,5
124670,473320,2021-03-05 19:39:54,wahoo,Zwift - Movistar Team Challenge // Points Race (women) ,garmin pedals V3,Wahoo Kickr ,246,238,8
124693,473320,2021-03-05 18:59:53,wahoo,Zwift - Ramp Test,garmin pedals V3,Wahoo Kickr ,243,245,-2
104272,168796,2021-01-26 17:29:36,wahoo,KickrV5 (Zwift) vs KickrV5 (MegaXL) - Race (TwoBridgesx5),Zwift,MegaXL_KickrV5,302,305,-3
104838,168796,2021-01-28 19:00:31,wahoo,KickrV5 (Zwift) vs KickrV5 (MegaXL) - RCCTurbo TT Efforts,Zwift,MegaXL_KickrV5,277,274,3
105822,168796,2021-01-30 16:58:49,wahoo,KickrV5 (Zwift) vs KickrV5 (MegaXL) - Tdz Innsbruckringx4,Zwift,MegaXL_KickrV5,298,294,4
106357,168796,2021-01-31 17:00:39,wahoo,KickrV5 (Zwift) vs KickrV5 (MegaXL) - TdZ WatopiaFlatx3,Zwift,MegaXL_KickrV5,290,290,0
110280,168796,2021-01-31 17:00:39,wahoo,KickrV5 (MegaXL) vs Assioma (Garmin530) - GranFondo100k,Garmin530_Assioma,MegaXL_KickrV5,283,290,-7
113514,168796,2021-02-11 18:57:16,wahoo,KickrV5 (Zwift) vs KickrV5 (MegaXL) - RCC RussianSteps ,Zwift,MegaXL_KickrV5,255,260,-5
114353,168796,2021-02-13 17:29:45,wahoo,KickrV5 (Zwift) vs KickrV5 (MegaXL) - Race (ChampsElyseex2),Zwift,MegaXL_KickrV5,299,304,-5
118440,168796,2021-02-13 17:29:45,wahoo,KickrV5 (Zwift) vs KickrV5 (MegaXL) - Race (WatopiaWaistbandx2),Zwift,MegaXL_KickrV5,296,304,-8
109092,520653,2021-02-04 13:02:59,wahoo,TDZ Stage 7: Shorter Ride,Vector,Kickr,297,287,10
109534,520653,2021-02-05 17:42:11,wahoo,Watopia,Vector,Kickr,236,244,-8
342,79239,2019-08-16 15:00:46,wahoo,Power2Max S-type / Wahoo Kickr 2nd gen,Power2Max S-type,Wahoo Kickr 2nd gen,379,377,2
3664,79239,2019-11-02 14:01:33,wahoo,Slovenian Zwift League presented by VS Bike - stage 1,Power2Max NG,Wahoo Kickr 2nd gen,416,408,8
3876,79239,2019-11-06 19:05:13,wahoo,Wahoo Kickr 2nd gen / Power2Max NG,Power2Max NG,Wahoo Kickr 2nd gen,404,405,-1
3919,79239,2019-11-07 18:19:20,wahoo,Zwift - WTRL Team Time Trial (EU-TTT),Power2Max NG,Wahoo Kickr 2nd gen,410,418,-8
4198,79239,2019-11-13 18:46:28,wahoo,Zwift - 11/13/2019,Power2Max NG,Wahoo Kickr 2nd gen,401,395,6
4337,79239,2019-11-16 13:46:35,wahoo,Slovenian Zwift League - Autumn Series,Power2Max NG,Wahoo Kickr 2nd gen,368,363,5
4720,79239,2019-11-23 13:55:46,wahoo,Slovenian Zwift League - Autumn Series (Stage 4),Power2Max NG,Wahoo Kickr 2nd gen,444,447,-3
5369,79239,2019-12-03 17:09:09,wahoo,3R Volcano KOM After Party Race - 2 laps + climb (40.2km/25mi 286m),Power2Max NG,Wahoo Kickr 2nd gen,456,458,-2
5747,79239,2019-12-08 09:23:16,wahoo,Slovenian Zwift League - Autumn Series - Stage 6,Power2Max NG,Wahoo Kickr 2nd gen,422,422,0
6048,79239,2019-12-11 18:47:50,wahoo,DBR HEINO CUP,Power2Max NG,Wahoo Kickr 2nd gen,445,453,-8
7017,79239,2019-12-22 09:00:27,wahoo,Slovenian Zwift League - Autumn Series,Power2Max NG,Wahoo Kickr 2nd gen,419,406,13
7264,79239,2019-12-25 16:33:24,wahoo,Crit City Race,Power2Max NG,Wahoo Kickr 2nd gen,361,358,3
7486,79239,2019-12-28 13:42:52,wahoo,Slovenian Zwift League - Autumn Series (Stage 9),Power2Max NG,Wahoo Kickr 2nd gen,431,431,0
7748,79239,2019-12-31 15:42:39,wahoo,Ultimate - Goodby 2019 by 3R,Power2Max NG,Wahoo Kickr 2nd gen,459,460,-1
8468,79239,2020-01-08 18:49:57,wahoo,Zwift - DBR HEINO CUP (A),Power2Max NG,Wahoo Kickr 2nd gen,439,431,8
8815,79239,2020-01-11 09:15:03,wahoo,Power2Max NG / Wahoo Kickr 2nd gen,Power2Max NG,Wahoo Kickr 2nd gen,398,394,4
9530,79239,2020-01-15 18:37:09,wahoo,Power2Max NG / Wahoo Kickr 2nd gen,Power2Max NG,Wahoo Kickr 2nd gen,377,375,2
9974,79239,2020-01-19 09:26:04,wahoo,Slovenian Zwift League - Fight for the Jersey,Power2Max NG,Wahoo Kickr 2nd gen,477,472,5
10632,79239,2020-01-23 17:17:47,wahoo,Power2Max NG / Wahoo Kickr 2nd gen,Power2Max NG,Wahoo Kickr 2nd gen,468,471,-3
12045,79239,2020-02-01 17:51:43,wahoo,3R Three Sisters Hilly Race (47km/29.2mi 879m),Power2Max NG,Wahoo Kickr 2nd gen,446,450,-4
12098,79239,2020-02-02 09:17:23,wahoo,SloZL - Fight for Jersey (Stage 3),Power2Max NG,Wahoo Kickr 2nd gen,427,430,-3
12923,79239,2020-02-07 17:40:53,wahoo,3R Lutscher CCW Climbing Race - 1 Lap (22.1km/13.9mi 827m),Power2Max NG,Wahoo Kickr 2nd gen,452,455,-3
13094,79239,2020-02-09 09:16:56,wahoo,Slovenian Zwift League - Fight for the Jersey - stage 4,Power2Max NG,Wahoo Kickr 2nd gen,415,412,3
13294,79239,2020-02-10 17:48:28,wahoo,DBR Winter Cup,Power2Max NG,Wahoo Kickr 2nd gen,452,452,0
14192,79239,2020-02-16 09:30:23,wahoo,Slovenian Zwift League - Fight for Jersey! - Stage 5,Power2Max NG,Wahoo Kickr 2nd gen,430,432,-2
14541,79239,2020-02-18 17:41:20,wahoo,Zwift - ZRG Winter Race Series 6/10 - Crit London Classique (A),Power2Max NG,Wahoo Kickr 2nd gen,396,393,3
15077,79239,2020-02-21 17:59:47,wahoo,Power2Max NG to Zwift / Wahoo Kickr 2nd gen to Wahoo Bolt,Power2Max NG to Zwift,Wahoo Kickr 2nd gen to Wahoo Bolt,440,439,1
15253,79239,2020-02-23 09:08:48,wahoo,Slovenian Zwift League - Fight for Jersey! - Stage 6,Power2Max NG to Zwift,Wahoo Kickr 2nd gen to Wahoo Bolt,387,373,14
15449,79239,2020-02-24 17:48:51,wahoo,DBR Winter Cup,Power2Max NG to Zwift,Wahoo Kickr 2nd gen to Wahoo Bolt,435,435,0
15582,79239,2020-02-25 17:43:35,wahoo,ZRG Winter Race Series 7/10 - Muir and the Mountain,Power2Max NG to Zwift,Wahoo Kickr 2nd gen to Wahoo Bolt,448,454,-6
16241,79239,2020-02-23 09:32:02,wahoo,Slovenian Zwift League - Fight for Jersey! - Stage 6 (Criterium),Power2Max NG to Zwift,Wahoo Kickr 2nd gen to Wahoo Bolt,420,421,-1
16614,79239,2020-03-03 17:33:30,wahoo,ZRG Winter series 8/10 - TT Bologna,Power2Max NG to Zwift,Wahoo Kickr 2nd gen to Wahoo Bolt,436,419,17
17844,79239,2020-03-12 18:34:43,wahoo,Zwift - KALAS Cup - Round 7 (A),Power2Max NG to Zwift,Wahoo Kickr 2nd gen to Wahoo Bolt,394,393,1
18121,79239,2020-03-15 09:14:09,wahoo,Slovenian Zwift League - Fight for Jersey! - Stage 9,Power2Max NG to Zwift,Wahoo Kickr 2nd gen to Wahoo Bolt,486,482,4
18432,79239,2020-03-17 17:35:03,wahoo,ZRG Winter Race Series 10/10 (Road to Sky),Power2Max NG to Zwift,Wahoo Kickr 2nd gen to Wahoo Bolt,423,417,6
19166,79239,2020-03-22 13:00:59,wahoo,Zwift - KISS 100km - Americas (A),Power2Max NG to Zwift,Wahoo Kickr 2nd gen to Wahoo Bolt,394,400,-6
19354,79239,2020-03-23 17:56:44,wahoo,DBR Monday Race (Watopia Figure 8),Power2Max NG to Zwift,Wahoo Kickr 2nd gen to Wahoo Bolt,445,445,0
22295,79239,2020-04-05 12:59:36,wahoo,Zwift - KISS 100km Race,Power2Max NG to Zwift,Wahoo Kickr 2nd gen to Wahoo Bolt,469,467,2
24302,79239,2020-04-13 17:01:32,wahoo,Power2Max NG to Zwift / Wahoo Kickr 2nd gen to Wahoo Bolt,Power2Max NG to Zwift,Wahoo Kickr 2nd gen to Wahoo Bolt,401,402,-1
28237,79239,2020-04-26 13:08:46,wahoo,Zwift - KISS 100km Race,Power2Max NG to Zwift,Wahoo Kickr 2nd gen to Wahoo Bolt,395,398,-3
38796,79239,2020-05-31 07:20:30,wahoo,Zwift - ZHR Masters Weekender (B),Power2Max NG to Zwift,Wahoo Kickr 2nd gen to Wahoo Bolt,418,425,-7
71568,79239,2020-11-15 09:18:01,wahoo,Zwift -  SloZl - Slovenian Zwift League - Weekly Race  (A),Power2Max NG to Zwift,Wahoo Kickr 2nd gen to Wahoo Bolt,469,469,0
73118,79239,2020-11-19 18:49:06,wahoo,Power2Max NG to Zwift / Wahoo Kickr 2nd gen to Wahoo Bolt,Power2Max NG to Zwift,Wahoo Kickr 2nd gen to Wahoo Bolt,417,414,3
74101,79239,2020-11-22 09:15:02,wahoo,Power2Max NG to Zwift / Wahoo Kickr 2nd gen to Wahoo Bolt,Power2Max NG to Zwift,Wahoo Kickr 2nd gen to Wahoo Bolt,400,400,0
77225,79239,2020-11-29 09:16:51,wahoo,Slovenian Zwift League - La guardia Loop,Power2Max NG to Zwift,Wahoo Kickr 2nd gen to Wahoo Bolt,372,367,5
79015,79239,2020-12-03 18:48:05,wahoo,WTRL Team Time Trial - Zone 7 (Harrogate reverse),Power2Max NG -&gt; Zwift,Wahoo Kickr 2018 -&gt; Wahoo Bolt,425,435,-10
80034,79239,2020-12-06 09:19:21,wahoo,SloZl - Slovenian Zwift League - Bologna climb (A),Power2Max NG -&gt; Zwift,Wahoo Kickr 2018 -&gt; Wahoo Bolt,464,462,2
81069,79239,2020-12-09 17:30:30,wahoo,Cycling Weekly Club 10mile TT,Power2Max NG -&gt; Zwift,Wahoo Kickr 2018 -&gt; Wahoo Bolt,415,423,-8
81647,79239,2020-12-10 18:28:34,wahoo,WTRL TTT Platinum League (Greater London Flat),Power2Max NG -&gt; Zwift,Wahoo Kickr 2018 -&gt; Wahoo Bolt,412,410,2
81652,79239,2020-12-10 18:28:34,wahoo,Crit City Race,Power2Max NG -&gt; Zwift,Wahoo Kickr 2018 -&gt; Wahoo Bolt,383,382,1
82779,79239,2020-12-13 09:13:49,wahoo,Zwift -  SloZl - Slovenian Zwift League - Weekly Race  (A),Power2Max NG -&gt; Zwift,Wahoo Kickr 2018 -&gt; Wahoo Bolt,414,416,-2
84381,79239,2020-12-17 17:45:11,wahoo,Power2Max NG -&gt; Zwift / Wahoo Kickr 2018 -&gt; Wahoo Bolt,Power2Max NG -&gt; Zwift,Wahoo Kickr 2018 -&gt; Wahoo Bolt,414,417,-3
85029,79239,2020-12-19 09:20:37,wahoo,DBR Saturday Race,Power2Max NG -&gt; Zwift,Wahoo Kickr 2018 -&gt; Wahoo Bolt,410,405,5
85470,79239,2020-12-20 14:05:35,wahoo,Zwift - KISS 100 Race Series - Americas (A),Power2Max NG -&gt; Zwift,Wahoo Kickr 2018 -&gt; Wahoo Bolt,369,366,3
87223,79239,2020-12-25 15:47:05,wahoo,Virtuslo.cc New Year Tour - Stage 1/7 - Gorca vineyards,Power2Max NG -&gt; RGT Cycling,Wahoo Kickr 2018 - &gt; Wahoo Bolt,395,436,-41
98415,79239,2021-01-17 09:21:50,wahoo,Power2Max NG -&gt; Zwift / Wahoo Kickr 2018 - &gt; Wahoo Bolt,Power2Max NG -&gt; Zwift,Wahoo Kickr 2018 - &gt; Wahoo Bolt,452,449,3
102244,79239,2021-01-24 09:17:00,wahoo,SloZL - Fight for Jersey (2/11),Power2Max NG -&gt; Zwift,Wahoo Kickr 2018 - &gt; Wahoo Bolt,370,383,-13
106167,79239,2021-01-31 09:10:34,wahoo,SloZL - Fight for Jersey (3/11),Power2Max NG -&gt; Zwift,Wahoo Kickr 2018 - &gt; Wahoo Bolt,435,436,-1
110291,79239,2021-02-07 09:28:14,wahoo,SloZL - Fight for Jersey (4/11),Power2Max NG -&gt; Zwift,Wahoo Kickr 2018 - &gt; Wahoo Bolt,445,441,4
112907,79239,2021-02-11 17:17:56,wahoo,3R iTT Race - Tick Tok - 1 Lap,Power2Max NG -&gt; Zwift,Wahoo Kickr 2018 - &gt; Wahoo Bolt,418,423,-5
114547,79239,2021-02-14 09:21:53,wahoo,SloZl - Fight for Jersey,Power2Max NG -&gt; Zwift,Wahoo Kickr 2018 - &gt; Wahoo Bolt,438,430,8
118610,79239,2021-02-21 09:16:39,wahoo,SloZl - Fight for Jersey (6/11),Power2Max NG -&gt; Zwift,Wahoo Kickr 2018 - &gt; Wahoo Bolt,430,428,2
121482,79239,2021-02-27 09:23:56,wahoo,Zwift - DBR SufferDay League III (A),Power2Max NG -&gt; Zwift,Wahoo Kickr 2018 - &gt; Wahoo Bolt,435,437,-2
122001,79239,2021-02-28 09:11:52,wahoo,SloZl - Fight for Jersey (7/11),Power2Max NG -&gt; Zwift,Wahoo Kickr 2018 - &gt; Wahoo Bolt,424,424,0
128305,79239,2021-03-14 09:10:40,wahoo,SloZl - Fight for Jersey (9/11),Power2Max NG -&gt; Zwift,Wahoo Kickr 2018 - &gt; Wahoo Bolt,435,421,14
128738,170629,2021-03-15 14:05:02,wahoo,Zwift - 3R Classique Reverse Flat Race - 5 Laps (32km/20.1mi 76m) (A),Rotor InSpider ,Wahoo Kickr 2017,389,387,2
51891,465473,2020-08-25 18:29:45,wahoo,Zwift,dFour,Kickr ,421,427,-6
53796,465473,2020-09-07 16:40:00,wahoo,Zwift - Team Italy PISSEI Race (A),dFour,Kickr ,404,410,-6
54029,465473,2020-09-08 18:59:59,wahoo,Zwift - KISS at Race - EU PM (A),dFour,Kickr ,444,444,0
54477,465473,2020-09-10 18:59:56,wahoo,Zwift - KISS at Race - EU PM (A),dFour,Kickr ,410,412,-2
55444,465473,2020-09-15 18:59:58,wahoo,Zwift - KISS at Race - EU PM (A),dFour,Kickr ,448,440,8
55636,465473,2020-09-16 19:14:58,wahoo,Zwift - 3R Tick Tock Flat Race - 2 Lap (36km/22.4mi 100m) (A),dFour,Kickr ,455,445,10
56018,465473,2020-09-17 18:07:08,wahoo,Zwift - Invitational League // Qualifying Race #2 (Men) ,dFour,Kickr ,411,402,9
56547,465473,2020-09-20 12:31:24,wahoo,Zwift - Invitational League // Qualifying Race #3 (Men) (A),dFour,Kickr ,453,443,10
57118,465473,2020-09-23 18:04:58,wahoo,Zwift - DBR Wednesday Race (A),dFour,Kickr ,447,426,21
58651,465473,2020-09-30 19:14:58,wahoo,Zwift,dFour,Kickr ,371,372,-1
59125,465473,2020-10-02 20:25:02,wahoo,Zwift - 3R Innsbruckring Flat Race - 4 Laps (35.2km/21.9mi 308m) (A),dFour,Kickr ,407,408,-1
59316,465473,2020-10-03 18:04:57,wahoo,Zwift - 3R Three Sisters Hilly Race (47km/29.2mi 879m) (A),dFour,Kickr ,446,440,6
59671,465473,2020-10-05 17:43:53,wahoo,Zwift - TFC Mad Monday Autumn Series (A),Favero Assioma,Kickr ,390,390,0
61642,465473,2020-10-13 17:14:58,wahoo,Zwift - Zwift Racing League | WTRL,dFour,Kickr ,442,434,8
68365,465473,2020-11-04 19:14:58,wahoo,Zwift - 3R Tick Tock Flat Race - 2 Lap (36km/22.4mi 100m) (A),dFour,Kickr ,436,437,-1
68915,465473,2020-11-07 17:54:19,wahoo,Zwift - 3R Three Sisters Hilly Race (47km/29.2mi 879m) (A),dFour,Kickr ,421,413,8
69863,465473,2020-11-10 18:12:18,wahoo,Zwift - Zwift Racing League | WTRL - EMEA E1 (MEN) -  Division 1 (A),dFour,Kickr ,447,442,5
70910,465473,2020-11-12 19:14:36,wahoo,Zwift - BRT Criterium Racing League (A),dFour,Kickr ,438,435,3
71505,465473,2020-11-14 21:05:45,wahoo,Zwift - 3R Gotham Grind Flat Race - 3 Laps (27.8km/17.4mi 87m) (A),dFour,Kickr ,421,412,9
73257,465473,2020-11-19 19:27:41,wahoo,Zwift - ZHR Up & Down Race (A),dFour,Kickr ,444,445,-1
73688,465473,2020-11-20 20:55:55,wahoo,Zwift,dFour,Kickr ,438,435,3
74047,465473,2020-11-21 20:01:07,wahoo,Zwift - 3R Flat Race (A),dFour,Kickr ,460,461,-1
74051,465473,2020-11-21 21:09:16,wahoo,Zwift - 3R Gotham Grind Flat Race - 3 Laps (27.8km/17.4mi 87m) (A),dFour,Kickr ,385,384,1
74776,465473,2020-11-23 19:09:02,wahoo,Zwift - ZA Road Race #1: 4 - 5 w/kg,dFour,Kickr ,408,404,4
76259,465473,2020-11-26 19:14:12,wahoo,Zwift - BRT Criterium Racing League (A),dFour,Kickr ,384,383,1
76653,465473,2020-11-27 20:21:59,wahoo,Zwift - 3R Innsbruckring Flat Race - 4 Laps (35.2km/21.9mi 308m) (A),dFour,Kickr ,438,439,-1
77153,465473,2020-11-28 21:08:23,wahoo,Zwift - 3R Gotham Grind Flat Race - 3 Laps (27.8km/17.4mi 87m) (A),dFour,Kickr ,456,457,-1
77155,465473,2020-11-28 20:01:14,wahoo,Zwift - 3R Flat Race (A),dFour,Kickr ,404,403,1
79184,465473,2020-12-03 21:59:59,wahoo,Zwift - XRS - ZTR Thursday Night Race (A),dFour,Kickr ,433,434,-1
80222,465473,2020-12-06 14:11:44,wahoo,Zwift - KISS 100 Race Series - Americas (A),dFour,Kickr ,383,384,-1
81236,465473,2020-12-08 20:03:58,wahoo,Zwift,dFour,Kickr ,425,425,0
81753,465473,2020-12-10 19:59:33,wahoo,Zwift - KISS Race Series - EU PM (A),dFour,Kickr ,447,449,-2
82100,465473,2020-12-11 20:20:25,wahoo,Zwift - 3R Innsbruckring Flat Race - 4 Laps (35.2km/21.9mi 308m) (A),dFour,Kickr ,412,412,0
82717,465473,2020-12-13 08:56:44,wahoo,Zwift - Newbury Velo Road Race (A),dFour,Kickr ,427,427,0
84888,465473,2020-12-18 20:19:23,wahoo,Zwift - 3R Innsbruckring Flat Race - 4 Laps (35.2km/21.9mi 308m) (A),dFour,Kickr ,428,423,5
85935,465473,2020-12-21 20:38:20,wahoo,Zwift,dFour,Kickr ,463,464,-1
87588,465473,2020-12-24 18:36:43,wahoo,Zwift - XRS - ZTR Thursday Night Race (A),dFour,Kickr ,444,444,0
88800,465473,2020-12-29 20:09:14,wahoo,Zwift - JETT ZWIFT Morning Race (A),dFour,Kickr ,413,414,-1
88801,465473,2020-12-28 19:10:22,wahoo,Zwift - Team TFC Mad Monday Winter Series (A),dFour,Kickr ,419,421,-2
89645,465473,2020-12-31 18:42:24,wahoo,Zwift - XRS - ZTR Thursday Night Race (A),dFour,Kickr ,475,474,1
89656,465473,2020-12-31 19:58:32,wahoo,Zwift,dFour,Kickr ,446,446,0
90962,465473,2021-01-03 14:13:00,wahoo,I&#039;ve Got a Bad Feeling About This :s - KISS 100 x 2,dFour,Kickr ,446,446,0
91971,465473,2021-01-05 19:56:06,wahoo,Zwift - KISS Race Series - EU PM (A),dFour,Kickr ,449,449,0
93098,465473,2021-01-07 18:26:44,wahoo,Zwift - FUSION WINTER CUP (A),dFour,Kickr ,441,441,0
93591,465473,2021-01-08 20:18:21,wahoo,Zwift - 3R Innsbruckring Flat Race - 4 Laps (35.2km/21.9mi 308m) (A),dFour,Kickr ,443,442,1
94515,465473,2021-01-10 14:13:44,wahoo,Zwift - KISS 100 Race Series - Americas (A),dFour,Kickr ,464,464,0
95959,465473,2021-01-12 18:11:39,wahoo,Zwift - Zwift Racing League | WTRL - Men&#039;s/Mixed EMEA E1 DIVISION 1 (A),dFour,Kickr ,449,444,5
97637,465473,2021-01-14 17:57:00,wahoo,Zwift - Doddie Aid Hare and Hounds Race (A),dFour,Kickr ,420,421,-1
100524,465473,2021-01-20 17:12:54,wahoo,Zwift,Favero Assioma,Kickr ,396,388,8
100529,465473,2021-01-20 13:59:23,wahoo,Zwift - KISS Race Series - Pacific AM (A),Favero Assioma,Kickr ,463,461,2
101565,465473,2021-01-22 20:22:05,wahoo,Zwift zrl recon,Favero Assioma,Kickr ,400,398,2
102469,465473,2021-01-24 14:07:35,wahoo,Zwift - KISS 100 Race Series - Americas (A),Favero Assioma,Kickr ,416,402,14
103768,465473,2021-01-26 18:08:41,wahoo,Zwift - Zwift Racing League | WTRL - Men&#039;s/Mixed EMEA E1 DIVISION 1 (A),Favero Assioma,Kickr ,436,437,-1
105950,465473,2021-01-30 19:59:23,wahoo,Zwift - 3R Flat Race (A),Favero Assioma,Kickr ,465,461,4
105952,465473,2021-01-30 21:09:51,wahoo,Zwift - 3R Gotham Grind Flat Race - 3 Laps (27.8km/17.4mi 87m) (A),Favero Assioma,Kickr ,406,406,0
109115,465473,2021-02-04 17:56:47,wahoo,Zwift - Renegade Race (A),Favero Assioma,Kickr ,392,393,-1
110170,465473,2021-02-05 15:26:39,wahoo,Zwift,Favero Assioma,Kickr ,428,429,-1
110171,465473,2021-02-06 17:56:47,wahoo,Zwift - 3R Three Sisters Hilly Race (47km/29.2mi 879m) (A),Favero Assioma,Kickr ,443,443,0
111597,465473,2021-02-09 18:13:02,wahoo,Zwift - Zwift Racing League | WTRL - TTT,Favero Assioma,Kickr ,447,446,1
113161,465473,2021-02-10 22:03:26,wahoo,Zwift - 3R Innsbruckring Flat Race - 3 Laps (26.4km/16.4mi 231m) (A),Favero Assioma,Kickr ,438,440,-2
113164,465473,2021-02-11 19:57:35,wahoo,Zwift - KISS Race Series,Favero Assioma,Kickr ,490,491,-1
113748,465473,2021-02-12 20:17:02,wahoo,Zwift - 3R Innsbruckring Flat Race - 4 Laps (35.2km/21.9mi 308m) (A),Favero Assioma,Kickr ,443,444,-1
115211,465473,2021-02-14 15:23:27,wahoo,Zwift - 3R Watopia 65km Race - 6 laps (40mi 324m) (A),Favero Assioma,Kickr ,409,409,0
116020,465473,2021-02-16 18:11:59,wahoo,Zwift - Zwift Racing League | WTRL - Men&#039;s/Mixed EMEA E1 DIVISION 1 (A),dFour,Kickr ,456,445,11
118605,465473,2021-02-20 19:21:53,wahoo,Zwift - 3R Endurance Series p/b OTE Sports- 1st place!,dFour,Kickr ,398,398,0
119926,465473,2021-02-24 00:38:27,wahoo,Zwift - Zwift Racing League | WTRL - Men&#039;s/Mixed AMERICAS E DIVISION 1 (A),dFour,Kickr ,424,412,12
120966,465473,2021-02-25 19:58:05,wahoo,Zwift - KISS Race Series - EU PM (A),dFour,Kickr ,453,452,1
121912,465473,2021-02-27 19:28:04,wahoo,Zwift - 3R Endurance Series p/b OTE Sports (A),dFour,Kickr ,412,413,-1
123080,465473,2021-03-02 18:14:58,wahoo,Zwift - Zwift Racing League | WTRL - Men&#039;s/Mixed EMEA E1 DIVISION 1 - Win!!,dFour,Kickr ,431,442,-11
124230,465473,2021-03-04 19:57:07,wahoo,Zwift - KISS Race Series - EU PM (A),dFour,Kickr ,471,472,-1
125693,465473,2021-03-07 14:14:43,wahoo,Zwift - KISS 100 Race Series (Americas) - The Uber Pretzel Edition (A),dFour,Kickr ,473,473,0
125695,465473,2021-03-06 21:07:45,wahoo,Zwift - 3R Gotham Grind Flat Race - 3 Laps (27.8km/17.4mi 87m) (A),dFour,Kickr ,377,371,6
38344,499737,2020-05-28 17:22:10,neo,Zwift - WTRL Team Time Trial (C),4iii,TACX Neo ,319,309,10
39046,499737,2020-06-02 09:57:41,neo,Zwift - KISS at Race - Americas AM (A),4iii,TACX Neo ,299,301,-2
39604,499737,2020-06-04 17:09:16,neo,Zwift - Espresso,4iii,TACX Neo ,305,302,3
45838,499737,2020-07-09 18:48:31,neo,Zwift - Frappe,4iii,TACX Neo ,286,287,-1
56084,499737,2020-09-17 15:49:11,neo,Zwift - France,4iii,TACX Neo ,226,231,-5
58410,499737,2020-09-26 02:52:48,neo,Zwift - France,4iii,TACX Neo ,212,225,-13
109631,522837,2021-02-05 10:23:14,wahoo,Three sisters test,Quarq power meter,Wahoo Kickr,300,275,25
118972,523906,2021-02-22 12:23:31,neo,Test Three Sisters,quarq,Neo,343,340,3
127598,523906,2021-03-12 18:45:01,wahoo,Team Italy Rosa League,Quarq,Wahoo Kickr V5,339,336,3
33224,382490,2020-05-10 09:05:01,neo,Zwift - ERacing Warmup,Zwift,Tacx Neo,379,368,11
36091,382490,2020-05-19 17:29:58,neo,Zwift - ERacing Warmup,Verve Infocrank Crankset,Tacx Neo,358,355,3
36518,382490,2020-05-20 16:59:59,neo,2020/05/20 18:00 - Swedish Zwift Racing Cup by SZR,Verve Infocrank Crankset,Tacx Neo,393,380,13
37382,382490,2020-05-24 09:04:55,neo,2020/05/24 10:05 - Newbury Velo Road Race,Verve Infocrank Crankset,Tacx Neo,392,382,10
9332,509565,2020-01-14 18:20:18,wahoo,Zwift - Flanders De Ronde Race (A),fav assioma,kickr core,348,343,5
10723,509565,2020-01-23 19:16:54,wahoo,Zwift - Tour de Zwift // Pro-Am Invitational,Favero Assioma,Kickr Core,377,373,4
20262,509565,2020-03-24 19:13:56,wahoo,Zwift - Tour of Watopia Pro-Am Men&#039;s Race #3 (A),Favero Assioma,Kickr Core,324,329,-5
23321,509565,2020-04-09 18:09:47,wahoo,Zwift - London International // Zwift Classic (A),Favero Assioma,Kickr Core,362,361,1
25605,509565,2020-04-17 18:10:51,wahoo,Zwift - Richmond Challenge // Zwift Classic (A),Favero Assioma,Kickr Core,343,343,0
30400,509565,2020-05-02 07:55:54,wahoo,Zwift - Flanders Toeristenkoers by PeakPower (A),Favero Assioma,Kickr Core,337,338,-1
39429,509565,2020-06-03 17:59:15,wahoo,Zwift - Zwift NL League - Woensdagavond Competitie (A),Favero Assioma,Kickr Core,352,341,11
50482,509565,2020-08-14 17:57:39,wahoo,Zwift - TFC Summer Series  (A),Favero Assioma,Kickr Core,294,292,2
53289,509565,2020-09-03 18:42:53,wahoo,Zwift - XRS - ZTR Thursday Night Race (A),Favero Assioma,Kickr Core,368,363,5
55979,509565,2020-09-17 18:11:53,wahoo,Zwift - Watopia,Favero Assioma,Kickr Core,336,332,4
60498,509565,2020-10-08 17:57:07,wahoo,Zwift -  Flanders The BZR Ronde  (A),Favero Assioma,Kickr Core,355,351,4
63485,509565,2020-10-20 17:18:17,wahoo,Zwift - Zwift Racing League | WTRL - EMEA E (MEN) - TTT Grp 1,Favero Assioma,Kickr Core,347,348,-1
66258,509565,2020-10-29 18:58:21,wahoo,Zwift -  Flanders The BZR Ronde  (A),Favero Assioma,Kickr Core,355,352,3
69796,509565,2020-11-10 18:14:04,wahoo,Zwift - Zwift Racing League | WTRL - EMEA E1 (MEN) -  Division 1 (A),Favero Assioma,Kickr Core,382,377,5
70789,509565,2020-11-12 18:58:40,wahoo,Zwift -  Flanders The BZR Ronde  (A),Favero Assioma (to Zwift),Kickr Core (to Garmin),372,360,12
73214,509565,2020-11-19 18:40:42,wahoo,Zwift -  Flanders The BZR Ronde  (A),Favero Assioma (to Zwift),Kickr Core (to Garmin),324,315,9
73603,509565,2020-11-20 18:28:54,wahoo,Zwift - Team WEZ Friday Race,Favero Assioma (to Zwift),Kickr Core (to Garmin),391,386,5
75809,509565,2020-11-23 19:17:02,wahoo,Zwift - Team TFC Mad Monday Races (A),Favero Assioma (to Zwift),Kickr Core (to Garmin),311,310,1
76399,509565,2020-11-26 18:56:49,wahoo,Zwift -  Flanders The BZR Ronde  (A),Favero Assioma (to Zwift),Kickr Core (to Garmin),362,354,8
78138,509565,2020-12-01 18:20:35,wahoo,Zwift - Zwift Racing League | WTRL - Men&#039;s EMEA E1 DIVISION 1 (A),Favero Assioma (to Zwift),Kickr Core (to Garmin),337,336,1
79316,509565,2020-12-03 18:58:15,wahoo,Zwift - BENELIGA 2020-2021 (E),Favero Assioma (to Zwift),Wahoo Kickr C (to Garmin),338,343,-5
81837,509565,2020-12-10 18:57:38,wahoo,Zwift - BENELIGA 2020-2021 (E),Favero Assioma (to Zwift),Wahoo Kickr C (to Garmin),358,345,13
84593,509565,2020-12-17 18:57:50,wahoo,Zwift - BENELIGA 2020-2021 (E),Favero Assioma (to Zwift),Wahoo Kickr C (to Garmin),365,360,5
87941,509565,2020-12-27 14:13:11,wahoo,Zwift - KISS 100 Race Series - Americas (A),Favero Assioma (to Zwift),Wahoo Kickr C (to Garmin),340,342,-2
89126,509565,2020-12-30 17:58:52,wahoo,Zwift - MIDWEEK Winter Series by SZR (A),Favero Assioma (to Zwift),Wahoo Kickr C (to Garmin),356,358,-2
89740,509565,2021-01-01 08:28:28,wahoo,Zwift - Flanders Endurance Series (E),Favero Assioma (to Zwift),Wahoo Kickr C (to Garmin),367,365,2
90873,509565,2021-01-03 16:04:01,wahoo,Zwift - 3R Tick Tock Flat Race - 1 Lap (19km/11.8mi 50m) (A),Favero Assioma (to Zwift),Wahoo Kickr C (to Garmin),327,333,-6
93017,509565,2021-01-07 18:58:08,wahoo,BENELIGA 2020-2021,Favero Assioma (to Zwift),Wahoo Kickr C (to Garmin),356,348,8
94267,509565,2021-01-10 08:59:28,wahoo,Zwift - Paceheads Race (A),Favero Assioma (to Garmin),Wahoo Kickr C (to Zwift),340,331,9
95084,509565,2021-01-11 19:18:29,wahoo,Zwift - Team TFC Mad Monday Winter Series (A),Favero Assioma (to Garmin),Wahoo Kickr C (to Zwift),367,369,-2
97110,509565,2021-01-14 18:57:48,wahoo,BENELIGA 2020-2021,Favero Assioma (to Zwift),Kickr Core (to Garmin),355,366,-11
101267,509565,2021-01-21 18:57:39,wahoo,Zwift - BENELIGA 2020-2021 (E),Favero Assioma (to Zwift),Wahoo Kickr C (to Garmin),348,342,6
104737,509565,2021-01-28 18:25:35,wahoo,Zwift - BENELIGA 2020-2021 (E),Favero Assioma (to Garmin),Wahoo Kickr C (to Zwift),348,342,6
109793,509565,2021-02-06 08:27:35,wahoo,Zwift - Zwift Fondo Series: Gran Fondo,Favero Assioma (to Garmin),Wahoo Kickr C (to Zwift),354,352,2
111613,509565,2021-02-09 18:21:36,wahoo,Zwift - Zwift Racing League | WTRL - Men&#039;s/Mixed EMEA E1 DIVISION 1 (A),Favero Assioma (to Garmin),Wahoo Kickr C (to Zwift),375,370,5
113130,509565,2021-02-11 18:59:08,wahoo,Zwift - BENELIGA 2020-2021 (E),Favero Assioma (to Garmin),Wahoo Kickr C (to Zwift),387,389,-2
115889,509565,2021-02-16 18:14:48,wahoo,Zwift - Zwift Racing League | WTRL - Men&#039;s/Mixed EMEA E1 DIVISION 1 (A),Favero Assioma DUO (to Garmin),Wahoo Kickr C (to Zwift),379,381,-2
117377,509565,2021-02-18 18:59:05,wahoo,Zwift - BENELIGA 2020-2021 (E),Favero Assioma DUO (to Garmin),Wahoo Kickr C (to Zwift),344,340,4
123036,509565,2021-03-02 18:19:15,wahoo,Zwift - Zwift Racing League | WTRL - Men&#039;s/Mixed EMEA E1 DIVISION 1 (A),Favero Assioma (to Garmin),Wahoo Kickr C (to Zwift),351,347,4
124208,509565,2021-03-04 18:59:30,wahoo,Zwift - Flanders The BZR Ronde Spring Classics League (A),Favero Assioma DUO (to Garmin),Wahoo Kickr C (to Zwift),328,324,4
126655,509565,2021-03-10 18:58:58,wahoo,Zwift - Zwift NL Race Day (A),Favero Assioma DUO (to Garmin),Wahoo Kickr C (to Zwift),362,360,2
127845,509565,2021-03-13 10:07:33,wahoo,ZADA - Three Sisters Test,Favero Assioma DUO (to Garmin),Wahoo Kickr C (to Zwift),387,382,5
129230,509565,2021-03-16 18:29:02,wahoo,Zwift - CeramicSpeed Race Series: Open Race (A),Favero Assioma DUO (to Garmin),Wahoo Kickr C (to Zwift),354,355,-1
64357,376620,2020-10-23 11:46:08,wahoo,FTP Test,Stages,Kickr,300,301,-1
76799,37327,2020-11-28 09:55:48,neo,Zwift - 11/28/2020,Quarq,Neo,360,356,4
76806,37327,2020-11-28 09:55:48,neo,Zwift - 11/28/2020,Quarq,neo,360,356,4
78792,37327,2020-12-02 17:55:42,neo,quarq / neo,quarq,neo,363,359,4
88701,37327,2020-12-29 18:51:15,neo,Zwift - 12/29/2020,quarq,neo,433,424,9
100366,37327,2021-01-20 19:09:13,neo,TUZ Winter chase race league,quarq,neo,375,369,6
25538,458382,2020-04-17 13:31:02,neo,Zwift - Innsbruck,inpower LT,TACX NEO 1,188,180,8
25661,458382,2020-04-17 18:30:45,neo,Zwift - BRT Ages Racing League (D),inpower LT,TACX NEO 1,325,309,16
26521,458382,2020-04-20 15:59:51,neo,Zwift - F lorent FLAMANT[3CY]&#039;s Meetup - Road to Ruins,POWERMAX2,TACX NEO 1,155,152,3
4101,510351,2019-11-11 18:15:15,wahoo,Zwift - DBR Monday Race (A),Power2Max - NGEco,Kickr Core,302,304,-2
4434,510351,2019-11-18 18:15:12,wahoo,Zwift - DBR Monday Race (A),Power2Max - NGEco,Kickr Core,303,305,-2
15357,510351,2020-02-23 16:20:00,wahoo,Zwift - ZHR Audax 100km (Ride) (B),Power2Max - NGEco,Kickr Core,241,241,0
15929,510351,2020-02-27 19:19:59,wahoo,Zwift - BRT Criterium Racing League (A),Power2Max - NGEco,Kickr Core,290,288,2
16648,510351,2020-03-03 17:59:41,wahoo,Zwift - ZRG Winter Race Series 8/10 - TT Bologna (A),Power2Max - NGEco,Kickr Core,304,296,8
57935,510351,2020-09-27 14:34:26,wahoo,Zwift - France,Power2Max - NGEco,Kickr Core,271,270,1
72256,510351,2020-11-17 18:23:10,wahoo,Zwift - Zwift Racing League | WTRL - Men&#039;s EMEA E1 DIVISION 2 (A),Power2Max - NGEco,Kickr Core,316,308,8
83540,510351,2020-12-15 18:23:53,wahoo,Zwift - Zwift Racing League | WTRL - Men&#039;s EMEA E1 DIVISION 2 (A),Power2Max - NGEco,Kickr Core,314,314,0
91808,510351,2021-01-05 18:29:21,wahoo,Zwift - ZTPL.CC Classic Race (E),Power2Max - NGEco,Kickr Core,331,331,0
99709,510351,2021-01-19 18:25:56,wahoo,Zwift - Zwift Racing League | WTRL - Men&#039;s/Mixed EMEA E1 DIVISION 5 (A),Power2Max - NGEco,Kickr Core,331,327,4
103472,510351,2021-01-26 18:15:54,wahoo,Zwift - Zwift Racing League | WTRL - Men&#039;s/Mixed EMEA E1 DIVISION 2 (A),Power2Max - NGEco,Kickr Core,327,325,2
110263,510351,2021-02-07 06:00:15,wahoo,Zwift - KISS 100 Race Series - EU (A),Power2Max - NGEco,Kickr Core,324,319,5
87491,524936,2020-12-26 14:29:33,wahoo,Zwift - EVR Summer Series (A),Favero Assioma DUO,Wahoo Kickr 5/2020,338,345,-7
88205,524936,2020-12-28 13:14:34,wahoo,Zwift - Magnum mOnDayZ RACE presented by Team ODZ,Favero Assioma DUO,Wahoo Kickr 5/2020,403,397,6
88839,524936,2020-12-30 00:29:44,wahoo,Zwift - Toronto Hustle Holiday Classic Stage Race: Stage Three (A),Favero Assioma DUO,Wahoo Kickr 5/2020,413,394,19
89243,524936,2020-12-30 23:29:49,wahoo,Zwift - ZHQ FutureWorks Circuit Race - Anti-sandbagging (A),Favero Assioma DUO,Wahoo Kickr 5/2020,313,313,0
89671,524936,2020-12-31 23:08:13,wahoo,Zwift - 2x20 FTP Intervals,Favero Assioma DUO,Wahoo Kickr 5/2020,356,352,4
90834,524936,2021-01-03 15:24:19,wahoo,Zwift - 3R Watopia 65km Race - 6 laps (40mi 324m) (A),Favero Assioma DUO,Wahoo Kickr 5/2020,342,350,-8
92001,524936,2021-01-05 23:59:01,wahoo,Zwift - TDZ Stage 1: Longer Ride,Favero Assioma DUO,Wahoo Kickr 5/2020,369,381,-12
93117,524936,2021-01-08 00:39:11,wahoo,WTRL Team Time Trial - Zone 10 (C),Favero Assioma DUO,Wahoo Kickr 5/2020,384,388,-4
95285,524936,2021-01-11 21:59:02,wahoo,Zwift - TDZ Stage 2: Longer Ride,Favero Assioma DUO,Wahoo Kickr 5/2020,376,384,-8
97255,524936,2021-01-15 00:43:02,wahoo,WTRL Team Time Trial - Zone 10 (C),Favero Assioma DUO,Wahoo Kickr 5/2020,362,365,-3
98008,524936,2021-01-16 12:59:10,wahoo,Zwift - TDZ Stage 3: Longer Ride,Favero Assioma DUO,Wahoo Kickr 5/2020,359,362,-3
100001,524936,2021-01-20 00:56:33,wahoo,Zwift - Emily&#039;s Short Mix,Favero Assioma DUO,Wahoo Kickr 5/2020,379,382,-3
100583,524936,2021-01-21 00:59:14,wahoo,Zwift - TDZ Stage 4: Longer Ride,Favero Assioma DUO,Wahoo Kickr 5/2020,391,392,-1
101961,524936,2021-01-23 15:14:28,wahoo,Zwift - NYC,Favero Assioma DUO,Wahoo Kickr 5/2020,390,394,-4
102863,524936,2021-01-25 16:58:23,wahoo,Zwift - Emily&#039;s Short Mix,Favero Assioma DUO,Wahoo Kickr 5/2020,403,409,-6
103822,524936,2021-01-27 00:49:22,wahoo,Zwift - Emily&#039;s Short Mix,Favero Assioma DUO,Wahoo Kickr 5/2020,373,376,-3
104924,524936,2021-01-29 00:46:17,wahoo,Zwift - Emily&#039;s Short Mix,Favero Assioma DUO,Wahoo Kickr 5/2020,360,362,-2
106234,524936,2021-01-31 00:59:27,wahoo,Zwift - TDZ Stage 6: Longer Ride,Favero Assioma DUO,Wahoo Kickr 5/2020,370,376,-6
108158,524936,2021-02-03 16:59:05,wahoo,Zwift - Emily&#039;s Short Mix,Favero Assioma DUO,Wahoo Kickr 5/2020,387,395,-8
109141,524936,2021-02-05 00:46:02,wahoo,Zwift - WTRL Team Time Trial - Zone 10 (D),Favero Assioma DUO,Wahoo Kickr 5/2020,345,348,-3
110933,524936,2021-02-08 17:00:57,wahoo,Zwift - TDZ Stage 8: Group Ride,Favero Assioma DUO,Wahoo Kickr 5/2020,382,389,-7
114438,524936,2021-02-13 21:10:00,wahoo,Zwift - 3R Gotham Grind Flat Race - 3 Laps (27.8km/17.4mi 87m) (A),Favero Assioma DUO,Wahoo Kickr 5/2020,354,355,-1
116235,524936,2021-02-17 00:48:29,wahoo,Zwift - Emily&#039;s Short Mix,Favero Assioma DUO,Wahoo Kickr 5/2020,409,409,0
117523,524936,2021-02-19 00:44:21,wahoo,Zwift - WTRL Team Time Trial - Zone 13 (D),Favero Assioma DUO,Wahoo Kickr 5/2020,372,377,-5
119980,524936,2021-02-24 00:48:09,wahoo,Zwift - Zwift Racing League | WTRL - Men&#039;s/Mixed AMERICAS E DIVISION 4 (A),Favero Assioma DUO,Wahoo Kickr 5/2020,360,362,-2
123288,524936,2021-03-03 00:56:29,wahoo,Zwift - Miracle,Favero Assioma DUO,Wahoo Kickr 5/2020,368,370,-2
14920,520895,2020-02-20 18:18:53,wahoo,Zwift - 02/20/2020,4iiii,kickr core,255,257,-2
14965,520895,2020-02-20 19:54:44,wahoo,Zwift - WTRL Team Time Trial (D) - WKG VOMIT,4iiii,kickr core,350,361,-11
15036,520895,2020-02-21 13:32:28,wahoo,Zwift - Tour of Innsbruck // Stage 1,4iiii,kickr core,287,292,-5
103970,517566,2020-12-15 18:10:45,wahoo,Zwift - Zwift Racing League | WTRL - Men&#039;s EMEA E2 DIVISION 2 (B),Favero Assioma DUO,Wahoo KICKR Power v5.0,343,338,5
107470,517566,2021-02-02 18:25:57,wahoo,Zwift - Zwift Racing League | WTRL - Men&#039;s/Mixed EMEA E2 DIVISION 3 (A),Favero Assioma DUO,Wahoo KICKR Power v5.0,356,368,-12
119694,517566,2021-02-23 18:25:52,wahoo,Zwift - Zwift Racing League | WTRL - Men&#039;s/Mixed EMEA E2 DIVISION 3 (A),Favero Assioma DUO,Wahoo KICKR Power v5.0,383,377,6
120573,517566,2021-02-25 07:01:57,wahoo,Zwift Duathlon League - Bike,Favero Assioma DUO,Wahoo KICKR Power v5.0,356,352,4
127798,517566,2021-03-13 07:59:58,wahoo,Zwift - Zwift NL - Lekker tochtje hoor! (E),Favero Assioma DUO,Wahoo KICKR Power v5.0,324,322,2
129811,517566,2021-03-17 19:01:59,wahoo,Zwift - Zwift Duathlon League - Bike (B),Favero Assioma DUO,Wahoo KICKR Power v5.0,353,346,7
85853,420644,2020-12-21 18:14:48,wahoo,Zwift -  DBR Monday Race (A),Vector 3,Wahoo Kickr,346,353,-7
99043,420644,2021-01-18 18:14:08,wahoo,Zwift -  DBR Monday Race (A),Vector 3,Wahoo Kickr,335,340,-5
102850,420644,2021-01-25 18:14:24,wahoo,Zwift -  DBR Monday Race (A),Vector 3,Wahoo Kickr,343,347,-4
106729,420644,2021-02-01 18:14:45,wahoo,Zwift -  DBR Monday Race (A),Vector 3,Wahoo Kickr,361,370,-9
122606,420644,2021-03-01 18:14:56,wahoo,Zwift -  DBR Monday Race (A),Vector 3,Wahoo Kickr,334,337,-3
128742,420644,2021-03-15 18:14:40,wahoo,Zwift -  DBR Monday Race (A),Vector 3,Wahoo Kickr,335,341,-6
105734,115922,2021-01-30 11:59:50,neo,Zwift - TDZ Stage 6: Longer Ride,Quarq,NEO,264,264,0
95420,537347,2021-01-12 08:44:54,wahoo,Zwift - Zwift Racing League | WTRL - Men&#039;s/Mixed APAC DIVISION 1 (A),Powertap P1S,Wahoo Kickr,337,350,-13
96202,537347,2021-01-13 10:44:54,wahoo,Zwift - The Morning Grind by STPC (A),Powertap P1S,Wahoo Kickr,344,345,-1
98121,537347,2021-01-16 15:15:22,wahoo,Zwift - OH MY CRIT - Saturday Smash Race (A),Powertap P1S,Wahoo Kickr,332,339,-7
101495,537347,2021-01-22 18:29:11,wahoo,Zwift - KIRCHMAIR Race Series (A),Powertap P1S,Wahoo Kickr,335,354,-19
108133,537347,2021-02-02 08:44:34,wahoo,Zwift - Zwift Racing League | WTRL - Men&#039;s/Mixed APAC DIVISION 1 (A),Morning_Ride,Wahoo Kickr,333,347,-14
108276,537347,2021-02-03 18:58:44,wahoo,Movistar Team Challenge Community Qualifier Race #1,Powertap P1S,Wahoo Kickr,368,373,-5
111319,537347,2021-02-09 08:51:58,wahoo,Zwift - Zwift Racing League | WTRL - Men&#039;s/Mixed APAC DIVISION 1 (A),Powertap P1S,Wahoo Kickr,354,369,-15
112248,537347,2021-02-10 17:42:27,wahoo,Zwift - MIDWEEK Winter Series by SZR (A),Powertap P1S,Wahoo Kickr,344,356,-12
112862,537347,2021-02-11 17:03:56,wahoo,Zwift - OH MY CRIT!! - The Double Race 2/2 (A),Powertap P1S,Wahoo Kickr,359,366,-7
115597,537347,2021-02-16 08:44:20,wahoo,Zwift - Zwift Racing League | WTRL - Men&#039;s/Mixed APAC DIVISION 1 (A),Powertap P1S,Wahoo Kickr,352,364,-12
116612,537347,2021-02-17 17:59:56,wahoo,Zwift - MIDWEEK Winter Series by SZR (A),Powertap P1S,Wahoo Kickr,346,361,-15
117190,537347,2021-02-18 16:14:21,wahoo,Zwift - OH MY CRIT!! - The Double Race 1/2 (A),Powertap P1S,Wahoo Kickr,359,377,-18
117197,537347,2021-02-18 17:03:31,wahoo,Zwift - OH MY CRIT!! - The Double Race 2/2 (A),Powertap P1S,Wahoo Kickr,363,378,-15
119401,537347,2021-02-23 08:43:40,wahoo,Zwift - Zwift Racing League | WTRL - Men&#039;s/Mixed APAC DIVISION 1 (A),Powertap P1S,Wahoo Kickr,292,304,-12
119237,539966,2021-02-22 20:32:49,neo,Zwift - TEST,Favero Assioma Uno,Tacx Neo,236,216,20
122193,539966,2021-02-28 19:00:11,neo,Zwift - TEST,Stages Power LR,Tacx Neo,207,216,-9
122504,539966,2021-03-01 20:04:10,neo,Zwift - TEST,Stages Power LR,Tacx Neo,234,226,8
122627,539966,2021-03-01 20:47:43,neo,Zwift - TEST,Stages Power L,Tacx Neo,205,204,1
125562,539966,2021-03-07 18:14:37,neo,Zwift - Absa Cape Epic Stage 1 pb Oakley - Open (B),Stages Power LR,Tacx Neo,280,289,-9
39863,536225,2020-06-05 15:15:01,wahoo,Zwift - 3R Sand and Sequoias Race (A),Srm powermeter,Kickr,379,416,-37
47854,536225,2020-07-27 12:39:59,wahoo,Zwift - 3R Volcano Climb Race - 1 Lap (22.4km/14mi 204m) (A),Srm powermeter,Kickr,357,371,-14
48904,536225,2020-08-05 13:00:19,wahoo,Zwift - KISS at Race - Pacific AM (A),Srm powermeter,Kickr,373,380,-7
73753,536225,2020-11-21 08:45:12,wahoo,Zwift - Crit City Race (A),Inpower,Kickr,366,365,1
75995,536225,2020-11-26 18:25:47,wahoo,Zwift - 11/26/2020,Inpower,Kickr,399,421,-22
95574,536225,2021-01-12 16:30:00,wahoo,Zwift - TEAM VEGAN Tofu Tornado (A),Srm powermeter,Kickr,388,419,-31
9698,539639,2020-01-16 18:14:10,wahoo,Zwift - FUSION ECT BEUNSTOPPABLE Racing Series (A) - winner winner chicken dinner,SRM,Wahoo KICKR,369,360,9
9884,539639,2020-01-18 08:59:50,wahoo,Zwift - Danmarks Cykle Union 2020 Cup (A) - ingen bjergben endnu,SRM,Wahoo KICKR,384,370,14
10150,539639,2020-01-20 17:04:00,wahoo,Zwift - Danmarks Cykle Union 2020 Cup (A)-2nd,SRM,Wahoo KICKR,361,352,9
11173,539639,2020-01-27 13:50:06,wahoo,Zwift - Tour de Zwift: Stage 4 Race (A) - 2nd,SRM,Wahoo KICKR,420,391,29
11775,539639,2020-01-30 17:46:20,wahoo,Zwift - Tour de Zwift: Stage 5 Race (A),SRM,Wahoo KICKR,336,348,-12
11776,539639,2020-01-30 17:46:20,wahoo,Zwift - Tour de Zwift: Stage 5 Race (A),SRM,Wahoo KICKR,336,322,14
116709,539639,2021-02-17 18:03:30,wahoo,Zwift - Danmarks Cykle Union & Partners 6/6 (A),SRM,Wahoo KICKR,365,371,-6
18587,541352,2020-03-18 17:59:19,wahoo,Zwift - SZR Spring Race Series (A),Stages (Garmin),Wahoo Kickr 18 (Zwift),341,348,-7
19502,541352,2020-03-24 18:40:08,wahoo,Zwift - Stage 4 Race (A) - Tour of Watopia 2020,Stages (Garmin),Wahoo Kickr 18 (Zwift),370,372,-2
19504,541352,2020-03-24 19:29:59,wahoo,British Cycling Race Series,Stages (Garmin),Wahoo Kickr 18 (Zwift),383,379,4
20087,541352,2020-03-28 09:29:57,wahoo,Zwift - DBR Saturday Race (A),Stages (Garmin),Wahoo Kickr 18 (Zwift),453,435,18
21059,541352,2020-04-01 09:44:55,wahoo,USA Cycling Race League by Indoor Specialist ,Stages (Garmin),Wahoo Kickr 18 (Zwift),375,375,0
21658,541352,2020-04-03 08:59:53,wahoo,Zwift -  Haute Route Watopia Stage 1 (E),Stages (Garmin),Wahoo Kickr 18 (Zwift),404,395,9
21925,541352,2020-04-04 08:59:55,wahoo,Zwift -  Haute Route Watopia Stage 2 (E),Stages (Garmin),Wahoo Kickr 18 (Zwift),368,359,9
22275,541352,2020-04-05 12:59:54,wahoo,Zwift -  Haute Route Watopia Stage 3 (E),Stages (Garmin),Wahoo Kickr 18 (Zwift),405,384,21
23263,541352,2020-04-09 15:14:51,wahoo,Zwift - OH CRIT!! - The Double Race - Race 1/2 (A),Stages (Garmin),Wahoo Kickr 18 (Zwift),401,393,8
23264,541352,2020-04-09 16:04:56,wahoo,Zwift - OH CRIT!! - The Double Race - Race 2/2 (A),Stages (Garmin),Wahoo Kickr 18 (Zwift),386,384,2
29689,541352,2020-04-30 17:29:57,wahoo,Zwift - British Cycling Time Trial Series (A),Stages (Garmin),Wahoo Kickr 18 (Zwift),382,375,7
30877,541352,2020-05-03 09:04:56,wahoo,Zwift - Newbury Velo Road Race (A),Stages (Garmin),Wahoo Kickr 18 (Zwift),364,363,1
32072,541352,2020-05-06 17:54:59,wahoo,Zwift - USA Cycling Race League p/b Saris+ThePro&#039;sCloset  (A),Stages (Garmin),Wahoo Kickr 18 (Zwift),389,384,5
34381,541352,2020-05-13 17:55:00,wahoo,Zwift - USA Cycling Race League by Indoor Specialist (A),Stages (Garmin),Wahoo Kickr 18 (Zwift),406,398,8
35093,541352,2020-05-15 17:03:18,wahoo,Zwift - Bologna TT  ,Stages (Garmin),Wahoo Kickr 18 (Zwift),410,396,14
36396,541352,2020-05-20 17:55:03,wahoo,Zwift - USA Cycling Race League by Indoor Specialist (A),Stages (Garmin),Wahoo Kickr 18 (Zwift),398,388,10
36663,541352,2020-05-21 17:39:59,wahoo,Zwift - Team 3R&#039;s Choice: Stage 5 Longer Race A/B,Stages (Garmin),Wahoo Kickr 18 (Zwift),420,404,16
37048,541352,2020-05-23 09:00:00,wahoo,Zwift - Cycling Ireland Zwift League Rd 9 (A),Stages (Garmin),Wahoo Kickr 18 (Zwift),394,381,13
37049,541352,2020-05-23 10:10:04,wahoo,Zwift - Team 3R&#039;s Choice: Stage 5 Longer Race A/B,Stages (Garmin),Wahoo Kickr 18 (Zwift),339,326,13
38116,541352,2020-05-27 17:54:58,wahoo,Zwift - USA Cycling Race League by Indoor Specialist (A),Stages (Garmin),Wahoo Kickr 18 (Zwift),409,405,4
39368,541352,2020-06-03 17:55:01,wahoo,Zwift - USA Cycling Race League by Indoor Specialist (A),Stages (Garmin),Wahoo Kickr 18 (Zwift),384,381,3
40796,541352,2020-06-10 17:54:57,wahoo,Zwift - USA Cycling Race League by Indoor Specialist (A),Stages (Garmin),Wahoo Kickr 18 (Zwift),456,446,10
42206,541352,2020-06-17 17:55:00,wahoo,Zwift - USA Cycling Race League by Indoor Specialist (A),Stages (Garmin),Wahoo Kickr 18 (Zwift),374,379,-5
42952,541352,2020-06-21 09:04:58,wahoo,Zwift - Newbury Velo Road Race (A),Stages (Garmin),Wahoo Kickr 18 (Zwift),409,412,-3
43400,541352,2020-06-24 17:54:56,wahoo,Zwift - USA Cycling Race League by Indoor Specialist (A),Stages (Garmin),Wahoo Kickr 18 (Zwift),394,376,18
44414,541352,2020-07-01 17:29:58,wahoo,Zwift - 3R & British Cycling South West - Series 2 (A),Stages (Garmin),Wahoo Kickr 18 (Zwift),405,398,7
45463,541352,2020-07-08 17:29:56,wahoo,Zwift - 3R & British Cycling South West - Series 2 (A),Stages (Garmin),Wahoo Kickr 18 (Zwift),379,370,9
46850,541352,2020-07-18 16:00:59,wahoo,Zwift - L&#039;Etape du Tour Stage 3 - Open,Stages (Garmin),Wahoo Kickr 18 (Zwift),360,351,9
46958,541352,2020-07-19 13:14:58,wahoo,Zwift - KISS at Race 100 - Americas (A),Stages (Garmin),Wahoo Kickr 18 (Zwift),339,333,6
47322,541352,2020-07-22 17:54:57,wahoo,Zwift - USA Cycling Race League by Indoor Specialist (A),Stages (Garmin),Wahoo Kickr 18 (Zwift),369,371,-2
49730,541352,2020-08-12 17:55:05,wahoo,Zwift - USA Cycling Race League by Indoor Specialist (A),Stages (Garmin),Wahoo Kickr 18 (Zwift),445,440,5
50231,541352,2020-08-16 12:59:59,wahoo,Zwift - Off The MAAP Stage 1 Race (A),Stages (Garmin),Wahoo Kickr 18 (Zwift),387,381,6
50552,541352,2020-08-18 17:00:01,wahoo,Zwift - Off The MAAP Stage 2 Race (A),Stages (Garmin),Wahoo Kickr 18 (Zwift),369,369,0
51085,541352,2020-08-21 13:00:01,wahoo,Zwift - Off The MAAP Stage 3 Race (A),Stages (Garmin),Wahoo Kickr 18 (Zwift),368,360,8
51653,541352,2020-08-25 13:00:01,wahoo,Zwift - Off The MAAP Stage 4 Race (A),Stages (Garmin),Wahoo Kickr 18 (Zwift),367,368,-1
52171,541352,2020-08-27 15:14:59,wahoo,Zwift - OH MY CRIT! - The Double Race 1/2 (A),Stages (Garmin),Wahoo Kickr 18 (Zwift),376,379,-3
52172,541352,2020-08-27 16:04:56,wahoo,Zwift - OH MY CRIT! - The Double Race 2/2 (A),Stages (Garmin),Wahoo Kickr 18 (Zwift),345,345,0
55565,541352,2020-09-16 16:59:56,wahoo,Zwift - MIDWEEK Autumn Series by SZR (A),Stages (Garmin),Wahoo Kickr 18 (Zwift),391,387,4
57071,541352,2020-09-23 16:59:58,wahoo,Zwift - MIDWEEK Autumn Series by SZR (A),Stages (Garmin),Wahoo Kickr 18 (Zwift),371,384,-13
63859,541352,2020-10-21 16:59:55,wahoo,Zwift - MIDWEEK Autumn Series by SZR (A),Stages (Garmin),Wahoo Kickr 18 (Zwift),398,393,5
65825,541352,2020-10-28 17:59:49,wahoo,Zwift - MIDWEEK Autumn Series by SZR (A),Stages (Garmin),Wahoo Kickr 18 (Zwift),411,395,16
66995,541352,2020-11-01 16:04:52,wahoo,Zwift - 3R Tick Tock Flat Race - 1 Lap (19km/11.8mi 50m) (A),Stages (Garmin),Wahoo Kickr 18 (Zwift),428,418,10
68008,541352,2020-11-04 17:59:56,wahoo,Zwift - MIDWEEK Autumn Series by SZR (A),Stages (Garmin),Wahoo Kickr 18 (Zwift),394,390,4
68760,541352,2020-11-07 11:09:56,wahoo,Zwift - ZA Road Race #1: 4 - 5 w/kg,Stages (Garmin),Wahoo Kickr 18 (Zwift),371,353,18
70230,541352,2020-11-11 17:59:54,wahoo,Zwift - MIDWEEK Autumn Series by SZR (A),Stages (Garmin),Wahoo Kickr 18 (Zwift),387,378,9
72618,541352,2020-11-18 17:59:51,wahoo,Zwift - MIDWEEK Autumn Series by SZR (A),Stages (Garmin),Wahoo Kickr 18 (Zwift),414,400,14
73751,541352,2020-11-21 08:29:48,wahoo,Zwift - TEAM VEGAN Tofu Tornado XL (A),Stages (Garmin),Wahoo Kickr 18 (Zwift),441,440,1
75519,541352,2020-11-25 17:59:48,wahoo,Zwift - MIDWEEK Autumn Series by SZR (A),Stages (Garmin),Wahoo Kickr 18 (Zwift),409,404,5
78573,541352,2020-12-02 17:59:43,wahoo,Zwift - MIDWEEK Winter Series by SZR (A),Stages (Garmin),Wahoo Kickr 18 (Zwift),399,388,11
78901,541352,2020-12-03 16:14:43,wahoo,Zwift - OH MY CRIT! - The Double Race 1/2 (A),Stages (Garmin),Wahoo Kickr 18 (Zwift),389,384,5
81082,541352,2020-12-09 17:59:45,wahoo,Zwift - MIDWEEK Winter Series by SZR (A),Stages (Garmin),Wahoo Kickr 18 (Zwift),392,408,-16
83999,541352,2020-12-16 17:59:42,wahoo,Zwift - MIDWEEK Winter Series by SZR (A),Stages (Garmin),Wahoo Kickr 18 (Zwift),390,384,6
86587,541352,2020-12-23 17:59:38,wahoo,Zwift - MIDWEEK Winter Series by SZR (A),Stages (Garmin),Wahoo Kickr 18 (Zwift),380,383,-3
87722,541352,2020-12-27 09:04:55,wahoo,Zwift - Newbury Velo Road Race (A),Stages (Garmin),Wahoo Kickr 18 (Zwift),397,394,3
92350,541352,2021-01-06 17:59:51,wahoo,Zwift - MIDWEEK Winter Series by SZR (A),Stages (Garmin),Wahoo Kickr 18 (Zwift),381,388,-7
96356,541352,2021-01-13 17:59:46,wahoo,Zwift - MIDWEEK Winter Series by SZR (A),Stages (Garmin),Wahoo Kickr 18 (Zwift),406,395,11
100304,541352,2021-01-20 17:59:47,wahoo,Zwift - MIDWEEK Winter Series by SZR (A),Stages (Garmin),Wahoo Kickr 18 (Zwift),406,395,11
104134,541352,2021-01-27 17:59:42,wahoo,Zwift - MIDWEEK Winter Series by SZR (A),Stages (Garmin),Wahoo Kickr 18 (Zwift),388,390,-2
105522,541352,2021-01-30 09:29:42,wahoo,Zwift - DBR SufferDay League III (A) ,Stages (Garmin),Wahoo Kickr 18 (Zwift),398,391,7
108193,541352,2021-02-03 17:59:41,wahoo,Zwift - MIDWEEK Winter Series by SZR (A),Stages (Garmin),Wahoo Kickr 18 (Zwift),369,370,-1
109814,541352,2021-02-06 09:29:40,wahoo,Zwift - DBR SufferDay League III (A),Stages (Garmin),Wahoo Kickr 18 (Zwift),399,387,12
112295,541352,2021-02-10 17:59:40,wahoo,Zwift - MIDWEEK Winter Series by SZR (A),Stages (Garmin),Wahoo Kickr 18 (Zwift),399,388,11
113951,541352,2021-02-13 08:29:44,wahoo,Zwift - TEAM VEGAN Tofu Tornado XL (A) + Endurance,Stages (Garmin),Wahoo Kickr 18 (Zwift),414,419,-5
116634,541352,2021-02-17 17:59:37,wahoo,Zwift - MIDWEEK Winter Series by SZR (A),Stages (Garmin),Wahoo Kickr 18 (Zwift),372,372,0
118218,541352,2021-02-20 08:29:40,wahoo,Zwift - TEAM VEGAN Tofu Tornado XL (A),Stages (Garmin),Wahoo Kickr 18 (Zwift),400,392,8
120277,541352,2021-02-24 17:59:35,wahoo,Zwift - MIDWEEK Winter Series by SZR (A),Stages (Garmin),Wahoo Kickr 18 (Zwift),413,410,3
123533,541352,2021-03-03 17:59:56,wahoo,Zwift - MIDWEEK Crit Race Series by SZR (A),Stages (Garmin),Wahoo Kickr 18 (Zwift),413,416,-3
126564,541352,2021-03-10 17:59:57,wahoo,Zwift - MIDWEEK Crit Race Series by SZR (A),Stages (Garmin),Wahoo Kickr 18 (Zwift),406,400,6
129219,541352,2021-03-16 18:29:53,wahoo,Zwift - CeramicSpeed Race Series: Open Race (A),Stages (Garmin),Wahoo Kickr 18 (Zwift),408,398,10
108637,502351,2021-02-03 19:18:42,wahoo,Zwift - 3R & Triathlon Ireland Race (B),Assioma Duo,Kickr Core,313,321,-8
111722,502351,2021-02-09 20:00:31,wahoo,Zwift - Zwift Racing League | WTRL - Men&#039;s/Mixed EMEA W2 DIVISION 1 (B),Assioma Duo,Kickr Core,339,342,-3
112642,502351,2021-02-10 19:20:20,wahoo,Zwift - 3R & Triathlon Ireland Race (B),Assioma Duo,Kickr Core,347,355,-8
120397,502351,2021-02-24 19:21:21,wahoo,Zwift - 3R & Triathlon Ireland Race iTT (B),Assioma Duo,Kickr Core,334,335,-1
123838,502351,2021-03-03 19:14:13,wahoo,Zwift - 3R & Triathlon Ireland Race (B),Assioma Duo,Kickr Core,352,352,0
125216,502351,2021-03-05 19:04:42,wahoo,Zwift - Zwift Racing League | WTRL Division Championships - Men&#039;s Points Race (A),Assioma Duo,Kickr Core,359,362,-3
125218,502351,2021-03-06 19:52:51,wahoo,Zwift - Zwift Racing League | WTRL Division Championships - Men&#039;s TTT (B),Assioma Duo,Kickr Core,348,359,-11
33567,497694,2020-05-09 14:44:56,neo,Zwift - GCA Liga #4 (D) Men Only,SRM Origin,Tacx Neo,390,384,6
33581,497694,2020-04-25 14:44:57,neo,Zwift - GCA Liga #2 (D) Men Only,SRM Origin,Tacx Neo,375,373,2
82049,497694,2020-11-26 18:44:58,neo,Zwift - XRS - ZTR Thursday Night Race (A),SRM Origin,Tacx Neo,372,360,12
112026,497694,2021-02-09 19:52:48,neo,Zwift - Zwift Racing League | WTRL - Men&#039;s/Mixed EMEA W1 DIVISION 2 (A),SRM Origin,Tacx Neo,381,381,0
113351,544841,2021-02-11 19:02:57,wahoo,TDZ stage 8 C,Assioma Duo,Wahoo Kickr,384,394,-10
113711,544841,2021-02-12 15:15:05,wahoo,Wahoo Kickr / Assioma Duo,Assioma Duo,Wahoo Kickr,416,380,36
115262,544841,2021-02-15 17:45:22,wahoo,PM test ,Assioma Duo,Wahoo Kickr,370,348,22
117395,544841,2021-02-18 16:15:15,wahoo,Wahoo Kickr / Assioma Duo,Assioma Duo,Wahoo Kickr,387,403,-16
129056,544841,2021-03-15 16:45:27,wahoo,Wahoo Kickr / Assioma Duo,Assioma Duo,Wahoo Kickr,357,366,-9
92537,415924,2021-01-06 15:00:00,wahoo,Zwift - TDZ Stage 1: Longer Ride,Garmin Vector 2,Kickr Core 18,321,313,8
17774,541854,2020-03-12 09:23:45,wahoo,Zwift - WTRL TTT (Relentless AF),STAGE (Verification),KICKR Core (Zwift),329,327,2
18032,541854,2020-03-14 10:09:55,wahoo,Zwift - Stage 2 Race (A) - Tour of Watopia 2020,STAGE (Verification),KICKR Core (Zwift),352,358,-6
18367,541854,2020-03-17 10:00:04,wahoo,Zwift - TOGURI: Zwift 20&#039; Warmup,STAGE (Verification),KICKR Core (Zwift),356,358,-2
19704,541854,2020-03-26 09:25:11,wahoo,Zwift - WTRL Team Time Trial (RELENTLESS),STAGE (Verification),KICKR Core (Zwift),352,355,-3
21336,541854,2020-04-02 09:26:17,wahoo,Zwift - WTRL Team Time Trial (w RELENTLESS),STAGES (Verification),KICKR Core (Zwift),343,345,-2
26916,541854,2020-04-22 11:20:05,wahoo,Zwift - 3R Flat Race - Volcano Circuit x6 (A),STAGES (Verification),KICKR Core (Zwift),344,342,2
32950,541854,2020-05-09 11:15:09,wahoo,Zwift - 3R Tick Tock Flat Race - 2 Lap (36km/22.4mi 100m) (A),STAGES (Verification),KICKR Core (Zwift),351,352,-1
38844,541854,2020-05-31 17:20:32,wahoo,Zwift - 3R Greater London 8 Hilly Race - 1 Lap (23.8km/14.8mi 238m) (A),STAGES (Verification),KICKR Core (Zwift),374,384,-10
39259,541854,2020-06-03 09:44:58,wahoo,Zwift - TOGURI: Zwift 20&#039; Warmup,STAGES (Verification),KICKR Core (Zwift),336,334,2
40973,541854,2020-06-11 09:59:52,wahoo,Zwift - KOA Sports League (A),STAGES (Verification),KICKR Core (Zwift),346,342,4
40976,541854,2020-06-11 10:39:54,wahoo,Zwift - DIRT Doozy Race (A),STAGES (Verification),KICKR Core (Zwift),316,312,4
43522,541854,2020-06-25 10:39:59,wahoo,Zwift - DIRT Doozy Race (A),STAGES (Verification),KICKR Core (Zwift),325,329,-4
43524,541854,2020-06-25 11:20:00,wahoo,Zwift - British Cycling Time Trial Series (A),STAGES (Verification),KICKR Core (Zwift),324,332,-8
45582,541854,2020-07-09 09:59:58,wahoo,Zwift - KOA Sports League Race (A),STAGES (Verification),KICKR Core (Zwift),333,337,-4
45584,541854,2020-07-09 10:39:53,wahoo,Zwift - DIRT Doozy Race (A),STAGES (Verification),KICKR Core (Zwift),320,323,-3
47417,541854,2020-07-23 09:59:59,wahoo,Zwift - Koa Sports League Race (A),STAGES (Verification),KICKR Core (Zwift),359,366,-7
48271,541854,2020-07-30 09:59:58,wahoo,Zwift - Koa Sports League Race (A),STAGES (Verification),KICKR Core (Zwift),348,361,-13
49040,541854,2020-08-06 09:59:58,wahoo,Zwift - Koa Sports League Race (A),STAGES (Verification),KICKR Core (Zwift),359,376,-17
49041,541854,2020-08-06 10:39:53,wahoo,Zwift - DIRT Doozy Race (A),STAGES (Verification),KICKR Core (Zwift),318,330,-12
50859,541854,2020-08-20 09:25:51,wahoo,Zwift - WTRL Espresso TTT (with intermittent),STAGES (Verification),KICKR Core (Zwift),363,367,-4
52197,541854,2020-08-27 10:39:58,wahoo,Zwift - DIRT Doozy Race (A),STAGES (Verification),KICKR Core (Zwift),346,357,-11
52847,541854,2020-08-27 10:00:05,wahoo,Zwift - Koa Sports League Race (A),STAGES (Verification),KICKR Core (Zwift),338,340,-2
52848,541854,2020-09-01 09:05:15,wahoo,Zwift - TOGURI: Zwift 20&#039; Warmup,STAGES (Verification),KICKR Core (Zwift),369,362,7
53889,541854,2020-09-08 09:05:01,wahoo,Zwift - TOGURI: Zwift 20&#039; Warmup,STAGES (Verification),KICKR Core (Zwift),331,329,2
55295,541854,2020-09-15 09:04:57,wahoo,Zwift - 3R Sundown Race Series  (A),STAGES (Verification),KICKR Core (Zwift),364,361,3
56774,541854,2020-09-22 09:05:12,wahoo,Zwift - 3R Sundown Race Series  (A),STAGES (Verification),KICKR Core (Zwift),346,337,9
58192,541854,2020-09-29 09:04:58,wahoo,Zwift - 3R Sundown Race Series  (A) + Cooldown,STAGES (Verification),KICKR Core (Zwift),351,351,0
59741,541854,2020-10-06 09:05:01,wahoo,Zwift - 3R Sundown Race Series - iTT (A),STAGES (Verification),KICKR Core (Zwift),361,354,7
60753,541854,2020-10-10 10:45:09,wahoo,Zwift - Into the Red by RELENTLESS (A),STAGES (Verification),KICKR Core (Zwift),352,347,5
62590,541854,2020-10-17 10:45:05,wahoo,Zwift - Into the Red by RELENTLESS (A),STAGES (Verification),KICKR Core (Zwift),359,365,-6
63335,541854,2020-10-20 09:59:59,wahoo,Zwift - KISS at Race - Americas AM (A),STAGES (Verification),KICKR Core (Zwift),362,364,-2
64853,541854,2020-10-25 11:10:11,wahoo,Zwift - ZA Road - Race #2 (A),STAGES (Verification),KICKR Core (Zwift),352,356,-4
68047,541854,2020-11-04 23:59:59,wahoo,Ligue Zwift Quebec 2020-21 - Race #1,STAGES (Verification),KICKR Core (Zwift),366,390,-24
70416,541854,2020-11-11 23:59:57,wahoo,League Zwift QC #2,STAGES (Verification),KICKR Core (Zwift),368,388,-20
71037,541854,2020-11-13 10:27:41,wahoo,Zwift - Sprintapalooza,STAGES (Verification),KICKR Core (Zwift),237,235,2
71602,541854,2020-11-15 11:30:04,wahoo,Zwift - Stages of DIRT,STAGES (Verification),KICKR Core (Zwift),372,386,-14
72781,541854,2020-11-18 23:59:55,wahoo,Zwift - League Zwift QC #3,STAGES (Verification),KICKR Core (Zwift),352,370,-18
73802,541854,2020-11-21 10:45:25,wahoo,Zwift - Into the Red by RELENTLESS (A),STAGES (Verification),KICKR Core (Zwift),340,351,-11
75393,541854,2020-11-25 10:47:58,wahoo,KICKR Core (Zwift) / STAGES (Verification),STAGES (Verification),KICKR Core (Zwift),272,273,-1
76828,541854,2020-11-28 10:45:19,wahoo,KICKR Core (Zwift) / STAGES (Verification),STAGES (Verification),KICKR Core (Zwift),364,392,-28
78812,541854,2020-12-03 10:29:28,wahoo,Zwift - WTRL TTT,STAGES (Verification),KICKR Core (Zwift),353,361,-8
80067,541854,2020-12-06 11:44:59,wahoo,KICKR Core (Zwift) / STAGES (Verification),STAGES (Verification),KICKR Core (Zwift),357,372,-15
81422,541854,2020-12-06 11:44:59,wahoo,KICKR Core (Zwift) / STAGES (Verification),STAGES (Verification),KICKR Core (Zwift),347,358,-11
83364,541854,2020-12-15 08:54:58,wahoo,KICKR Core (Zwift) / STAGES (Verification),STAGES (Verification),KICKR Core (Zwift),349,363,-14
85031,541854,2020-12-19 10:44:59,wahoo,KICKR Core (Zwift) / STAGES (Verification),STAGES (Verification),KICKR Core (Zwift),356,377,-21
97866,541854,2021-01-16 10:44:51,wahoo,Zwift - Into the Red by RELENTLESS (A),STAGES (Verification),KICKR Core (Zwift),347,351,-4
99985,541854,2021-01-20 00:14:56,wahoo,Zwift - MSCC Team Training (60&#039; Ven-Top),STAGES (Verification),KICKR Core (Zwift),332,340,-8
100674,541854,2021-01-21 10:24:56,wahoo,KICKR Core (Zwift) / STAGES (Verification),STAGES (Verification),KICKR Core (Zwift),338,346,-8
109741,541854,2021-02-06 10:45:06,wahoo,Zwift - Into the Red by RELENTLESS (A),STAGES (Verification),KICKR Core (Zwift),341,344,-3
112705,541854,2021-02-11 10:28:54,wahoo,KICKR Core (Zwift) / STAGES (Verification),STAGES (Verification),KICKR Core (Zwift),350,356,-6
119949,541854,2021-02-24 00:09:11,wahoo,MSCC - Team Tests,STAGES (Verification),KICKR Core (Zwift),359,366,-7
121745,541854,2021-02-27 17:29:54,wahoo,KICKR Core (Zwift) / STAGES (Verification),STAGES (Verification),KICKR Core (Zwift),343,343,0
24847,473552,2020-04-15 12:30:00,neo,Zwift - 3R LaGuardia Loop Flat Race - 10 Laps (28.3km/17.6mi 270m) (A),vector 3,neo,293,299,-6
8622,550613,2020-01-09 17:30:44,wahoo,DCUCup (B) - 2nd,"Zwift, Sram Red Quarq DZero","Garmin 520, Wahoo Kickr &#039;19",283,278,5
11383,550613,2020-01-28 17:59:55,wahoo,DCU Cup,"Zwift, Sram Red Quarq DZero","Garmin 520, Wahoo Kickr &#039;19",330,312,18
11393,550613,2020-01-28 14:01:15,wahoo,Zwift - Zwift Time Trial Tuesday: Tempus Fugit (E),"Zwift, Sram Red Quarq DZero","Garmin 520, Wahoo Kickr &#039;19",307,295,12
18941,550613,2020-03-20 19:14:58,wahoo,Tour of Watopia Pro-Am Men&#039;s Race,"Zwift, Sram Red Quarq DZero","Garmin 520, Wahoo Kickr &#039;19",365,350,15
19459,550613,2020-03-24 19:14:58,wahoo,Tour of Watopia Pro-Am Men&#039;s Race,"Zwift, Sram Red Quarq DZero","Garmin 520, Wahoo Kickr &#039;19",334,328,6
31738,550613,2020-05-05 18:14:59,wahoo,UNO X CUP - ondt i benene fra søndagens vEveresting,"Zwift, Sram Red Quarq DZero","Garmin 520, Wahoo Kickr &#039;19",356,341,15
34099,550613,2020-05-12 18:14:50,wahoo,UNO X CUP - Begynderfejl: sad for langt tilbage da feltet splitter,"*Garmin 520, Sram Red Quarq DZero","*Zwift, Wahoo Kickr &#039;19",324,312,12
56628,550613,2020-09-20 13:00:00,wahoo,Zwift - Invitational League // Qualifying Race #3 (Men) (A),"*Garmin 830, Sram Red Quarq DZero","*Zwift, Wahoo Kickr &#039;19",363,344,19
67327,550613,2020-11-02 19:00:01,wahoo,Zwift - EVR Europe Race (A),"Zwift, Sram Red Quarq DZero","Garmin 830, Wahoo Kickr gen 5",318,303,15
67689,550613,2020-11-03 18:35:22,wahoo,Zwift - Zwift Racing League | WTRL - Men&#039;s EMEA E1 DIVISION 1 (A),"Zwift, Sram Red Quarq DZero","Garmin 830, Wahoo Kickr gen 5",346,330,16
79086,550613,2020-12-03 18:29:58,wahoo,Zwift - FUSION DECEMBER CUP,"Zwift, Sram Red Quarq DZero","Garmin 830, Wahoo Kickr gen 5",317,301,16
80125,550613,2020-12-06 13:44:57,wahoo,Zwift,"Garmin 830, Sram Red Quarq DZero","Zwift, Wahoo Kickr Gen 5",298,293,5
80856,550613,2020-12-08 18:14:54,wahoo,Zwift,"Garmin 830, Sram Red Quarq DZero","Zwift, Wahoo Kickr Gen 5",345,338,7
92457,550613,2021-01-06 19:29:53,wahoo,"Zwift, Wahoo Kickr Gen 5 / Garmin 830, Sram Red Quarq DZero","Garmin 830, Sram Red Quarq DZero","Zwift, Wahoo Kickr Gen 5",335,328,7
92949,550613,2021-01-07 18:29:50,wahoo,"Zwift, Wahoo Kickr Gen 5 / Garmin 830, Sram Red Quarq DZero","Garmin 830, Sram Red Quarq DZero","Zwift, Wahoo Kickr Gen 5",352,353,-1
93424,550613,2021-01-08 16:59:42,wahoo,"Zwift, Wahoo Kickr Gen 5 / Garmin 830, Sram Red Quarq DZero","Garmin 830, Sram Red Quarq DZero","Zwift, Wahoo Kickr Gen 5",349,345,4
96827,550613,2021-01-14 12:14:50,wahoo,Zwift,"Garmin 830, Sram Red Quarq DZero","Zwift, Wahoo Kickr Gen 5",345,340,5
99023,550613,2021-01-18 17:29:50,wahoo,Zwift,"Garmin 830, Sram Red Quarq DZero","Zwift, Wahoo Kickr Gen 5",303,298,5
101036,550613,2021-01-21 18:29:49,wahoo,Zwift - FUSION WINTER CUP (A),"Garmin 830, Sram Red Quarq DZero","Zwift, Wahoo Kickr Gen 5",357,356,1
106844,550613,2021-02-01 17:34:54,wahoo,Zwift - TT,"Garmin 830, Sram Red Quarq DZero","Zwift, Wahoo Kickr Gen 5",350,344,6
108955,550613,2021-02-04 18:29:53,wahoo,Zwift - FUSION WINTER CUP #2nd,"Garmin 830, Sram Red Quarq DZero","Zwift, Wahoo Kickr Gen 5",363,356,7
111685,550613,2021-02-09 18:23:26,wahoo,Zwift - Zwift Racing League | WTRL - Men&#039;s/Mixed EMEA E1 DIVISION 1 (A),"Garmin 830, Sram Red Quarq DZero","Zwift, Wahoo Kickr Gen 5",379,371,8
113072,550613,2021-02-11 18:29:58,wahoo,Zwift - 02/11/2021,"Garmin 830, Sram Red Quarq DZero","Zwift, Wahoo Kickr Gen 5",365,364,1
115228,550613,2021-02-15 18:44:25,wahoo,Zwift - KATT Race by WKG - #1,"Garmin 830, Sram Red Quarq DZero","Zwift, Wahoo Kickr Gen 5",347,338,9
117344,550613,2021-02-18 18:29:56,wahoo,Zwift - FUSION WINTER CUP (A),"Garmin 830, Sram Red Quarq DZero","Zwift, Wahoo Kickr Gen 5",363,363,0
119533,550613,2021-02-23 17:00:10,wahoo,Zwift - BST Mountaingoat iTT (A),"Garmin 830, Sram Red Quarq DZero","Zwift, Wahoo Kickr Gen 5",351,349,2
120842,550613,2021-02-25 18:29:47,wahoo,Zwift - FUSION WINTER CUP (A),"Garmin 830, Sram Red Quarq DZero","Zwift, Wahoo Kickr Gen 5",407,402,5
124114,550613,2021-03-04 18:29:35,wahoo,Zwift - 03/04/2021,"Garmin 830, Sram Red Quarq DZero","Zwift, Wahoo Kickr Gen 5",354,347,7
127172,550613,2021-03-11 18:29:59,wahoo,Zwift - FUSION SPRING CUP (A),"Garmin 830, Sram Red Quarq DZero","Zwift, Wahoo Kickr Gen 5",352,353,-1
128749,550613,2021-03-15 18:14:54,wahoo,Zwift -  DBR Monday Race (A),"Garmin 830, Sram Red Quarq DZero","Zwift, Wahoo Kickr Gen 5",370,358,12
129332,550613,2021-03-16 18:29:55,wahoo,Zwift - CeramicSpeed Race Series: Open Race (A),"Garmin 830, Sram Red Quarq DZero","Zwift, Wahoo Kickr Gen 5",351,342,9
109359,553750,2021-02-05 17:02:22,wahoo,Zwift - Zwift Fast Fridays: Bologna Time Trial (E),Quarq power meter,Wahoo Kickr,331,311,20
111480,553750,2021-02-09 17:30:58,wahoo,Zwift - EVO CC Sprint Race Series  (B),Quarq power meter,Wahoo Kickr,342,317,25
19026,469365,2020-03-15 15:00:23,wahoo,Zwift - Stage 2 Race (B) - Tour of Watopia 2020,Garmin Vector 3S,Wahoo KICKR 2018,276,276,0
19030,469365,2020-03-10 17:59:44,wahoo,Zwift - SZR iTT Spring Racing League (B),Garmin Vector 3S,Wahoo KICKR 2018,270,267,3
19032,469365,2020-03-08 13:33:31,wahoo,Zwift - Crit City Race (B),4633488021,Wahoo KICKR 2018,266,265,1
19300,469365,2020-03-23 09:58:36,wahoo,Zwift - Stage 4 Race (B) - Tour of Watopia 2020,Garmin Vector 3S,Wahoo KICKR 2018,266,267,-1
19961,469365,2020-03-25 17:52:57,wahoo,Zwift - Swedish Zwift Racing Cup Women by SZR (A),Garmin Vector 3S,Wahoo KICKR 2018,256,255,1
78016,2021,2020-12-01 17:10:15,wahoo,Zwift - 3R Volcano KOM After Party Race - 2 laps + climb (40.2km/25mi 286m) (A),Rotor INPower,Wahoo Kickr,455,427,28
79321,2021,2020-12-04 11:20:05,wahoo,Zwift - 3R LaGuardia Loop Reverse Flat Race - 8 Laps (24.5km/15.2mi 216m) (A),Rotor INPower,Wahoo Kickr,422,391,31
99775,2021,2021-01-19 18:30:04,wahoo,Zwift - Zwift Racing League | WTRL - Men&#039;s/Mixed EMEA E2 DIVISION 4 (A),Rotor INPower,Wahoo Kickr,436,417,19
117345,2021,2021-02-18 18:59:54,wahoo,Zwift - BENELIGA 2020-2021 (E),Rotor INPower,Wahoo Kickr,452,426,26
21842,545920,2020-04-01 19:26:05,wahoo,Zwift - Stage 4 Race (A) - Tour of Watopia 2020,Quarq ,Kickr18,370,359,11
22116,545920,2020-04-04 23:48:50,wahoo,Zwift - Herd Summer Racing League Race 1 (A),Quarq ,Kickr18,424,412,12
23927,545920,2020-04-12 05:21:48,wahoo,Zwift - XRS Races: a Longer and Hard race (A),Quarq ,Kickr18,376,366,10
25027,545920,2020-04-15 06:47:37,wahoo,Zwift - ZHQ Beta Crit City Race (A),Quarq ,Kickr18,405,375,30
25028,545920,2020-04-15 06:47:37,wahoo,Zwift - Aussie Crit Crushers Race 1 of 2 (A),Quarq ,Kickr18,369,354,15
25029,545920,2020-04-15 06:47:37,wahoo,Zwift - Aussie Crit Crushers Race 2 of 2 (A),Primary,Kickr18,346,333,13
27746,545920,2020-04-24 20:47:31,wahoo,Zwift -  Triathlon NZ Saturday Race League (A),Quarq ,Kickr18,384,379,5
28965,545920,2020-04-29 07:26:52,wahoo,Zwift - dPAC.fit Climbers Day (A),Quarq ,Kickr18,390,379,11
29378,545920,2020-04-30 05:54:05,wahoo,Zwift - 3R Watopia Flat Route Race - 3 Laps (30.3km/18.8mi 162m) (A),Quarq ,Kickr18,375,363,12
29973,545920,2020-05-01 07:45:50,wahoo,Zwift - NTT Pro Cycling Hilly Race (A),Quarq ,Kickr18,402,393,9
30296,545920,2020-05-01 20:45:02,wahoo,Zwift -  Triathlon NZ Saturday Race League (A),Quarq ,Kickr18,372,358,14
33820,545920,2020-05-12 08:25:37,wahoo,Zwift - SRAM Send it Series - Race 1 - Men&#039;s (E),Quarq ,Kickr18,407,392,15
35778,545920,2020-05-18 06:47:39,wahoo,Zwift - 3R Watopia Flat Route Race - 3 Laps (30.3km/18.8mi 162m) (A),Quarq ,Kickr18,390,378,12
35971,545920,2020-05-19 08:40:29,wahoo,Zwift - SRAM Send it Series - Race 2 - Men&#039;s (E),Quarq ,Kickr18,410,401,9
38238,545920,2020-05-28 08:59:28,wahoo,Zwift - Cycling Australia&#039;s The Chop by AHDR (A),Quarq ,Kickr18,376,364,12
39029,545920,2020-06-02 08:33:54,wahoo,Zwift - SRAM Send it Series - Race 4 - Men&#039;s (E),Quarq ,Kickr18,424,421,3
39255,545920,2020-06-03 08:53:46,wahoo,Zwift - USA Cycling Race League by Indoor Specialist (A),Quarq ,Kickr18,379,367,12
39493,545920,2020-06-04 09:03:41,wahoo,Zwift - Cycling Australia&#039;s The Chop by AHDR (A),Quarq ,Kickr18,369,347,22
40474,545920,2020-06-09 08:10:52,wahoo,Zwift - SRAM Send it Series - Race 5 - Men&#039;s (E),Quarq ,Kickr18,409,401,8
40956,545920,2020-06-11 08:57:56,wahoo,Zwift - Cycling Australia&#039;s The Chop by AHDR (A),Quarq ,Kickr18,377,376,1
41889,545920,2020-06-16 08:20:02,wahoo,Zwift - SRAM Send it Series - Race 6 - Men&#039;s (E),Quarq ,Kickr18,388,386,2
42350,545920,2020-06-18 09:15:07,wahoo,Zwift - Cycling Australia&#039;s The Chop by AHDR (A),Quarq ,Kickr18,367,353,14
43064,545920,2020-06-22 06:50:53,wahoo,Zwift - 3R Watopia Flat Route Race - 3 Laps (30.3km/18.8mi 162m) (A),Quarq ,Kickr18,400,384,16
43182,545920,2020-06-23 08:36:54,wahoo,Zwift - SRAM Send it Series - Race 7 - Men&#039;s (E),Quarq ,Kickr18,454,450,4
44155,545920,2020-06-30 08:22:40,wahoo,Zwift - SRAM Send it Series - Race 8 - Men&#039;s (E),Quarq ,Kickr18,383,375,8
45042,545920,2020-07-05 07:05:12,wahoo,Zwift - Team Italy & Frenchy Fuzion Endurance Race (A),Quarq ,Kickr18,415,407,8
45399,545920,2020-07-08 09:38:57,wahoo,Zwift - USA Cycling Race League by Indoor Specialist (A),Quarq ,Kickr18,332,312,20
45570,545920,2020-07-09 08:52:48,wahoo,Zwift - The Lamb Chop p/b Black Sheep (A),Quarq ,Kickr18,389,376,13
47256,545920,2020-07-22 04:55:39,wahoo,Zwift - Virtual Tour de France - Open - Stage 5 Discovery Ride,Quarq ,Kickr18,384,376,8
49014,545920,2020-08-06 08:42:40,wahoo,Zwift - The Lamb Chop p/b Black Sheep (A),Quarq ,Kickr18,389,376,13
49257,545920,2020-08-08 05:15:59,wahoo,Zwift - XRS Races - The Saturday Classic (A),Quarq ,Kickr18,427,428,-1
49686,545920,2020-08-12 08:23:56,wahoo,Zwift - Longer Ride - 7 Days of Tarmac SL7: Stage 2,Quarq ,Kickr18,406,407,-1
49936,545920,2020-08-14 08:49:04,wahoo,Zwift - Off the MAAP Invitational Race // Stage 1 (Men) (A),Quarq ,Kickr18,401,410,-9
50349,545920,2020-08-17 09:49:49,wahoo,Zwift - Off the MAAP Invitational Race // Stage 2 (Men) (A),Quarq ,Kickr18,431,428,3
50834,545920,2020-08-20 08:50:03,wahoo,Zwift - Off the MAAP Invitational Race // Stage 3 (men) ,Quarq ,Kickr18,400,398,2
51183,545920,2020-08-22 05:19:11,wahoo,Zwift - XRS Races - The Saturday Classic (A),Quarq ,Kickr18,413,406,7
51472,545920,2020-08-24 09:35:11,wahoo,Zwift - Off the MAAP Invitational Race // Stage 4 (men) ,Quarq ,Kickr18,404,400,4
52116,545920,2020-08-27 08:58:19,wahoo,Zwift - Cycling Australia&#039;s The Chop by AHDR (A),Quarq ,Kickr18,389,377,12
53013,545920,2020-09-02 08:47:10,wahoo,Zwift - ZADA test- 3 Sisters,Quarq ,Kickr18,422,413,9
54063,545920,2020-09-09 07:48:20,wahoo,Zwift - Giant Crit Crushers Race 1 (A),Quarq ,Kickr18,395,382,13
54064,545920,2020-09-09 07:48:20,wahoo,Zwift - Giant Crit Crushers Race 2 (A),Quarq ,Kickr18,372,363,9
54664,545920,2020-09-12 05:18:22,wahoo,Zwift - XRS Races - The Saturday Classic (A),Quarq ,Kickr18,393,382,11
55034,545920,2020-09-14 18:00:10,wahoo,Zwift - Invitational League // Qualifying Race #1,Quarq ,Kickr18,379,371,8
56414,545920,2020-09-20 13:00:12,wahoo,Zwift - Invitational League // Qualifying Race #3 (Men) (A),Quarq ,Kickr18,383,371,12
61450,545920,2020-10-13 08:45:06,wahoo,Zwift - Zwift Racing League | WTRL (A),Quarq ,Kickr18,386,395,-9
65327,545920,2020-10-27 08:45:11,wahoo,Zwift - Zwift Racing League | WTRL - APAC (MEN) -  Division 1 (A),Quarq ,Kickr18,389,382,7
80359,545920,2020-12-07 07:11:48,wahoo,Zwift - ZHQ FutureWorks Crit City Race - Anti-sandbagging (A),Quarq ,Kickr18,425,416,9
80656,545920,2020-12-08 08:21:53,wahoo,Zwift - Zwift Racing League | WTRL - Men&#039;s APAC DIVISION 1 (A),SRM origin,Kickr18,424,405,19
16533,148260,2020-03-02 18:13:28,wahoo,Zwift - DBR Winter Cup (A),SRM,Wahoo kickr,386,382,4
20925,148260,2020-03-31 18:13:50,wahoo,Zwift - Feltet.dk Race Series (A),SRM,Wahoo kickr,385,400,-15
23682,148260,2020-04-11 08:28:10,wahoo,DBR Sufferday League,SRM,Wahoo kickr,408,413,-5
24314,148260,2020-04-13 17:13:32,wahoo,DBR Wahoo League,SRM,Wahoo kickr,379,381,-2
24944,148260,2020-04-15 16:59:17,wahoo,Swedish Zwift Racing Cup by SZR,SRM,Wahoo kickr,413,404,9
24947,148260,2020-04-15 18:03:35,wahoo,Zwift - DBR Sprinthooligan Cup (A),SRM,Wahoo kickr,393,391,2
26138,148260,2020-04-19 09:03:27,wahoo,Zwift - Newbury Velo Road Race (A),SRM,Wahoo kickr,389,392,-3
27823,148260,2020-04-25 08:28:52,wahoo,Zwift - DBR Sufferday League (A),SRM,Wahoo kickr,390,392,-2
28464,148260,2020-04-27 17:13:26,wahoo,Zwift - DBR Wahoo League (A),SRM,Wahoo kickr,393,399,-6
30444,148260,2020-05-02 08:28:14,wahoo,DBR Sufferday League,SRM,Wahoo kickr,413,423,-10
30449,148260,2020-04-30 18:01:11,wahoo,Zwift - WTRL Team Time Trial (A),SRM,Wahoo kickr,382,384,-2
31711,148260,2020-05-05 18:12:57,wahoo,Zwift - UNO X CUP powered by DCU & Feltet.dk (A),SRM,Wahoo kickr,404,422,-18
33682,148260,2020-05-11 17:14:11,wahoo,Zwift - DBR Wahoo League (A),SRM,Wahoo kickr,367,373,-6
34079,148260,2020-05-12 18:13:17,wahoo,Zwift - UNO X CUP powered by DCU & Feltet.dk (A),SRM,Wahoo kickr,415,427,-12
36105,148260,2020-05-19 18:13:14,wahoo,Zwift - UNO X CUP powered by DCU & Feltet.dk (A),SRM,Wahoo kickr,403,401,2
36413,148260,2020-05-20 18:01:26,wahoo,Zwift - DBR Boerkop Cykler Cup (A),SRM,Wahoo kickr,368,373,-5
39388,148260,2020-06-03 18:03:18,wahoo,Zwift - DBR Boerkop Cykler Cup (A),SRM,Wahoo kickr,366,370,-4
42231,148260,2020-06-17 18:01:02,wahoo,Zwift - DBR Boerkop Cykler Cup (A),SRM,Wahoo kickr,312,313,-1
54273,148260,2020-09-09 17:37:24,wahoo,Zwift - DBR Wednesday Race (A),Infocrank,Wahoo kickr,406,392,14
55733,148260,2020-09-16 16:57:36,wahoo,Zwift - MIDWEEK Autumn Series by SZR (A),SRM,Wahoo kickr,379,382,-3
55827,148260,2020-09-17 18:28:12,wahoo,Zwift - Invitational League // Qualifying Race #2 (Men) ,SRM,Wahoo kickr,383,385,-2
56481,148260,2020-09-20 12:55:51,wahoo,Zwift - Invitational League // Qualifying Race #3 (Men) (A),SRM,Wahoo kickr,409,409,0
58245,148260,2020-09-28 17:11:38,wahoo,Zwift - DBR Ride´N´Roll League (A),SRM,Wahoo kickr,363,355,8
59586,148260,2020-10-05 09:14:12,wahoo,Zwift - 3R Watopia Flat Route Race - 4 Laps (41km/25.5mi 216m) (A),SRM,Wahoo kickr,354,356,-2
60146,148260,2020-10-07 18:02:31,wahoo,Zwift - DBR HEINO CUP III (A),SRM,Wahoo kickr,384,376,8
61551,148260,2020-10-13 17:10:29,wahoo,Zwift - Zwift Racing League | WTRL,SRM,Wahoo kickr,409,405,4
62111,148260,2020-10-15 15:11:04,wahoo,Zwift - OH MY CRIT! - The Double Race 1/2 (A),SRM,Wahoo kickr,364,357,7
63407,148260,2020-10-20 17:09:47,wahoo,Zwift - Zwift Racing League | WTRL - EMEA E (MEN) - TTT Grp 1,Infocrank,Wahoo kickr,370,362,8
65875,148260,2020-10-28 18:51:25,wahoo,Zwift - DBR HEINO CUP III (A),Infocrank,Wahoo kickr,348,343,5
67597,148260,2020-11-03 18:14:59,wahoo,Zwift Racing League | WTRL - Mens EMEA E1 DIVISION 1,Infocrank,Wahoo kickr,360,389,-29
69321,148260,2020-11-09 16:03:31,wahoo,Zwift - 3R Classique Reverse Flat Race - 4 Laps (26.9km/16.7mi 57m) (A),Infocrank,Wahoo kickr,363,359,4
70246,148260,2020-11-11 17:54:36,wahoo,Zwift - MIDWEEK Autumn Series by SZR (A),Infocrank,Wahoo kickr,361,350,11
75037,148260,2020-11-24 18:05:20,wahoo,Zwift - Zwift Racing League | WTRL - Men&#039;s EMEA E1 DIVISION 1,Infocrank,Wahoo kickr 5.0,415,417,-2
78048,148260,2020-12-01 18:14:55,wahoo,Zwift - Zwift Racing League | WTRL - Men&#039;s EMEA E1 DIVISION 1 (A),Infocrank ,Wahoo kickr 5.0,378,376,2
86836,148260,2020-12-24 08:24:28,wahoo,Zwift - KISS Race Series - Down Under (A),Infocrank,Wahoo kickr 5.0,391,394,-3
90130,148260,2021-01-02 09:24:49,wahoo,Zwift - DBR SufferDay League III (A),Infocrank,Wahoo kickr 5.0,414,416,-2
91344,148260,2021-01-04 18:10:51,wahoo,Zwift -  DBR Monday Race (A),Infocrank,Wahoo kickr 5.0,396,384,12
94950,148260,2021-01-11 18:10:15,wahoo,Zwift -  DBR Monday Race (A),Quarq sram red,Wahoo kickr 5.0,333,332,1
96997,148260,2021-01-14 18:40:29,wahoo,Zwift - Watopia,Quarq sram red,Wahoo kickr 5.0,389,389,0
97885,148260,2021-01-16 09:25:31,wahoo,Zwift - DBR SufferDay League III (A),Quarq sram red,Wahoo kickr 5.0,387,376,11
99644,148260,2021-01-19 18:14:59,wahoo,Zwift Racing League | WTRL - Mens/Mixed EMEA E1 DIVISION 1,Quarq sram red,Wahoo kickr 5.0,372,371,1
103617,148260,2021-01-26 18:09:29,wahoo,Zwift - Zwift Racing League | WTRL - Men&#039;s/Mixed EMEA E1 DIVISION 1 (A),Quarq sram red,Wahoo kickr 5.0,388,377,11
106144,148260,2021-01-31 11:26:30,wahoo,Zwift - Stages of DIRT (E),Quarq sram red,Wahoo kickr 5.0,352,348,4
107309,148260,2021-02-02 18:09:53,wahoo,Zwift - Zwift Racing League | WTRL - Men&#039;s/Mixed EMEA E1 DIVISION 1 (A),Quarq sram red,Wahoo kickr 5.0,391,397,-6
108204,148260,2021-02-03 18:39:18,wahoo,Zwift - Danmarks Cykle Union & Partners 4/6 (A),Quarq sram red,Wahoo kickr 5.0,381,383,-2
111534,148260,2021-02-09 18:14:58,wahoo,Zwift - Zwift Racing League | WTRL - Men&#039;s/Mixed EMEA E1 DIVISION 1 (A),Quarq sram red,Wahoo kickr 5.0,389,393,-4
112302,148260,2021-02-10 18:38:53,wahoo,Zwift - Danmarks Cykle Union & Partners 5/6 (A),Quarq sram red,Wahoo kickr 5.0,418,422,-4
120404,148260,2021-02-24 18:39:50,wahoo,Zwift - Scandinavian Cup 2021 - Round 1 - Men (A),Quarq sram red,Wahoo kickr 5.0,365,363,2
127316,148260,2021-03-11 18:24:17,wahoo,Zwift - FUSION SPRING CUP (A),Quarq sram red,Wahoo kickr 5.0,355,359,-4
127803,148260,2021-03-13 10:01:18,wahoo,Zwift -  3R Racing (A),Quarq sram red,Wahoo kickr 5.0,349,355,-6
129155,148260,2021-03-16 18:26:23,wahoo,Zwift - CeramicSpeed Race Series: Open Race (A),Quarq sram red,Wahoo kickr 5.0,388,380,8
105242,170967,2021-01-20 18:17:30,neo,Zwift - Danmarks Cykle Union & Partners 2/6 (A),SRM,Tacx Neo,342,330,12
105245,170967,2021-01-13 17:33:18,neo,Zwift - Danmarks Cykle Union & Partners 1/6 (A),SRM,Tacx Neo,336,323,13
108282,170967,2021-02-03 18:14:25,neo,Zwift - Danmarks Cykle Union & Partners 4/6 (A),SRM,Tacx Neo,356,344,12
109893,170967,2021-02-06 09:16:12,neo,Zwift - DBR SufferDay League III (A),SRM,Tacx Neo,335,321,14
106453,35751,2021-01-31 09:31:05,neo,Zwift -  SloZl - Slovenian Zwift League - Weekly Race  (B),Stages Gen3 (Colnago),Neo (Zwift),287,307,-20
110490,35751,2021-02-07 09:31:17,neo,Zwift - SloZl - Fight for Jersey (B),Stages Gen3 (Colnago),Neo (Zwift),284,300,-16
113063,35751,2021-02-11 18:24:57,neo,Zwift - WTRL Team Time Trial - Zone 5 (D),Stages Gen3 (Colnago),Neo (Zwift),299,307,-8
127426,35751,2021-03-11 18:05:23,neo,Zwift - WTRL Team Time Trial - Zone 5 (D),Stages Wilier Gen2,Neo (Zwift),271,293,-22
63275,159260,2020-10-19 08:25:14,wahoo,Zwift - Stufentest,Favero,Kickr Core,327,339,-12
76369,159260,2020-11-26 20:22:34,wahoo,Zwift - NYC - Streckencheck,Favero,Kickr Core,294,294,0
84187,159260,2020-12-16 18:49:11,wahoo,Zwift - 3 GA1 Stufen + 1*10min KA,Favero,Kickr Core,285,265,20
87444,159260,2020-12-26 08:50:56,wahoo,Zwift - ZTS Christmas Special - Race 3,Favero,Kickr Core,328,326,2
89123,360262,2020-12-30 17:25:01,wahoo,Zwift - LEQP Provence Rose Ride (C),Vector 3 Dual pedals,Wahoo Kickr ,178,181,-3
91152,360262,2021-01-04 11:10:02,wahoo,Zwift - DIRT Monday Morning Blues Ride (C),Vector 3 Dual pedals,Wahoo Kickr ,173,166,7
59995,361126,2020-10-07 05:51:29,wahoo,3 Sister Test - Stages PM,Stages and ROAM,kickr,261,271,-10
71864,361126,2020-11-16 07:30:59,wahoo,Stages and ROAM / kickr,Stages and ROAM,kickr,254,263,-9
71972,361126,2020-11-16 19:15:05,wahoo,Stages and ROAM / kickr,Stages and ROAM,kickr,268,270,-2
72035,361126,2020-11-17 06:53:19,wahoo,Stages and ROAM / kickr,Stages and ROAM,kickr,238,243,-5
72462,361126,2020-11-18 05:27:40,wahoo,ac maintenance #2,Stages and ROAM,kickr,232,240,-8
72883,361126,2020-11-19 06:06:49,wahoo,Sub TH ,Stages and ROAM,kickr,247,247,0
73747,361126,2020-11-21 06:39:58,wahoo,Pretzel,Stages and ROAM,kickr,224,245,-21
74657,361126,2020-11-23 18:12:45,wahoo,Stages and ROAM / kickr,Stages and ROAM,kickr,268,273,-5
75329,361126,2020-11-25 05:28:11,wahoo,Ramps,Stages and ROAM,kickr,238,246,-8
75391,361126,2020-11-25 11:11:26,wahoo,test,Stages and ROAM,kickr,217,226,-9
77789,361126,2020-11-30 19:14:51,wahoo,TTT,Stages and ROAM,kickr,259,271,-12
88899,361126,2020-12-30 06:09:29,wahoo,3 sister test 2,Stages and ROAM,kickr,294,282,12
110859,361126,2021-02-08 11:19:44,wahoo,Stages and ROAM / kickr,Stages and ROAM,kickr,235,260,-25
73657,60679,2020-11-20 16:01:40,neo,Quarq vs NEO - Zwift Race,2020-11-20-17-01-41_Quarq,2020-11-20-17-01-40_NEO,306,304,2
96694,505941,2021-01-11 17:46:00,wahoo,Zwift - SCF SWE Cup (B),Garmin Vector 3,Wahoo Kickr 2018,335,325,10
96696,505941,2021-01-06 18:01:01,wahoo,Zwift - MIDWEEK Winter Series by SZR (B),Garmin Vector 3,Wahoo Kickr 2018,326,328,-2
6632,103879,2019-12-18 18:54:21,wahoo,Zwift - DBR HEINO CUP (A),TT bike stages,kickr,419,396,23
6954,103879,2019-12-21 16:45:47,wahoo,FRC fartlek + a couple sprints,Stages Left Side,kickr,306,285,21
7910,103879,2020-01-02 19:07:13,wahoo,proper double sided dual recording. check!,Patrickwalle.2020-01-02-20-13-47-865Z.GarminPush.46594083482,kickr,340,329,11
8245,103879,2020-01-06 22:55:10,wahoo,Zwift - Watopia,garmin pedals,kickr,354,337,17
8735,103879,2020-01-10 14:21:59,wahoo,Zwift - Richmond,garmin pedals,kickr,283,279,4
9036,103879,2020-01-12 17:14:14,wahoo,Zwift - endurance 60&#039;,garmin pedals,kickr,234,227,7
9356,103879,2020-01-14 19:10:20,wahoo,Koule,garmin pedals,kickr,281,270,11
9955,103879,2020-01-18 19:38:27,wahoo,Zwift - Japan Endurance Ride - Gotham Grind Rev.(B)3.0~3.4w/kg-100km (B),garmin pedals,kickr,325,324,1
10015,103879,2020-01-19 16:28:38,wahoo,Zwift - Crit City Race (A),garmin pedals,kickr,397,384,13
10024,103879,2020-01-19 17:06:20,wahoo,Got Hit with those XP. points,garmin pedals,kickr,376,358,18
10087,103879,2020-01-19 22:55:29,wahoo,Zwift - 3R Achterbahn Climbing Race (47.4km/29.5mi 988m) (A) Cooked through ,garmin pedals,kickr,383,362,21
10676,103879,2020-01-23 18:49:08,wahoo,Zwift - Tour de Zwift // Pro-Am Invitational,garmin pedals,kickr,403,411,-8
14591,103879,2020-02-18 19:17:00,wahoo,Zwift - 3R SuperCRITical Race Series - Round 1of4 (A),garmin pedals,kickr,388,390,-2
16143,103879,2020-02-29 15:01:41,wahoo,Zwift - OH CRIT!! - Saturday Smash Series (A),garmin pedals,kickr,369,368,1
18206,103879,2020-03-15 19:26:34,wahoo,Zwift - KISS at Race - EU PM (A),garmin pedals,kickr,450,453,-3
18477,103879,2020-03-17 20:39:26,wahoo,Zwift - 3R Watopia Flat Sprint Race - 1 Lap (9.8km/6.1mi 54m) (A),Patrickwalle.2020-03-17-20-57-59-741Z.GarminPush.51579538812,kickr,350,347,3
18478,103879,2020-03-17 19:27:19,wahoo,Zwift - 3R SuperCRITical Race Series - Round 4of4 (A),garmin pedals,kickr,380,376,4
18782,103879,2020-03-19 23:27:34,wahoo,Zwift - Crit City Race (A),garmin pedals,kickr,401,402,-1
19061,103879,2020-03-21 15:14:23,wahoo,Zwift - OH CRIT!! - Saturday Smash Series (A),garmin pedals,kickr,381,378,3
20237,103879,2020-03-28 21:35:15,wahoo,Crit City Race,garmin pedals,kickr,408,403,5
21531,103879,2020-04-02 17:57:14,wahoo,Zwift - KALAS Cup - Round 10 (A),garmin pedals,kickr,389,385,4
22093,103879,2020-04-04 20:04:36,wahoo,Zwift - 3R Watopia Hilly Race - 2 Laps (18.3km/11.4mi 200m) (A),Stages Left Side,kickr,408,407,1
22631,103879,2020-04-04 20:04:36,wahoo,Zwift - 3R London Loop Hilly Race - 2 Laps (29km/18mi 440m) (A),Patrickwalle.2020-04-06-22-41-37-205Z.GarminPush.52893328135 (1),kickr,434,423,11
23294,103879,2020-04-09 18:06:07,wahoo,Zwift - London International // Zwift Classic (A),garmin pedals,kickr,402,408,-6
23417,103879,2020-04-09 23:29:44,wahoo,Zwift - Austin Driveway Series Criterium (CAT P/1/2/3),garmin pedals,kickr,375,378,-3
24654,103879,2020-04-14 18:39:33,wahoo,Zwift - 3R Spring Loaded Race Series - Round 3of6 (A),garmin pedals,kickr,392,399,-7
25389,103879,2020-04-16 23:28:21,wahoo,Zwift - Austin Driveway Series Criterium (CAT P/1/2/3),garmin pedals,kickr,386,395,-9
25620,103879,2020-04-17 17:44:38,wahoo,Zwift - Richmond Challenge // Zwift Classic (A),garmin pedals,kickr,411,401,10
27480,103879,2020-04-23 23:27:02,wahoo,Zwift - Austin Driveway Series Criterium (CAT P/1/2/3) Lead out for a hungry MONSTER,garmin pedals,kickr,386,394,-8
29891,103879,2020-04-30 23:23:16,wahoo,Zwift - Austin Driveway Series Criterium (CAT P/1/2/3)- good fun and decent legs for another top 10,garmin pedals,kickr,383,387,-4
34386,103879,2020-05-13 17:51:46,wahoo,Zwift - USA Cycling Race League by Indoor Specialist (A),Patrickwalle.2020-05-13-18-40-46-895Z.GarminPush.55772555212,kickr,396,400,-4
36691,103879,2020-05-21 17:47:28,wahoo,Zwift - Tour for All Invitational Race // Men (A),garmin pedals,kickr,399,403,-4
38362,103879,2020-05-28 17:49:12,wahoo,Zwift - Tour for All Invitational Race // Men (A),garmin pedals,kickr,428,455,-27
39380,103879,2020-06-03 17:50:19,wahoo,Zwift - USA Cycling Race League by Indoor Specialist (A),garmin pedals,kickr,387,413,-26
42007,103879,2020-06-16 18:13:48,wahoo,Zwift - 3R & Wahoo Ride Real Race Series - Round 5 of 7 (A),garmin pedals,kickr,413,406,7
42293,103879,2020-06-17 23:10:33,wahoo,Zwift - Austin Driveway Series Criterium (A),garmin pedals,kickr,417,407,10
43454,103879,2020-06-24 23:17:25,wahoo,Zwift - Austin Driveway Series Criterium (A),garmin pedals,kickr,385,381,4
45511,103879,2020-07-08 23:14:55,wahoo,Zwift - Austin Driveway Series Criterium (A),garmin pedals,kickr,389,399,-10
45991,103879,2020-07-11 19:36:40,wahoo,LEtape du Tour Stage 2,Patrickwalle.2020-07-11-21-10-22-611Z.GarminPush.60984731396,kickr,401,393,8
46304,103879,2020-07-14 14:52:31,wahoo,Zwift - 3R Turbocharged Team Race Series - Round 1 (A),garmin pedals,kickr,379,382,-3
46513,103879,2020-07-15 23:27:27,wahoo,Austin Driveway Series Criterium,garmin pedals,kickr,407,404,3
46968,103879,2020-07-19 15:51:32,wahoo,Zwift - L&#039;Etape du Tour Stage 3 - Open,garmin pedals,kickr,398,406,-8
47165,103879,2020-07-21 14:49:43,wahoo,Zwift - 3R Turbocharged Team Race Series - Round 2 (A),garmin pedals,kickr,367,377,-10
47468,103879,2020-07-23 15:14:01,wahoo,OH MY CRIT! - The Double Race 1/2,garmin pedals,kickr,385,389,-4
47469,103879,2020-07-23 16:02:38,wahoo,OH MY CRIT! - The Double Race 2/2,garmin pedals,kickr,409,397,12
47682,103879,2020-07-25 19:22:58,wahoo,Zwift - Watopia 3 sisters Verification Test,garmin pedals,kickr,415,408,7
48041,103879,2020-07-28 14:54:12,wahoo,Zwift - 3R Turbocharged Team Race Series - Round 3 (A),garmin pedals,kickr,397,421,-24
48376,103879,2020-07-30 23:32:04,wahoo,Zwift - WTRL Team Time Trial (B),garmin pedals,kickr,401,398,3
50070,103879,2020-08-14 21:58:31,wahoo,7 Days of Tarmac SL7: Stage 3 - France,garmin pedals,kickr,400,399,1
50143,103879,2020-08-15 14:11:54,wahoo,Zwift - OH MY CRIT - Saturday Smash Race (A),garmin pedals,kickr,449,449,0
50602,103879,2020-08-18 22:30:15,wahoo,SweatFest in France p/b Fell Swoop,garmin pedals,kickr,399,397,2
50603,103879,2020-08-18 21:54:12,wahoo,Zwift - Off The MAAP Stage 2 Race (A),garmin pedals,kickr,391,394,-3
50848,103879,2020-08-20 08:33:15,wahoo,Zwift - Off the MAAP Invitational Race // Stage 3 (men) 18th!!!!,garmin pedals,kickr,416,419,-3
51005,103879,2020-08-20 23:14:15,wahoo,WTRL Team Time Trial - Zone7,garmin pedals,kickr,387,388,-1
51251,103879,2020-08-22 13:52:08,wahoo,Zwift - OH MY CRIT - Saturday Smash Race* (A),garmin pedals,kickr,430,432,-2
52076,103879,2020-08-26 22:16:13,wahoo,Zwift - Thom Thrall&#039;s Meetup - Three Sisters ZADA,garmin pedals,kickr,416,411,5
52282,103879,2020-08-27 23:00:19,wahoo,WTRL Team Time Trial - Zone7,Patrickwalle.2020-08-28-00-29-54-156Z.GarminPush.65749867842,kickr,400,396,4
52535,103879,2020-08-29 14:14:30,wahoo,Zwift - OH MY CRIT - Saturday Smash Race* (A),garmin pedals,kickr,385,381,4
52536,103879,2020-08-29 14:14:30,wahoo,Zwift - Patrick Walle&#039;s Meetup - Ven-Top -the boys dropped me ,garmin pedals,kickr,364,361,3
54634,103879,2020-09-11 20:04:27,wahoo,new pedal body check,Patrickwalle.2020-09-11-21-02-40-891Z.GarminPush.67161309598,kickr,362,354,8
56337,103879,2020-09-19 12:55:14,wahoo,calibration and course preview for the smackdown tomorrow,garmin pedals,kickr,243,235,8
56432,103879,2020-09-20 12:30:00,wahoo,Zwift - Invitational League // Qualifying Race #3 (Men) (A),garmin pedals,kickr,422,421,1
57378,103879,2020-09-24 22:54:09,wahoo,Zwift - Espresso ttt with special guest Tanner Ward!,garmin pedals,kickr,402,398,4
58133,103879,2020-09-28 22:20:04,wahoo,Zwift - ZHQ Beta Crit City Race (A),garmin pedals,kickr,413,411,2
58135,103879,2020-09-28 22:20:04,wahoo,Zwift - 3R LaGuardia Loop Reverse Flat Race - 6 Laps (19.1km/11.9 162m) (A),garmin pedals,kickr,413,377,36
61037,103879,2020-10-11 18:08:56,wahoo,calibration check ,garmin pedals,kickr,265,255,10
61297,103879,2020-10-12 18:28:04,wahoo,Zwift - Premier Division // Zwift Racing League (men) ,garmin pedals,kickr,424,423,1
61997,103879,2020-10-14 22:51:05,wahoo,Zwift - Watopia,garmin pedals,kickr,312,309,3
62334,103879,2020-10-15 23:22:42,wahoo,Zwift - Patrick Walle&#039;s Meetup - R.G.V.,garmin pedals,kickr,424,412,12
62685,103879,2020-10-17 15:19:25,wahoo,Zwift - Patrick Walle&#039;s Meetup - R.G.V. ble test,garmin pedals,kickr,202,201,1
62915,103879,2020-10-18 15:58:01,wahoo,Zwift - Watopia finally watched stage 10 giro. dayum!,garmin pedals,kickr,315,309,6
63071,103879,2020-10-19 17:42:22,wahoo,Zwift - Premier Division // Zwift Racing League (men) trip to barftown,garmin pedals,kickr,420,415,5
65600,103879,2020-10-27 22:20:40,wahoo,tap tap tap. endurance,garmin pedals,kickr,301,297,4
65921,103879,2020-10-28 21:29:10,wahoo,Zwift - Long Island Cranx Race (A),garmin pedals,kickr,442,440,2
66294,103879,2020-10-29 22:55:51,wahoo,Zwift - Espresso,garmin pedals,kickr,386,380,6
66522,103879,2020-10-30 22:11:57,wahoo,Zwift - France,garmin pedals,kickr,382,377,5
67313,103879,2020-11-02 18:58:12,wahoo,Zwift - Premier Division // Zwift Racing League (men) (A),garmin pedals,kickr,408,411,-3
68206,103879,2020-11-05 17:57:13,wahoo,Zwift - WTRL Team Time Trial - Zone 4 (C),garmin pedals,kickr,423,422,1
69480,103879,2020-11-09 19:24:05,wahoo,Zwift - Premier Division // Zwift Racing League (men) (A),garmin pedals,kickr,449,446,3
70793,103879,2020-11-12 18:28:05,wahoo,Zwift - Espresso,garmin pedals,kickr,400,393,7
71942,103879,2020-11-16 18:35:16,wahoo,Zwift - Premier Division // Zwift Racing League (men) (A),garmin pedals,kickr,411,408,3
73903,103879,2020-11-21 14:54:04,wahoo,Zwift - OH MY CRIT - Saturday Smash Race (A),garmin pedals,kickr,386,380,6
75264,103879,2020-11-24 23:13:21,wahoo,SweatFest Fall/Winter Series 2020/21,garmin pedals,kickr,418,417,1
75693,103879,2020-11-25 18:40:06,wahoo,Zwift - DCU – Feltet.dk November series (A),garmin pedals,kickr,420,416,4
76227,103879,2020-11-26 17:46:38,wahoo,Zwift - WTRL NOPINZ WORLD TTT CHAMPIONSHIPS - Zone 6 (C),garmin pedals,kickr,421,414,7
77055,103879,2020-11-28 16:39:45,wahoo,Zwift - Cycling Canada Pre-Worlds Showdown Series (A),garmin pedals,kickr,423,418,5
77699,103879,2020-11-30 18:31:52,wahoo,Zwift - Premier Division // Zwift Racing League (men) (A),garmin pedals,kickr,414,406,8
78281,103879,2020-12-01 23:28:25,wahoo,Midweek Criterium Race,garmin pedals,kickr,392,387,5
79208,103879,2020-12-03 23:02:08,wahoo,Zwift - Crit City Race (A),garmin pedals,kickr,389,382,7
82418,103879,2020-12-12 14:39:35,wahoo,Zwift - OH MY CRIT - Saturday Smash Race (A),garmin pedals,kickr,468,466,2
82970,103879,2020-12-13 20:35:21,wahoo,Zwift - 3R Gotham Grind Flat Race - 3 Laps (27.8km/17.4mi 87m) (A),garmin pedals,kickr,400,394,6
84132,103879,2020-12-16 23:04:31,wahoo,Zwift - 3R Volcano Flat Reverse 50k Race - 4 Laps (48.8km/30.7mi 184m) (A),garmin pedals,kickr,341,338,3
86580,103879,2020-12-23 17:26:30,wahoo,garmin pedals,garmin pedals,kickr,390,387,3
87021,103879,2020-12-24 15:51:19,wahoo,Zwift - OH MY CRIT! - The Double Race 1/2 (A),garmin pedals,kickr,418,418,0
87022,103879,2020-12-24 15:51:19,wahoo,Oh My Crit! The Double Race 12/24 2/2,garmin pedals,kickr,392,388,4
87025,103879,2020-12-24 15:51:19,wahoo,TTT 2x Bologna. oww,garmin pedals,kickr,391,391,0
87521,103879,2020-12-26 15:02:14,wahoo,Zwift - OH MY CRIT - Saturday Smash Race (A),garmin pedals,kickr,409,415,-6
87900,103879,2020-12-27 14:13:35,wahoo,Zwift - KISS 100 Race Series - Americas (A) woah\hard,garmin pedals,kickr,411,410,1
89125,103879,2020-12-30 17:46:40,wahoo,MIDWEEK Winter Series by SZR,garmin pedals,kickr,407,411,-4
89565,103879,2020-12-31 16:08:17,wahoo,Zwift - OH MY CRIT! - The Double Race 1/2 (A),garmin pedals,kickr,367,372,-5
89566,103879,2020-12-31 16:08:17,wahoo,Zwift - OH MY CRIT! - The Double Race 2/2 (A),garmin pedals,kickr,382,383,-1
93920,103879,2021-01-09 14:55:21,wahoo,Zwift - OH MY CRIT - Saturday Smash Race (A),garmin pedals,kickr,385,403,-18
95056,103879,2021-01-11 18:43:04,wahoo,Zwift - Premier Division // Zwift Racing League (men) (A)4th!!!,garmin pedals,kickr,378,394,-16
97672,103879,2021-01-15 23:33:56,wahoo,chill. happy fri ya&#039;ll!,garmin pedals,kickr,253,260,-7
98129,103879,2021-01-16 14:54:27,wahoo,Zwift - OH MY CRIT - Saturday Smash Race (A),garmin pedals,kickr,374,379,-5
98135,103879,2021-01-16 14:54:27,wahoo,Zwift - TEAM VEGAN Tofu Tornado (A),garmin pedals,kickr,372,375,-3
98985,103879,2021-01-18 16:44:05,wahoo,before ttt,Garmin Vector 3,Wahoo Kickr 19,226,229,-3
99285,103879,2021-01-18 19:14:33,wahoo,Zwift - Premier Division // Zwift Racing League (men) (A),Garmin Vector 3,Wahoo Kickr 19,396,403,-7
100444,103879,2021-01-20 20:11:03,wahoo,Zwift - Watopia,Assioma Duo,Wahoo Kickr 19 BLE,378,375,3
100554,103879,2021-01-20 23:59:05,wahoo,Zwift - EVR Definitely Not the WTNC (A) Nice to do an evening tussle with the squad!,Assioma Duo,Wahoo Kickr 19 ANT+,399,398,1
101194,103879,2021-01-22 01:07:42,wahoo,consistency feels good,Assioma Duo,Wahoo Kickr 19 BLE companion app,347,347,0
104338,103879,2021-01-27 22:44:56,wahoo,Zwift - 3R Volcano Flat Reverse 50k Race - 4 Laps (48.8km/30.7mi 184m) (A),Assioma Duo,Wahoo Kickr 19 BLE companion app,383,381,2
104937,103879,2021-01-29 00:56:52,wahoo,Zwift - Watopia,Assioma Duo,Wahoo Kickr 19 BLE PC,310,309,1
105678,103879,2021-01-30 15:03:48,wahoo,Zwift - OH MY CRIT!! - Saturday Smash Race (A),Garmin Vector 3,Wahoo Kickr Gen 4 BLE PC,392,415,-23
106361,103879,2021-01-31 17:43:41,wahoo,Zwift - Watopia,Garmin Vector 3,Wahoo Kickr Gen 4 BLE PC,258,262,-4
106970,103879,2021-02-01 19:36:16,wahoo,Zwift - Premier Division // Zwift Racing League (men) (A) 3 laps OF DOOM,Garmin Vector 3,Wahoo Kickr Gen 4 BLE PC,397,414,-17
107248,103879,2021-02-02 16:04:00,wahoo,Zwift - Watopia,Garmin Vector 3 on 830,Wahoo Kickr Gen 4 BLE PC,154,158,-4
107554,103879,2021-02-02 19:56:34,wahoo,Zwift - Watopia,Garmin Vector 3 on 830,Wahoo Kickr Gen 4 BLE PC,215,224,-9
108135,103879,2021-02-03 15:38:48,wahoo,Zwift - Innsbruck,Assioma Duo to 830,Wahoo Kickr Gen 4 BLE PC,302,297,5
108529,103879,2021-02-03 23:42:03,wahoo,Zwift - Open - Movistar Team Challenge Community Qualifier Race #2,Assioma Duo to 830,Wahoo Kickr Gen 4 BLE PC,420,415,5
109153,103879,2021-02-05 00:08:18,wahoo,Zwift - Watopia,Assioma Duo to 830,Wahoo Kickr Gen 4 BLE PC,278,277,1
110517,103879,2021-02-07 14:24:49,wahoo,Team Draft Libby Hill After Party Race,Assioma Duo to 830,Wahoo Kickr Gen 4 BLE PC,372,368,4
111838,103879,2021-02-09 20:40:25,wahoo,sector smashing. onward.,Assioma Duo to 830,Wahoo Kickr Gen 4 BLE PC,409,406,3
113233,103879,2021-02-12 03:01:58,wahoo,Zwift - Watopia,Assioma Duo to 830,Wahoo Kickr Gen 4 BLE PC,386,382,4
113761,103879,2021-02-12 23:11:01,wahoo,Zwift - recovery,Garmin Vector 3 on 830,Wahoo Kickr Gen 4 BLE PC,226,223,3
114219,103879,2021-02-13 15:04:25,wahoo,Zwift - OH MY CRIT!! - Saturday Smash Race (A),Garmin Vector 3 on 830,Wahoo Kickr Gen 4 BLE PC,422,443,-21
115438,103879,2021-02-15 19:31:45,wahoo,Zwift - Premier Division // Zwift Racing League (men) (A),Garmin Vector 3 on 1000,Wahoo Kickr Gen 4 BLE PC,426,430,-4
116627,103879,2021-02-17 17:45:20,wahoo,Zwift - MIDWEEK Winter Series by SZR (A),Garmin Vector 3 on 830,Wahoo Kickr Gen 4 BLE PC,390,383,7
117208,103879,2021-02-18 17:03:41,wahoo,Zwift - OH MY CRIT!! - The Double Race 2/2 (A),Assioma Duo to 830,Wahoo Kickr Gen 4 BLE PC,417,412,5
117361,103879,2021-02-18 18:33:58,wahoo,Zwift - FLANDERS The BZR Ronde Watopian League (A),Assioma Duo to 830,Wahoo Kickr Gen 4 BLE companion app,417,413,4
118312,103879,2021-02-20 16:04:21,wahoo,Zwift - 3R Endurance Series p/b OTE Sports- Stage 1 (E),Assioma Duo to 830,Wahoo Kickr Gen 4 BLE PC,372,368,4
119986,103879,2021-02-24 00:04:46,wahoo,Zwift - Midweek Crit: Downtown Dolphin (A),Assioma Duo to 830,Wahoo Kickr Gen 4 BLE PC,385,372,13
121004,103879,2021-02-25 15:46:03,wahoo,Zwift - power meter erg test v2,New Garmin Vector 3 on 830,Wahoo Kickr Gen 4 BLE PC,302,292,10
121671,103879,2021-02-27 15:08:20,wahoo,Zwift - OH MY CRIT!! - Saturday Smash Race (A),Assioma Duo to 830,Wahoo Kickr Gen 4 BLE PC,400,399,1
125259,103879,2021-03-06 14:30:56,wahoo,Zwift - OH MY CRIT!! - Saturday Smash Race (A),Assioma Duo to 830,Wahoo Kickr Gen 4 BLE PC,380,380,0
125509,103879,2021-03-07 14:15:20,wahoo,Zwift - KISS 100 Race Series (Americas) - The Uber Pretzel Edition (A),Assioma Duo to 830,Wahoo Kickr Gen 4 BLE PC,436,435,1
127005,103879,2021-03-11 15:48:31,wahoo,Zwift - OH MY CRIT!! - The Double Race 1/2 (A),Assioma Duo to 830,Wahoo Kickr Gen 4 BLE PC,391,383,8
3387,473748,2019-10-28 10:19:36,neo,Zwift - 3R Volcano Flat Reverse Race - (A) #3 - 3rd race in a row so a liiitle empty in final.,Favero Assioma Duo v.4.04,Tacx Neo 2018 (Garmin),368,364,4
3475,473748,2019-10-29 19:09:39,neo,Zwift - WORLDOFFUSION Racing League (A) #15 with front group,Zwift,Tacx Neo 2018 (Garmin),406,402,4
4044,473748,2019-11-10 14:14:29,neo,Zwift - KISS at Race 100 - Americas (A) #10 bunchsprint,Favero Assioma Duo v.4.04,Tacx Neo 2018,368,360,8
37890,473748,2020-05-26 17:39:14,neo,Zwift - UNO X CUP powered by DCU & Feltet.dk (A) #35,Favero Assioma Duo v.4.25 (Zwift),Tacx Neo 2018 (Garmin),439,430,9
38397,473748,2020-05-28 18:15:16,neo,Zwift - WTRL Team Time Trial (C) - Fusion Dev - TTT,Favero Assioma Duo v.4.25 (Zwift),Tacx Neo 2018 (Garmin),371,358,13
39144,473748,2020-06-02 18:14:15,neo,Zwift - UNO X CUP powered by DCU & Feltet.dk (A),Favero Assioma Duo v.4.25 (Zwift),Tacx Neo 2018 (Garmin),396,392,4
39654,473748,2020-06-04 18:52:03,neo,Zwift - Espresso - FUSION TTT,Favero Assioma Duo v.4.25 (Zwift),Tacx Neo 2018 (Garmin),361,346,15
40562,473748,2020-06-09 18:14:53,neo,Zwift - UNO X CUP powered by DCU & Feltet.dk (A) #29 + #4 i indlagt sprint,Favero Assioma Duo v.4.25 (Zwift),Tacx Neo 2018 (Garmin),401,378,23
67465,473748,2020-11-03 08:55:05,wahoo,Zwift - Richmond - Kickr first ride test,Favero Assioma Duo (to Garmin),Kickr v5 2020,223,223,0
67673,473748,2020-11-03 19:49:45,wahoo,Zwift - Zwift Racing League | WTRL - Men&#039;s EMEA W1 DIVISION 1 (A),Favero Assioma Duo v.4.25 (Zwift),Wahoo Kickr v5 2020,344,348,-4
68242,473748,2020-11-05 18:30:16,wahoo,Zwift - FUSION ECT BEUNSTOPPABLE Racing Series (A) #8 - frontgroup sprint,Favero Assioma Duo v.4.25 (Zwift),Wahoo Kickr v5 2020,361,345,16
69944,473748,2020-11-10 19:44:02,wahoo,Zwift - Zwift Racing League | WTRL - EMEA W1 (MEN) -  Division 1 (A),Favero Assioma Duo v.4.25 (Zwift),Kickr v5 2020,432,411,21
70884,473748,2020-11-12 19:05:30,wahoo,Zwift - Espresso - Thursdays TTT wit da Fusion boyz,Favero Assioma Duo v.4.25 (Zwift),Wahoo Kickr v5 2020,350,342,8
72366,473748,2020-11-17 19:46:41,wahoo,Zwift - Zwift Racing League | WTRL - Men&#039;s EMEA W1 DIVISION 1 (A) - TTT Fusion development,Favero Assioma Duo v.4.25 (Zwift),Wahoo Kickr v5 2020,356,340,16
73191,473748,2020-11-19 19:29:34,wahoo,Zwift - World Championships Experience // Danish Cycling Federation - #28 frontgroup sprint on the wall,Favero Assioma Duo v.4.25 (Zwift),Wahoo Kickr v5 2020,389,370,19
74845,473748,2020-11-24 07:59:38,wahoo,Zwift - KISS Race Series - Down Under (A),Favero Assioma Duo v.4.25 (Zwift),Wahoo Kickr v5 2020,368,346,22
74850,473748,2020-11-24 09:15:25,wahoo,Zwift - 3R Whole Lotta Lava Hilly Race - 2 Laps (28.9km/12.53mi 336m) (A),Favero Assioma Duo v.4.25 (Zwift),Wahoo Kickr v5 2020,376,367,9
76167,473748,2020-11-26 18:29:48,wahoo,Zwift - FUSION ECT BEUNSTOPPABLE Racing Series (A) #6 efter sprint fra &#039;stort&#039; felt.,Favero Assioma Duo v.4.25 (Zwift),Wahoo Kickr v5 2020,359,351,8
78178,473748,2020-12-01 19:47:51,wahoo,Favero Assioma Duo v.4.25 (Zwift) / Wahoo Kickr v5 2020,Favero Assioma Duo v.4.25 (Zwift),Wahoo Kickr v5 2020,361,350,11
79073,473748,2020-12-03 18:29:43,wahoo,Zwift - FUSION DECEMBER CUP (A) - hard&#039;n&#039;semi-long. Sprinting from smaller frontgroup.,Favero Assioma Duo v.4.25 (Zwift),Wahoo Kickr v5 2020,370,372,-2
80657,473748,2020-12-08 08:44:20,wahoo,Zwift - WTRL Racing #4,Favero Assioma Duo v.4.25 (Zwift),Wahoo Kickr v5 2020,364,344,20
81680,473748,2020-12-10 18:29:38,wahoo,Zwift - FUSION DECEMBER CUP (A) - #24,Favero Assioma Duo v.4.25 (Zwift),Wahoo Kickr v5 2020,391,384,7
83424,473748,2020-12-15 11:29:40,wahoo,Zwift - 3R Volcano Circuit Flat Race - 8 Laps (A) #3 a good sprint for once,Favero Assioma Duo v.4.25 (Zwift),Wahoo Kickr v5 2020,347,345,2
84435,473748,2020-12-17 18:29:24,wahoo,Zwift - FUSION DECEMBER CUP (A) #23 sprint from frontgroup.,Favero Assioma Duo v.4.25 (Zwift),Wahoo Kickr v5 2020,376,377,-1
89768,473748,2021-01-01 12:17:57,wahoo,Zwift - Peak-PTY Climb Challenge Fridays - #6 went from 5km to go. Exploded on unexpected hillfinish.,Favero Assioma Duo v.4.25 (Zwift),Wahoo Kickr v5 2020,379,384,-5
91872,473748,2021-01-05 18:54:30,wahoo,Zwift - Team Italy & Frenchy Fuzion League (A),Favero Assioma Duo (to Garmin),Wahoo Kickr v5 2020,371,370,1
95765,473748,2021-01-12 18:54:15,wahoo,Zwift - Team Italy & Frenchy Fuzion League (A),Favero Assioma Duo (to Garmin),Wahoo Kickr v5 2020,351,337,14
97133,473748,2021-01-14 18:29:42,wahoo,Zwift - FUSION WINTER CUP (A) - huge dropouts on kickr5 - converted the race into 5min intervals.,Favero Assioma Duo (to Garmin),Wahoo Kickr v5 2020,374,367,7
99788,473748,2021-01-19 18:36:50,wahoo,Zwift - Zwift Racing League | WTRL - Men&#039;s/Mixed EMEA E2 DIVISION 6 (A),Favero Assioma Duo v.4.25 (Zwift),Wahoo Kickr v5 2020,350,350,0
101004,473748,2021-01-21 18:29:57,wahoo,Zwift - FUSION WINTER CUP (A) - Hard! #16,Favero Assioma Duo v.4.25 (Zwift),Wahoo Kickr v5 2020,365,367,-2
104760,473748,2021-01-28 18:29:57,wahoo,Zwift - FUSION WINTER CUP (A) - sprinting in frontgroup. #16 - good night for the team with 2nd place as well.,Favero Assioma Duo (to Garmin),Wahoo Kickr v5 2020,395,389,6
106027,473748,2021-01-31 06:54:51,wahoo,Zwift - No Pain No Gain Endurance Racing Series (A) - #2 trying to follow 1km distance attack. New season PB on 1min,Favero Assioma Duo (Zwift),Wahoo Kickr v5 2020 (Garmin),329,324,5
107561,473748,2021-02-02 19:51:57,wahoo,Zwift - Zwift Racing League | WTRL - Men&#039;s/Mixed EMEA W2 DIVISION 1 (A),Favero Assioma Duo v.4.25 (Zwift),Wahoo Kickr v5 2020,390,381,9
108986,473748,2021-02-04 18:29:55,wahoo,"Zwift - FUSION WINTER CUP (A) - Mountainstage #20. HR monitor disconnected just before kickoff. Its in my dual though. Best 20min in a loong time, so happy even though I couldn&#039;t keep up with frontgroup.",Favero Assioma Duo (to Garmin),Wahoo Kickr v5 2020,376,371,5
111667,473748,2021-02-09 18:37:25,wahoo,Zwift - EMEA E2 A6 - TTT on Mighty Metropolitan. Not the best legs....,Favero Assioma Duo (to Garmin),Wahoo Kickr v5 2020,375,368,7
113064,473748,2021-02-11 18:29:56,wahoo,Zwift - FUSION WINTER CUP (A) #sprint from frontgroup. Not much to sprint with though.....,Favero Assioma Duo (to Garmin),Wahoo Kickr v5 2020,371,367,4
117304,473748,2021-02-18 18:29:45,wahoo,Zwift - FUSION WINTER CUP (A) - teameffort to catch the break. Teamwin by star-sprinter Mr. Salby!!,Favero Assioma Duo (to Garmin),Wahoo Kickr v5 2020,359,358,1
119816,473748,2021-02-23 19:51:57,wahoo,Zwift - Zwift Racing League | WTRL - Men&#039;s/Mixed EMEA W2 DIVISION 1 (A),Favero Assioma Duo (to Garmin),Wahoo Kickr v5 2020,358,350,8
120836,473748,2021-02-25 18:29:54,wahoo,Zwift - FUSION WINTER CUP (A) - to much on Box Hill....,Favero Assioma Duo (to Garmin),Wahoo Kickr v5 2020,418,407,11
123116,473748,2021-03-02 18:34:58,wahoo,Zwift - Zwift Racing League | WTRL - Men&#039;s/Mixed EMEA E2 DIVISION 6 (A),Favero Assioma Duo v.4.75 (Zwift),Wahoo Kickr v5 2020,360,348,12
127161,473748,2021-03-11 18:29:55,wahoo,Zwift - FUSION SPRING CUP (A) - Tough finish....,Favero Assioma Duo (to Garmin),Wahoo Kickr v5 2020,360,356,4
35966,571602,2020-05-18 18:20:39,neo,Zwift - TFC Mad Monday World Series (6 of 6) (B),Zwift - Assioma,Garmin - Tacx Neo,340,322,18
36813,571602,2020-05-21 17:19:34,neo,Zwift - WTRL Team Time Trial Premier League (A),Zwift - Assioma,Garmin - Tacx Neo,323,306,17
38847,571602,2020-05-31 18:36:31,neo,Zwift - Powertap / Garmin - Neo,Zwift - Powertap,Garmin - Neo,238,232,6
38850,571602,2020-05-31 18:47:01,neo,Zwift - Neo / Garmin - Powertap,Garmin - Powertap,Zwift - Neo,210,208,2
40251,571602,2020-06-07 19:11:27,neo,Zwift -  TFC Group Sub 2.5 W/Kg Group Ride (C),Zwift - Powertap,Garmin - Tacx Neo,339,333,6
40384,571602,2020-06-08 18:21:01,neo,Zwift - TFC Mad Monday Series (3 of 6) (B),Zwift - Powertap,Garmin - Tacx Neo,332,320,12
29250,529622,2020-04-29 14:46:14,neo,Z PRO TRI Race Series / Mens Race A,power2max,tacx neo,376,378,-2
32170,529622,2020-05-06 18:08:07,neo,Zwift - Z PRO TRI Race Series (A),power2max,tacx neo,408,397,11
34631,529622,2020-05-13 14:28:58,neo,Z PRO TRI Race Series: Mens A Race 5,power2max,tacx neo,411,405,6
36380,529622,2020-05-20 13:22:12,neo,Z PRO TRI Race Series: Mens A Race 6,power2max,tacx neo to zwift ,374,361,13
38113,529622,2020-05-27 14:28:55,neo,Zwift - Z PRO TRI Race Series: Men&#039;s A Race 7 (A),power2max secondary (forgot  to start until a couple mins in),tacx neo to zwift ,373,362,11
40887,529622,2020-06-10 18:49:37,neo,Zwift - Z PRO TRI Race Series: Men&#039;s Race (A),power2max (seccondary),tacx neo to zwift ,391,381,10
99357,30432,2021-01-18 21:17:18,wahoo,Zwift - TDZ Stage 3: Standard Ride,Power2Max,Kickr Core,222,228,-6
126605,123667,2021-03-10 18:30:01,neo,Zwift - Flanders Cycling Happening (D),favero assioma duo,Tacx neo,338,330,8
127159,123667,2021-03-11 18:59:49,neo,Zwift - Flanders The BZR Ronde Spring Classics League (A),favero assioma duo,Tacx Neo,356,348,8
127954,123667,2021-03-13 14:44:46,neo,Zwift - Crit City Race (A),favero assioma duo,Tacx neo,355,348,7
128279,123667,2021-03-14 08:29:44,neo,Zwift - Flanders Endurance Race League Giro Di Grinta! (A),favero assioma duo,Tacx neo,378,366,12
45948,545017,2020-07-11 14:14:16,wahoo,Zwift - OH MY CRIT!! - Saturday Smash Race (A),Quarq dfour (computer),Wahoo Kickr 2018 (zwift),358,340,18
46969,545017,2020-07-19 13:14:18,wahoo,Zwift - KISS at Race 100 - Americas (A),Quarq dfour (computer),Wahoo Kickr 2018 (zwift),305,295,10
48502,545017,2020-08-01 14:14:57,wahoo,Zwift - OH MY CRIT - Saturday Smash Race (A),Quarq dfour (computer),Wahoo Kickr 2018 (zwift),311,301,10
52984,545017,2020-09-02 00:31:36,wahoo,Zwift - 3R Sundown Race Series - Round1 iTT (A),Quarq dfour (computer),Wahoo Kickr 2017 Zwift,307,302,5
53323,545017,2020-09-03 23:00:13,wahoo,Zwift - Koa Sports League Warrior Race (A),Quarq dfour (computer),Wahoo Kickr 2017 Zwift,326,315,11
53775,545017,2020-09-07 18:19:53,wahoo,Zwift - TFC Mad Monday Summer Series (10 of 10) (A),Quarq dfour (computer),Wahoo Kickr 2017 Zwift,317,308,9
54254,545017,2020-09-10 00:45:36,wahoo,Zwift - USA Cycling Race League by Indoor Specialist (A),Quarq dfour (computer),Wahoo Kickr 2017 Zwift,341,327,14
59455,545017,2020-10-04 16:18:57,wahoo,Zwift - Stages of DIRT (A),Quarq dfour (computer),Wahoo Kickr 2018 (zwift),335,334,1
59938,545017,2020-10-06 18:58:42,wahoo,Zwift - KISS at Race - EU PM (A),Quarq dfour (computer),Wahoo Kickr 2017 Zwift,339,343,-4
61703,545017,2020-10-14 01:48:47,wahoo,Zwift - Zwift Racing League | WTRL,Quarq dfour (computer),Wahoo Kickr 2017 Zwift,353,339,14
64074,545017,2020-10-22 09:56:32,wahoo,Zwift - KISS at Race - Americas AM (A),Quarq dfour (computer),Wahoo Kickr 2017 Zwift,349,334,15
65629,545017,2020-10-28 01:56:38,wahoo,Zwift - Zwift Racing League | WTRL - AMERICAS W (MEN) -  Division 1 (A),Quarq dfour (computer),Wahoo Kickr 2017 Zwift,345,330,15
67043,545017,2020-11-01 18:34:08,wahoo,Zwift - XRS Races Crit (A),Quarq dfour (computer),Wahoo Kickr 2017 Zwift,315,303,12
71633,579101,2020-11-15 08:44:56,wahoo,Favero_Assioma / Wahoo_Kickr,Favero_Assioma,Wahoo_Kickr,386,375,11
73402,579101,2016-01-01 01:25:19,wahoo,Favero_Assioma / Wahoo_Kickr,Favero_Assioma,Wahoo_Kickr,408,406,2
76831,579101,2020-11-28 08:14:54,wahoo,Matando o Corpo® Sergio Samitier Edition by PETA-Z,Favero_Assioma,Wahoo_Kickr,410,398,12
103288,579101,2021-01-26 09:15:17,wahoo,3R Whole Lotta Lava Hilly Race - 2 Laps (28.9km/12.53mi 336m) (A),Favero_Assioma,Wahoo_Kickr,410,399,11
107981,579101,2021-02-03 10:44:57,wahoo,The Morning Grind by STPC (A),Favero_Assioma,Wahoo_Kickr,382,378,4
16509,487002,2020-03-02 19:47:31,wahoo,Vector 3 / Kickr 2019,Vector 3,Kickr 2019,271,269,2
18845,487002,2020-03-20 06:29:56,wahoo,Kickr 2019 / Vector 3,Vector 3,Kickr 2019,252,245,7
67510,487002,2020-11-03 10:49:43,wahoo,Zwift - SZR Lunch Race (B),Vector 3,Kickr 2019,297,294,3
75590,487002,2020-11-25 17:39:51,wahoo,Zwift - ZHR Hare & Hounds Race (B),Vector 3,Kickr 2019,290,295,-5
88054,487002,2020-12-27 10:09:35,wahoo,Zwift - 3R Sand & Sequoias - 1 Lap (20km/12.5mi 173m) (B),Vector 3,Kickr 2019,310,310,0
26028,9500,2020-04-18 16:34:34,wahoo,"Mx Endurance Challenge, fast lap Tic Toc second attempt",Stages,Kickr,341,341,0
36212,9500,2020-05-19 07:54:59,wahoo,"MX Endurance Challenge, four Horsemen Solo ride",4955181572,Kickr,287,306,-19
36213,9500,2020-05-19 07:54:59,wahoo,"MX Endurance Challenge, four Horsemen Solo ride",Stages,Kickr,287,306,-19
57894,9500,2020-09-27 11:44:50,wahoo,Zwift - Crit City Race (A),Stages,Kickr,321,319,2
127348,548388,2021-03-11 18:59:56,wahoo,Zwift - Flanders The BZR Ronde Spring Classics League (A) Stage 1 + losrijden,Quarq Dfoor,Wahoo Kickr V5.0,383,371,12
85447,559244,2020-12-20 16:04:58,wahoo,3R Tick Tock Flat Race - 1 Lap (19km/11.8mi 50m),Favero Asioma,Wahoo KICKR,394,384,10
85690,559244,2020-12-21 10:40:00,wahoo,"Zwift - ZWC Hill Climb Battle (A) Very, very bad legs. But it was just for dual recording ",Favero Assioma,Wahoo KICKR,402,395,7
35315,569648,2020-05-16 07:10:18,neo,Zwift - ZWC Weekend Race  (A),neo,neo,246,250,-4
35316,569648,2020-05-16 07:10:18,neo,Zwift - ZWC Weekend Race  (A),biela,neo,250,246,4
36639,569648,2020-05-21 17:16:22,neo,Zwift - WTRL Team Time Trial (D) EQUIPAZO,biela,neo,288,286,2
40133,569648,2020-06-07 06:54:57,neo,Zwift - No Pain No Gain Endurance Racing Series (B),biela 4iii,neo,269,274,-5
40357,569648,2020-06-08 16:39:57,neo,Zwift - Team Italy PISSEI Race (B),biela 4iii,neo,286,292,-6
60597,569648,2020-10-09 16:51:06,neo,neo / biela,biela,neo,203,189,14
89515,569648,2020-12-31 16:26:41,wahoo,Zwift - Richmond,Zwift,kickr,203,197,6
105030,569648,2021-01-29 10:02:01,wahoo,Zwift - TDZ Stage 6: Standard Ride,vector3,kickr,205,204,1
108876,569648,2021-02-04 18:31:52,wahoo,TTT PETA-Z 7 TOP CLASS,vector3,kickr,300,301,-1
109376,569648,2021-02-05 17:04:31,wahoo,Zwift - Ritxiper&#039;s Marmitako Social Ride con PETA-Z (E),vector3,kickr,185,173,12
110283,569648,2021-02-07 09:13:29,wahoo,Zwift - Fantasy Nutrinovex Rice by PETA-Z (A),vector3,kickr v5,311,302,9
110934,569648,2021-02-08 17:31:01,wahoo,Zwift - Nenucos Mimosines Social Ride by PETA-Z (D),vector3,kickr v5,240,241,-1
119615,569648,2021-02-23 18:16:44,wahoo,ZRL EMEA A ,vector3,kickr v5,332,334,-2
122989,569648,2021-03-02 18:24:59,wahoo,"PAC-MAN Why not? al palo, pero muy contento :)�",vector3,kickr v5,315,319,-4
124783,569648,2021-03-06 08:04:45,wahoo,Movistar Why not? by peta-z Carrera 1 Fase 2. Muerte y destruccion,vector3,kickr v5,327,337,-10
127704,569648,2021-03-13 08:01:48,wahoo,Movistar Why not? by Peta-Z 2a carrera 2a fase. Un orgullo entrar alante ,vector3,kickr v5,302,318,-16
128244,569648,2021-03-14 08:54:47,wahoo,"Movistar why not? by PETA-Z. 3a carrera. Vida, muerte y resurreci�on",vector3,kickr v5,339,339,0
3511,561362,2019-10-29 19:09:33,neo,Zwift - WORLDOFFUSION Racing League (A),Assioma Favero Duo,Tacx Neo,407,410,-3
4040,561362,2019-11-05 19:09:30,neo,Zwift - WORLDOFFUSION Racing League (A),Assioma Favero Duo,Tacx Neo,376,380,-4
4155,561362,2019-11-12 19:09:02,neo,Zwift - WORLDOFFUSION Racing League (A),Assioma Favero Duo,Tacx Neo,377,381,-4
40844,561362,2020-06-10 16:44:59,neo,Zwift - 3R 100 Steady Ride [~3.0w/kg avg] (B),Assioma Favero Duo,Tacx Neo,305,311,-6
41083,561362,2020-06-11 17:06:38,neo,Zwift - Espresso,Assioma Favero Duo,Tacx Neo,369,382,-13
55078,561362,2020-09-14 17:55:07,neo,Zwift - Invitational League // Qualifying Race #1,Assioma Favero Duo,Tacx Neo,392,385,7
56425,561362,2020-09-20 12:55:21,neo,Zwift - Invitational League // Qualifying Race #3 (Men) (A),Assioma Favero Duo,Tacx Neo,401,394,7
76061,561362,2020-11-26 18:21:43,neo,Zwift - WTRL NOPINZ WORLD TTT CHAMPIONSHIPS - Zone 5 (C),Assioma Favero Duo,Tacx Neo,380,375,5
62845,585011,2020-10-17 15:39:05,wahoo,ZHQ Beta Crit City Race,Garmin 830/Stages (left only),Zwift/KICKR 2017,291,284,7
62846,585011,2020-10-02 15:07:39,wahoo,Zwift - 3R Sand and Sequoias Race (B),Garmin 830/Stages (left only),Zwift/KICKR 2017,294,295,-1
62848,585011,2020-09-29 15:00:59,wahoo,Zwift - 3R Sundown Race Series  (B),Garmin 830/Stages (left only),Zwift/KICKR 2017,285,280,5
62852,585011,2020-09-27 13:11:39,wahoo,Zwift - Herd Summer Racing League Series (B),Garmin 830/Stages (left only),Zwift/KICKR 2017,287,274,13
65692,585011,2020-10-27 14:57:46,wahoo,Zwift - ZA Road 2020 - Segment Ride #1: Innsbruck Course,Garmin 830/Stages (left only),Zwift/KICKR 2017,270,272,-2
65697,585011,2020-10-20 13:56:36,wahoo,Zwift Academy Road: Workout 3 | VO2 Capacity,Garmin 830/Stages (left only),Zwift/KICKR 2017,309,313,-4
66281,585011,2020-10-29 15:36:16,wahoo,Zwift - Crit City Race (B),Garmin 830/Stages (left only),Zwift/KICKR 2017,289,293,-4
66869,585011,2020-10-31 15:50:45,wahoo,Zwift - ZA Road 2020 - Segment Ride #1: Sand and Sequoias Course,Garmin 830/Stages (left only),Zwift/KICKR 2017,307,307,0
68746,585011,2020-11-06 15:51:21,wahoo,Zwift - ZA Road Race #1: 3.2 - 4 w/kg,Garmin 830/Stages (left only),Zwift/KICKR 2017,308,300,8
69073,585011,2020-11-08 15:47:31,wahoo,Zwift - 3R Super Six Sunday Race,Garmin 830/Stages (left only),Zwift/KICKR 2017,311,307,4
69671,585011,2020-11-10 13:53:21,wahoo,Zwift Academy Road: Workout 6 | Alternative Sprints,Garmin 830/Stages (left only),Zwift/KICKR 2017,230,234,-4
71204,585011,2020-11-13 15:50:53,wahoo,Zwift - 3R Volcano Flat Race - 3 Laps (36.6km/22.7mi 138m) (B),Garmin 830/Stages (left only),Zwift/KICKR 2017,316,314,2
72939,585011,2020-11-18 15:51:20,wahoo,Zwift - Sydkysten / KST Race (B),Garmin 830/Stages (left only),Zwift/KICKR 2017,290,288,2
73517,585011,2020-11-20 15:01:38,wahoo,Zwift - 3R Sand and Sequoias Race (B),Garmin 830/Stages (left only),Zwift/KICKR 2017,316,297,19
74540,585011,2020-11-23 14:59:57,wahoo,6.9 km Sprint race (B),Garmin 830/Stages (left only),Zwift/KICKR 2017,304,302,2
77795,585011,2020-11-30 15:49:09,wahoo,3R Classique Reverse Flat Race (B),Garmin 830/Stages (left only),Zwift/KICKR 2017,318,306,12
82793,585011,2020-12-13 15:11:28,wahoo,Zwift - 3R Watopia 65km Race - 6 laps (40mi 324m) (B),Garmin 830/Stages (left only),Zwift/KICKR 2017,302,297,5
83489,585011,2020-12-15 16:14:16,wahoo,Zwift - ZHQ FutureWorks Crit City Race - Anti-sandbagging (B),Garmin 830/Stages (left only),Zwift/KICKR 2017,307,291,16
89371,585011,2020-12-31 12:15:46,wahoo,Zwift - ZHQ FutureWorks Crit City Race - Anti-sandbagging (B),Garmin 830/Stages (left only),Zwift/KICKR 2017,317,302,15
96824,585011,2021-01-14 13:11:45,wahoo,Zwift - ZHQ FutureWorks Circuit Race - Anti-sandbagging (B),Garmin 830/Stages (left only),Zwift/KICKR 2017,292,290,2
98612,585011,2021-01-17 15:10:42,wahoo,Zwift - 3R Watopia 65km Race - 6 laps (40mi 324m) (B),Garmin 830/Stages (left only),Zwift/KICKR 2017,305,305,0
100963,585011,2021-01-21 13:15:46,wahoo,Zwift - ZHQ FutureWorks Circuit Race - Anti-sandbagging (B),Garmin 830/Stages (left only),Zwift/KICKR 2017,284,287,-3
103361,585011,2021-01-26 13:50:00,wahoo,Zwift - 3R LaGuardia Super Sprint Race - 1 Lap (3.7km/2.6mi 27m) (1st in B),Garmin 830/Stages (left only),Zwift/KICKR 2017,340,339,1
103362,585011,2021-01-24 15:10:51,wahoo,Zwift - 3R Watopia 65km Race - 6 laps (40mi 324m) (B),Garmin 830/Stages (left only),Zwift/KICKR 2017,315,312,3
106384,585011,2021-01-31 15:07:10,wahoo,Zwift - 3R Watopia 65km Race - 6 laps (40mi 324m) (3th in B),Garmin 830/Stages (left only),Zwift/KICKR 2017,299,299,0
118731,585011,2021-02-21 15:03:00,wahoo,Zwift - SCANNELLATORI SERIALI TOUR (B),Garmin 830/Stages (left only),Zwift/KICKR 2017,285,289,-4
126740,585011,2021-03-09 17:26:21,wahoo,Zwift - KC Club Championship 2021 (B),Garmin 830/Stages (left only),Zwift/KICKR 2017,311,305,6
98426,460996,2021-01-17 08:30:00,wahoo,Zwift - Flandres Endurance Race,Assioma,Kickr,336,343,-7
107994,461812,2021-02-02 19:52:02,wahoo,Zwift - Zwift Racing League | WTRL - Men&#039;s/Mixed EMEA W2 DIVISION 1 (A),Powertap P1,Wahoo kickr ,395,403,-8
108312,461812,2021-02-03 19:00:01,wahoo,Zwift - Open - Movistar Team Challenge Community Qualifier Race #1,Powertap P1,Wahoo kickr ,379,387,-8
111743,461812,2021-02-09 19:56:02,wahoo,Zwift - Zwift Racing League | WTRL - Men&#039;s/Mixed EMEA W2 DIVISION 1 (A),Powertap P1,Wahoo kickr ,360,366,-6
116079,461812,2021-02-16 19:51:57,wahoo,Zwift - Zwift Racing League | WTRL - Men&#039;s/Mixed EMEA W2 DIVISION 1 (A),Powertap P1,Wahoo kickr ,393,400,-7
119778,461812,2021-02-23 19:52:03,wahoo,Zwift - Zwift Racing League | WTRL - Men&#039;s/Mixed EMEA W2 DIVISION 1 (A),Powertap P1,Wahoo kickr ,331,338,-7
123108,461812,2021-03-02 19:56:27,wahoo,Zwift - Zwift Racing League | WTRL - Men&#039;s/Mixed EMEA W2 DIVISION 1 (A),Powertap P1,Wahoo kickr ,328,334,-6
129253,461812,2021-03-16 18:17:40,wahoo,Zwift - CeramicSpeed Race Series: Open Race (A),Powertap P1,Wahoo kickr ,411,421,-10
34102,595081,2020-05-12 18:12:20,wahoo,Zwift - UNO X CUP powered by DCU & Feltet.dk (A),SRAM Quarq DZero,Wahoo Kickr 2018,378,371,7
35519,595081,2020-05-17 04:56:39,wahoo,Zwift - KISS at Race 100 - EU (A),SRAM Quarq DZero,Wahoo Kickr 2018,389,378,11
36085,595081,2020-05-19 18:13:17,wahoo,Zwift - UNO X CUP powered by DCU & Feltet.dk (A),SRAM Quarq DZero,Wahoo Kickr 2018,410,405,5
37284,595081,2020-05-24 04:59:32,wahoo,Zwift - KISS at Race 100 - EU (A),SRAM Quarq DZero,Wahoo Kickr 2018,370,365,5
39592,595081,2020-06-04 17:26:58,wahoo,Zwift - FUSION ECT BEUNSTOPPABLE Racing Series (A),SRAM Quarq DZero,Wahoo Kickr 2018,402,391,11
40545,595081,2020-06-09 17:52:05,wahoo,Zwift - Team Italy & Frenchy Fuzion League (A),SRAM Quarq DZero,Wahoo Kickr 2018,414,403,11
42710,595081,2020-06-20 07:34:59,wahoo,Zwift - Duathlon Race Series (A),SRAM Quarq DZero,Wahoo Kickr 2018,407,396,11
44840,595081,2020-07-04 12:10:02,wahoo,Zwift - Team ODZ RACE (A),SRAM Quarq DZero,Wahoo Kickr 2018,387,368,19
44952,595081,2020-07-05 07:29:33,wahoo,Zwift - ZHR Masters Weekender (B),SRAM Quarq DZero,Wahoo Kickr 2018,385,376,9
45213,595081,2020-07-07 09:57:21,wahoo,Zwift - KISS at Race - Americas AM (A),SRAM Quarq DZero,Wahoo Kickr 2018,412,388,24
45572,595081,2020-07-09 09:54:25,wahoo,Zwift - KISS at Race - Americas AM (A),SRAM Quarq DZero,Wahoo Kickr 2018,409,400,9
45574,595081,2020-07-09 10:41:46,wahoo,Zwift - ZHR Crit Race (A),SRAM Quarq DZero,Wahoo Kickr 2018,346,341,5
46251,595081,2020-07-14 09:57:21,wahoo,Zwift - KISS at Race - Americas AM (A),SRAM Quarq DZero,Wahoo Kickr 2018,405,407,-2
46440,595081,2020-07-15 12:53:09,wahoo,KISS at Race - Pacific AM,SRAM Quarq DZero,Wahoo Kickr 2018,382,370,12
47263,595081,2020-07-22 08:01:19,wahoo,Zwift - 3R Tempus Fugit Flat Race - 1 Lap (19.8km/12.3mi 20m) (A),SRAM Quarq DZero,Wahoo Kickr 2018,379,371,8
47265,595081,2020-07-22 09:00:09,wahoo,Zwift - 3R Watopia Flat Route Race - 3 Laps (30.3km/18.8mi 162m) (A),SRAM Quarq DZero,Wahoo Kickr 2018,400,389,11
47399,595081,2020-07-23 08:25:02,wahoo,Zwift - KISS at Race - Down Under (A),SRAM Quarq DZero,Wahoo Kickr 2018,339,334,5
34861,533940,2020-05-14 21:04:58,wahoo,3R Innsbruckring Flat Race - 2 Laps (17.6km/10.9m 154m),Garmin Vector,Kickr,419,420,-1
52784,533940,2020-08-31 18:20:00,wahoo,Kickr / Garmin Vector,Garmin Vector,Kickr,344,363,-19
230,591535,2019-07-30 18:10:17,neo,Zwift - FUSION ECT Racing League (B),Zwift - Assioma Duo,Tacx Neo,326,319,7
786,591535,2019-08-17 20:00:16,neo,Zwift - Team Dimension Data Zwift Academy Race: Circuit (B),Assioma Duo,Tacx Neo,351,351,0
2658,591535,2019-09-26 18:35:41,neo,Zwift - WTRL Team Time Trial (D),Assioma Duo,Tacx Neo,350,356,-6
11385,591535,2020-01-28 19:40:52,neo,3R Ultimate Racing League - Round 4,Assioma Duo,Tacx Neo,344,345,-1
16501,591535,2020-03-02 19:21:23,neo,Zwift - TFC & WTRL Mad Monday London Series (1 of 6) (B),Assioma Duo,Tacx Neo,365,365,0
79938,366842,2020-12-05 15:37:43,neo,Zwift - TEAM VEGAN Tofu Tornado (A),Afternoon_Ride (1),Neo,355,353,2
47867,422723,2020-07-25 18:09:57,wahoo,Zwift - TBR Pancake Chase Race! (A),Vectors,Wahoo Kickr,422,413,9
85912,570713,2020-12-21 00:21:11,wahoo,Zwift - Watopia,4iiii power meter,wahoo kickr core,313,299,14
116563,601103,2021-02-17 14:35:02,neo,Zwift - 3R Sand & Sequoias - 1 Lap (20km/12.5mi 173m) (A),Assioma favero,Tacx Neo Bike,347,335,12
118213,601103,2021-02-20 12:00:01,neo,Zwift - Herd Beginner Racing Series (E),Assioma favero uno,Tacx Neo Bike,367,344,23
120002,601103,2021-02-24 02:59:59,neo,Zwift - Zwift Racing League | WTRL - Men&#039;s/Mixed AMERICAS W DIVISION 1 (A),Assioma Favero Uno,Tacx Neo Bike,383,379,4
123305,601103,2021-03-03 03:03:52,neo,Zwift - Zwift Racing League | WTRL - Men&#039;s/Mixed AMERICAS W DIVISION 1 (A),Assioma favero,Tacx Neo Bike,336,329,7
118362,10008,2021-02-20 17:00:06,wahoo,Zwift - ZTPL.CC Winter League 2021 Stage 10 (A),stages left,kickr,314,314,0
38021,309897,2020-05-27 10:16:37,wahoo,Zwift - Yorkshire,Assiomas,Wahoo Kickr,217,219,-2
38245,309897,2020-05-28 09:09:06,wahoo,Zwift - WTRL Team Time Trial (D),Assiomas,Wahoo Kickr,307,315,-8
38725,309897,2020-05-30 16:44:39,wahoo,Assiomas / Wahoo Kickr,Assiomas,Wahoo Kickr,306,321,-15
39045,309897,2020-06-02 09:30:16,wahoo,Zwift - MGCC Ride & Race (B),Assiomas,Wahoo Kickr,298,315,-17
39961,309897,2020-06-06 10:59:34,wahoo,Zwift - DIRT Dadurday Chase Race  (A),Assiomas,Wahoo Kickr,303,310,-7
43545,309897,2020-06-25 09:08:00,wahoo,Zwift - Espresso,Assiomas,Wahoo Kickr,302,316,-14
43988,309897,2020-06-28 17:59:59,wahoo,Zwift - Andy Hadfield (DIRT)&#039;s Meetup - Road to Sky,Assiomas,Wahoo Kickr,292,297,-5
44030,309897,2020-06-29 10:14:03,wahoo,Zwift - 3R Volcano Flat Race - 3 Laps (36.6km/22.7mi 138m) (A),Assiomas,Wahoo Kickr,313,319,-6
46565,309897,2020-07-16 09:17:56,wahoo,Zwift - Espresso,Assiomas,Wahoo Kickr,305,318,-13
47969,309897,2020-07-28 11:23:33,wahoo,Zwift - 3R Volcano Circuit Flat Race - 8 Laps (35.2km/21.9mi 160m) (A),Assiomas,Wahoo Kickr,313,321,-8
52117,309897,2020-08-27 09:17:41,wahoo,WTRL Team Time Trial - Zone1,Assiomas,Wahoo Kickr,317,318,-1
52483,309897,2020-08-29 11:00:49,wahoo,DIRT Dadurday Chase Race ,Assiomas,Wahoo Kickr,314,314,0
53398,309897,2020-09-04 09:02:08,wahoo,3R Whole Lotta Lava Hilly Race - 2 Laps (28.9km/12.53mi 336m),Assiomas,Wahoo Kickr,347,347,0
53904,309897,2020-09-08 09:27:55,wahoo,MGCC Ride & Race,Assiomas,Wahoo Kickr,323,323,0
54910,309897,2020-09-13 18:09:43,wahoo,Zwift - 3R Watopia Hilly Reverse Race - 4 Laps (36.7km/22.8mi 400m) (A),Assiomas,Wahoo Kickr,327,327,0
74347,309897,2020-11-22 18:55:01,wahoo,Zwift - 11/22/2020,Assiomas,Wahoo Kickr,314,317,-3
74465,309897,2020-11-23 09:54:17,wahoo,Zwift - ZA Road 2020 - Segment Ride #1: Three Sisters Course,Assiomas,Wahoo Kickr,293,299,-6
75212,309897,2020-11-24 19:32:12,wahoo,Zwift - Zwift Racing League | WTRL - Men&#039;s EMEA W1 DIVISION 3 (A),Assiomas,Wahoo Kickr,329,339,-10
77461,309897,2020-11-29 19:23:42,wahoo,Zwift - Innsbruck,Assiomas,Wahoo Kickr,321,317,4
80395,309897,2020-12-07 10:50:56,wahoo,Zwift - KISS at Base Training Ride (B),Assiomas,Wahoo Kickr,232,237,-5
80911,309897,2020-12-08 19:39:49,wahoo,Zwift Racing League | WTRL - Mens EMEA W1 DIVISION 3,Assiomas,Wahoo Kickr,333,338,-5
106393,309897,2021-01-31 18:56:03,wahoo,Zwift - SST (Short),Assiomas,Wahoo Kickr,285,290,-5
107557,309897,2021-02-02 19:33:08,wahoo,Zwift Racing League | WTRL - Mens/Mixed EMEA W1 DIVISION 2,Assiomas,Wahoo Kickr,349,351,-2
110121,309897,2021-02-06 17:26:23,wahoo,Zwift - Watopia,Assiomas,Wahoo Kickr,311,314,-3
127476,309897,2021-03-12 15:45:25,wahoo,Zwift - Watopia,Assiomas,Wahoo Kickr,324,325,-1
128012,309897,2021-03-13 15:21:10,wahoo,Absa Cape Epic Stage 4 pb Assos - Open,2021-03-13-15-21-10,Wahoo Kickr,332,334,-2
128981,309897,2021-03-16 10:04:14,wahoo,MGCC Ride & Race,Assiomas,Wahoo Kickr,343,343,0
129592,309897,2021-03-17 12:55:01,wahoo,KISS Race Series - Pacific AM,Assiomas,Wahoo Kickr,331,331,0
31296,596613,2020-05-04 17:11:12,wahoo,Zwift - DBR Wahoo League (A),Garmin Vector 2 Dual Side,Wahoo Kicker 3,428,412,16
31907,596613,2020-05-06 06:11:28,wahoo,Zwift - 3R Innsbruckring Flat Race - 3 Laps (26.4km/16.4mi 231m) (A),Garmin Vector 2 Dual Side,Wahoo Kicker 3,437,415,22
32963,596613,2020-05-09 11:08:09,wahoo,Zwift - DIRT Dadurday Chase Race  (A),Garmin Vector 2 Dual Side,Wahoo Kicker 3,426,402,24
32985,596613,2020-05-09 13:03:25,wahoo,Zwift - Tour for All 2020: Stage 2 Shorter Race A/B,Garmin Vector 2 Dual Side,Wahoo Kicker 3,414,389,25
33189,596613,2020-05-10 09:43:23,wahoo,Zwift - Points Race League by Team DIRT (A),Garmin Vector 2 Dual Side,Wahoo Kicker 3,380,363,17
33325,596613,2020-05-03 07:21:55,wahoo,Zwift - ZHR Masters Weekender (B),Garmin Vector 2 Dual Side,Wahoo Kicker 3,412,388,24
34557,596613,2020-05-14 08:11:54,wahoo,Zwift - Tour for All 2020: Stage 3 Shorter Race A/B,Garmin Vector 2 Dual Side,Wahoo Kicker 3,382,382,0
41401,596613,2020-06-13 07:43:57,wahoo,Zwift - EVR Asia Weekend (A),Garmin Vector 2 Dual Side,Wahoo Kicker 3,373,358,15
41613,596613,2020-06-14 08:36:51,wahoo,Zwift - Newbury Velo Road Race (A),Garmin Vector 2 Dual Side,Wahoo Kicker 3,434,402,32
42619,596613,2020-06-19 16:36:06,wahoo,Zwift - Crit City Race (A),Garmin Vector 2 Dual Side,Wahoo Kicker 3,388,400,-12
42812,596613,2020-06-20 12:34:48,wahoo,Zwift - WTRL Saturday Crit (A).... Race no 500 on Zwift,Garmin Vector 2 Dual Side,Wahoo Kicker 3,399,395,4
44066,596613,2020-06-29 16:43:21,wahoo,Zwift - DBR Monday Race  (A),Garmin Vector 3 Single Side,Wahoo Kicker 3,399,375,24
46927,596613,2020-07-19 08:49:02,wahoo,Zwift - Newbury Velo Road Race (A),Garmin Vector 3 Single Side,Wahoo Kicker 3,390,384,6
47452,596613,2020-07-23 16:01:57,wahoo,Zwift - OH MY CRIT! - The Double Race 2/2 (A),Garmin Vector 3 Single Side,Wahoo Kicker 3,406,407,-1
47453,596613,2020-07-23 17:48:21,wahoo,Zwift - Team Italy Superveloce Race (A),Garmin Vector 3 Single Side,Wahoo Kicker 3,363,357,6
47557,596613,2020-07-24 16:00:28,wahoo,Zwift - 3R Volcano Flat Race - 3 Laps (36.6km/22.7mi 138m) (A),Garmin Vector 3 Single Side,Wahoo Kicker 3,394,383,11
48003,596613,2020-07-28 15:52:36,wahoo,Wahoo Kicker 3 / Garmin Vector 3 Single Side,Garmin Vector 3 Single Side,Wahoo Kicker 3,431,402,29
48573,596613,2020-08-02 08:38:51,wahoo,Zwift - Newbury Velo Road Race (A).... Trying to hold The Saris boys&#039; wheels,Garmin Vector 3 Single Side,Wahoo Kicker 3,418,397,21
49197,596613,2020-08-07 15:55:22,wahoo,Zwift - 3R Volcano Flat Race - 3 Laps (36.6km/22.7mi 138m) (A).... New bike day!! Spezialized SL 7,Garmin Vector 3 Single Side,Wahoo Kicker 3,389,389,0
54886,596613,2020-09-13 16:05:23,wahoo,Zwift - Stages of DIRT (A),Garmin Vector 3 Single Side,Wahoo Kicker 3,383,366,17
61543,596613,2020-10-13 16:51:11,wahoo,Zwift - Zwift Racing League | WTRL,Garmin Vector 3 Single Side,Wahoo Kicker 3,401,400,1
69332,596613,2020-11-09 16:32:35,wahoo,Zwift - Garmin Never Stop Cycling // Stage 1 Road - Open Category,Garmin Vector 3 Single Side,Wahoo Kicker 3,407,392,15
78032,596613,2020-12-01 17:29:24,wahoo,Zwift - Zwift Racing League | WTRL - Men&#039;s EMEA E1 DIVISION 1 (A),Garmin Vector 3 Single Side,Wahoo Kicker 3,390,383,7
95606,596613,2021-01-12 17:20:32,wahoo,Zwift - Zwift Racing League | WTRL - Men&#039;s/Mixed EMEA E1 DIVISION 2 (A),Garmin Vector 3 Single Side,Wahoo Kicker 3,378,371,7
122893,596613,2021-03-02 17:25:25,wahoo,Zwift - ZHQ FutureWorks Circuit Race - Anti-sandbagging (A),Garmin Vector 3 Single Side,Wahoo Kicker 3,368,345,23
111906,190541,2021-02-10 00:57:21,wahoo,Zwift - Zwift Racing League | WTRL - Men&#039;s/Mixed AMERICAS E DIVISION 3 (A),Ultegra Crank,Kickr,351,350,1
120172,190541,2021-02-24 00:47:59,wahoo,Zwift - Zwift Racing League | WTRL - Men&#039;s/Mixed AMERICAS E DIVISION 3 (A),Ultegra Crank,Kickr,345,316,29
8925,499,2018-02-24 15:46:17,wahoo,Zwift - Danmarks Cykle Union 2020 Cup (A),Garmin Vector 2,Wahoo Kickr Core,338,348,-10
9373,499,2020-01-14 17:58:57,wahoo,Zwift - Danmarks Cykle Union 2020 Cup (A),Garmin Vector 2,Wahoo Kickr Core,322,333,-11
9855,499,2020-01-18 08:58:15,wahoo,Zwift - Danmarks Cykle Union 2020 Cup (A),Garmin Vector 2,Wahoo Kickr Core,354,363,-9
10168,499,2020-01-20 17:28:36,wahoo,Zwift - Danmarks Cykle Union 2020 Cup (A) #moderatturpaafusionsmaekken,Garmin Vector 2,Wahoo Kickr Core,358,372,-14
10969,499,2020-01-26 08:58:14,wahoo,Zwift - Danmarks Cykle Union 2020 Cup (A),Garmin Vector 2,Wahoo Kickr Core,380,386,-6
21176,499,2020-04-01 17:29:08,wahoo,Zwift - Danmarks Cykle Union – mid-week racing  (A),Garmin Vector 2,Wahoo Kickr Core,337,334,3
27547,499,2020-04-24 07:30:14,wahoo,Zwift - Watopia Cup Race // Zwift Classic (A),Garmin Vector 2,Wahoo Kickr Core,343,361,-18
29025,499,2020-04-29 09:32:07,wahoo,Zwift - Crit City Slam Race // Zwift Classic (C),Garmin Vector 2,Wahoo Kickr Core,333,348,-15
58807,499,2020-10-01 14:05:22,wahoo,Zwift - 3R Classique Flat Race - 6 Laps (37.7km/23.4mi 114m) (A),Garmin Vector 2,Wahoo Kickr Core,353,342,11
63657,499,2020-10-20 18:55:26,wahoo,Zwift - Zwift Racing League | WTRL - EMEA (MEN) - TTT Grp 1 (E),Garmin Vector 2,Wahoo Kickr Core,350,377,-27
65652,499,2020-10-27 19:43:11,wahoo,Zwift - Zwift Racing League | WTRL - EMEA W (MEN) -  Division 1 (A),Garmin Vector 2,Wahoo Kickr Core,361,383,-22
67786,499,2020-11-03 19:46:39,wahoo,Zwift - Zwift Racing League | WTRL - Men&#039;s EMEA W1 DIVISION 1 (A),Garmin Vector 2,Wahoo Kickr Core,363,384,-21
101009,499,2021-01-21 18:29:15,wahoo,Zwift - FUSION WINTER CUP (A),Garmin Vector 2,Wahoo Kickr Core,349,369,-20
104766,499,2021-01-28 18:28:55,wahoo,Zwift - FUSION WINTER CUP (A),Garmin Vector 2,Wahoo Kickr Core,347,354,-7
107546,499,2021-02-02 18:22:40,wahoo,Zwift - Zwift Racing League | WTRL - Men&#039;s/Mixed EMEA E2 DIVISION 1 (A),Garmin Vector 2,Wahoo Kickr Core,366,393,-27
119785,499,2021-02-23 19:54:12,wahoo,Zwift - Zwift Racing League | WTRL - Men&#039;s/Mixed EMEA W2 DIVISION 3 (A),Garmin Vector 2,Wahoo Kickr Core,354,361,-7
129260,499,2021-03-16 18:28:57,wahoo,Zwift - CeramicSpeed Race Series: Open Race (A),Garmin Vector 2,Wahoo Kickr Core,374,403,-29
66166,572110,2020-10-29 18:31:05,wahoo,Zwift - 4wk FTP Booster Week 2 Day 5 - 40/20&#039;s #2,5745688614,Wahoo Kickr Core,332,332,0
66168,572110,2020-10-29 18:30:25,wahoo,Zwift - 4wk FTP Booster Week 2 Day 5 - 40/20&#039;s #2,4iii ,Wahoo Kickr Core,347,332,15
68546,572110,2020-11-06 16:04:59,wahoo,Zwift - 3R Volcano Flat Race - 3 Laps (36.6km/22.7mi 138m) (B),4iii ,Wahoo Kickr Core,401,366,35
74827,572110,2020-11-23 16:10:07,wahoo,Zwift - 3R Classique Reverse Flat Race - 4 Laps (26.9km/16.7mi 57m) (A),4iii ,Wahoo Kickr Core,381,392,-11
75567,572110,2020-11-25 18:59:51,wahoo,Zwift - Zwift NL Race Day (A),4iii ,Wahoo Kickr Core,379,385,-6
81843,572110,2020-12-10 18:59:59,wahoo,Zwift -  Flanders The BZR Ronde  (A),4iii ,Wahoo Kickr Core,383,380,3
86201,572110,2020-12-22 18:55:18,wahoo,Zwift - Team Italy & Frenchy Fuzion League (A),4iii ,Wahoo Kickr Core,370,370,0
86203,572110,2020-12-22 18:54:53,wahoo,Zwift - Team Italy & Frenchy Fuzion League (A),4iii ,Wahoo Kickr Core,370,368,2
88141,591599,2020-12-28 09:22:03,wahoo,Kickr Core calibrated 1.0.12 VS Favero Assioma Duo - 1h40,Favero Assioma Duo,Kickr Core,234,249,-15
88266,591599,2020-12-28 16:57:24,wahoo,Kickr Core calibrated 1.0.13 VS Favero Assioma Duo - 0h40,Favero Assioma Duo,Kickr Core,167,181,-14
88274,591599,2020-12-27 06:50:29,wahoo,Kickr Core uncalibrated 1.0.12 VS Favero Assioma Duo,Favero Assioma Duo,Kickr Core,204,223,-19
88567,591599,2020-12-29 13:59:36,wahoo,Kickr Core Factory Spindown 1.0.13 VS Favero Assioma Duo,Favero Assioma Duo,Kickr Core,175,184,-9
90582,591599,2021-01-02 16:23:35,wahoo,Kick Core post Factory Spindown 1.0.13 vs Favero Assioma Duo - Higher watts,Favero Assioma Duo,Kickr Core,272,280,-8
91150,591599,2021-01-03 16:37:02,wahoo,Zwift - M athieu Bonnet 👾 [UCC]&#039;s Meetup - Lutscher CCW,Favero Assioma Duo,Kickr Core,186,196,-10
92051,591599,2021-01-06 07:00:31,wahoo,Zwift - TDZ Stage 1: Longer Ride,Favero Assioma Duo,Kickr Core,296,308,-12
95758,591599,2021-01-12 18:17:20,wahoo,Zwift - Zwift Racing League | WTRL - Men&#039;s/Mixed EMEA E1 DIVISION 3 (A),Favero Assioma Duo,Kickr Core,309,321,-12
97342,591599,2021-01-14 19:03:29,wahoo,Zwift - TDZ Stage 3: Shorter Ride,Favero Assioma Duo,Kickr Core,285,294,-9
98840,591599,2021-01-16 16:33:33,wahoo,Zwift - M athieu Bonnet 👾 [UCC]&#039;s Meetup - Tire-Bouchon,Favero Assioma Duo,Kickr Core,212,223,-11
99786,591599,2021-01-19 18:25:02,wahoo,Zwift - Zwift Racing League | WTRL - Men&#039;s/Mixed EMEA E1 DIVISION 3 (A),Favero Assioma Duo,Kickr Core,304,311,-7
103542,591599,2021-01-26 18:05:38,wahoo,Zwift - Zwift Racing League | WTRL - Men&#039;s/Mixed EMEA E1 DIVISION 3 (A),Favero Assioma Duo,Kickr Core,314,327,-13
104422,591599,2021-01-28 06:06:00,wahoo,Zwift - 3R Racing (A),Favero Assioma Duo,Kickr Core,310,323,-13
105784,591599,2021-01-30 17:00:33,wahoo,Zwift - TDZ Stage 6: Longer Ride,Favero Assioma Duo,Kickr Core,306,314,-8
107533,591599,2021-02-02 18:02:27,wahoo,Zwift - Zwift Racing League | WTRL - Men&#039;s/Mixed EMEA E1 DIVISION 3 (A),Favero Assioma Duo,Kickr Core,310,324,-14
108590,591599,2021-02-04 06:02:42,wahoo,Zwift - TDZ Stage 7: Standard Ride,Favero Assioma Duo,Kickr Core,183,194,-11
119827,591599,2021-02-23 18:07:32,wahoo,Zwift - Zwift Racing League | WTRL - Men&#039;s/Mixed EMEA E1 DIVISION 3 (A),Favero Assioma Duo,Kickr Core,317,325,-8
100779,529833,2021-01-20 18:45:58,wahoo,Zwift - Danmarks Cykle Union & Partners 2/6 (B),Garmin vector 3s,Wahoo Kickr Core,351,350,1
105817,44323,2021-01-30 18:10:04,neo,Zwift - Yorkshire,V3,NEO1,326,313,13
34402,19898,2020-05-12 18:14:50,neo,Zwift - UNO X CUP powered by DCU & Feltet.dk (A),FSA Powerbox,Tacx Neo,373,360,13
35259,19898,2020-05-16 08:29:59,neo,Zwift - DBR Sufferday League (A),FSA Powerbox,Tacx Neo,346,348,-2
35808,19898,2020-05-18 14:14:57,neo,Zwift - 3R Classique Reverse Flat Race - 5 Laps (32km/20.1mi 76m) (A),FSA Powerbox,Tacx Neo,363,370,-7
36078,19898,2020-05-19 18:14:51,neo,Zwift - UNO X CUP powered by DCU & Feltet.dk (A),FSA Powerbox,Tacx Neo,363,379,-16
36869,19898,2020-05-22 15:14:58,neo,Zwift - 3R Sand and Sequoias Race (A),FSA Powerbox,Tacx Neo,386,359,27
36991,19898,2020-05-23 07:34:59,neo,Zwift - INC Steady State - Group Training Ride 2.9 - 3.5w (B),FSA Powerbox,Tacx Neo,358,337,21
38301,19898,2020-05-28 15:46:27,neo,Zwift - Richmond,FSA Powerbox,Tacx Neo,308,293,15
7674,520473,2019-12-30 18:15:17,neo,DBR Monday Race,Assioma Duo,Neo 1,381,358,23
8079,520473,2020-01-03 13:03:28,neo,Zwift - Crit City Race (A),Assioma Duo,Neo 1,416,384,32
8081,520473,2020-01-04 15:14:58,neo,Zwift - OH CRIT!! - Saturday Smash Series (A),Assioma Duo,Neo 1,353,334,19
8258,520473,2020-01-06 18:15:18,neo,Zwift - DBR Caresport Crit Cup  (A),Assioma Duo,Neo 1,396,376,20
8935,520473,2020-01-12 09:00:17,neo,Zwift - Danmarks Cykle Union 2020 Cup (A),Assioma Duo,Neo 1,329,307,22
8937,520473,2020-01-12 09:47:40,neo,Assioma Duo,Assioma Duo,Neo 1,220,210,10
9175,520473,2020-01-13 18:30:24,neo,Zwift - Tour de Zwift: Stage 1 Long Distance,Assioma Duo,Neo 1,252,241,11
10171,520473,2020-01-20 09:00:00,neo,Zwift - Tour de Zwift: Stage 3 Group Ride - Long Distance,Assioma Duo,Neo 1,356,339,17
10724,520473,2020-01-23 19:12:14,neo,Zwift - Tour de Zwift // Pro-Am Invitational,Assioma Duo,Neo 1,416,392,24
10916,520473,2020-01-25 09:30:04,wahoo,Zwift - DBR Saturday Race (A),Assioma Duo,Wahoo Kickr Core,343,355,-12
10967,520473,2020-01-26 09:00:14,wahoo,Zwift - Danmarks Cykle Union 2020 Cup (A),Assioma Duo,Wahoo Kickr Core,389,386,3
11186,520473,2020-01-27 18:15:13,wahoo,Zwift - DBR Caresport Crit Cup  (A),Assioma Duo,Wahoo Kickr Core,377,377,0
11629,520473,2020-01-30 11:00:16,wahoo,Zwift - Tour de Zwift: Stage 5 Long Distance,Assioma Duo,Wahoo Kickr Core,381,384,-3
11898,520473,2020-01-31 19:11:14,wahoo,Zwift - Tour de Zwift // Pro-Am Invitational (A),Assioma Duo,Wahoo Kickr Core,387,394,-7
12014,520473,2020-02-01 09:30:18,wahoo,Zwift - DBR Saturday Race (A),Assioma Duo,Wahoo Kickr Core,362,373,-11
12249,520473,2020-02-03 09:10:25,wahoo,Zwift - Tour de Zwift: Stage 6 Race (A),Assioma Duo,Wahoo Kickr Core,394,387,7
12521,520473,2020-02-04 19:13:38,wahoo,Zwift - Tour de Zwift // Pro-Am Invitational (A),Assioma Duo,Wahoo Kickr Core,394,395,-1
12866,520473,2020-02-06 18:59:02,wahoo,Zwift - KALAS Cup - Round 2 (A),Assioma Duo,Wahoo Kickr Core,421,427,-6
13050,520473,2020-02-08 07:25:00,wahoo,Zwift - 3R Tempus Fugit Flat Race - 1 Lap (19.8km/12.3mi 20m) (A),Assioma Duo,Wahoo Kickr Core,349,352,-3
13052,520473,2020-02-08 08:05:00,wahoo,Zwift - 3R Yorkshire Dutchy Estate Race - 10 Laps (A),Assioma Duo,Wahoo Kickr Core,387,393,-6
13923,520473,2020-02-13 18:58:30,wahoo,Zwift - KALAS Cup - Round 3 (A),Assioma Duo,Wahoo Kickr Core,354,360,-6
14164,520473,2020-02-15 15:14:54,wahoo,Zwift - OH CRIT!! - Saturday Smash Series (A),Assioma Duo,Wahoo Kickr Core,385,390,-5
14449,520473,2020-02-17 09:13:59,wahoo,Zwift - 3R Watopia Flat Route Race - 4 Laps (41km/25.5mi 216m) (A),Assioma Duo,Wahoo Kickr Core,370,378,-8
14594,520473,2020-02-18 19:14:04,wahoo,Zwift - Feltet.dk Race Series,Assioma Duo,Wahoo Kickr Core,376,377,-1
15019,520473,2020-02-20 10:45:15,wahoo,Zwift - Crit City Race (A),Assioma Duo,Wahoo Kickr Core,380,375,5
15020,520473,2020-02-20 11:11:51,wahoo,Zwift - 3R Classique Flat Race - 4 Laps (26.9km/16.7mi 76m) (A),Assioma Duo,Wahoo Kickr Core,337,341,-4
15302,520473,2020-02-23 09:59:23,wahoo,Zwift - Tour of Innsbruck // Stage 3,Assioma Duo,Wahoo Kickr Core,396,408,-12
15454,520473,2020-02-24 18:15:02,wahoo,Zwift - DBR Winter Cup (A),Assioma Duo,Wahoo Kickr Core,401,405,-4
16025,520473,2020-02-27 19:00:14,wahoo,Zwift - KALAS Cup - Round 5 (A),Assioma Duo,Wahoo Kickr Core,349,357,-8
16481,520473,2020-03-02 18:14:45,wahoo,Zwift - DBR Winter Cup (A),Assioma Duo,Wahoo Kickr Core,376,381,-5
35049,520473,2020-05-14 18:13:37,wahoo,Zwift - WTRL Team Time Trial (C),Assioma Duo,Wahoo Kickr Core,374,383,-9
35841,520473,2020-05-18 17:15:17,wahoo,Zwift - DBR Wahoo League (A),Assioma Duo,Wahoo Kickr Core,343,348,-5
50754,520473,2020-08-19 18:05:13,wahoo,Zwift - DBR Wednesday Race (A),Assioma Uno,Wahoo Kickr Core,416,423,-7
50984,520473,2020-08-20 18:03:21,wahoo,Zwift - Frappe,Assioma Uno,Wahoo Kickr Core,357,366,-9
51074,520473,2020-08-21 09:33:51,wahoo,Zwift - TBR Burrito Race (A),Assioma Uno,Wahoo Kickr Core,358,358,0
51444,520473,2020-08-23 07:34:59,wahoo,Zwift -  30-39 years - ZHR Masters Weekender (A),Assioma Uno,Wahoo Kickr Core,360,364,-4
51656,520473,2020-08-25 09:04:59,wahoo,Zwift - 3R Turbocharged Team Race Series - Bonus Round (A),Assioma Uno,Wahoo Kickr Core,358,365,-7
52111,520473,2020-08-27 07:22:07,wahoo,Zwift - FTP Test (shorter),Assioma Uno,Wahoo Kickr Core,390,398,-8
52112,520473,2020-08-27 08:30:11,wahoo,KISS at Race - Down under,Assioma Uno,Wahoo Kickr Core,370,376,-6
53657,520473,2020-09-06 14:00:26,wahoo,Zwift - ZHR Masters Weekender (A),Assioma Uno,Wahoo Kickr Core,407,417,-10
53760,520473,2020-09-07 17:13:51,wahoo,Zwift - DBR Ride´N´Roll League (A),Assioma Uno,Wahoo Kickr Core,390,396,-6
54072,520473,2020-09-09 07:59:36,wahoo,Zwift - Giant Crit Crushers Race 1 (A),Assioma Uno,Wahoo Kickr Core,394,393,1
54073,520473,2020-09-09 08:19:36,wahoo,Zwift - Giant Crit Crushers Race 2 (A),Assioma Uno,Wahoo Kickr Core,368,378,-10
54074,520473,2020-09-09 09:04:30,wahoo,Zwift - 3R Watopia Flat Route Race - 3 Laps (30.3km/18.8mi 162m) (A),Assioma Uno,Wahoo Kickr Core,353,361,-8
54716,520473,2020-09-12 12:09:57,wahoo,Zwift - The BMTR Fundo (D),Assioma Uno,Wahoo Kickr Core,388,396,-8
54943,520473,2020-09-14 07:04:56,wahoo,3R Watopia Flat Route Race - 3 Laps (30.3km/18.8mi 162m) (A),Assioma Uno,Wahoo Kickr Core,341,345,-4
56013,520473,2020-09-17 18:28:24,wahoo,Zwift - Invitational League // Qualifying Race #2 (Men) ,Assioma Uno,Wahoo Kickr Core,386,386,0
57145,520473,2020-09-23 17:43:58,wahoo,Zwift - DCU powered by Feltet.dk (A),Assioma Uno,Wahoo Kickr Core,376,380,-4
57224,520473,2020-09-24 08:30:13,wahoo,Zwift - KISS at Race - Down Under (A),Assioma Uno,Wahoo Kickr Core,395,405,-10
57783,520473,2020-09-26 08:29:57,wahoo,Zwift - DBR SufferDay League II (A),Assioma Uno,Wahoo Kickr Core,387,397,-10
57941,520473,2020-09-27 13:15:16,wahoo,Zwift - KISS at Race 100 - Americas (A),Assioma Uno,Wahoo Kickr Core,390,393,-3
58546,520473,2020-09-30 17:43:45,wahoo,Zwift - DCU powered by Feltet.dk (A),Assioma Uno,Wahoo Kickr Core,368,381,-13
59015,520473,2020-10-02 08:30:15,wahoo,Zwift - The Gorby,Assioma Uno,Wahoo Kickr Core,394,395,-1
59158,520473,2020-10-03 07:03:40,wahoo,Zwift - 3R Flat Race (A),Assioma Uno,Wahoo Kickr Core,366,368,-2
59358,520473,2020-10-04 07:19:56,wahoo,Zwift - Team Italy & Frenchy Fuzion Endurance Race (A),Assioma Uno,Wahoo Kickr Core,391,398,-7
59619,520473,2020-10-05 17:14:41,wahoo,Zwift - DBR Ride´N´Roll League (A),Assioma Uno,Wahoo Kickr Core,358,364,-6
60241,520473,2020-10-08 07:04:59,wahoo,Zwift - 3R Innsbruckring Flat Race - 5 Laps (44km/27.3mi 385m) (A),Assioma Uno,Wahoo Kickr Core,348,356,-8
60534,520473,2020-10-09 08:04:55,wahoo,Zwift - 3R Lagurdia Super Sprint Race - 1 Lap (3.7km/2.6mi 27m) (A),Assioma Uno,Wahoo Kickr Core,334,342,-8
60536,520473,2020-10-09 08:34:55,wahoo,Zwift - TBR Burrito Race (A),Assioma Uno,Wahoo Kickr Core,361,364,-3
60821,520473,2020-10-10 14:14:56,wahoo,Zwift - OH MY CRIT - Saturday Smash Race (A),Assioma Uno,Wahoo Kickr Core,362,358,4
61123,520473,2020-10-12 09:14:58,wahoo,Zwift - 3R Watopia Flat Route Race - 4 Laps (41km/25.5mi 216m) (A),Assioma Uno,Wahoo Kickr Core,348,342,6
61564,520473,2020-10-13 17:13:28,wahoo,Zwift - Zwift Racing League | WTRL,Assioma Uno,Wahoo Kickr Core,421,419,2
62030,520473,2020-10-14 18:05:13,wahoo,Zwift - DBR HEINO CUP III (A),Assioma Uno,Wahoo Kickr Core,363,365,-2
62261,520473,2020-10-15 17:29:59,wahoo,Zwift - FUSION ECT BEUNSTOPPABLE Racing Series (A),Assioma Uno,Wahoo Kickr Core,424,432,-8
62643,520473,2020-10-17 14:14:59,wahoo,Zwift - OH MY CRIT - Saturday Smash Race (A),Assioma Uno,Wahoo Kickr Core,360,364,-4
62801,520473,2020-10-18 07:10:18,wahoo,Zwift - 3R Figure 8 Hilly Race - 1 Lap (29.2km/18.1m 234m) (A),Assioma Uno,Wahoo Kickr Core,400,408,-8
63021,520473,2020-10-19 07:30:12,wahoo,Zwift - Flanders Endurance Series (E),Assioma Uno,Wahoo Kickr Core,377,380,-3
63384,520473,2020-10-20 14:00:32,wahoo,Zwift - Zwift Time Trial Tuesday: Tempus Fugit (E),Assioma Uno,Wahoo Kickr Core,404,403,1
64071,520473,2020-10-22 10:00:00,wahoo,Zwift - KISS at Race - Americas AM (A),Assioma Uno,Wahoo Kickr Core,429,433,-4
64827,520473,2020-10-25 08:45:21,wahoo,Zwift - 100km ZESP Fondo (A),Assioma Uno,Wahoo Kickr Core,416,418,-2
65044,520473,2020-10-26 13:38:51,wahoo,Zwift - 3R Richmond UCI Hilly Race - 1 Lap (16.2km/10.1mi 142m) (A),Assioma Uno,Wahoo Kickr Core,344,349,-5
86816,520473,2020-12-24 08:28:51,wahoo,Zwift - KISS Race Series - Down Under (A),Assioma Uno,Wahoo Kickr Core,407,409,-2
87171,520473,2020-12-25 13:49:59,wahoo,Zwift - KISS Race Series - Pacific AM (A),Assioma Uno,Wahoo Kickr Core,430,428,2
88094,520473,2020-12-28 09:15:17,wahoo,Zwift - 3R Watopia Flat Route Race - 4 Laps (41km/25.5mi 216m) (A),Assioma Uno,Wahoo Kickr Core,316,322,-6
89298,520473,2020-12-30 17:56:21,wahoo,Zwift - MIDWEEK Winter Series by SZR (A),Assioma Uno,Wahoo Kickr Core,389,383,6
89299,520473,2020-12-30 19:04:18,wahoo,Zwift - DBR Wednesday Race (A),Assioma Uno,Wahoo Kickr Core,392,391,1
89758,520473,2021-01-01 12:20:15,wahoo,Peak-PTY Climb Challenge Fridays,Assioma Uno,Wahoo Kickr Core,396,399,-3
90108,520473,2021-01-02 09:30:30,wahoo,Zwift - DBR SufferDay League III (A),Assioma Uno,Wahoo Kickr Core,414,426,-12
90759,520473,2021-01-03 09:05:13,wahoo,Zwift - Newbury Velo Road Race (A),Assioma Uno,Wahoo Kickr Core,382,387,-5
91595,520473,2021-01-05 11:00:23,wahoo,Zwift - KISS Race Series - Americas AM (A),Assioma Uno,Wahoo Kickr Core,427,428,-1
92160,520473,2021-01-06 09:59:54,wahoo,Zwift - EVR Definitely Not the WTNC (A),Assioma Uno,Wahoo Kickr Core,397,395,2
92953,520473,2021-01-07 18:30:13,wahoo,Zwift - FUSION WINTER CUP (A),Assioma Uno,Wahoo Kickr Core,368,365,3
93659,520473,2021-01-09 07:35:46,wahoo,Zwift - 40/20&#039;s,Assioma Uno,Wahoo Kickr Core,363,359,4
95596,520473,2021-01-12 18:14:22,wahoo,Zwift - Zwift Racing League | WTRL - Men&#039;s/Mixed EMEA E1 DIVISION 1 (A),Assioma Uno,Wahoo Kickr Core,378,382,-4
96766,520473,2021-01-14 10:59:59,wahoo,Zwift - KISS Race Series - Americas AM (A),Assioma Uno,Wahoo Kickr Core,329,329,0
98347,520473,2021-01-16 08:29:31,wahoo,Zwift - TEAM VEGAN Tofu Tornado XL (A),Assioma Uno,Wahoo Kickr Core,408,411,-3
99651,520473,2021-01-19 18:23:39,wahoo,Zwift Racing League | WTRL - Mens/Mixed EMEA E1 DIVISION 1,Assioma Uno,Wahoo Kickr Core,371,372,-1
101346,520473,2021-01-22 13:02:48,wahoo,Zwift Fast Fridays: Tempus Fugit Time Trial,Assioma Uno,Wahoo Kickr Core,408,402,6
102483,520473,2021-01-24 14:15:25,wahoo,Zwift - KISS 100 Race Series - Americas (A),Assioma Uno,Wahoo Kickr Core,367,368,-1
103614,520473,2021-01-26 18:15:03,wahoo,Zwift - Zwift Racing League | WTRL - Men&#039;s/Mixed EMEA E1 DIVISION 1 (A),Assioma Uno,Wahoo Kickr Core,386,387,-1
104086,520473,2021-01-27 10:45:01,wahoo,Zwift - The Morning Grind by STPC (A),Assioma Uno,Wahoo Kickr Core,380,387,-7
104485,520473,2021-01-28 10:59:58,wahoo,KISS Race Series - Americas AM,Assioma Uno,Wahoo Kickr Core,360,358,2
105480,520473,2021-01-30 09:29:51,wahoo,Zwift - DBR SufferDay League III (A),Assioma Uno,Wahoo Kickr Core,385,395,-10
110044,520473,2021-02-06 12:32:00,wahoo,Zwift - Zwift Fondo Series: Bambino Fondo,Assioma Uno,Wahoo Kickr Core,411,417,-6
110787,520473,2021-02-07 10:00:20,wahoo,Zwift - DBR Sunday Race (A),Assioma Uno,Wahoo Kickr Core,388,402,-14
111542,520473,2021-02-09 18:24:22,wahoo,Zwift - Zwift Racing League | WTRL - Men&#039;s/Mixed EMEA E1 DIVISION 1 (A),Assioma Uno,Wahoo Kickr Core,411,416,-5
112300,520473,2021-02-10 18:45:14,wahoo,Zwift - Danmarks Cykle Union & Partners 5/6 (A),Assioma Uno,Wahoo Kickr v5,415,408,7
113874,520473,2021-02-13 09:29:44,wahoo,Zwift - DBR SufferDay League III (A),Assioma Uno,Wahoo Kickr v5,407,411,-4
115644,520473,2021-02-16 11:00:26,wahoo,KISS Race Series - Americas AM,Assioma Uno,Wahoo Kickr v5,424,422,2
116658,520473,2021-02-17 18:44:32,wahoo,Danmarks Cykle Union & Partners 6/6,Assioma Uno,Wahoo Kickr v5,365,365,0
117072,520473,2021-02-18 10:58:09,wahoo,Zwift - KISS Race Series - Americas AM (A),Assioma Uno,Wahoo Kickr v5,422,421,1
118306,520473,2021-02-20 13:59:55,wahoo,Zwift - XRS Races: Saturday Climbing Series (A),Assioma Uno,Wahoo Kickr v5,398,396,2
119068,520473,2021-02-22 18:15:01,wahoo,DBR Monday Race,Assioma Uno,Wahoo Kickr v5,415,411,4
120341,520473,2021-02-24 18:43:10,wahoo,Zwift - Scandinavian Cup 2021 - Round 1 - Men (A),Assioma Uno,Wahoo Kickr v5,350,351,-1
121438,520473,2021-02-27 09:05:55,wahoo,Zwift - 3R Endurance Series p/b OTE Sports (A),Assioma Uno,Wahoo Kickr v5,337,338,-1
121961,520473,2021-02-28 07:00:17,wahoo,Zwift - 02/28/2021,Assioma Uno,Wahoo Kickr v5,367,364,3
122941,520473,2021-03-02 18:17:41,wahoo,Zwift - Zwift Racing League | WTRL - Men&#039;s/Mixed EMEA E1 DIVISION 1 (A),Assioma Uno,Wahoo Kickr v5,383,383,0
123598,520473,2021-03-03 18:42:58,wahoo,Zwift - Scandinavian Cup 2021 - Round 2 - Men (A),Assioma Uno,Wahoo Kickr v5,389,390,-1
125327,520473,2021-03-07 09:59:55,wahoo,Zwift - DBR Sunday Race (A),Assioma Uno,Wahoo Kickr v5,397,401,-4
126023,520473,2021-03-09 10:59:43,wahoo,Zwift - KISS Race Series - Americas AM (A),Assioma Uno,Wahoo Kickr v5,359,359,0
126640,520473,2021-03-10 18:44:07,wahoo,Zwift - Scandinavian Cup 2021 - Round 3 - Men (A),Assioma Uno,Wahoo Kickr v5,374,373,1
127915,520473,2021-03-13 12:43:56,wahoo,Zwift - WTRL Racing (A),Assioma Uno,Wahoo Kickr v5,403,403,0
128481,520473,2021-03-14 13:05:19,wahoo,Zwift - 3R Watopia Flat Route Race - 4 Laps (40.5km/25.1mi 216m) (A),Assioma Uno,Wahoo Kickr v5,416,417,-1
129157,520473,2021-03-16 18:27:30,wahoo,Zwift - CeramicSpeed Race Series: Open Race (A),Assioma Uno,Wahoo Kickr v5,384,394,-10
129564,520473,2021-03-17 11:19:17,wahoo,Zwift - 3R Volcano Circuit Flat Race - 6 Laps (27km/16.8mi 120m) (A),Assioma Uno,Wahoo Kickr v5,346,345,1
27382,142024,2020-04-23 13:08:25,neo,Zwift - Watopia,Stages Ultegra Trek,Tacx Neo,303,305,-2
27385,142024,2020-04-23 17:22:34,neo,Zwift - Watopia,Stages xt Trek,Tacx Neo,304,277,27
31463,142024,2020-05-04 17:00:18,neo,Zwift - SCF Road Challenge 3 (B),2020-05-04-19-00-31,Neo,339,342,-3
58303,142024,2020-09-29 17:31:15,neo,Stages ultegra / Neo,Stages ultegra,Neo,355,349,6
58838,142024,2020-10-01 16:29:55,neo,Stages ultegra / Tacx Neo,Stages ultegra,Tacx Neo,365,352,13
60437,142024,2020-10-07 18:01:14,neo,Neo / Stages ultegra,Stages ultegra,Neo,345,342,3
60441,142024,2020-10-08 18:00:54,neo,Neo / Stages ultegra,Stages ultegra,Neo,372,368,4
61573,142024,2020-10-13 17:15:54,neo,Zwift - Zwift Racing League | WTRL,Stages ultegra,Tacx Neo,349,344,5
62226,142024,2020-10-15 18:00:43,neo,Zwift -  Flanders The BZR Ronde  (B),Stages ultegra,Tacx Neo,364,361,3
62354,142024,2020-10-16 06:10:07,neo,Zwift - 3R Volcano Circuit Flat Race - 4 Laps (18.9km/11.7mi 80m) (B),Stages ultegra,Tacx Neo,344,348,-4
63378,142024,2020-10-19 18:40:53,neo,Zwift - F rank BZR LIONS 2&#039;s Meetup - R.G.V.,Stages ultegra,Tacx Neo,328,334,-6
64222,142024,2020-10-22 18:01:03,neo,Zwift -  Flanders The BZR Ronde  (B),Stages ultegra,Neo,372,372,0
64439,142024,2020-10-23 18:01:18,neo,Zwift - TFC Autumn Race Series (B),Stages ultegra,Neo,342,344,-2
65446,142024,2020-10-27 18:15:59,neo,Zwift - Zwift Racing League | WTRL - EMEA E (MEN) -  Division 1 (B),Stages ultegra,Tacx Neo,366,374,-8
65832,142024,2020-10-28 18:34:59,neo,Zwift - BRT Time Trial League (B),Stages ultegra,Tacx Neo,340,343,-3
66217,142024,2020-10-29 19:00:53,neo,Zwift -  Flanders The BZR Ronde  (B),Stages ultegra,Tacx Neo,368,361,7
66490,142024,2020-10-30 19:01:06,neo,TFC Autumn Race Series (B) (8/52),Stages ultegra,Tacx Neo,363,362,1
67606,142024,2020-11-03 18:22:34,neo,Zwift - Warm up GPLama,Stages ultegra,Tacx Neo,356,357,-1
68125,142024,2020-11-04 18:35:01,neo,BRT Time Trial League (B),Stages ultegra,Tacx Neo,375,376,-1
68282,142024,2020-11-05 19:00:34,neo,Zwift -  Flanders The BZR Ronde  (B),Stages ultegra,Tacx Neo,388,381,7
68602,142024,2020-11-06 19:01:01,neo,TFC Autumn Race Series (B),Stages ultegra,Tacx Neo,378,375,3
69755,142024,2020-11-10 18:15:56,neo,Zwift - Zwift Racing League | WTRL - EMEA E1 (MEN) -  Division 1 (B),Stages ultegra,Tacx Neo,374,376,-2
70247,142024,2020-11-11 18:34:45,neo,BRT Time Trail League (B),Stages ultegra,Tacx Neo,354,346,8
70785,142024,2020-11-12 19:00:56,neo,Flanders The BZR Ronde (B) 31/124,Stages ultegra,Tacx Neo,375,383,-8
72245,142024,2020-11-17 18:23:08,neo,Zwift Racing League �| WTRL - Men&#039;s EMEA E1 DIVISION 1 (B),Stages ultegra,Tacx Neo,348,336,12
72635,142024,2020-11-18 18:34:55,neo,BRT Time Trail League (B),Stages ultegra,Tacx Neo,356,356,0
73629,142024,2020-11-20 19:00:57,neo,TFC Autumn Race Series (B),Stages ultegra,Tacx Neo,384,386,-2
75075,142024,2020-11-24 18:15:39,neo,Zwift Racing League | WTRL - Men&#039;s EMEA E1 DIVISION 1  ,Stages ultegra,Tacx Neo,372,374,-2
75552,142024,2020-11-25 18:34:50,neo,Zwift - Carmichael warm up SH,Stages ultegra,Tacx Neo,363,366,-3
76174,142024,2020-11-26 19:01:15,neo,Flanders The BZR Ronde (B),Stages ultegra,Tacx Neo,367,372,-5
76579,142024,2020-11-27 19:00:57,neo,TFC Autumn Race Series (B),Stages ultegra,Tacx Neo,361,360,1
78042,142024,2020-12-01 18:23:02,neo,Zwift Racing League | WTRL - Men&#039;s EMEA E1 DIVISION 1,Stages ultegra,Tacx Neo,346,338,8
79065,142024,2020-12-03 19:00:43,neo,Flanders The BZR Ronde (B),Stages ultegra,Tacx Neo,350,353,-3
80625,142024,2020-12-08 07:01:00,neo,KISS Race Series - Down Under (B),Stages ultegra,Tacx Neo,369,369,0
82040,142024,2020-12-11 19:01:18,neo,Team IRL Without Borders Race (B),Stages ultegra,Tacx Neo,341,334,7
83200,142024,2020-12-14 19:20:43,neo,Team TFC Mad Monday Winter Series (B),Stages ultegra,Tacx Neo,360,367,-7
84438,142024,2020-12-17 19:01:17,neo,Flanders The BZR Ronde (B),Stages ultegra,Tacx Neo,364,366,-2
85882,142024,2020-12-21 19:20:58,neo,Team TFC Mad Monday Winter Series (B),Stages ultegra,Tacx Neo,361,357,4
86652,142024,2020-12-23 18:50:14,neo,Flanders V Yorkshire - Clubhouse Bash by ATR (B),Stages ultegra,Tacx Neo,352,351,1
95450,142024,2021-01-12 11:09:57,neo,Japan Zwift Tuesday Race (B),Stages ultegra,Tacx Neo,352,343,9
97043,142024,2021-01-14 19:01:12,neo,The BZR Ronde Watopian League (B),Stages ultegra,Tacx Neo,363,371,-8
25169,614942,2020-04-16 12:53:45,wahoo,test kickr,assioma,Wahoo kickr,238,237,1
25171,614942,2020-04-16 12:53:45,wahoo,Test Bologna,assioma,Wahoo kickr,344,345,-1
32178,546747,2020-05-06 18:09:23,wahoo,Zwift - Z PRO TRI Race Series (A),4iiii Dual Side Precision Pro,Wahoo Kickr,391,389,2
34340,546747,2020-05-13 14:50:14,wahoo,Z PRO TRI Race Series: Mens B Race 5,4iiii Dual Side Precision Pro,Wahoo Kickr (reported to Zwift),416,410,6
36417,546747,2020-05-20 14:49:57,wahoo,Z PRO TRI Race Series: Mens B Race 6,4iiii Dual Side Precision Pro,Wahoo Kickr (reported to Zwift),372,382,-10
76188,100251,2020-11-26 18:43:59,wahoo,Zwift - WTRL NOPINZ WORLD TTT CHAMPIONSHIPS - Zone 6 (E),favero assioma duo ,Wahoo Kickr V4,254,244,10
66246,309460,2020-10-29 20:06:29,neo,Zwift - Tempo w/ Bursts,Favero Assioma,Tacx Neo,272,272,0
66892,309460,2020-11-01 09:59:45,neo,Zwift - Climbers Day p/b dPAC.fit & Precision Hydration (A),Favero Assioma,Tacx Neo,338,337,1
69194,452777,2020-11-08 21:14:43,wahoo,Zwift - Zwift Fondo Series 2020/21: Bambino Fondo,Assioma Duo,Kickr,296,293,3
70195,452777,2020-11-11 15:09:17,wahoo,Zwift Academy Road: Workout 7 | VO2 Development,Assioma Duo,Kickr,306,301,5
71199,452777,2020-11-13 18:56:29,wahoo,Zwift Academy Road: Workout 6 | Alternative Sprints,Assioma Duo,Kickr,333,326,7
74028,452777,2020-11-21 20:52:17,wahoo,LMP Runway Model - Trying to sprint on kickr bike ,Assioma Duo,Kickr,276,268,8
75261,452777,2020-11-24 19:42:52,wahoo,Zwift - France,Assioma Duo,Kickr,232,231,1
76681,452777,2020-11-27 16:55:09,wahoo,Zwift - Focus: Colours of PARI - Longer Ride,Assioma Duo,Kickr,352,349,3
78168,452777,2020-12-01 19:42:18,wahoo,Zwift - Zwift Racing League | WTRL - Men&#039;s EMEA W1 DIVISION 1 (A),Assioma Duo,Kickr,344,345,-1
80986,452777,2020-12-08 19:44:16,wahoo,Zwift - Zwift Racing League | WTRL - Men&#039;s EMEA W1 DIVISION 1 (A),Assioma Duo,Kickr,362,360,2
82893,452777,2020-12-13 14:14:18,wahoo,Zwift - KISS 100 Race Series - Americas (A),Assioma Duo,Kickr,325,327,-2
85427,452777,2020-12-19 18:59:34,wahoo,Zwift - Tour of New York Stage 2 - Open Longer,Assioma Duo,Kickr,346,334,12
85562,452777,2020-12-20 18:59:10,wahoo,Zwift - Tour of New York Stage 3 - Open Longer,Assioma Duo,Kickr,311,303,8
85936,452777,2020-12-21 21:10:31,wahoo,Zwift - 3R Watopia Flat Route Race - 3 Laps (30.8km/19.1mi 162m) (A),Assioma Duo,Kickr,339,335,4
88396,452777,2020-12-28 21:28:12,wahoo,Zwift - Crit City Race (A),Assioma Duo,Kickr,342,337,5
88653,452777,2020-12-29 16:39:19,wahoo,Zwift - Team Italy Specialissima Race (A),Assioma Duo,Kickr,321,315,6
90935,452777,2021-01-03 13:57:23,wahoo,Zwift - Zwift Fondo Series 2020/21 (A),Assioma Duo,Kickr,327,332,-5
91910,452777,2021-01-05 19:58:19,wahoo,Zwift - TDZ Stage 1: Longer Ride,Assioma Duo,Kickr,330,325,5
93550,452777,2021-01-08 18:47:42,wahoo,Zwift - Team CLS Racing - Hills &#039;n&#039; Thrills S5 (E),Assioma Duo,Kickr,340,332,8
93554,452777,2021-01-08 19:58:06,wahoo,Zwift - TDZ Stage 1: Longer Ride,Assioma Duo,Kickr,292,292,0
96191,452777,2021-01-13 00:48:18,wahoo,Zwift - Zwift Racing League | WTRL - Men&#039;s/Mixed AMERICAS E DIVISION 4 (A),Assioma Duo,Kickr,363,354,9
97259,542806,2021-01-15 02:44:20,wahoo,Zwift - WTRL Team Time Trial - Zone 11 (D),Power2Max NG,Wahoo Kickr,412,416,-4
109152,542806,2021-02-05 02:36:47,wahoo,Zwift - WTRL Team Time Trial - Zone 11 (D),Power2Max NG,Wahoo Kickr,380,375,5
111929,542806,2021-02-10 03:02:57,wahoo,Zwift - Zwift Racing League | WTRL - Men&#039;s/Mixed AMERICAS W DIVISION 1 (A),Power2Max NG,Wahoo Kickr,419,416,3
113221,542806,2021-02-12 02:34:01,wahoo,Zwift - WTRL Team Time Trial - Zone 13 (C),Power2Max NG,Wahoo Kickr,409,406,3
46819,602618,2020-07-18 09:00:58,wahoo,Zwift - L&#039;Etape du Tour Stage 3 - Open,Favero Assioma,Wahoo Kickr Core,346,352,-6
118590,602618,2021-02-20 13:56:42,wahoo,Zwift -  Zwift Insider Badge Hunters - The Uber Pretzel Edition (E),Favero Assioma,Wahoo Kickr Core,226,240,-14
20823,153295,2020-03-24 19:00:00,wahoo,Zwift - NCF Spring Cup (A),Assioma Duo,Kickr Core,339,342,-3
53537,153295,2020-09-05 12:45:59,wahoo,Zwift - WTRL Racing (B),Assioma Duo,Kickr Core,347,348,-1
61728,153295,2020-10-13 18:44:55,wahoo,Zwift - Zwift Racing League | WTRL,Assioma Duo,Kickr Core,340,345,-5
65708,184281,2020-10-15 18:01:07,wahoo,Zwift -  Flanders The BZR Ronde  (B),Stages Powermeter Dura-Ace,Wahoo Kickr,318,319,-1
67813,184281,2020-11-03 18:27:29,wahoo,Zwift - Zwift Racing League | WTRL - Men&#039;s EMEA E2 DIVISION 1 (B),Stages Powermeter Dura-Ace,Wahoo Kickr,318,318,0
68446,184281,2020-11-05 19:00:27,wahoo,Zwift -  Flanders The BZR Ronde  (B),Stages Powermeter Dura-Ace,Wahoo Kickr,331,335,-4
72576,184281,2020-11-17 18:23:30,wahoo,Zwift - Zwift Racing League | WTRL - Men&#039;s EMEA E2 DIVISION 1 (B),Stages Powermeter Dura-Ace,Wahoo Kickr,300,305,-5
35400,193214,2020-05-16 14:30:03,wahoo,Zwift - OCA Indoor Race Series (A) - Top 5,Vector 3s,KICKR,385,391,-6
43231,193214,2020-06-23 15:32:26,wahoo,Zwift - London,Vector 3s,KICKR,382,390,-8
81525,193214,2020-12-10 14:15:23,wahoo,Zwift - Watopia,Vector 3s,KICKR,298,303,-5
83709,505185,2020-12-15 19:51:38,wahoo,Zwift - Zwift Racing League | WTRL - Men&#039;s EMEA W1 DIVISION 1 (A),Stages single crank PM,Kickr Core Trainer,351,341,10
96004,505185,2021-01-13 00:46:18,wahoo,Zwift - Zwift Racing League | WTRL - Men&#039;s/Mixed AMERICAS E DIVISION 1 (A),Stages Ultegra L Crank PowerMeter,Kickr Core Trainer,356,362,-6
97245,505185,2021-01-15 00:50:19,wahoo,Zwift - WTRL Team Time Trial - Zone 10,Stages Ultegra L Crank PowerMeter,Kickr Core Trainer,365,358,7
100002,505185,2021-01-20 00:54:33,wahoo, Zwift Racing League | WTRL - Men&#039;s/Mixed AMERICAS E DIVISION 1 (A),Stages Ultegra L Crank PowerMeter,Kickr Core Trainer,340,338,2
101192,505185,2021-01-22 00:43:55,wahoo,WTRL Team Time Trial - Zone 10,Stages Ultegra L Crank PowerMeter,Kickr Core Trainer,354,344,10
104913,505185,2021-01-29 00:40:59,wahoo,WTRL Team Time Trial - Zone 10,Stages Ultegra L Crank PowerMeter,Kickr Core Trainer,345,335,10
107711,505185,2021-02-03 00:46:02,wahoo,Zwift Racing League - Men&#039;s/Mixed AMERICAS E DIVISION 1 (A),Stages Ultegra L Crank PowerMeter,Kickr Core Trainer,372,368,4
108286,505185,2021-02-03 18:59:58,wahoo,Movistar Team Challenge Community Qualifier,Stages Ultegra L Crank PowerMeter,Kickr Core Trainer,349,340,9
112558,505185,2021-02-11 01:05:04,wahoo,Cycling Canada Wednesday Night Race Series (A),Stages Ultegra L Crank PowerMeter,Kickr Core Trainer,358,352,6
113197,505185,2021-02-12 00:49:06,wahoo,Zwift - WTRL Team Time Trial - Zone 12 (C),Stages Ultegra L Crank PowerMeter,Kickr Core Trainer,339,329,10
115547,505185,2021-02-10 00:54:48,wahoo,Kickr Core Trainer / Stages Ultegra L Crank PowerMeter,Stages Ultegra L Crank PowerMeter,Kickr Core Trainer,364,364,0
116920,505185,2021-02-17 23:02:02,wahoo,Zwift - Zwift Duathlon League - Bike,Stages Ultegra L Crank PowerMeter,Kickr Core Trainer,354,355,-1
116934,505185,2021-02-18 01:04:59,wahoo,Zwift - Cycling Canada Wednesday Night Race Series (A),Stages Ultegra L Crank PowerMeter,Kickr Core Trainer,335,343,-8
117499,505185,2021-02-19 00:46:55,wahoo,Zwift - WTRL Team Time Trial - Zone 13,Stages Ultegra L Crank PowerMeter,Kickr Core Trainer,326,325,1
120981,505185,2021-02-26 00:48:06,wahoo,Zwift - WTRL Team Time Trial - Zone 13,Stages Ultegra L Crank PowerMeter,Kickr Core Trainer,330,325,5
21664,7193,2020-02-23 11:51:15,wahoo,Zwift - FTP test,Vector2,Kickr 2017,287,284,3
103984,7193,2021-01-26 19:46:24,wahoo,Zwift - Zwift Racing League | WTRL - Men&#039;s/Mixed EMEA W1 DIVISION 1 (B),Vector3,Kickr 2017,265,287,-22
104459,7193,2021-01-27 17:50:04,wahoo,Zwift - Watopia,Vector3,Kickr 2017,168,167,1
107110,7193,2021-02-01 18:59:47,wahoo,Zwift - EVR Europe Race (B),Vector3,Kickr 2017,301,293,8
48223,383194,2020-07-29 11:12:53,wahoo,Zwift - 3R Volcano Circuit Flat Race - 6 Laps (27km/16.8mi 120m) (B),crank power meter,kickr,268,271,-3
48224,383194,2020-07-28 22:01:40,wahoo,Zwift - 3R Classique Flat Race - 5 Laps (32.3km/20.1mi 95m) (B),crank power meter,kickr,284,284,0
48409,383194,2020-07-31 07:46:38,wahoo,Zwift - 3R Lagurdia Super Sprint Race - 1 Lap (3.7km/2.6mi 27m) (A),crank power meter,kickr,299,298,1
48411,383194,2020-07-31 09:00:00,wahoo,Zwift - Doan Sijabat ZID [CRYOGEN]&#039;s Meetup - Sand And Sequoias,crank power meter,kickr,311,312,-1
48413,383194,2020-07-30 13:55:10,wahoo,Zwift - 3R Classique Flat Race,crank power meter,kickr,287,289,-2
51305,383194,2020-08-21 23:48:26,wahoo,Zwift - 3R & ZID Merdeka La Reine Hilly Race - Round 3 of 4 (A),crank power meter,kickr,303,302,1
51306,383194,2020-08-22 23:45:37,wahoo,Zwift - 3R & ZID Merdeka Classique Flat Race Series - Round 4 of 4 (A),crank power meter,kickr,341,343,-2
14580,606652,2020-02-18 19:14:58,wahoo,Zwift - Feltet.dk Race Series,Quarq DFour,Wahoo Kickr 2018,359,337,22
16637,606652,2020-03-03 19:14:57,wahoo,Zwift - Feltet.dk Race Series (A),Quarq DFour,Wahoo Kickr 2018,385,365,20
19518,606652,2020-03-24 19:07:07,wahoo,Zwift - Feltet.dk Race Series (A),Quarq DFour,Wahoo Kickr 2018,381,360,21
21130,606652,2020-03-31 18:15:12,wahoo,Zwift - Feltet.dk Race Series (A),Quarq DFour,Wahoo Kickr 2018,387,370,17
22219,606652,2020-04-05 08:59:59,wahoo,Zwift - Ronde van Zwift (A),Quarq DFour,Wahoo Kickr 2018,380,360,20
25008,606652,2020-04-14 18:36:25,wahoo,Zwift - 3R Spring Loaded Race Series - Round 3of6 (A),Quarq DFour,Wahoo Kickr 2018,405,378,27
25627,606652,2020-04-16 17:24:11,wahoo,Zwift - WTRL Team Time Trial (C),Quarq DFour,Wahoo Kickr 2018,368,358,10
25630,606652,2020-04-17 18:31:35,wahoo,Zwift - Newbury Velo Crit (A),Quarq DFour,Wahoo Kickr 2018,384,367,17
29137,606652,2020-04-29 17:28:02,wahoo,Zwift - Danmarks Cykle Union – mid-week racing  (A),Quarq DFour,Wahoo Kickr 2018,391,361,30
29608,606652,2020-04-30 10:32:40,wahoo,Zwift - Watopia,Quarq DFour to Garmin 1030,Wahoo Kickr 2018 to Zwift,345,340,5
30655,606652,2020-05-02 15:48:51,wahoo,Zwift - Watopia,Quarq DFour to Zwift,Wahoo Kickr 2018 to Garmin 1030,325,307,18
31747,606652,2020-05-05 17:57:36,wahoo,Zwift - UNO X CUP powered by DCU & Feltet.dk (A),Quarq DFour to Zwift,Wahoo Kickr 2018 to Garmin 1030,399,399,0
34064,606652,2020-05-12 18:10:03,wahoo,Zwift - UNO X CUP powered by DCU & Feltet.dk (A),Quarq DFour to Zwift,Wahoo Kickr 2018 to Garmin 1030,413,393,20
34779,606652,2020-05-14 17:23:31,wahoo,Zwift - FUSION ECT BEUNSTOPPABLE Racing Series (A),Quarq DFour to Zwift,Wahoo Kickr 2018 to Garmin 1030,417,407,10
36149,606652,2020-05-19 18:11:04,wahoo,Zwift - UNO X CUP powered by DCU & Feltet.dk (A),Quarq DFour to Zwift,Wahoo Kickr 2018 to Garmin 1030,421,409,12
37997,606652,2020-05-26 18:06:44,wahoo,Zwift - UNO X CUP powered by DCU & Feltet.dk (A),Quarq DFour to Zwift,Wahoo Kickr 2018 to Garmin 1030,438,422,16
39252,606652,2020-06-02 18:07:59,wahoo,Zwift - UNO X CUP powered by DCU & Feltet.dk (A),Quarq DFour to Zwift,Wahoo Kickr 2018 to Garmin 1030,405,400,5
39730,606652,2020-06-04 17:30:00,wahoo,Zwift - FUSION ECT BEUNSTOPPABLE Racing Series (A),Quarq DFour to Zwift,Wahoo Kickr 2018 to Garmin 1030,385,369,16
40572,606652,2020-06-09 18:10:23,wahoo,Zwift - UNO X CUP powered by DCU & Feltet.dk (A),Quarq DFour to Zwift,Wahoo Kickr 2018 to Garmin 1030,398,380,18
42273,606652,2020-06-16 18:10:38,wahoo,Zwift - UNO X CUP powered by DCU & Feltet.dk (A),Quarq DFour to Zwift,Wahoo Kickr 2018 to Garmin 1030,396,369,27
44696,606652,2020-07-03 14:53:53,wahoo,Zwift - Watopia,Quarq DFour to Zwift,Wahoo Kickr 2018 to Garmin 1030,265,263,2
51866,606652,2020-08-25 17:46:15,wahoo,Zwift - RHYS HOWELL [CANYON]&#039;s Meetup - Big Foot Hills,Quarq DFour to Zwift,Wahoo Kickr 2018 to Garmin 1030,403,381,22
52337,606652,2020-08-27 14:03:16,wahoo,Zwift - 3R Classique Flat Race - 6 Laps (37.7km/23.4mi 114m) (A),Quarq DFour to Zwift,Wahoo Kickr 2018 to Garmin 1030,367,335,32
55983,606652,2020-09-17 18:25:13,wahoo,Zwift - Invitational League // Qualifying Race #2 (Men) ,Quarq DZero to Garmin 1030,Wahoo Kickr 2018 to Zwift,379,371,8
58472,606652,2020-09-23 17:37:36,wahoo,Zwift - DCU powered by Feltet.dk (A),Quarq DFour to Zwift,Wahoo Kickr 2018 to Garmin 1030,394,383,11
58744,606652,2020-09-30 17:34:00,wahoo,Zwift - DCU powered by Feltet.dk (A),Quarq DFour to Zwift,Wahoo Kickr 2018 to Garmin 1030,383,360,23
61565,606652,2020-10-13 17:04:37,wahoo,Zwift - Zwift Racing League | WTRL,Quarq DFour to Zwift,Wahoo Kickr 2018 to Garmin 1030,405,381,24
63438,606652,2020-10-20 17:13:27,wahoo,Zwift - Zwift Racing League | WTRL - EMEA E (MEN) - TTT Grp 1,Quarq DFour to Zwift,Wahoo Kickr 2018 to Garmin 1030,377,356,21
64461,606652,2020-10-23 17:57:52,wahoo,Zwift - Team IRL Without Borders Race (A),Quarq DFour to Zwift,Wahoo Kickr 2018 to Garmin 1030,382,356,26
65467,606652,2020-10-27 18:10:40,wahoo,Zwift - Zwift Racing League | WTRL - EMEA E (MEN) -  Division 1 (A),Quarq DFour to Zwift,Wahoo Kickr 2018 to Garmin 1030,385,359,26
66223,606652,2020-10-29 18:28:52,wahoo,Zwift - FUSION ECT BEUNSTOPPABLE Racing Series (A),Quarq DFour to Zwift,Wahoo Kickr 2018 to Garmin 1030,366,349,17
67621,606652,2020-11-03 18:30:45,wahoo,Zwift - Zwift Racing League | WTRL - Men&#039;s EMEA E1 DIVISION 1 (A),Quarq DFour to Zwift,Wahoo Kickr 2018 to Garmin 1030,383,369,14
68057,606652,2020-11-04 18:59:11,wahoo,Zwift - DCU – Feltet.dk November series,Quarq DFour to Zwift,Wahoo Kickr 2018 to Garmin 1030,384,353,31
69795,606652,2020-11-10 18:13:20,wahoo,Zwift - Zwift Racing League | WTRL - EMEA E1 (MEN) -  Division 1 (A),Quarq DFour to Zwift,Wahoo Kickr 2018 to Garmin 1030,426,398,28
70348,606652,2020-11-11 19:04:06,wahoo,Zwift - DBR HEINO CUP III (A),Quarq DFour to Zwift,Wahoo Kickr 2018 to Garmin 1030,368,343,25
72260,606652,2020-11-17 18:18:57,wahoo,Zwift - Zwift Racing League | WTRL - Men&#039;s EMEA E1 DIVISION 1 (A),Quarq DFour to Zwift,Wahoo Kickr 2018 to Garmin 1030,396,385,11
75602,606652,2020-11-25 18:55:28,wahoo,Zwift - DCU – Feltet.dk November series (A),Quarq DFour to Zwift,Wahoo Kickr 2018 to Garmin 1030,383,369,14
76194,606652,2020-11-26 18:29:49,wahoo,Zwift - FUSION ECT BEUNSTOPPABLE Racing Series (A),Quarq DFour to Zwift,Wahoo Kickr 2018 to Garmin 1030,372,357,15
78123,606652,2020-12-01 18:19:11,wahoo,Zwift - Zwift Racing League | WTRL - Men&#039;s EMEA E1 DIVISION 1 (A),Quarq DFour to Zwift,Wahoo Kickr 2018 to Garmin 1030,377,364,13
79091,606652,2020-12-03 18:29:50,wahoo,Zwift - FUSION DECEMBER CUP (A),Quarq DFour to Zwift,Wahoo Kickr 2018 to Garmin 1030,378,361,17
80853,606652,2020-12-08 18:14:50,wahoo,Zwift - Zwift Racing League | WTRL - Men&#039;s EMEA E1 DIVISION 1 (A),Quarq DFour to Zwift,Wahoo Kickr 2018 to Garmin 1030,377,356,21
82057,606652,2020-12-11 18:58:44,wahoo,Zwift - Team IRL Without Borders Race (A),Quarq DFour to Zwift,Wahoo Kickr 2018 to Garmin 1030,362,342,20
84473,606652,2020-12-17 18:29:55,wahoo,FUSION DECEMBER CUP,Quarq DFour to Zwift,Wahoo Kickr 2018 to Wahoo Fitness App,369,358,11
86217,606652,2020-12-22 18:54:41,wahoo,Zwift - Team Italy & Frenchy Fuzion League (A),Quarq DFour to Zwift,Wahoo Kickr 2018 to Wahoo Fitness App,388,374,14
89121,606652,2020-12-30 17:59:16,wahoo,Zwift - MIDWEEK Winter Series by SZR (A),Quarq DFour to Zwift,Wahoo Kickr 2018 to Wahoo Fitness App,388,375,13
92996,606652,2021-01-07 18:29:33,wahoo,Zwift - FUSION WINTER CUP (A),Quarq DZero(secondary bike) to Zwift,Wahoo Kickr 2018 to Wahoo Fitness App,392,383,9
95725,606652,2021-01-12 18:14:34,wahoo,Zwift - Zwift Racing League | WTRL - Men&#039;s/Mixed EMEA E1 DIVISION 1 (A),Quarq DFour to Zwift,Wahoo Kickr 2018 to Wahoo Fitness App,367,358,9
96367,606652,2021-01-13 15:59:49,wahoo,Zwift - Sydkysten Race (A),Quarq DFour to Zwift,Wahoo Kickr 2018 to Wahoo Fitness App,374,363,11
97119,606652,2021-01-14 18:29:17,wahoo,Zwift - FUSION WINTER CUP (A),Quarq DFour to Zwift,Wahoo Kickr 2018 to Wahoo Fitness App,391,379,12
98221,606652,2021-01-16 11:14:22,wahoo,Zwift - 3R Tick Tock Flat Race - 2 Lap (36km/22.4mi 100m) (A),Quarq DFour to Zwift,Wahoo Kickr 2018 to Wahoo Fitness App,357,346,11
98224,606652,2021-01-16 09:04:09,wahoo,Zwift - 3R Weekend Race Club - Race 2 (A),Quarq DFour to Zwift,Wahoo Kickr 2018 to Wahoo Fitness App,345,338,7
99737,606652,2021-01-19 18:22:17,wahoo,Zwift - Zwift Racing League | WTRL - Men&#039;s/Mixed EMEA E1 DIVISION 1 (A),Quarq DFour to Zwift,Wahoo Kickr 2018 to Wahoo Fitness App,367,356,11
101059,606652,2021-01-21 18:29:21,wahoo,Zwift - FUSION WINTER CUP (A),Quarq DFour to Zwift,Wahoo Kickr 2018 to Wahoo Fitness App,382,371,11
103538,606652,2021-01-26 18:14:03,wahoo,Zwift - Zwift Racing League | WTRL - Men&#039;s/Mixed EMEA E1 DIVISION 1 (A),Quarq DFour to Zwift,Wahoo Kickr 2018 to Wahoo Fitness App,381,369,12
116588,606652,2021-02-17 17:38:42,wahoo,Zwift - Watopia,Quarq DFour to Garmin 1030,Kickr V5 to Zwift,261,249,12
116675,606652,2021-02-17 18:38:46,wahoo,Zwift - Danmarks Cykle Union & Partners 6/6 (A),Quarq DFour to Garmin 1030,Kickr V5 to Zwift,376,365,11
117352,606652,2021-02-18 18:29:52,wahoo,Zwift - FUSION WINTER CUP (A),Quarq DFour to Garmin 1030,Kickr V5 to Zwift,366,360,6
119625,606652,2021-02-23 18:13:32,wahoo,Zwift - Zwift Racing League | WTRL - Men&#039;s/Mixed EMEA E1 DIVISION 1 (A),Quarq DFour to Zwift,Kickr V5 to Wahoo Fitness App,382,373,9
120328,606652,2021-02-24 18:44:08,wahoo,Zwift - Scandinavian Cup 2021 - Round 1 - Men (A),Quarq DFour to Wahoo Fitness App,Kickr V5 to Zwift,355,345,10
120809,606652,2021-02-25 18:52:07,wahoo,Zwift - Watopia,Quarq DZero(secondary bike) to Zwift,Kickr V5 to Wahoo Fitness App,362,352,10
122968,606652,2021-03-02 18:19:47,wahoo,Zwift - Zwift Racing League | WTRL - Men&#039;s/Mixed EMEA E1 DIVISION 1 (A),Quarq DFour to Zwift,Kickr V5 to Wahoo Fitness App,402,383,19
124581,606652,2021-03-05 19:03:30,wahoo,Zwift - Zwift Racing League | WTRL Battle Royale Playoff - Men&#039;s Points Race (A),Quarq DFour to Wahoo Fitness App,Kickr V5 to Zwift,403,382,21
125168,606652,2021-03-06 19:55:23,wahoo,Zwift - Zwift Racing League | WTRL Battle Royale Playoff - Men&#039;s TTT (A),Quarq DFour to Wahoo Fitness App,Kickr V5 to Zwift,405,387,18
126070,606652,2021-03-09 12:53:29,wahoo,Zwift - Watopia,Quarq DZero(secondary bike) to Zwift,Kickr V5 to Wahoo Fitness App,401,393,8
41562,610587,2020-06-13 15:30:01,wahoo,Zwift - GCA Nachwuchs Klassiker #2 (A),Power2max NGeco,Wahoo Kickr Core,428,422,6
42927,610587,2020-06-20 15:30:20,wahoo,Zwift - GCA Nachwuchs Klassiker #3 (A),Power2max NGeco,Wahoo Kickr Core,466,461,5
105839,610587,2021-01-30 16:59:55,wahoo,Zwift - GCA Liga 2021 #1,Power2max NGeco,Wahoo Kickr Core,458,468,-10
110107,610587,2021-02-06 16:59:53,wahoo,Zwift - GCA Liga 2021 #2 (A),Power2max NGeco,Wahoo Kickr Core,447,444,3
114355,610587,2021-02-13 17:00:20,wahoo,Zwift - GCA Liga 2021 #3 (A),Power2max NGeco,Wahoo Kickr Core,431,425,6
118439,610587,2021-02-20 16:38:18,wahoo,Zwift - GCA Liga 2021 #4 (A),Power2max NGeco,Wahoo Kickr Core,442,461,-19
121850,610587,2021-02-27 17:00:16,wahoo,Zwift - GCA Liga 2021 #5 (A),Power2max NGeco,Wahoo Kickr Core,453,459,-6
102521,69943,2021-01-24 18:00:02,wahoo,Zwift - Sunday Decaf Ride (C),Power Tap Pedals,Kicker,270,270,0
102532,69943,2021-01-24 17:21:43,wahoo,Zwift - Innsbruck,Power Tap Pedals,Kicker,275,274,1
96508,617974,2021-01-13 18:00:00,wahoo,TDZ Stage 2,Dura Ace Power,KickrV5,319,324,-5
97014,617974,2021-01-14 17:02:56,wahoo,TDZ Stage 3,Dura Ace Power,KickrV5,310,319,-9
97952,617974,2021-01-16 09:33:17,wahoo,Ascenders Team Watopia Pretzel Family Challenge ,Shimano Dura Ace R9100-P,Wahoo KICKR V5,310,320,-10
101828,617974,2021-01-23 06:59:59,wahoo,SZR Endurance Ride (C),Shimano Dura Ace R9100-P,Wahoo KICKR V5,275,282,-7
106193,617974,2021-01-30 08:15:21,wahoo,Wahoo KICKR V5 / Shimano Dura Ace R9100-P,Shimano Dura Ace R9100-P,Wahoo KICKR V5,305,309,-4
109938,617974,2021-02-06 08:30:39,wahoo,Zwift Fondo Series 2020/21,Shimano Dura Ace R9100-P,Wahoo KICKR V5,316,322,-6
89816,623859,2021-01-01 15:15:16,wahoo,Zwift - 3R Sand and Sequoias Race (C),quarq riken,WAHOO KICKR V5,341,367,-26
90527,623859,2021-01-03 08:07:01,wahoo,Zwift - 3R Volcano Circuit - 6 Laps (C),quarq riken,WAHOO KICKR V5,333,344,-11
91745,623859,2021-01-05 16:42:00,wahoo,Zwift - Team Italy Specialissima Race (C),quarq riken,WAHOO KICKR V5,347,354,-7
94901,623859,2021-01-11 16:47:02,wahoo,Zwift - FZR Segment Killer Race (C),quarq riken,WAHOO KICKR V5,353,360,-7
97434,623859,2021-01-15 13:53:04,wahoo,Zwift - KISS Race Series - Pacific AM (C),quarq riken,WAHOO KICKR V5,313,321,-8
100247,623859,2021-01-20 16:02:02,wahoo,Zwift - Sydkysten Race (C),quarq riken,WAHOO KICKR V5,346,355,-9
106065,623859,2021-01-31 10:02:00,wahoo,Zwift - DBR Sunday Race (C),quarq riken,WAHOO KICKR V5,370,373,-3
128224,623859,2021-03-14 08:07:02,wahoo,Zwift - 3R Volcano Circuit - 6 Laps (C),quarq riken,WAHOO KICKR V5,339,356,-17
40143,543349,2020-06-07 07:20:16,wahoo,Zwift - Team Italy & Frenchy Fuzion Endurance Race #1st,4iiii Left Crank Arm only (garmin),Wahoo KICKR,411,419,-8
40942,543349,2020-06-10 17:59:22,wahoo,Zwift - Zwift NL League - Woensdagavond Competitie (A),4iiii Left Crank Arm only (garmin),Wahoo KICKR,415,436,-21
49667,543349,2020-08-11 17:57:30,wahoo,Zwift - ZWIFT NL - WAHOO Kickr Social Race,4iiii Left Crank Arm only (garmin),Wahoo KICKR V5,387,385,2
55050,543349,2020-09-14 17:57:24,wahoo,Zwift - Invitational League // Qualifying Race #1,4iiii Left Crank Arm only (garmin),Wahoo KICKR V5,399,406,-7
55885,543349,2020-09-17 18:27:31,wahoo,Zwift - Invitational League // Qualifying Race #2 (Men) ,4iiii Left Crank Arm only (garmin),Wahoo KICKR V5,380,399,-19
69036,543349,2020-11-08 12:35:40,wahoo,Zwift - NYC Recon & Calibration Ride,4iiii Left Crank Arm only (garmin),Wahoo KICKR V5,275,302,-27
69501,543349,2020-11-09 19:59:49,wahoo,Zwift - Premier Division // Zwift Racing League,4iiii Left Crank Arm only (garmin),Wahoo KICKR V5,460,459,1
71978,543349,2020-11-16 18:59:31,wahoo,Zwift - Premier Division // Zwift Racing League (men) (A),4iiii Left Crank Arm only (garmin),Wahoo KICKR V5,409,401,8
74711,543349,2020-11-23 19:57:24,wahoo,Zwift - Premier Division // Zwift Racing League (men) (A),4iiii Left Crank Arm only (garmin),Wahoo KICKR V5,471,447,24
77694,543349,2020-11-30 19:05:03,wahoo,Zwift - Premier Division // Zwift Racing League (men) (A),4iiii Left Crank Arm only (garmin),Wahoo KICKR V5,412,405,7
79231,543349,2020-12-03 18:57:16,wahoo,BENELIGA 2020-2021,4iiii Left Crank Arm only (garmin),Wahoo KICKR V5,425,398,27
81819,543349,2020-12-10 18:58:52,wahoo,Zwift - BENELIGA 2020-2021 (E) #39e + 13 Points,4iiii Left Crank Arm only (garmin),Wahoo KICKR V5,429,418,11
84499,543349,2020-12-17 18:56:16,wahoo,Zwift - BENELIGA 2020-2021 #24 + 1 point..,4iiii Left Crank Arm only (garmin),Wahoo KICKR V5,438,433,5
86176,543349,2020-12-22 17:25:05,wahoo,Zwift - Anaerobic efforts,4iiii Left Crank Arm only (garmin),Wahoo KICKR V5,349,334,15
93667,543349,2021-01-07 18:58:21,wahoo,Zwift - BENELIGA 2020-2021,4iiii Left Crank Arm only (garmin),Wahoo KICKR V5,432,429,3
95026,543349,2021-01-11 18:48:43,wahoo,Zwift - Premier Division // Zwift Racing League (men) (A),4iiii Left Crank Arm only (garmin),Wahoo KICKR V5,409,401,8
99266,543349,2021-01-18 19:57:31,wahoo,Zwift - Premier Division // Zwift Racing League,4iiii Left Crank Arm only (garmin),Wahoo KICKR V5,407,400,7
101236,543349,2021-01-21 18:56:30,wahoo,Zwift - BENELIGA 2020-2021 (E) +8 points,4iiii Left Crank Arm only (garmin),Wahoo KICKR V5,414,424,-10
104962,543349,2021-01-28 18:49:58,wahoo,Wahoo KICKR V5 / 4iiii Left Crank Arm only (garmin),4iiii Left Crank Arm only (garmin),Wahoo KICKR V5,413,396,17
106937,543349,2021-02-01 20:03:41,wahoo,Zwift - Premier Division // Zwift Racing League (men) (A),4iiii Left Crank Arm only (garmin),Wahoo KICKR V5,396,397,-1
111074,543349,2021-02-08 19:19:57,wahoo,Zwift - Premier Division // Zwift Racing League (men) (A),4iiii Left Crank Arm only (garmin),Wahoo KICKR V5,427,425,2
115424,543349,2021-02-15 20:01:39,wahoo,Zwift - Premier Division // Zwift Racing League ,4iiii Left Crank Arm only (garmin),Wahoo KICKR V5,433,433,0
117574,543349,2021-02-18 18:58:53,wahoo,Zwift - BENELIGA 2020-2021 (E),4iiii Left Crank Arm only (garmin),Wahoo KICKR V5,399,409,-10
119133,543349,2021-02-22 19:10:09,wahoo,Zwift - Premier Division // Zwift Racing League (men) (A),4iiii Left Crank Arm only (garmin),Wahoo KICKR V5,422,404,18
29875,346642,2020-04-30 22:01:02,wahoo,Zwift - ZHQ Beta Crit City Race (B),Quarq,Kickr 2018,281,280,1
33120,346642,2020-05-09 20:32:46,wahoo,Zwift - Tower 26/USA Duathlon Virtual 20K Time Trial (E),Quarq,Kickr 2018,240,238,2
19487,76018,2020-03-25 09:50:01,wahoo,Zwift - KISS 80 km group ride,Quarq SRAM Red,Wahoo Kickr,342,329,13
19505,76018,2020-03-25 12:01:01,wahoo,Zwift - Stage 5 - Shorter Ride - Tour of Watopia 2020,Quarq SRAM Red,Wahoo Kickr,375,355,20
19526,76018,2020-03-25 13:00:02,wahoo,Zwift - Stage 5 - Longer Ride - Tour of Watopia 2020,Quarq SRAM Red,Wahoo Kickr,288,278,10
21483,76018,2020-04-02 17:59:59,wahoo,Zwift - KALAS Cup - Round 10 (A),Quarq SRAM Red,Wahoo Kickr,379,374,5
21941,76018,2020-04-04 08:29:58,wahoo,Zwift - DBR Sufferday League (A),Quarq SRAM Red,Wahoo Kickr,409,402,7
26993,76018,2020-04-22 17:00:01,wahoo,Zwift - Swedish Zwift Racing Cup by SZR - Dead! ,Quarq SRAM Red,Wahoo Kickr,385,363,22
28986,76018,2020-04-27 17:37:37,wahoo,Zwift - USA Cycling Race League by Indoor Specialist  (A) - Just kill me 😳☠,Quarq SRAM Red,Wahoo Kickr,378,367,11
29941,76018,2020-04-30 17:28:07,wahoo,Zwift - WTRL Team Time Trial Premier League - Zwift race is pain. Team Time Trial is torture,Quarq SRAM Red,Wahoo Kickr,404,385,19
37010,76018,2020-05-23 08:30:02,wahoo,Zwift - DBR Sufferday League (A),Quarq SRAM Red,Wahoo Kickr,376,359,17
57187,76018,2020-09-24 09:59:59,wahoo,KISS at Race - Americas AM - 3rd ,Quarq SRAM Red,Wahoo Kickr gen5,441,430,11
60116,76018,2020-10-07 17:45:01,wahoo,DCU race,Quarq SRAM Red,Wahoo Kickr gen5,424,412,12
60838,76018,2020-10-10 14:46:12,wahoo,ZADA 3 Sisters Test,Quarq SRAM Red,Wahoo Kickr gen5,416,404,12
62190,76018,2020-10-15 18:10:03,wahoo,TTT,Quarq SRAM Red,Wahoo Kickr gen5,413,403,10
64062,76018,2020-10-22 09:59:59,wahoo,Zwift - KISS at Race - Americas AM (A),Quarq SRAM Red,Wahoo Kickr gen5,418,403,15
64177,76018,2020-10-22 17:28:04,wahoo,WTRL - Team Time Trial,Quarq SRAM Red,Wahoo Kickr gen5,408,389,19
66137,76018,2020-10-29 18:25:04,wahoo,WTRL - TTT,Quarq SRAM Red,Wahoo Kickr gen5,429,416,13
67953,76018,2020-11-04 19:00:02,wahoo,DCU - Feltet.dk November Series - Made it hard on the climb and 7th in the sprint. Team mate won,Quarq SRAM Red,Wahoo Kickr gen5,455,446,9
70331,76018,2020-11-11 18:59:59,wahoo,Zwift - DCU – Feltet.dk November series (A) 1st - Whaat:),Quarq SRAM Red,Wahoo Kickr gen5,430,415,15
71002,76018,2020-11-12 18:57:06,wahoo,Zwift - Espresso,Quarq SRAM Red,Wahoo Kickr gen5,410,392,18
72653,76018,2020-11-18 18:59:59,wahoo,DCU - Feltet.dk November Series. 4th on results,Quarq SRAM Red,Wahoo Kickr gen5,396,384,12
73225,76018,2020-11-19 19:30:01,wahoo,Zwift - World Championships Experience // Danish Cycling Federation - 8th,Quarq SRAM Red,Wahoo Kickr gen5,392,388,4
75570,76018,2020-11-25 19:00:03,wahoo,Zwift - DCU – Feltet.dk November series (A),Quarq SRAM Red,Wahoo Kickr gen5,390,378,12
76988,76018,2020-11-28 15:15:02,wahoo,Zwift - OH MY CRIT - Saturday Smash Race (A),Quarq SRAM Red,Wahoo Kickr gen5,378,371,7
77313,76018,2020-11-29 14:15:19,wahoo,Zwift - KISS 100 Race Series - Americas (A),Quarq SRAM Red,Wahoo Kickr gen5,339,336,3
78423,76018,2020-12-02 10:44:59,wahoo,Zwift - New Workout,Quarq SRAM Red,Wahoo Kickr gen5,398,388,10
79264,76018,2020-12-04 09:05:03,wahoo,Zwift - 3R Whole Lotta Lava Hilly Race - 2 Laps (28.9km/12.53mi 336m) (A),Quarq SRAM Red,Wahoo Kickr gen5,394,383,11
81102,76018,2020-12-09 17:59:58,wahoo,Zwift - MIDWEEK Winter Series by SZR (A),Quarq SRAM Red,Wahoo Kickr gen5,393,384,9
81631,76018,2020-12-10 18:29:59,wahoo,FUSION DECEMBER CUP - 1st,Quarq SRAM Red,Wahoo Kickr gen5,427,417,10
82718,76018,2020-12-13 12:12:01,wahoo,ZADA 3 sister test - Michael Knudsen (PO auto - CeramicSpeed),Quarq SRAM Red,Wahoo Kickr gen5,437,431,6
89109,76018,2020-12-30 18:00:02,wahoo,Zwift - MIDWEEK Winter Series by SZR (A),Quarq SRAM Red,Wahoo Kickr gen5,466,450,16
89789,76018,2020-12-31 08:53:01,wahoo,Zwift - Peel Cycling - Morning Chase (A),Quarq SRAM Red,Wahoo Kickr gen5,437,447,-10
90268,76018,2021-01-02 15:15:01,wahoo,Zwift - New Workout,Quarq SRAM Red,Wahoo Kickr gen5,389,399,-10
91269,76018,2021-01-04 17:00:02,wahoo,Zwift - TDZ Stage 1: Standard Ride,Quarq SRAM Red,Wahoo Kickr gen5,198,201,-3
93317,76018,2021-01-08 13:07:36,wahoo,Zwift - TDZ Stage 1: Shorter Ride,Quarq SRAM Red,Wahoo Kickr gen5,232,240,-8
93825,76018,2021-01-09 13:02:01,wahoo,Zwift - New Workout,Quarq SRAM Red,Wahoo Kickr gen5,379,390,-11
94414,76018,2021-01-10 14:03:02,wahoo,Zwift - TDZ Stage 2: Shorter Ride,Quarq SRAM Red,Wahoo Kickr gen5,376,385,-9
94959,76018,2021-01-11 19:15:01,wahoo,Zwift - Premier Division // Zwift Racing League (men) (A),Quarq SRAM Red,Wahoo Kickr gen5,403,412,-9
97421,76018,2021-01-15 14:02:03,wahoo,Zwift - TDZ Stage 3: Standard Ride,Quarq SRAM Red,Wahoo Kickr gen5,383,399,-16
98356,76018,2021-01-17 06:56:22,wahoo,active recovery,Quarq SRAM Red,Wahoo Kickr gen5,175,181,-6
99174,76018,2021-01-18 19:47:36,wahoo,Zwift - Premier Division // Zwift Racing League (men) (A),Quarq SRAM Red,Wahoo Kickr gen5,394,399,-5
100126,76018,2021-01-20 08:00:02,wahoo,Zwift - TDZ Stage 4: Longer Ride,Quarq SRAM Red,Wahoo Kickr gen5,287,288,-1
100341,76018,2021-01-20 18:45:01,wahoo,Zwift - Danmarks Cykle Union & Partners 2/6 (A),Quarq SRAM Red,Wahoo Kickr gen5,435,435,0
102691,76018,2021-01-23 07:00:02,wahoo,Zwift - EVO CC 160km Base Ride [3.0-3.2w/kg avg] (B),Quarq SRAM Red,Wahoo Kickr gen5,372,375,-3
102717,76018,2021-01-25 10:13:15,wahoo,Zwift - Innsbruck,Quarq SRAM Red,Wahoo Kickr gen5,270,270,0
102883,76018,2021-01-25 19:04:54,wahoo,Zwift - Premier Division // Zwift Racing League (men) (A) - 4th,Quarq SRAM Red,Wahoo Kickr gen5,439,447,-8
106593,76018,2021-02-01 11:52:39,wahoo,Premier Division stage 4 recon ride,Quarq SRAM Red,Wahoo Kickr gen5,249,251,-2
106875,76018,2021-02-01 20:06:51,wahoo,Zwift - Premier Division // Zwift Racing League (men) (A),Quarq SRAM Red,Wahoo Kickr gen5,404,402,2
111483,76018,2021-02-09 17:00:04,wahoo,Zwift - TDZ Stage 8: Group Ride,Quarq SRAM Red,Wahoo Kickr gen5,218,216,2
115368,76018,2021-02-15 20:01:59,wahoo,Zwift - Premier Division // Zwift Racing League (men) (A) - F*cking drop out on second climb,Quarq SRAM Red,Wahoo Kickr gen5,430,435,-5
119118,76018,2021-02-22 19:10:01,wahoo,Zwift - Premier Division // Zwift Racing League (men) (A) - 15th,Quarq SRAM Red,Wahoo Kickr gen5,372,384,-12
122616,76018,2021-03-01 20:21:34,wahoo,Zwift - Premier Division // Zwift Racing League (men) (A),Quarq SRAM Red,Wahoo Kickr gen5,425,428,-3
117820,552300,2021-02-19 16:59:59,wahoo,zwift assioma / kickr,zwift assioma,kickr,181,181,0
118243,552300,2021-02-20 11:15:00,wahoo,Zwift - 3R Tick Tock Flat Race - 2 Lap (36km/22.4mi 100m) (B),Zwift,kickr,330,328,2
119449,552300,2021-02-23 12:31:00,wahoo,Zwift - ZHQ FutureWorks Crit City Race - Anti-sandbagging (B),Zwift,kickr,338,341,-3
121098,552300,2021-02-26 10:21:27,wahoo,Zwift - Watopia,Zwift,kickr and tickr,306,297,9
103443,597567,2021-01-26 15:59:57,wahoo,Zwift - TDZ Stage 5: Longer Ride,Favero Assioma Duo,Wahoo Kickr,370,341,29
107288,597567,2021-02-02 17:00:16,wahoo,Zwift - TDZ Stage 6: Longer Ride,Favero Assioma Duo,Wahoo Kickr,359,360,-1
112937,597567,2021-02-11 17:46:22,wahoo,Zwift - WTRL Team Time Trial - Zone 3 (C),Favero Assioma Duo,Wahoo Kickr,358,367,-9
117229,597567,2021-02-18 17:48:23,wahoo,Zwift - WTRL Team Time Trial - Zone 3 (C),Favero Assioma Duo,Wahoo Kickr,364,371,-7
76955,620461,2020-11-28 13:16:37,wahoo,Zwift - Yorkshire - wup and calibration,4iiii,Wahoo Kickr V5,237,227,10
76956,620461,2020-11-28 13:27:29,wahoo,Zwift - Watopia,4iiii,Wahoo Kickr V5,355,328,27
51375,631742,2020-08-23 15:13:09,wahoo,4iiii vs Kickr,4iiii,Kickr,325,325,0
51500,631742,2020-08-24 10:56:16,wahoo,Kickr / Quarq,Quarq,Kickr,339,333,6
51502,631742,2020-08-24 11:32:31,wahoo,Kickr / 4iiii,4iiii,Kickr,308,337,-29
94991,631742,2021-01-11 19:07:07,wahoo,Zwift - Premier Division // Zwift Racing League (men) (A),Quarq,Kickr,435,414,21
99201,631742,2021-01-18 19:43:45,wahoo,Zwift - Premier Division // Zwift Racing League (men) (A),Quarq,Kickr,398,409,-11
100576,631742,2021-01-21 00:51:04,wahoo,Zwift - Cycling Canada Wednesday Night Race Series (A),Quarq,Kickr,399,426,-27
101886,631742,2021-01-23 00:09:44,wahoo,Redlands TT,Quarq,Kickr,469,429,40
102920,631742,2021-01-25 18:57:01,wahoo,Zwift - Premier Division // Zwift Racing League (men) (A),Quarq-Secondary,Kickr-Primary,414,419,-5
106895,631742,2021-02-01 19:57:05,wahoo,Zwift - Premier Division // Zwift Racing League (men) (A),Quarq,Kickr-Primary,404,413,-9
109838,631742,2021-02-05 23:10:38,wahoo,Joe Martin TT,Quarq-Secondary,Kickr-Primary,463,430,33
110177,631742,2021-02-06 17:09:01,wahoo,JMSR Stage 2,Quarq-Secondary,Kickr-Primary,457,421,36
111031,631742,2021-02-08 19:13:15,wahoo,Zwift - Premier Division // Zwift Racing League (men) (A),hwarner84.2021-02-08-20-06-07-240Z.GarminPush.81495825249,Kickr-Primary,427,438,-11
115342,631742,2021-02-15 19:52:06,wahoo,Zwift - Premier Division // Zwift Racing League (men) (A),Quarq-Secondary,Kickr-Primary,459,470,-11
119088,631742,2021-02-22 19:06:33,wahoo,Zwift - Premier Division // Zwift Racing League (men) (A),Quarq-Secondary,Kickr-Primary,408,410,-2
122554,631742,2021-03-01 20:04:00,wahoo,Zwift - Premier Division // Zwift Racing League (men) (A),Quarq-Secondary,Kickr-Primary,418,417,1
79116,629187,2020-12-03 15:59:46,wahoo,Zwift - Baby Bear,ASSIOMA,WAHOO KICKR V5,153,159,-6
79132,629187,2020-12-03 16:31:14,wahoo,Zwift - CREAT CITY,FAVERO ASSIOMA,WAHOO KICKR V5,250,247,3
117972,629187,2021-02-19 18:15:00,wahoo,Zwift - Cocorico Race League - Bikes France (A),QUARQ DZERO LAPIERRE,WAHOO KICKR V5,282,292,-10
119814,629187,2021-02-23 19:08:23,wahoo,Zwift - Watopia,QUARQ DZERO LAPIERRE,WAHOO KICKR V5,165,164,1
121292,629187,2021-02-26 18:15:20,wahoo,Zwift - Cocorico Race League - Bikes France (A),QUARQ DZERO LAPIERRE,WAHOO KICKR V5,316,308,8
122076,629187,2021-02-28 13:21:51,wahoo,Zwift - The HERD Sunday Endurance (D),QUARQ DZERO LAPIERRE,WAHOO KICKR V5,286,283,3
122541,629187,2021-03-01 16:51:59,wahoo,Zwift - INC Relentless Steady State (C),QUARQ DZERO LAPIERRE,WAHOO KICKR V5,210,207,3
122561,629187,2021-03-01 18:00:02,wahoo,Zwift - SZR Evening Joyride,QUARQ DZERO LAPIERRE,WAHOO KICKR V5,238,237,1
124215,629187,2021-03-04 18:56:03,wahoo,Zwift - Paris,SWORKS VENGE QUARQ AXS,WAHOO KICKR V5,211,211,0
124700,629187,2021-03-05 18:35:13,wahoo,Newbury Velo Crit,QUARQ DZERO LAPIERRE,WAHOO KICKR V5,272,268,4
124706,629187,2021-03-05 18:15:20,wahoo,Zwift - Cocorico Race League - Bikes France (A),LAPIERRE QUARQ DFOUR,WAHOO KICKR V5,299,292,7
125896,629187,2021-03-08 19:20:01,wahoo,Zwift - Team TFC Mad Monday Race Series (low-end categories) (A),QUARQ DZERO LAPIERRE,WAHOO KICKR V5,300,294,6
127622,629187,2021-03-12 18:15:05,wahoo,Zwift - Cocorico Race League - Bikes France (A),LAPIERRE QUARQ DFOUR,WAHOO KICKR V5,312,309,3
128843,629187,2021-03-15 19:20:21,wahoo,Zwift - Team TFC Mad Monday Race Series (low-end categories) (A),LAPIERRE QUARQ DFOUR,WAHOO KICKR V5,301,297,4
129799,629187,2021-03-17 17:41:32,wahoo,Zwift - . Martial Pottier (Foudre)⚡️&#039;s Meetup,QUARQ DZERO LAPIERRE,WAHOO KICKR V5,357,348,9
34427,291671,2020-05-13 17:59:52,wahoo,Stages Dura Ace R/L PM / Wahoo Kickr,Stages Dura Ace R/L PM,Wahoo Kickr,302,303,-1
36438,291671,2020-05-20 18:00:04,wahoo,Stages Dura Ace R/L PM / Wahoo Kickr,Stages Dura Ace R/L PM,Wahoo Kickr,303,303,0
38134,291671,2020-05-20 18:00:16,wahoo,USA Cycling Race League by Indoor Specialist (A),Stages Dura Ace R/L PM,Wahoo Kickr,287,303,-16
95262,291671,2021-01-11 20:06:44,wahoo,Wahoo Kickr / Stages Dura Ace R/L PM,Stages Dura Ace R/L PM,Wahoo Kickr,288,303,-15
99067,291671,2021-01-18 19:00:48,wahoo,Wahoo Kickr / Stages Dura Ace R/L PM,Stages Dura Ace R/L PM,Wahoo Kickr,241,261,-20
105909,291671,2021-01-30 17:38:35,wahoo,Three Sister Course,Stages Dura Ace R/L PM,Wahoo Kickr 20,275,293,-18
106818,291671,2021-02-01 19:04:07,wahoo,Wahoo Kickr 20 / Stages Dura Ace R/L PM,Stages Dura Ace R/L PM,Wahoo Kickr 20,292,303,-11
112488,291671,2021-02-10 19:01:17,wahoo,Wahoo Kickr 20 / Stages Dura Ace R/L PM,Stages Dura Ace R/L PM,Wahoo Kickr 20,290,298,-8
113686,291671,2021-02-12 19:01:21,wahoo,Wahoo Kickr 20 / Stages Dura Ace R/L PM,Stages Dura Ace R/L PM,Wahoo Kickr 20,277,295,-18
116818,291671,2021-02-17 19:00:47,wahoo,Wahoo Kickr 20 / Stages Dura Ace R/L PM,Stages Dura Ace R/L PM,Wahoo Kickr 20,264,278,-14
117957,291671,2021-02-19 19:01:11,wahoo,Wahoo Kickr 20 / Stages Dura Ace R/L PM,Stages Dura Ace R/L PM,Wahoo Kickr 20,289,307,-18
122471,291671,2021-03-01 19:14:13,wahoo,Wahoo Kickr 20 / Stages Dura Ace R/L PM,Stages Dura Ace R/L PM,Wahoo Kickr 20,254,263,-9
122483,291671,2021-03-01 19:14:18,wahoo,Wahoo Kickr 20 / Garmin Vector 3,Garmin Vector 3,Wahoo Kickr 20,264,263,1
94825,328371,2021-01-09 14:52:53,wahoo,Zwift - DIRT Dadurday Chase Race  (B),Garmin Vector 3,Wahoo Kickr - Refurb Unit,275,259,16
96013,328371,2021-01-13 00:52:56,wahoo,Zwift - Zwift Racing League | WTRL - Men&#039;s/Mixed AMERICAS E DIVISION 7 (B),Garmin Vector 3,Wahoo Kickr - Refurb Unit,256,251,5
97439,328371,2021-01-15 01:13:28,wahoo,Zwift - Force Dev!,Garmin Vector 3,Wahoo Kickr - Refurb Unit,211,216,-5
100744,328371,2021-01-16 14:45:20,wahoo,Zwift - DIRT Dadurday Chase Race  (B),Garmin Vector 3,Wahoo Kickr,259,241,18
100749,328371,2021-01-16 14:45:20,wahoo,Zwift - DIRT Dadurday Chase Race  (B),Garmin Vector 3,Wahoo Kickr - Refurb Unit,259,237,22
122197,593395,2021-02-28 16:54:00,wahoo,Zwift - Haute Route Watopia 2021 Stage 3 (A),Assioma,Wahoo Kickr,260,256,4
7988,640583,2019-12-31 08:44:54,wahoo,Zwift - Watopia,quark,wahoo kickr,219,205,14
8887,640583,2020-01-11 18:56:48,wahoo,Zwift - Tour de Zwift // Pro-Am Invitational,quark,wahoo kickr,266,254,12
10092,640583,2020-01-19 18:59:37,wahoo,Zwift - Tour de Zwift // Pro-Am Invitational,quark,wahoo kickr,291,276,15
10389,640583,2020-01-22 04:49:19,wahoo,Zwift - 3R Gotham Grind Flat Race - 1 Lap (9.25km/5.8mi 29m) (B),quark,wahoo kickr,262,254,8
10600,640583,2020-01-23 05:02:05,wahoo,Zwift - 3R Innsbruckring Sprint Race - 1 Lap (8.8km/5.5mi 77m) (B),quark,wahoo kickr,296,286,10
11236,640583,2020-01-27 19:10:51,wahoo,Zwift - Tour de Zwift // Pro-Am Invitational (A),quark,wahoo kickr,279,269,10
29562,283889,2020-04-30 10:06:38,wahoo,Zwift - 3R Volcano Circuit Flat Race - 8 Laps (35.2km/21.9mi 160m) (A),Quarq Dfour91,Wahoo Kickr Core,343,358,-15
29589,283889,2020-04-30 10:06:38,wahoo,Zwift - ZHR Crit Race (A),Quarq Dfour91,Wahoo Kickr Core,379,396,-17
30486,283889,2020-05-02 08:05:31,wahoo,Zwift - DBR Sufferday League (A),Quarq Dfour91,Wahoo Kickr Core,435,461,-26
31741,283889,2020-05-05 17:48:00,wahoo,Zwift - UNO X CUP powered by DCU & Feltet.dk (A),Quarq Dzero,Wahoo Kickr Core,441,454,-13
34065,283889,2020-05-12 17:46:47,wahoo,Zwift - UNO X CUP powered by DCU & Feltet.dk (A),Quarq Dfour91,Wahoo Kickr Core,445,478,-33
35419,283889,2020-05-16 15:47:30,wahoo,Zwift - 3R Classique Flat Race - 4 Laps (26.9km/16.7mi 76m) (A),Quarq Dfour91,Wahoo Kickr Core,418,434,-16
35423,283889,2020-05-16 15:47:30,wahoo,Zwift - Crit City Race (A),Quarq Dfour91,Wahoo Kickr Core,383,399,-16
36158,283889,2020-05-19 17:50:44,wahoo,Zwift - UNO X CUP powered by DCU & Feltet.dk (A),Quarq Dfour91,Wahoo Kickr Core,435,436,-1
37345,283889,2020-05-24 08:38:03,wahoo,Zwift - Newbury Velo Road Race (A),Quarq Dzero,Wahoo Kickr Core,397,413,-16
39173,283889,2020-06-02 17:51:12,wahoo,Zwift - UNO X CUP powered by DCU & Feltet.dk (A),Quarq Dfour91,Wahoo Kickr Core,443,452,-9
39996,283889,2020-06-06 11:52:48,wahoo,Zwift - Team ODZ RACE (A),Quarq Dfour91,Wahoo Kickr Core,391,411,-20
39997,283889,2020-06-06 11:52:48,wahoo,Zwift - 3R Innsbruckring Flat Race - 5 Laps (44km/27.3mi 385m) (A),Quarq Dfour91,Wahoo Kickr Core,383,397,-14
41511,283889,2020-06-13 08:10:35,wahoo,Zwift - DBR Saturday Race  (A),Quarq Dfour91,Wahoo Kickr Core,392,418,-26
44849,283889,2020-07-04 10:31:51,wahoo,Zwift - Herd Summer Racing League Race 4 (A),Quarq Dfour91,Wahoo Kickr Core,425,444,-19
101391,283889,2021-01-22 14:37:48,wahoo,Zwift - 4x5,Quarq Dzero,Wahoo Kickr Core,453,472,-19
104090,283889,2021-01-27 15:58:32,wahoo,Zwift - Watopia,Powertap P1,Wahoo Kickr Core,429,457,-28
105365,283889,2021-01-28 15:57:56,wahoo,Zwift - Over/Under,Powertap P1,Wahoo Kickr Core,423,458,-35
108336,283889,2021-02-03 18:11:01,wahoo,Zwift - Danmarks Cykle Union & Partners 4/6 (A),Quarq Dzero,Wahoo Kickr Core,440,451,-11
110655,283889,2021-02-07 10:35:38,wahoo,Zwift - Over/Under,Quarq Dzero,Wahoo Kickr Core,426,436,-10
116839,283889,2021-02-17 17:59:40,wahoo,Zwift - Danmarks Cykle Union & Partners 6/6 (A),Quarq Dzero,Wahoo Kickr Core,440,453,-13
75086,621940,2020-11-24 18:15:59,wahoo,Zwift - Zwift Racing League | WTRL - Men&#039;s EMEA E1 DIVISION 1,Favero Assioma Duo,Wahoo Kickr,353,348,5
76251,621940,2020-11-26 18:09:21,wahoo,Zwift - WTRL NOPINZ WORLD TTT CHAMPIONSHIPS - Zone 4 (C),Favero Assioma Duo,Wahoo Kickr,344,355,-11
76967,621940,2020-11-28 13:20:01,wahoo,Zwift - 3R Innsbruckring Flat Race - 5 Laps (44km/27.3mi 385m) (A),Favero Assioma Duo,Wahoo Kickr,358,333,25
78077,621940,2020-12-01 18:24:51,wahoo,Zwift - Zwift Racing League | WTRL - Men&#039;s EMEA E1 DIVISION 1 (B),Favero Assioma Duo,Wahoo Kickr,356,348,8
80864,621940,2020-12-08 18:15:05,wahoo,Zwift - Zwift Racing League | WTRL - Men&#039;s EMEA E1 DIVISION 1 (B),Favero Assioma Duo,Wahoo Kickr,352,339,13
95717,621940,2021-01-12 17:50:50,wahoo,Zwift - Zwift Racing League | WTRL - Men&#039;s/Mixed EMEA E1 DIVISION 5 (A),Favero Assioma Duo,Wahoo Kickr,356,350,6
99747,621940,2021-01-19 17:39:40,wahoo,Zwift - Zwift Racing League | WTRL - Men&#039;s/Mixed EMEA E1 DIVISION 5 (A),Favero Assioma Duo,Wahoo Kickr,342,328,14
103900,621940,2021-01-26 17:37:59,wahoo,Zwift - Zwift Racing League | WTRL - Men&#039;s/Mixed EMEA E1 DIVISION 5 (A),Favero Assioma Duo,Wahoo Kickr,354,341,13
107461,621940,2021-02-02 17:13:38,wahoo,Zwift - Zwift Racing League | WTRL - Men&#039;s/Mixed EMEA E1 DIVISION 5 (A),Favero Assioma Duo,Wahoo Kickr,352,342,10
111683,621940,2021-02-09 16:58:59,wahoo,Zwift Racing League | WTRL - Men&#039;s/Mixed EMEA E1 DIVISION 5,Favero Assioma Duo,Wahoo Kickr,361,352,9
115961,621940,2021-02-16 17:26:00,wahoo,Zwift Racing League | WTRL - Men&#039;s/Mixed EMEA E1 DIVISION 5,Favero Assioma Duo,Wahoo Kickr,386,367,19
35298,612542,2020-05-16 08:29:59,wahoo,Zwift - DBR Sufferday League (A),assioma favero,Kickr Core,318,315,3
36419,612542,2020-05-15 13:21:18,wahoo,Zwift - DBR Boerkop Cykler Cup (A),assioma favero Duo,Kickr Core,338,337,1
37281,612542,2020-05-23 08:29:58,wahoo,Zwift - DBR Sufferday League (A),assioma favero Duo,Kickr Core,325,324,1
38124,612542,2020-05-27 18:04:58,wahoo,Zwift - DBR Boerkop Cykler Cup (A),assioma favero Duo,Kickr Core,344,346,-2
38665,612542,2020-05-30 08:30:04,wahoo,Zwift - DBR Sufferday League (A),assioma favero Duo,Kickr Core,344,344,0
39395,612542,2020-06-03 18:05:00,wahoo,Zwift - DBR Boerkop Cykler Cup (A),assioma favero Duo,Kickr Core,329,322,7
40044,612542,2020-06-06 08:29:58,wahoo,Zwift - DBR Sufferday League (A),assioma favero Duo,Kickr Core,318,313,5
42787,612542,2020-06-20 08:30:14,wahoo,Zwift - DBR Saturday Race  (A),assioma favero Duo,Kickr Core,327,326,1
44798,612542,2020-07-04 08:29:59,wahoo,Zwift - DBR Saturday Race  (A),assioma favero Duo,Kickr Core,331,330,1
46043,612542,2020-07-12 13:05:00,wahoo,Zwift - 3R Watopia Flat Route Race - 4 Laps (40.5km/25.1mi 216m) (A),assioma favero Duo,Kickr Core,325,325,0
47656,612542,2020-07-25 16:04:58,wahoo,Zwift - 3R Classique Flat Race - 4 Laps (26.9km/16.7mi 76m) (A),assioma favero Duo,Kickr Core,344,340,4
52822,612542,2020-08-31 17:14:54,wahoo,Zwift - DBR Monday Race  (A),assioma favero Duo,Kickr Core,321,314,7
63671,612542,2020-10-19 17:14:47,wahoo,Zwift - DBR Ride´N´Roll League (A),assioma favero Duo,Kickr Core,324,319,5
64561,612542,2020-10-24 08:29:58,wahoo,Zwift - DBR SufferDay League II (A),assioma favero Duo,Kickr Core,336,332,4
65468,612542,2020-10-27 18:20:04,wahoo,Zwift - Zwift Racing League | WTRL - EMEA E (MEN) -  Division 6 (A),assioma favero Duo,Kickr Core,347,343,4
66605,612542,2020-10-31 09:29:57,wahoo,Zwift - DBR Saturday Race (A),assioma favero Duo,Kickr Core,352,350,2
67600,612542,2020-11-03 18:24:16,wahoo,Zwift - Zwift Racing League | WTRL - Men&#039;s EMEA E2 DIVISION 2 (A),assioma favero Duo,Kickr Core,339,336,3
68743,612542,2020-11-07 09:30:05,wahoo,Zwift - DBR Saturday Race (A),assioma favero Duo,Kickr Core,351,350,1
69761,612542,2020-11-10 18:19:49,wahoo,Zwift - Zwift Racing League | WTRL - EMEA E2 (MEN) -  Division 2 (A),assioma favero Duo,Kickr Core,384,377,7
71278,612542,2020-11-14 09:29:51,wahoo,Zwift - DBR Saturday Race (A),assioma favero Duo,Kickr Core,319,317,2
72230,612542,2020-11-17 18:24:50,wahoo,Zwift - Zwift Racing League | WTRL - Men&#039;s EMEA E2 DIVISION 2 (A),assioma favero Duo,Kickr Core,335,337,-2
73770,612542,2020-11-21 09:29:47,wahoo,Zwift - DBR Saturday Race (A),assioma favero Duo,Kickr Core,323,321,2
78046,612542,2020-12-01 18:24:00,wahoo,Zwift - Zwift Racing League | WTRL - Men&#039;s EMEA E2 DIVISION 2 (A),assioma favero Duo,Kickr Core,331,329,2
107407,612542,2021-02-02 18:23:54,wahoo,Zwift - Zwift Racing League | WTRL - Men&#039;s/Mixed EMEA E2 DIVISION 1 (A),assioma favero Duo,Kickr Core,352,365,-13
110423,612542,2021-02-07 12:36:53,wahoo,Zwift - Watopia,assioma favero Duo,Kickr Core,271,273,-2
111622,612542,2021-02-09 18:29:31,wahoo,Zwift - Zwift Racing League | WTRL - Men&#039;s/Mixed EMEA E2 DIVISION 1 (A),assioma favero Duo,Kickr Core,369,365,4
115943,612542,2021-02-16 18:24:11,wahoo,Zwift - Zwift Racing League | WTRL - Men&#039;s/Mixed EMEA E2 DIVISION 1 (A),assioma favero Duo,Kickr Core,357,357,0
125458,612542,2021-03-07 13:21:23,wahoo,Zwift - Watopia,assioma favero Duo,Kickr Core #2,317,324,-7
128050,612542,2021-03-13 16:30:00,wahoo,Zwift - ZHQ FutureWorks Crit City Race - Anti-sandbagging (A),assioma favero Duo,Kickr Core #2,331,330,1
129920,612542,2021-03-17 18:30:05,wahoo,Zwift - 3R Race - France Petit Boucle - 45KM (A),assioma favero Duo,Kickr Core #2,335,332,3
7867,177987,2019-12-29 12:01:59,wahoo,Zwift - ZRG-Race-Series-10/10 (B),Favero Powermeter,Wahoo Kickr Core,389,390,-1
7868,177987,2019-12-22 12:01:56,wahoo,Zwift - ZRG-Race-Series-9/10 (B),Favero Powermeter,Wahoo Kickr Core,370,369,1
7986,177987,2020-01-03 18:34:58,wahoo,Zwift - KIRCHMAIR New Year Race (A),Favero Powermeter,Wahoo Kickr Core,448,444,4
11324,177987,2020-01-28 18:01:58,wahoo,Zwift - ZRG Winter Race Series 3/10 - Keith Hill Afterparty (B),Favero Powermeter,Wahoo Kickr Core,395,387,8
11466,177987,2020-01-29 10:45:55,wahoo,Zwift - DIRT & IS: Baker&#039;s Dozen (B),Favero Powermeter,Wahoo Kickr Core,420,409,11
13405,177987,2020-02-11 18:01:59,wahoo,Zwift - ZRG Winter Race Series 5/10 - Dust in the Wind (B),Favero Powermeter,Wahoo Kickr Core,371,360,11
14074,177987,2020-02-15 14:00:03,wahoo,Zwift - ZSUN Base Builder 2 (C),Favero Powermeter,Wahoo Kickr Core,304,282,22
15443,177987,2020-02-24 18:03:02,wahoo,Zwift - SZR Evening Joyride (D),Favero Powermeter,Wahoo Kickr Core,218,208,10
16128,177987,2020-02-29 13:59:59,wahoo,Zwift - ZSUN Base Builder 2,Favero Assioma duo Powermeter,Wahoo Kickr Core,265,262,3
112232,522665,2021-02-10 00:56:49,wahoo,Zwift - Zwift Racing League | WTRL - Men&#039;s/Mixed AMERICAS E DIVISION 3 (A),2021-02-09-18-42-59,Wahoo Kickr Core,344,344,0
122994,610848,2021-03-02 18:38:58,wahoo,Zwift - Zwift Racing League | WTRL - Men&#039;s/Mixed EMEA E2 DIVISION 9 (B),Quarq DZero,Wahoo Kickr V5,325,316,9
10502,649278,2020-01-17 20:35:43,wahoo,Zwift - Sila na progu,Ronde,Wahoo Kickr Core,259,272,-13
10507,649278,2020-01-18 17:26:37,wahoo,Zwift - WOSP ZwiftTeamPL,Ronde,Wahoo Kickr Core,254,263,-9
15544,649278,2019-10-09 18:18:00,neo,Zwift - TeamPL CoffeeRide (B),Ronde,Neo,248,252,-4
15549,649278,2019-10-14 19:01:10,neo,Zwift - SweetSpot 3x16x90%,Ronde,Neo,219,226,-7
15556,649278,2019-10-17 18:03:16,neo,Zwift - TeamPL & Decathlon ride (C),Ronde,Neo,235,251,-16
15558,649278,2019-10-19 18:41:03,neo,Zwift - VO2max,Ronde,Neo,251,276,-25
15560,649278,2019-10-22 17:57:48,neo,Zwift - ZwiftTeamPL League  – Classic Series (B),Ronde,Neo,278,286,-8
15561,649278,2019-10-26 18:13:33,neo,Zwift - 3x10minFTP,Ronde,Neo,233,252,-19
15715,649278,2019-11-10 09:25:00,neo,Zwift - SweetSpot 1h*85%,Ronde,Neo,222,229,-7
15718,649278,2019-11-18 19:27:44,neo,Zwift - SweetSpot 2x20x90%,Ronde,Neo,228,235,-7
15719,649278,2019-11-19 18:59:06,neo,Zwift - ZwiftTeamPL League – Sprinters Series (B),Ronde,Neo,263,281,-18
16230,649278,2019-11-29 19:34:53,neo,Zwift - 3x10minFTP,Ronde,Neo,257,278,-21
18886,649278,2020-03-20 17:00:04,wahoo,Zwift - ZTPL.CC at Second Base (B),Ronde,Wahoo Kickr Core,223,235,-12
19590,649278,2020-03-24 18:34:55,wahoo,Zwift - ZTPL.CC Tour Stage 2 (E),Ronde,Wahoo Kickr Core,293,293,0
19616,649278,2020-03-25 19:19:38,wahoo,Zwift - ZTPL.CC CoffeeRide (B),Ronde,Wahoo Kickr Core,263,272,-9
19809,649278,2020-03-26 18:34:45,wahoo,ZTPL.CC Tour Stage 3,Ronde,Wahoo Kickr Core,280,287,-7
20046,649278,2020-03-27 16:59:57,wahoo,Zwift - ZTPL.CC at Second Base (B),Ronde,Wahoo Kickr Core,198,207,-9
20084,649278,2020-03-28 08:34:54,wahoo,Zwift - ZTPL.CC Tour Stage 4 (E),Ronde,Wahoo Kickr Core,258,259,-1
21252,649278,2020-03-31 17:34:56,wahoo,Zwift - ZTPL.CC Tour Stage 5 (E),Ronde,Wahoo Kickr Core,287,296,-9
21254,649278,2020-04-01 18:21:01,wahoo,Zwift - ZTPL.CC CoffeeRide (C),Ronde,Wahoo Kickr Core,227,236,-9
21473,649278,2020-04-02 17:35:02,wahoo,Zwift - ZTPL.CC Tour Stage 6 (E),Ronde,Wahoo Kickr Core,297,292,5
24681,649278,2020-04-14 17:34:55,wahoo,Zwift - ZTPLCCTour2020 Stage 2 (E),Ronde,Wahoo Kickr Core,300,299,1
25669,649278,2020-04-16 17:34:50,wahoo,Zwift - ZTPL.CC Tour2020 Stage 3 (E),Ronde,Wahoo Kickr Core,291,294,-3
25670,649278,2020-04-16 18:04:43,wahoo,Zwift - ZTPL.CC & Prawie.PRO Deca ride (C),Ronde,Wahoo Kickr Core,181,194,-13
25944,649278,2020-04-18 07:35:01,wahoo,Zwift - ZTPL.CC Tour2020 Stage 4 (E),Ronde,Wahoo Kickr Core,258,264,-6
26790,649278,2020-04-21 17:35:00,wahoo,Zwift - ZTPL.CC Tour2020 Stage 5 (E),Ronde,Wahoo Kickr Core,292,293,-1
27736,649278,2020-04-23 17:34:56,wahoo,Zwift - ZTPL.CC Tour2020 Stage 6 (E),Ronde,Wahoo Kickr Core,274,279,-5
76261,649278,2020-11-26 18:59:59,wahoo,Zwift - ZTPL.CC ITT League (E),Ronde,Wahoo Kickr Core,283,292,-9
76264,649278,2020-11-24 18:29:56,wahoo,Zwift - ZTPL.CC ITT League (E),Ronde,Wahoo Kickr Core,289,285,4
76265,649278,2020-11-21 09:00:20,wahoo,Zwift - ZTPL.CC ITT League (E),Ronde,Wahoo Kickr Core,285,281,4
77265,649278,2020-11-22 17:20:35,wahoo,Zwift - ZTPL.CC Coffee Ride (C),Ronde,Wahoo Kickr Core,276,276,0
110448,649278,2020-11-29 17:20:12,wahoo,Zwift - ZTPL.CC Coffee Ride (C),Ronde,Wahoo Kickr Core,276,286,-10
110451,649278,2020-11-30 19:11:50,wahoo,Zwift - Base (almost) 2h*60%,Ronde,Wahoo Kickr Core,175,164,11
110452,649278,2020-12-03 17:29:44,wahoo,Zwift - UCI Cycling Esports World Championships Recon Ride - Poland,Ronde,Wahoo Kickr Core,283,279,4
110454,649278,2020-12-04 19:20:28,wahoo,Zwift - SweetSpot 4x15x90%,Ronde,Wahoo Kickr Core,250,240,10
110460,649278,2020-12-06 16:36:09,wahoo,Zwift - Nations Challenge // Poland (E),Ronde,Wahoo Kickr Core,265,276,-11
110462,649278,2020-12-11 17:45:17,wahoo,Zwift - ZTPL.CC & Way2Champ TRENING 06,Ronde,Wahoo Kickr Core,269,262,7
110465,649278,2020-12-13 17:20:28,wahoo,Zwift - ZTPL.CC Coffee Ride (C),Ronde,Wahoo Kickr Core,278,287,-9
118355,649278,2021-02-20 17:02:42,wahoo,Zwift - ZTPL.CC Winter League 2021 Stage 10 (B),Ronde,Wahoo Kickr Core,282,265,17
22829,637915,2020-04-07 18:39:58,wahoo,Zwift - 3R Spring Loaded Race Series - Round 2of6 (A),Power2Max,Kickr,359,350,9
32817,336198,2020-05-08 21:05:47,wahoo,Zwift - Watopia,Garmin/Stages,Kickr/zwift,166,163,3
34493,336198,2020-05-13 20:36:39,wahoo,Zwift - Bullseye Points Race Event 6 by Herd Racing League (B),Stages,kickr,274,277,-3
36490,336198,2020-05-20 22:32:19,wahoo,Zwift - Bullseye Points Race Event 7 by Herd Racing League (B),Stages,kickr,271,274,-3
98022,641900,2021-01-16 14:02:40,wahoo,Zwift - TDZ Stage 3: Alpe du Zwift,6116923046_ACTIVITY,Wahoo Kickr,234,235,-1
100568,641900,2021-01-21 00:48:22,wahoo,Cycling Canada Wednesday Night Race Series,Power2Max NGEco,Wahoo Kickr,270,268,2
13000,281872,2020-02-08 11:36:39,wahoo,Zwift - Richmond UCI reverse x2 - no drop outs....,Power tap p2 pedals,Kickr Core,198,197,1
13926,281872,2020-02-14 06:15:20,wahoo,Zwift - 3R SPARK Interval Ride [~2.2-2.8 w/kg avg] (C),Power tap p2 pedals,Kickr Core,168,170,-2
27577,281872,2020-04-24 11:08:50,wahoo,Zwift - NYC assioma testing :-),Assioma pedals,Kickr Core,182,186,-4
27789,281872,2020-04-25 06:31:59,wahoo,Zwift - Watopia Cup Race // Zwift Classic (C),Assioma pedals,Kickr Core,217,221,-4
28187,281872,2020-04-26 08:09:53,wahoo,Zwift - BRT Breakfast Club (B),Assioma pedals,Kickr Core,227,229,-2
28383,281872,2020-04-27 04:59:58,wahoo,Zwift - 3R VOLT Interval Ride [~2.6-3.2 w/kg avg] (C),Assioma pedals,Kickr Core,168,173,-5
29001,281872,2020-04-29 11:00:02,wahoo,Zwift - Yorkshire assioma duo love fest,Assioma pedals,Kickr Core,187,188,-1
30033,281872,2020-05-01 10:30:00,wahoo,Zwift - European Lunch Ride  (E) - tempo with 1 min power efforts up leg snapper!,Assioma pedals,Kickr Core,220,224,-4
33191,281872,2020-05-10 07:34:46,wahoo,Zwift - Watopia - 3 Sisters and 3 Little Sisters,Assioma pedals,Kickr Core,220,219,1
33786,281872,2020-05-12 04:59:57,wahoo,Zwift - 3R VOLT Interval Ride [~2.6-3.2 w/kg avg] (C),Assioma pedals,Kickr Core,207,209,-2
35560,281872,2020-05-17 07:59:59,wahoo,Zwift - Tour for All 2020: Stage 4 Longer Ride 34/837 - Alpe PB 46:50!!,Assioma pedals,Kickr Core,236,235,1
38477,281872,2020-05-29 05:04:00,wahoo,Zwift - 3R SPARK v&#039;s VOLT v&#039;s Octane Chase Race,Assioma pedals,Kickr Core,202,205,-3
44776,281872,2020-07-04 04:59:56,wahoo,Zwift - L&#039;Etape du Tour Stage 1 - Women Only 4th,Assioma pedals,Kickr Core,238,234,4
45749,281872,2020-07-10 07:28:49,wahoo,Zwift - London more z1,Assioma pedals,Kickr Core,144,144,0
55481,281872,2020-09-16 04:59:35,wahoo,Zwift - 3R VOLT Interval Ride [~2.6-3.2 w/kg avg] (C),Assioma pedals,Kickr Core,188,188,0
56069,281872,2020-09-18 05:01:55,wahoo,Zwift -  Stage 1 // Virtual Haute Route Ventoux  (B),Assioma pedals,Kickr Core,227,227,0
59363,281872,2020-10-04 06:29:53,wahoo,Zwift - LEQP Provence Badge Hunter Series (C),Assioma pedals,Kickr Core,224,221,3
73359,281872,2020-11-20 04:59:59,wahoo,Zwift - Watopia Dawn Patrol (C),Assioma pedals,Kickr Core,193,197,-4
84656,281872,2020-12-18 11:02:07,wahoo,Zwift - Tour of New York Stage 1 - Women Only,Assioma pedals,Kickr Core,217,220,-3
101735,281872,2021-01-23 10:00:15,wahoo,Zwift - Watopia,Assioma pedals,Kickr Core,125,124,1
15455,411062,2020-02-24 18:15:00,wahoo,Zwift - DBR Winter Cup (A),Vector 3S,kickr core,336,334,2
23219,411062,2020-04-09 11:14:40,wahoo,Zwift - 3R Classique Flat Race - 4 Laps (26.9km/16.7mi 76m) (A),Vector 3S,kickr core,334,340,-6
39978,411062,2020-06-06 08:28:56,wahoo,Zwift - DBR Sufferday League (A),Vector 3S,kickr core,352,344,8
65911,650245,2020-10-28 20:27:17,wahoo,Zwift - Watopia - Three Sisters Test,Quarq Dzero,Wahoo Kickr v5,461,459,2
66243,650245,2020-10-29 18:24:48,wahoo,Zwift - WTRL Team Time Trial Platinum League (C),Quarq Dzero,Wahoo Kickr v5,459,457,2
67266,650245,2020-11-02 19:12:41,wahoo,Zwift - Premier Division // Zwift Racing League (men) (A),Quarq Dzero,Wahoo Kickr v5,438,437,1
68232,650245,2020-11-04 18:59:47,wahoo,Zwift - DCU – Feltet.dk November series,Quarq Dzero,Wahoo Kickr v5,487,483,4
68233,650245,2020-11-05 18:53:13,wahoo,Zwift - Espresso,Quarq Dzero,Wahoo Kickr v5,437,433,4
69508,650245,2020-11-09 19:59:35,wahoo,Zwift - Premier Division // Zwift Racing League (men) (A),Quarq Dzero,Wahoo Kickr v5,486,488,-2
73176,650245,2020-11-16 19:08:26,wahoo,Zwift - Premier Division // Zwift Racing League (men) (A),Quarq Dzero,Wahoo Kickr v5,447,447,0
74699,650245,2020-11-23 19:59:20,wahoo,Zwift - Premier Division // Zwift Racing League (men) (A),Quarq Dzero,Wahoo Kickr v5,476,473,3
76521,650245,2020-11-26 18:43:28,wahoo,Zwift - WTRL NOPINZ WORLD TTT CHAMPIONSHIPS - Zone 6 (C),Quarq Dzero,Wahoo Kickr 2018,448,443,5
77740,650245,2020-11-30 19:13:26,wahoo,Zwift - Premier Division // Zwift Racing League (men) (A),Quarq Dzero,Wahoo Kickr v5,444,442,2
93793,650245,2021-01-09 09:29:45,wahoo,Zwift - DBR SufferDay League III (A),Quarq Dzero,Wahoo Kickr v5,459,452,7
95080,650245,2021-01-11 19:14:29,wahoo,Zwift - Premier Division // Zwift Racing League (men) (A),Quarq Dzero,Wahoo Kickr v5,408,403,5
97116,650245,2021-01-14 18:29:38,wahoo,Zwift - FUSION WINTER CUP (A),Quarq Dzero,Wahoo Kickr v5,446,444,2
97933,650245,2021-01-16 09:29:43,wahoo,Zwift - DBR SufferDay League III (A),Quarq Dzero,Wahoo Kickr v5,464,464,0
99282,650245,2021-01-18 19:43:33,wahoo,Zwift - Premier Division // Zwift Racing League (men) (A),Quarq Dzero,Wahoo Kickr v5,453,458,-5
100424,650245,2021-01-20 18:44:27,wahoo,Zwift - Danmarks Cykle Union & Partners 2/6 (A),Quarq Dzero,Wahoo Kickr v5,441,438,3
101042,650245,2021-01-21 18:29:31,wahoo,FUSION WINTER CUP // victory,Quarq Dzero,Wahoo Kickr v5,419,417,2
103018,650245,2021-01-25 19:04:29,wahoo,Zwift - Premier Division // Zwift Racing League (men) (A),Quarq Dzero,Wahoo Kickr v5,459,453,6
104264,650245,2021-01-27 18:44:33,wahoo,Zwift - Danmarks Cykle Union & Partners 3/6 (A),Quarq Dzero,Wahoo Kickr v5,442,440,2
104786,650245,2021-01-28 18:29:35,wahoo,Zwift - FUSION WINTER CUP (A),Quarq Dzero,Wahoo Kickr v5,447,441,6
106952,650245,2021-02-01 20:06:37,wahoo,Zwift - Premier Division // Zwift Racing League (men) (A),Quarq Dzero,Wahoo Kickr v5,412,407,5
108371,650245,2021-02-03 18:44:53,wahoo,Zwift - Danmarks Cykle Union & Partners 4/6 (A),Quarq Dzero,Wahoo Kickr v5,431,420,11
110567,650245,2021-02-07 14:14:43,wahoo,Zwift - KISS 100 Race Series - Americas (A),Quarq Dzero,Wahoo Kickr v5,465,452,13
111065,650245,2021-02-08 19:24:00,wahoo,Zwift - Premier Division // Zwift Racing League (men) (A),Quarq Dzero,Wahoo Kickr v5,452,451,1
112294,650245,2021-02-10 18:44:48,wahoo,Zwift - Danmarks Cykle Union & Partners 5/6 (A),Quarq Dzero,Wahoo Kickr v5,457,456,1
115397,650245,2021-02-15 20:01:45,wahoo,Zwift - Premier Division // Zwift Racing League (men) (A),Quarq Dzero,Wahoo Kickr v5,468,455,13
116740,650245,2021-02-17 18:44:53,wahoo,Zwift - Danmarks Cykle Union & Partners 6/6 (A),Quarq Dzero,Wahoo Kickr v5,405,405,0
122622,650245,2021-03-01 20:21:04,wahoo,Zwift - Premier Division // Zwift Racing League (men) (A),Quarq Dzero,Wahoo Kickr v5,428,429,-1
125437,650245,2021-03-07 15:30:14,wahoo,Zwift - Absa Cape Epic Stage 1 pb Oakley - Open (A),Quarq Dzero,Wahoo Kickr v5,444,426,18
125438,650245,2021-03-07 16:00:00,wahoo,Zwift - 3R Super Six Sunday Race (A),Quarq Dzero,Wahoo Kickr v5,449,432,17
129194,650245,2021-03-16 18:29:49,wahoo,Zwift - CeramicSpeed Race Series: Open Race (A),Quarq Dzero,Wahoo Kickr v5,466,442,24
57253,244714,2020-09-24 17:04:22,neo,Zwift - Espresso,Zwift,Tacx Neo,338,340,-2
57478,244714,2020-09-25 12:49:18,neo,Zwift - KISS at Race - Pacific AM (A),Zwift,Tacx Neo,392,383,9
58787,244714,2020-10-01 15:44:50,neo,Zwift - Mikkeller and Friends Race (A),Zwift,Tacx Neo,392,371,21
59057,244714,2020-10-02 12:49:53,neo,Stages / Tacx Neo,Stages,Tacx Neo,346,331,15
59451,244714,2020-10-04 16:20:00,neo,Stages of DIRT,Power Tap P1,Tacx Neo,381,349,32
59854,244714,2020-10-06 17:54:47,neo,Stages / Tacx Neo,Stages,Tacx Neo,339,334,5
59857,244714,2020-10-06 18:33:47,neo,P1 - Neo test,Power Tap P1,Tacx Neo,250,235,15
60799,244714,2020-10-10 14:07:53,neo,Stages / Tacx Neo,Stages,Tacx Neo,239,222,17
66269,244714,2020-10-29 21:43:59,neo,Power comparison test,Stages,Tacx Neo,362,346,16
67066,244714,2020-11-01 18:58:45,neo,Power Tap P1 / Tacx Neo,Power Tap P1,Tacx Neo,332,338,-6
67405,244714,2020-11-02 23:32:23,neo,3R 50km LONDON-Greater London Flat Race (52km/32.4mi),Power Tap P1,Tacx Neo,357,351,6
68394,244714,2020-11-05 22:14:22,neo,Power Tap P1 / Tacx Neo,Power Tap P1,Tacx Neo,326,331,-5
68396,244714,2020-11-05 01:00:47,neo,Power Tap P1 / Tacx Neo,Power Tap P1,Tacx Neo,339,338,1
69988,244714,2020-11-10 19:39:47,neo,Zwift Racing League | WTRL - EMEA W1 (MEN) -  Division 1,Power Tap P1,Tacx Neo,405,406,-1
72432,244714,2020-11-16 23:35:16,neo,Power Tap P1 / Tacx Neo,Power Tap P1,Tacx Neo,359,355,4
74790,244714,2020-11-23 23:35:14,neo,Power Tap P1 / Tacx Neo,Power Tap P1,Tacx Neo,360,349,11
77826,244714,2020-11-30 23:29:29,neo,Power Tap P1 / Tacx Neo,Power Tap P1,Tacx Neo,389,375,14
84146,244714,2020-12-17 01:04:53,neo,Zwift - Cycling Canada Wednesday Night Race Series (A),Power Tap P1,Tacx Neo,379,376,3
85629,244714,2020-12-21 01:25:11,neo,Power Tap P1 / Tacx Neo,Power Tap P1,Tacx Neo,252,253,-1
87044,244714,2020-12-24 18:27:38,neo,Three Sisters Test,Power Tap P1,Tacx Neo,356,358,-2
91675,244714,2021-01-04 19:16:23,neo,Zwift - Team TFC Mad Monday Winter Series (A),Power Tap P1,Tacx Neo,361,353,8
92482,244714,2021-01-06 21:26:53,neo,Tacx Neo / Power Tap P1,Power Tap P1,Tacx Neo,304,310,-6
92742,244714,2021-01-07 16:07:31,neo,Power Tap P1 / Tacx Neo,Power Tap P1,Tacx Neo,383,388,-5
95979,244714,2021-01-13 00:30:55,neo,Zwift - Zwift Racing League | WTRL - Men&#039;s/Mixed AMERICAS E DIVISION 4 (A),Power Tap P1,Tacx Neo,341,345,-4
98563,244714,2021-01-17 14:07:05,neo,Power Tap P1 / Tacx Neo,Power Tap P1,Tacx Neo,337,338,-1
99991,244714,2021-01-20 00:56:21,neo,Power Tap P1 / Tacx Neo,Power Tap P1,Tacx Neo,345,344,1
103804,244714,2021-01-27 00:44:33,neo,Tacx Neo,Power Tap P1,Tacx Neo,359,356,3
107702,244714,2021-02-03 00:48:09,neo,Power Tap P1 / Tacx Neo,Power Tap P1,Tacx Neo,364,361,3
111888,244714,2021-02-10 00:53:52,neo,Power Tap P1 / Tacx Neo,Power Tap P1,Tacx Neo,376,376,0
114436,244714,2021-02-11 23:13:35,neo,Power Tap P1 / Tacx Neo,Power Tap P1,Tacx Neo,328,328,0
119938,244714,2021-02-24 00:48:10,neo,Power Tap P1 / Tacx Neo,Power Tap P1,Tacx Neo,369,366,3
120954,244714,2021-02-25 23:12:05,neo,Koa Sports League Warrior Race,Power Tap P1,Tacx Neo,383,380,3
122422,244714,2021-03-01 18:12:48,neo,Tacx Neo / Power Tap P1,Power Tap P1,Tacx Neo,333,333,0
122713,244714,2021-03-01 23:33:10,neo,Power Tap P1 / Tacx Neo,Power Tap P1,Tacx Neo,377,370,7
123254,244714,2021-03-03 00:53:19,neo,Power Tap P1 / Tacx Neo,Power Tap P1,Tacx Neo,352,351,1
125007,244714,2021-03-06 15:14:03,neo,Power Tap P1 / Tacx Neo,Power Tap P1,Tacx Neo,361,360,1
128434,244714,2021-03-14 16:26:59,neo,Power Tap P1 / Tacx Neo,Power Tap P1,Tacx Neo,368,367,1
129423,244714,2021-03-16 22:29:26,neo,SweatFest Fall/Winter Series 2020/21,Power Tap P1,Tacx Neo,354,355,-1
129424,244714,2021-03-16 23:28:15,neo,Power Tap P1 / Tacx Neo,Power Tap P1,Tacx Neo,339,335,4
14964,210530,2020-02-20 19:00:59,neo,Zwift - KALAS Cup - Round 4 (B),Garmin Vector S,Tacx NEO,303,314,-11
111436,178637,2021-02-08 17:25:54,neo,Zwift -  SCF SWE Cup Men (B),Stages Gen 2 - Left Side / Garmin 520,Tacx Neo,349,349,0
126100,178637,2021-03-08 17:27:58,neo,Zwift -  SCF SWE Cup Men (B),Stages Gen 2,Tacx Neo,347,341,6
317,230573,2019-08-16 12:07:25,neo,Assioma / Neo,Assioma,Neo,269,256,13
1806,230573,2019-09-14 06:45:16,neo,Zwift - 3R 160 Steady Ride [~3.0w/kg avg] (B),Assioma,Neo,283,278,5
7238,230573,2019-12-25 10:46:44,neo,Zwift - KISS at Base Training Ride (B),Assioma,Neo,296,282,14
7957,230573,2020-01-03 12:42:49,neo,Neo / Assioma,Assioma,Neo,286,267,19
8572,230573,2020-01-08 17:07:27,neo,Assioma / Neo,Assioma,Neo,302,300,2
17065,230573,2020-03-06 13:14:58,neo,Neo / Assioma,Assioma,Neo,272,276,-4
53084,230573,2020-09-02 16:59:35,neo,Zwift -  Cycling Weekly Club Ten (E),Assioma,Neo,364,337,27
53089,230573,2020-09-02 15:45:07,neo,Zwift - INC Steady State 45min - Group Training Ride 2.5 - 3.0w/kg Average (C),X-Power,Neo,285,265,20
60080,230573,2020-10-07 16:57:54,wahoo,Zwift - MIDWEEK Autumn Series by SZR (A),Assioma DUO,Wahoo Kickr 5,350,349,1
60771,230573,2020-10-10 08:29:25,wahoo,Zwift - DBR SufferDay League II (A),Assioma DUO,Wahoo Kickr 5,323,325,-2
61191,230573,2020-10-12 16:40:10,wahoo,Zwift - Watopia,Assioma DUO,Wahoo Kickr 5,302,290,12
63529,230573,2020-10-20 17:16:52,wahoo,Zwift Racing League | WTRL - EMEA E (MEN) - TTT Grp 1,X-Power,Wahoo Kickr 5,379,365,14
67467,230573,2020-11-02 18:06:27,wahoo,Zwift - Innsbruck,Assioma DUO,Wahoo Kickr 5,299,299,0
67808,230573,2020-11-03 18:03:19,wahoo,Zwift - Zwift Racing League | WTRL - Men&#039;s EMEA E1 DIVISION 1 (A),Assioma DUO,Wahoo Kickr 5,386,402,-16
72440,230573,2020-11-17 18:20:31,wahoo,Zwift - Zwift Racing League | WTRL - Men&#039;s EMEA E1 DIVISION 1 (A),Assioma DUO,Wahoo Kickr 5,392,388,4
91227,230573,2021-01-04 14:07:31,wahoo,Zwift - Watopia,X-Power,Wahoo Kickr 5,378,380,-2
93240,230573,2021-01-08 10:23:42,wahoo,Zwift - DIRT Friday Morning Sprintapalooza (C),Assioma DUO,Wahoo Kickr 5,274,267,7
93686,230573,2021-01-09 07:28:02,wahoo,Zwift - 3R 100 Steady Ride [~2.5w/kg avg] (C),Assioma DUO,Wahoo Kickr 5,295,288,7
95656,230573,2021-01-12 18:24:52,wahoo,Zwift - Zwift Racing League | WTRL - Men&#039;s/Mixed EMEA E2 DIVISION 5 (A),Assioma DUO,Wahoo Kickr 5,387,359,28
96161,230573,2021-01-13 09:24:25,wahoo,Zwift - Watopia,X-Power,Wahoo Kickr 5,401,387,14
99743,230573,2021-01-19 18:23:53,wahoo,Zwift - Zwift Racing League | WTRL - Men&#039;s/Mixed EMEA E2 DIVISION 5 (A),Assioma DUO,Wahoo Kickr 5,388,389,-1
103506,230573,2021-01-26 18:26:05,wahoo,Zwift - Zwift Racing League | WTRL - Men&#039;s/Mixed EMEA E2 DIVISION 5 (A),Assioma DUO,Wahoo Kickr 5,408,417,-9
104676,230573,2021-01-28 17:49:06,wahoo,Zwift - WTRL Team Time Trial - Zone 4 (D),Assioma DUO,Wahoo Kickr 5,353,361,-8
105039,230573,2021-01-29 10:51:31,wahoo,Zwift - KISS at Base Training Ride (C),X-Power,Wahoo Kickr 5,268,262,6
105408,230573,2021-01-30 07:28:55,wahoo,Zwift - 3R 100 Steady Ride [~2.5w/kg avg] (C),X-Power,Wahoo Kickr 5,298,290,8
107351,230573,2021-02-02 18:22:41,wahoo,Zwift - Zwift Racing League | WTRL - Men&#039;s/Mixed EMEA E2 DIVISION 5 (A),Assioma DUO,Wahoo Kickr 5,420,410,10
107993,230573,2021-02-03 10:51:35,wahoo,Zwift - KISS at Base Training Ride (C),Assioma DUO,Wahoo Kickr 5,356,345,11
111576,230573,2021-02-09 18:19:58,wahoo,Zwift - Zwift Racing League | WTRL - Men&#039;s/Mixed EMEA E2 DIVISION 5 (A),Assioma DUO,Wahoo Kickr 5,388,402,-14
115967,230573,2021-02-16 18:25:19,wahoo,Zwift - Zwift Racing League | WTRL - Men&#039;s/Mixed EMEA E2 DIVISION 5 (A),Assioma DUO,Wahoo Kickr 5,414,418,-4
117264,230573,2021-02-18 18:17:31,wahoo,Zwift - Frappe,Assioma DUO,Wahoo Kickr 5,392,396,-4
122947,230573,2021-03-02 18:24:21,wahoo,Zwift - Zwift Racing League | WTRL - Men&#039;s/Mixed EMEA E2 DIVISION 1 (A),Assioma DUO,Wahoo Kickr 5,397,401,-4
129192,230573,2021-03-16 18:26:23,wahoo,Zwift - CeramicSpeed Race Series: Open Race (A),Assioma DUO,Wahoo Kickr 5,461,468,-7
103644,509257,2021-01-26 18:26:00,neo,Zwift - Zwift Racing League | WTRL - Men&#039;s/Mixed EMEA E2 DIVISION 3 (A),Rotor Inspider,Taxc Neo 1,455,425,30
107519,509257,2021-01-26 18:26:00,neo,Zwift - Zwift Racing League | WTRL - Men&#039;s/Mixed EMEA E2 DIVISION 3 (A),Rotor Inspider,Taxc Neo 1,455,477,-22
65674,667753,2020-10-27 18:55:16,wahoo,Zwift - Team Italy & Frenchy Fuzion League (A),Stages ,Kickr Core ,346,344,2
67962,667753,2020-11-04 10:29:35,wahoo,Zwift - USA Cycling Race League by Indoor Specialist (A),Stages,Kickr Core ,362,361,1
68077,667753,2020-11-05 07:50:35,wahoo,Zwift - Cycling Australia&#039;s The Chop by AHDR (A),Stages ,Kickr Core ,380,367,13
70613,667753,2020-11-12 10:04:04,wahoo,Zwift - 3R Whole Lotta Lava Hilly Race - 1 Lap (16.9km/10.5mi 183m) (A),Stages ,Kickr Core ,388,393,-5
75511,667753,2020-11-25 10:44:10,wahoo,Zwift - USA Cycling Race League by Indoor Specialist (A),Stages ,Kickr Core ,373,374,-1
48432,668086,2020-07-31 13:34:49,wahoo,Zwift - Crit City Race (A),Stages LR,Wahoo Kickr,345,346,-1
107740,60464,2021-02-03 00:50:00,wahoo,Zwift - Zwift Racing League | WTRL - Men&#039;s/Mixed AMERICAS E DIVISION 4 (B),PowerTap P2,Kickr Core,288,295,-7
111909,60464,2021-02-09 23:45:32,wahoo,Zwift - Chase the Break - :57 Minutes,PowerTap P2,Kickr Core,272,280,-8
46909,646053,2020-07-15 09:00:58,wahoo,Zwift - Virtual Tour de France - Open - Stage 3 Discovery Ride,Favero Assioma,Kickr,296,280,16
62805,668342,2020-10-18 08:29:50,wahoo,Zwift - 3R Watopia Road To Sky - 1 Lap (A),4iiii,wahoo kickr core,372,359,13
65541,668342,2020-10-27 19:44:49,wahoo,Zwift - Zwift Racing League | WTRL - EMEA W (MEN) -  Division 1 (A),4iiii,wahoo kickr core,398,431,-33
75695,668342,2020-11-25 20:33:16,wahoo,Zwift - Tri Aus TT (E),4iiii,wahoo kickr core,317,317,0
81766,668342,2020-12-10 19:20:01,wahoo,Zwift - Jonathan  Caulfield(IRL)&#039;s Meetup - Tempus Fugit,4iiii,wahoo kickr core,311,312,-1
87620,668342,2020-12-26 20:05:06,wahoo,Zwift - 3R Flat Race (A),4iiii,wahoo kickr core,364,364,0
90427,668342,2021-01-02 17:29:51,wahoo,Zwift - ZHQ FutureWorks Circuit Race - Anti-sandbagging (A),4iiii,wahoo kickr core,369,368,1
92989,668342,2021-01-07 18:28:07,wahoo,Zwift - FUSION WINTER CUP (A),4iiii,wahoo kickr core,370,371,-1
93725,668342,2021-01-09 09:59:06,wahoo,Zwift - Cycling Ireland Zwift League Rd 7 (A),4iiii,wahoo kickr core,390,393,-3
95238,668342,2021-01-11 20:58:46,wahoo,Zwift - TDZ Stage 2: Longer Ride,4iiii,wahoo kickr core,356,357,-1
97823,668342,2021-01-16 10:00:20,wahoo,Zwift - Cycling Ireland Zwift League Rd 8 (A),4iiii,wahoo kickr core,357,357,0
104708,668342,2021-01-28 18:45:15,wahoo,Zwift - XRS - ZTR Thursday Night Race (A),4iiii,wahoo kickr core,393,395,-2
105542,668342,2021-01-30 10:59:06,wahoo,Zwift - TDZ Stage 6: Longer Ride,4iiii,wahoo kickr core,368,370,-2
106823,668342,2021-02-01 19:01:01,wahoo,Zwift - TDZ Stage 6: Standard Ride,4iiii,wahoo kickr core,347,350,-3
108398,668342,2021-02-03 18:01:33,wahoo,Zwift - Cycling Weekly Club 10 (D),4iiii,wahoo kickr core,361,361,0
108914,668342,2021-02-04 18:44:05,wahoo,Zwift - XRS - ZTR Thursday Night Race (A),4iiii,wahoo kickr core,400,399,1
109721,668342,2021-02-06 10:08:59,wahoo,Zwift - Cycling Ireland Spring Australian Handicap Race (A),4iiii,wahoo kickr core,375,366,9
113084,668342,2021-02-11 19:59:01,wahoo,Zwift - KISS Race Series - EU PM (A),4iiii,Wahoo Kickr Core (PRIMARY),379,378,1
117227,668342,2021-02-18 17:59:02,wahoo,Zwift - Renegade Race (A),4iiii,Wahoo Kickr Core (PRIMARY),375,371,4
119314,668342,2021-02-22 20:34:51,wahoo,Zwift - Tri Aus TT (E),4iiii,Wahoo Kickr Core (PRIMARY),311,310,1
120927,668342,2021-02-25 18:19:28,wahoo,Zwift - III Liga ZESP - Etapa 3 (A),4iiii,Wahoo Kickr Core (PRIMARY),368,368,0
124042,668342,2021-03-04 17:58:39,wahoo,Zwift - Renegade Race (A),4iiii,Wahoo Kickr Core (PRIMARY),374,368,6
124846,668342,2021-03-06 09:59:51,wahoo,Zwift - Cycling Ireland eRacing Spring League Rd 2 (A),4iiii,Wahoo Kickr Core (PRIMARY),369,367,2
125841,668342,2021-03-08 19:29:01,wahoo,Zwift - Aero Army Wyn TT Series (A),4iiii,Wahoo Kickr Core (PRIMARY),393,389,4
127115,668342,2021-03-11 17:58:54,wahoo,Zwift - Renegade Race (A),4iiii,Wahoo Kickr Core (PRIMARY),365,365,0
127823,668342,2021-03-13 09:59:41,wahoo,Zwift - Cycling Ireland eRacing Spring League Rd 3 (A),4iiii,Wahoo Kickr Core (PRIMARY),415,416,-1
58663,340855,2020-09-29 17:50:19,wahoo,Zwift - Team CLS This &#039;n&#039; That Training Camp Build Phase (B),Stages Power Meter,Wahoo Kickr 2016,226,219,7
60663,340855,2020-10-09 22:12:43,wahoo,3 Sisters Verification Take 2,Stages Power Meter,Wahoo Kickr 2016,241,239,2
61216,340855,2020-10-12 17:44:58,wahoo,Zwift - Premier Division // Zwift Racing League (women) (A),Stages Power Meter,Wahoo Kickr 2016,252,251,1
63206,340855,2020-10-19 19:01:59,wahoo,Zwift - Premier Division // Zwift Racing League (women) (A),Stages Power Meter,Wahoo Kickr 2016,241,238,3
65111,340855,2020-10-26 19:04:59,wahoo,Zwift - Premier Division // Zwift Racing League (women) ,Stages Power Meter,Wahoo Kickr 2016,251,249,2
69422,340855,2020-11-09 19:04:56,wahoo,Zwift - Premier Division // Zwift Racing League (women) (A),Stages Power Meter,Wahoo Kickr 2016,255,258,-3
74660,340855,2020-11-23 18:54:58,wahoo,Zwift - Premier Division // Zwift Racing League (women) (A),Stages Power Meter,Wahoo Kickr 2016,258,269,-11
95100,340855,2021-01-11 20:07:01,wahoo,Zwift - Premier Division // Zwift Racing League (women) (A),Stages Power Meter,Wahoo Kickr 2016,262,260,2
6018,660836,2019-12-11 19:05:00,wahoo,Zwift - DBR HEINO CUP (A),Stages ,Kickr ,423,420,3
10682,660836,2020-01-23 19:14:55,wahoo,Tour de Zwift // Pro-Am Invitational,Quark,Kickr ,455,459,-4
11879,660836,2020-01-31 19:14:59,wahoo,Tour de Zwift // Pro-Am Invitational,Quark,Kickr ,418,431,-13
17436,660836,2020-03-10 09:20:01,wahoo,Eat The Pain Race,Quark Red Axs,Kickr ,423,424,-1
18450,660836,2020-03-17 19:15:01,wahoo,Feltet.dk Race Series,Quark Red Axs,Kickr ,433,434,-1
18908,660836,2020-03-20 19:14:59,wahoo,Tour of Watopia Pro-Am Mens Race #2,Quark Red Axs,Kickr ,399,401,-2
19497,660836,2020-03-24 19:15:01,wahoo,Zwift - Tour of Watopia Pro-Am Men&#039;s Race #3 (A),Quark Red Axs,Kickr ,380,380,0
22176,660836,2020-04-05 09:00:01,wahoo,Ronde van Zwift,Quark Red Axs,Kickr ,435,434,1
23359,660836,2020-04-09 18:10:02,wahoo,London International // Zwift Classic,Quark Red Axs,Kickr ,444,446,-2
25611,660836,2020-04-17 18:11:01,wahoo,Richmond Challenge // Zwift Classic,Quark Red Axs,Kickr ,430,429,1
28026,660836,2020-04-25 18:10:01,wahoo,Crit City Slam // Zwift Classic,Quark Red Axs,Kickr ,444,442,2
49955,660836,2020-08-14 08:49:54,wahoo,Off the MAAP Invitational Race // Stage 1 (Men),Quark Red Axs,Kickr ,375,362,13
50352,660836,2020-08-17 09:49:48,wahoo,Zwift - Off the MAAP Invitational Race // Stage 2 (Men) (A),2020-08-17-094948-ELEMNT_BOLT_19DD-133-0,Kickr ,394,391,3
50836,660836,2020-08-20 08:49:54,wahoo,Zwift - Off the MAAP Invitational Race // Stage 3 (men) ,Quark Red Axs,Kickr ,383,383,0
51463,660836,2020-08-24 09:34:55,wahoo,Zwift - Off the MAAP Invitational Race // Stage 4 (men) ,Quark Red Axs,Kickr ,389,379,10
55032,660836,2020-09-14 17:59:57,wahoo,Zwift - Invitational League // Qualifying Race #1,Quark Red Axs,Kickr ,384,381,3
56427,660836,2020-09-20 12:59:56,wahoo,Zwift - Invitational League // Qualifying Race #3 (Men) (A),Quark Red Axs,Kickr ,381,379,2
63130,660836,2020-10-19 18:20:53,wahoo,Zwift - Premier Division // Zwift Racing League (men) (A),2020-10-19-182053-ELEMNT_BOLT_19DD-201-0,Kickr ,366,369,-3
112417,660836,2021-02-10 18:59:58,wahoo,Zwift - Movistar Team Challenge // Round 1 (A),Quark Red Axs,Kickr ,386,387,-1
55671,372523,2020-09-17 04:45:02,wahoo,Zwift - EVO CC Flux Ride [1.5 - 2.0w/kg avg] (D),Zwift,2020-09-17-044503-EVO on KICKR B221-154-0,128,132,-4
55672,372523,2020-09-17 04:00:02,wahoo,Zwift - Vikings Valhalla Fatburn Ride (D),Zwift,2020-09-17-040610-Valhalla on KICKR B221-153-0,138,142,-4
56778,372523,2020-09-22 09:00:14,neo,Zwift - 3R Crank It Up Ladies Race Series  (A),Favero assioma duo,Tacx Neo,197,199,-2
57379,372523,2020-09-25 00:46:15,neo,Zwift - Crit City Race (B),Favero assioma duo,Tacx Neo,231,230,1
58197,372523,2020-09-29 09:00:16,neo,Zwift - 3R Crank It Up Ladies Race Series  (A),Favero assioma duo,Tacx Neo,236,242,-6
58868,372523,2020-10-01 18:08:00,neo,Zwift - Vienna,Favero assioma duo,Tacx Neo,226,223,3
59738,372523,2020-10-06 09:00:19,neo,Zwift - 3R Crank It Up Ladies Race Series - iTT (A),Favero assioma duo,Tacx Neo,232,235,-3
62335,372523,2020-10-15 23:46:05,neo,Zwift - Crit City Race (B),Favero assioma duo,Tacx Neo,221,222,-1
63705,372523,2020-10-21 06:15:16,neo,Zwift - 3R Innsbruckring Flat Race - 3 Laps (26.4km/16.4mi 231m) (B),Favero assioma duo,Tacx Neo,219,222,-3
64516,372523,2020-10-23 23:46:15,neo,Zwift - Crit City Race (B),Favero assioma duo,Tacx Neo,215,220,-5
65979,372523,2020-10-29 08:17:23,neo,Zwift - Cycling Australia&#039;s The Chop by AHDR (B),Favero assioma duo,Tacx Neo,215,216,-1
68027,372523,2020-11-05 08:17:17,neo,Zwift - Cycling Australia&#039;s The Chop by AHDR (B),Favero assioma duo,Tacx Neo,211,216,-5
72072,372523,2020-11-17 10:00:47,neo,Zwift - Zwift Time Trial Tuesday: Bologna (E),Favero assioma duo,Tacx Neo,237,245,-8
72874,372523,2020-11-19 08:17:20,neo,Zwift - Cycling Australia&#039;s The Chop by AHDR (B),Favero assioma duo,Tacx Neo,206,210,-4
74056,372523,2020-11-21 22:04:15,neo,Zwift - Watopia,Favero assioma duo,Tacx Neo,240,244,-4
76147,372523,2020-11-26 18:32:13,neo,Zwift - WTRL NOPINZ WORLD TTT CHAMPIONSHIPS - Zone 6 (E),Favero assioma duo,Tacx Neo,235,236,-1
77828,372523,2020-12-01 00:10:59,wahoo,Zwift - Watopia,Favero assioma duo,Wahoo Kickr,149,147,2
80593,372523,2020-12-08 00:46:12,wahoo,Zwift - Crit City Race (B),Favero assioma duo,Wahoo Kickr,219,211,8
87661,372523,2020-12-27 02:01:11,neo,Zwift - ZHQ FutureWorks Circuit Race - Anti-sandbagging (B),Favero assioma duo,Tacx Neo,220,223,-3
90014,372523,2021-01-01 23:46:13,neo,Zwift - Crit City Race (B),Favero assioma duo,Tacx Neo,213,217,-4
93602,372523,2021-01-09 01:03:44,neo,Zwift - Tour De Boudicca,Favero assioma duo,Tacx Neo,228,225,3
94097,372523,2021-01-09 19:03:17,neo,Zwift -  Tour De Boudicca,Favero assioma duo,Tacx Neo,204,207,-3
94708,372523,2021-01-10 19:04:09,neo,Zwift -  Tour De Boudicca,Favero assioma duo,Tacx Neo,223,226,-3
100577,372523,2021-01-21 01:06:01,neo,Zwift - Cycling Canada Wednesday Night Race Series (B),Favero assioma duo,Tacx Neo,217,224,-7
103115,372523,2021-01-25 20:05:05,neo,Zwift - Premier Division // Zwift Racing League (women) (A),Favero assioma duo,Tacx Neo,230,234,-4
109130,372523,2021-02-04 23:34:28,neo,Zwift - Watopia,Favero assioma duo,Tacx Neo,237,237,0
110196,372523,2021-02-06 23:31:01,neo,Zwift - ZHQ FutureWorks Circuit Race - Anti-sandbagging (B),Favero assioma duo,Tacx Neo,203,209,-6
115501,372523,2021-02-15 19:05:19,neo,Zwift - Premier Division // Zwift Racing League (women) (A),Favero assioma duo,Tacx Neo,217,217,0
117254,372523,2021-02-18 07:03:27,neo,Zwift - TDZ Stage 5: Shorter Ride,Favero assioma duo,Tacx Neo,212,214,-2
70045,676023,2020-11-11 02:40:29,wahoo,Zwift Racing League | WTRL - AMERICAS W (MEN) -  Division 1,Powertap P1,Wahoo Kickr,388,411,-23
71596,676023,2020-11-15 09:52:58,wahoo,Zwift - Climbers Day p/b dPAC.fit & Precision Hydration (A),Powertap P1,Wahoo Kickr,365,377,-12
73009,676023,2020-11-19 09:54:27,wahoo,Zwift - Espresso,Powertap P1,Wahoo Kickr,308,325,-17
73079,676023,2020-11-19 17:34:55,wahoo,WTRL Team Time Trial - Zone 4,Powertap P1,Wahoo Kickr,363,373,-10
73371,676023,2020-11-20 02:15:50,wahoo,Zwift - Espresso,Powertap P1,Wahoo Kickr,364,380,-16
95870,676023,2021-01-12 19:20:21,wahoo,Zwift - Zwift Racing League | WTRL - Men&#039;s/Mixed EMEA W1 DIVISION 2 (A),Powertap P1,Wahoo Kickr,379,390,-11
104110,676023,2021-01-26 19:26:58,wahoo,Zwift - Zwift Racing League | WTRL - Men&#039;s/Mixed EMEA W1 DIVISION 2 (A),Powertap P1,Wahoo Kickr,395,413,-18
106338,676023,2021-01-31 17:35:23,wahoo,Zwift - Stages of DIRT (E),Powertap P1,Wahoo Kickr,380,395,-15
106470,676023,2021-01-27 02:52:08,wahoo,Zwift - Zwift Racing League | WTRL - Men&#039;s/Mixed AMERICAS W DIVISION 1 (A),Powertap P1,Wahoo Kickr,380,403,-23
106789,676023,2021-02-01 10:49:19,wahoo,Zwift - TDZ Stage 6: Shorter Ride,Powertap P1,Wahoo Kickr,380,395,-15
107516,676023,2021-02-02 19:19:05,wahoo,Zwift - Zwift Racing League | WTRL - Men&#039;s/Mixed EMEA W1 DIVISION 2 (A),Powertap P1,Wahoo Kickr,381,402,-21
107827,676023,2021-02-03 02:48:25,wahoo,Zwift - Zwift Racing League | WTRL - Men&#039;s/Mixed AMERICAS W DIVISION 1 (A),Powertap P1,Wahoo Kickr,368,385,-17
108866,676023,2021-02-04 18:09:19,wahoo,Zwift - Espresso,Powertap P1,Wahoo Kickr,340,358,-18
109184,676023,2021-02-05 02:23:04,wahoo,Zwift - WTRL Team Time Trial - Zone 11 (C),Powertap P1,Wahoo Kickr,339,360,-21
109905,676023,2021-02-06 11:58:19,wahoo,Zwift - DIRT Dadurday Chase Race  (A),Powertap P1,Wahoo Kickr,361,376,-15
110539,676023,2021-02-07 14:50:10,wahoo,Zwift - TDZ Stage 7: Shorter Ride,Powertap P1,Wahoo Kickr,369,398,-29
111783,676023,2021-02-09 19:14:32,wahoo,Zwift - Zwift Racing League | WTRL - Men&#039;s/Mixed EMEA W1 DIVISION 2 (A),Powertap P1,Wahoo Kickr,386,403,-17
111932,676023,2021-02-10 02:46:36,wahoo,Zwift - Zwift Racing League | WTRL - Men&#039;s/Mixed AMERICAS W DIVISION 1 (A),Powertap P1,Wahoo Kickr,395,411,-16
112793,676023,2021-02-11 10:11:10,wahoo,Zwift - WTRL Team Time Trial - Zone 2 (C),Powertap P1,Wahoo Kickr,329,350,-21
114260,676023,2021-02-13 16:42:01,wahoo,Zwift - Crit City Race (A),Powertap P1,Wahoo Kickr,353,373,-20
116027,676023,2021-02-16 19:26:30,wahoo,Zwift - Zwift Racing League | WTRL - Men&#039;s/Mixed EMEA W1 DIVISION 2 (A),Powertap P1,Wahoo Kickr,405,420,-15
116428,676023,2021-02-17 10:34:32,wahoo,Zwift - Zwift Duathlon League - Bike,Powertap P1,Wahoo Kickr,327,342,-15
117076,676023,2021-02-18 10:06:38,wahoo,Zwift - WTRL Team Time Trial - Zone 2 (C),Powertap P1,Wahoo Kickr,341,355,-14
118491,676023,2021-02-20 15:25:14,wahoo,Zwift - TDZ Stage 7: Longer Ride,Powertap P1,Wahoo Kickr,358,377,-19
119864,676023,2021-02-23 19:27:08,wahoo,Zwift - Zwift Racing League | WTRL - Men&#039;s/Mixed EMEA W1 DIVISION 2 (A),Powertap P1,Wahoo Kickr,356,365,-9
120141,676023,2021-02-24 10:40:27,wahoo,Zwift - Zwift Duathlon League - Bike (B),Powertap P1,Wahoo Kickr,346,357,-11
123096,676023,2021-03-02 19:30:21,wahoo,Zwift - Zwift Racing League | WTRL - Men&#039;s/Mixed EMEA W1 DIVISION 2 (A),Powertap P1,Wahoo Kickr,367,378,-11
75295,101396,2020-11-25 00:44:12,wahoo,Zwift - Ramp Test,4iiii Crank,Wahoo Kickr,397,394,3
69153,650723,2020-11-08 19:03:58,wahoo,Zwift -  Tour De Spartacus  (E),Rotor InPower,Wahoo kickr,420,434,-14
69433,650723,2020-11-09 19:59:59,wahoo,Zwift - Premier Division // Zwift Racing League (men) (A),Rotor InPower,Wahoo kickr,436,438,-2
72011,650723,2020-11-16 19:05:26,wahoo,Zwift - Premier Division // Zwift Racing League (men) (A),Rotor InPower,Wahoo kickr,386,388,-2
74825,650723,2020-11-23 19:59:55,wahoo,Zwift - Premier Division // Zwift Racing League (men) (A),Rotor InPower,Wahoo kickr,411,420,-9
78643,650723,2020-12-02 19:24:59,wahoo,Zwift - Deeside Thistle and Moray Firth Race (A),Rotor InPower,Wahoo kickr,410,403,7
86506,650723,2020-12-23 14:39:59,wahoo,Zwift - Ross Fawcett&#039;s ZADA - Three Sisters,Rotor InPower,Wahoo Kickr V5,439,450,-11
94973,650723,2021-01-11 19:14:57,wahoo,Zwift - Premier Division // Zwift Racing League (men) (A),Rotor InPower,Wahoo Kickr V5,424,416,8
102438,650723,2021-01-24 14:14:56,wahoo,Zwift - KISS 100 Race Series - Americas (A),Rotor InPower,Wahoo Kickr V5,386,385,1
102953,650723,2021-01-25 19:04:58,wahoo,Zwift - Premier Division // Zwift Racing League (men) (A),Rotor InPower,Wahoo Kickr V5,415,418,-3
105636,650723,2021-01-30 15:30:01,wahoo,Zwift - 4wk FTP Booster Week 4 Day 3 - 10min Best effort! ,Rotor InPower,Wahoo Kickr V5,432,433,-1
106905,650723,2021-02-01 20:06:59,wahoo,Zwift - Premier Division // Zwift Racing League (men) (A),Rotor InPower,Wahoo Kickr V5,419,429,-10
109917,650723,2021-02-06 15:14:59,wahoo,Zwift - 4wk FTP Booster Week 4 Day 7 - FTP Test,Rotor InPower,Wahoo Kickr V5,425,433,-8
110413,650723,2021-02-07 13:04:56,wahoo,Zwift - 3R Watopia Flat Route Race - 4 Laps (40.5km/25.1mi 216m) (A),Rotor InPower,Wahoo Kickr V5,408,414,-6
111004,650723,2021-02-08 19:17:41,wahoo,Zwift - 4wk FTP Booster Week 4 Day 7 - FTP Test,Rotor InPower,Wahoo kickr,424,438,-14
112328,650723,2021-02-10 18:59:54,wahoo,Zwift - Movistar Team Challenge // Round 1 (A),Rotor InPower,Wahoo Kickr V5,416,424,-8
113617,650723,2021-02-12 18:59:57,wahoo,Zwift - Movistar Team Challenge // Round 1 (men),Rotor InPower,Wahoo Kickr V5,428,438,-10
116772,650723,2021-02-17 18:59:58,wahoo,Zwift - Movistar Team Challenge // Round 2 (men) - Race 3/4,Rotor InPower,Wahoo Kickr V5,403,399,4
117927,650723,2021-02-19 18:59:59,wahoo,Zwift - 02/19/2021,Rotor InPower,Wahoo Kickr V5,444,450,-6
122646,650723,2021-03-01 20:16:23,wahoo,Zwift - Premier Division // Zwift Racing League (men) (A),Rotor InPower,Wahoo Kickr V5,416,426,-10
124218,650723,2021-03-04 19:40:01,wahoo,Zwift - Movistar Team Challenge // Points Race (men),Rotor InPower,Wahoo Kickr V5,400,403,-3
124224,650723,2021-03-04 18:59:59,wahoo,Zwift - Ramp Test,Rotor InPower,Wahoo Kickr V5,447,472,-25
13693,678429,2020-02-11 00:03:34,wahoo,Zwift - The Bump Sprint Race (B),Favero Assioma,Wahoo KiCKR CoRe,296,310,-14
14688,678429,2020-02-18 18:59:02,wahoo,Zwift - Feltet.dk Race Series,Favero Assioma,Wahoo KiCKR CoRe,330,342,-12
26060,678429,2020-04-18 16:52:33,wahoo,Zwift - B oBByG (DiRTy WaTTZ 2)&#039;s Meetup - Four Horsemen,Favero Assioma,Wahoo KiCKR CoRe,297,314,-17
59387,678429,2020-10-04 10:23:52,wahoo,"Stages of DIRT, Oct 4 2020 06:30",Favero Assioma,Wahoo KiCKR CoRe,319,334,-15
60951,678429,2020-10-11 10:18:09,wahoo,Zwift - Stages of DIRT (B),Favero Assioma,Wahoo KiCKR CoRe,327,329,-2
61838,678429,2020-10-13 23:30:13,wahoo,Zwift - Zwift Racing League | WTRL (B) 2 X intermediate sprints + final sprint! Nice start to ZCL :O,Favero Assioma,Wahoo KiCKR CoRe,343,349,-6
62818,678429,2020-10-18 10:12:09,wahoo,Zwift - Stages of DIRT (B),Favero Assioma,Wahoo KiCKR CoRe,383,397,-14
64286,678429,2020-10-22 23:28:04,wahoo,Zwift - Frappe,Favero Assioma,Wahoo KiCKR CoRe,336,349,-13
92400,678429,2021-01-06 00:48:04,wahoo,Zwift - KISS Race Series - Americas PM (A),Favero Assioma,Wahoo KiCKR CoRe,360,384,-24
118607,659110,2021-02-21 06:32:01,neo,Zwift - TDZ Stage 3: Standard Ride,SGY-PM930H,Tacx Neo,267,268,-1
45357,9297,2020-07-08 01:00:29,wahoo,Zwift - Virtual Tour de France - Open - Stage 2 Discovery Ride,Garmin Vector 2 Pedals,Wahoo Kickr 16&#039;,268,291,-23
56544,9297,2020-09-19 18:59:46,wahoo,Zwift -  Stage 2 // Virtual Haute Route Ventoux  (A),GV 3,Wahoo Kickr 16&#039;,264,268,-4
56927,9297,2020-09-23 00:04:31,wahoo,Zwift - 3R Sundown Race Series  (A),2020-09-22-18-04-31,Wahoo Kickr 16&#039;,302,316,-14
61811,9297,2020-10-13 23:44:46,wahoo,Zwift - Zwift Racing League | WTRL (A),GV 3,Wahoo Kickr 16&#039;,285,302,-17
73894,9297,2020-11-21 15:14:38,wahoo,Zwift - OH MY CRIT - Saturday Smash Race (A),GV 3,Wahoo Kickr 16&#039;,309,321,-12
82836,9297,2020-12-09 00:44:54,wahoo,Zwift - Zwift Racing League | WTRL - Men&#039;s AMERICAS E DIVISION 1 (A),GV 3,Wahoo Kickr 16&#039;,295,323,-28
90437,9297,2021-01-02 13:59:44,wahoo,Zwift - XRS Races: Saturday Climbing Series (A),GV 3,Wahoo Kickr 16&#039;,288,290,-2
94684,9297,2021-01-10 20:44:48,wahoo,Zwift - TDZ Stage 2: Longer Ride,GV 3,Wahoo Kickr 16&#039;,264,290,-26
98937,9297,2021-01-16 15:57:27,wahoo,TEAM VEGAN Tofu Tornado - Veganuary STAGE 3,GV 3,Wahoo Kickr 16&#039;,288,300,-12
100595,9297,2021-01-20 00:34:41,wahoo,Zwift - Zwift Racing League | WTRL - Men&#039;s/Mixed AMERICAS E DIVISION 4 (A),GV 3,Wahoo Kickr 16&#039;,269,292,-23
101173,9297,2021-01-21 18:35:20,wahoo,Zwift - WTRL Team Time Trial - Zone 6 (C),GV 3,Wahoo Kickr 16&#039;,272,292,-20
104104,9297,2021-01-27 02:34:21,wahoo,Zwift Racing League | WTRL - Mens/Mixed AMERICAS W DIVISION 1,GV 3,Wahoo Kickr 16&#039;,304,328,-24
113212,9297,2021-02-11 22:02:42,wahoo,Zwift - TDZ Stage 8: Group Ride,GV 3,Wahoo Kickr 16&#039;,266,275,-9
113215,9297,2021-02-11 23:14:43,wahoo,Zwift - Koa Sports League Warrior Race (A),GV 3,Wahoo Kickr 16&#039;,286,302,-16
125383,9297,2021-03-06 19:30:28,wahoo,Zwift - 3R Endurance Series p/b OTE Sports (A),GV 3,KICKR Generation 4 (’18),263,259,4
128352,9297,2021-01-30 19:37:40,wahoo,Zwift - Herd Beginner Racing Series (E),GV 3,KICKR Generation 2 (’16),299,301,-2
128355,9297,2021-02-22 22:13:34,wahoo,Zwift - 3R LaGuardia Loop Reverse Flat Race - 6 Laps (19.1km/11.9 162m) (A),GV 3,KICKR Generation 2 (’16),265,284,-19
21562,268899,2020-04-01 16:00:01,wahoo,Zwift - Stage 1 - Longer Ride - Tour of Watopia 2020,power2max NGeco,Kickr Core,352,351,1
71607,268899,2020-11-15 06:00:37,wahoo,Zwift - SAS - ULTRA 200km (B),Kickr Core (Bluetooth),Kickr Core (ANT+),245,240,5
107541,268899,2021-02-02 18:34:27,wahoo,Zwift - Zwift Racing League | WTRL - Men&#039;s/Mixed EMEA W2 DIVISION 3 (A),power2max NGeco,Kickr Core (ANT+),372,356,16
107895,268899,2021-02-03 08:18:13,wahoo,Looking for the Watts,power2max NGeco,Kickr Core,239,227,12
108112,268899,2021-02-03 16:22:15,wahoo,KesiLab,power2max NGeco,Kickr Core (ANT+),290,284,6
108824,268899,2021-02-04 16:29:53,wahoo,Zwift - Ryzon Days of Dedication: Stage 1 ,power2max NGeco,Kickr Core (ANT+),352,347,5
111156,268899,2021-02-08 20:03:03,wahoo,Zwift - TDZ Stage 8: Group Ride,power2max NGeco (Bluetooth),Kickr Core (ANT+),290,284,6
112485,268899,2021-02-10 20:11:25,wahoo,Jobs -2 #TrainerZwift,power2max NGeco (ANT+),Kickr Core (Bluetooth),331,325,6
113097,268899,2021-02-11 18:40:26,wahoo,Zwift - TDZ Stage 8: Group Ride,power2max NGeco (ANT+),Kickr Core (Bluetooth),347,340,7
113392,268899,2021-02-12 12:14:59,wahoo,Zwift - Friday Ebb presented by Team ODZ (C),power2max NGeco (ANT+),Kickr Core (Bluetooth),270,265,5
114652,268899,2021-02-14 06:00:28,wahoo,Zwift - SAS - ULTRA 200km,power2max NGeco (ANT+),Kickr Core (Bluetooth),251,247,4
116172,268899,2021-02-16 18:30:37,wahoo,Zwift - Zwift Racing League | WTRL - Men&#039;s/Mixed EMEA W2 DIVISION 3 (A),power2max NGeco (ANT+),Kickr Core (Bluetooth),372,370,2
117226,268899,2021-02-18 16:30:02,wahoo,Zwift - Ryzon Days of Dedication: Stage 3,power2max NGeco (ANT+),Kickr Core (Bluetooth),330,326,4
119123,268899,2021-02-22 18:30:04,wahoo,Zwift - KIRCHMAIR ZRL Preparation Ride (C),power2max NGeco (ANT+),Kickr Core (Bluetooth),337,328,9
119789,268899,2021-02-23 18:47:41,wahoo,Zwift - Zwift Racing League | WTRL EMEA W2 A3,power2max NGeco (ANT+),Kickr Core (Bluetooth),341,334,7
121478,268899,2021-02-27 08:43:21,wahoo,"Zwift - Haute Route Watopia 2021, Stage 2",power2max NGeco (Bluetooth),Kickr Core (ANT+),353,341,12
122004,268899,2021-02-28 08:43:42,wahoo,"Zwift - Haute Route Watopia 2021, Stage 3",power2max NGeco,Kickr Core,357,355,2
123145,268899,2021-03-02 19:44:44,wahoo,Zwift - Zwift Racing League | WTRL - Men&#039;s/Mixed EMEA W2 DIVISION 3 (A),power2max NGeco,Kickr Core,340,336,4
124180,268899,2021-03-04 19:37:21,wahoo,WTRL Team Time Trial #98 - SegmentRide,power2max NGeco,Kickr Core,395,385,10
123157,577547,2021-03-02 19:49:54,wahoo,Zwift - Zwift Racing League | WTRL - Men&#039;s/Mixed EMEA W1 DIVISION 3 (B),stages LH,wahoo Kickr,269,279,-10
54674,651511,2020-09-11 17:18:55,wahoo,Zwift - Richmond,power meter power2max,wahoo kickr,160,156,4
54759,651511,2020-09-12 17:29:20,wahoo,Zwift - Richmond,power meter power2max,wahoo kickr,199,197,2
55854,651511,2020-09-17 17:58:58,wahoo,Zwift - Invitational League // Qualifying Race #2 (Women) (A),power meter power2max,wahoo kickr,237,233,4
56501,651511,2020-09-20 13:26:39,wahoo,Zwift - Invitational League // Qualifying Race #3 (Women) (A),power meter power2max,wahoo kickr,235,231,4
57303,651511,2020-09-24 17:26:19,wahoo,Zwift - Vienna,stages power meter,wahoo kickr,243,232,11
58562,651511,2020-09-30 09:58:19,wahoo,Zwift - Watopia,stages power meter,wahoo kickr,229,235,-6
61224,651511,2020-10-12 17:43:03,wahoo,Zwift - Premier Division // Zwift Racing League (women) (A),stages power meter,wahoo kickr,248,254,-6
63215,651511,2020-10-19 18:59:00,wahoo,Zwift - Premier Division // Zwift Racing League (women) (A),stages power meter,wahoo kickr,223,221,2
65137,651511,2020-10-26 19:02:36,wahoo,Zwift - Premier Division // Zwift Racing League (women) ,stages power meter,wahoo kickr,255,260,-5
67375,651511,2020-11-02 19:53:56,wahoo,Zwift - Premier Division // Zwift Racing League (women) (A),stages power meter,wahoo kickr,249,247,2
69402,651511,2020-11-09 19:00:08,wahoo,Zwift - Premier Division // Zwift Racing League (women) (A),power meter power2max,wahoo kickr,281,277,4
95209,651511,2021-01-11 20:03:50,wahoo,Zwift - Premier Division // Zwift Racing League (women) (A),power meter power2max,wahoo kickr,276,272,4
99137,651511,2021-01-18 19:03:35,wahoo,Zwift - Premier Division // Zwift Racing League (women) (A),power meter power2max,wahoo kickr,258,257,1
103113,651511,2021-01-25 20:00:29,wahoo,Zwift - Premier Division // Zwift Racing League (women) (A),power meter power2max,wahoo kickr,265,264,1
106858,651511,2021-02-01 19:02:43,wahoo,Zwift - Premier Division // Zwift Racing League (women) (A),power meter power2max,wahoo kickr,268,271,-3
111144,651511,2021-02-08 19:53:26,wahoo,Zwift - Premier Division // Zwift Racing League (women) (A),power meter power2max,wahoo kickr,259,256,3
112437,651511,2021-02-10 18:58:17,wahoo,Zwift - Movistar Team Challenge // Round 1 (B),power meter power2max,wahoo kickr,268,260,8
113660,651511,2021-02-12 18:58:45,wahoo,Zwift - Movistar Team Challenge // Round 1 (women),power meter power2max,wahoo kickr,262,260,2
119251,651511,2021-02-22 19:59:00,wahoo,Zwift - Premier Division // Zwift Racing League (women) (A),power meter power2max,wahoo kickr,254,252,2
122509,651511,2021-03-01 19:16:50,wahoo,Zwift - Premier Division // Zwift Racing League (women) (A),power meter power2max,wahoo kickr,252,250,2
6505,297914,2019-12-17 18:15:00,wahoo,Zwift - Danmarks Cykle Union Racing League (A),Sram Dzero,Wahoo Kickr,402,388,14
8050,297914,2020-01-04 13:45:17,wahoo,Zwift - WTRL Winter Racing League,Sram Dzero,Wahoo Kickr,339,324,15
8329,297914,2020-01-07 18:54:59,wahoo,Zwift - Team Italy Gladiators Race (A),Sram Dzero,Wahoo Kickr,388,370,18
9018,297914,2020-01-12 14:15:00,wahoo,Zwift - KISS at Race 100 - Americas (A),Sram Dzero,Wahoo Kickr,349,338,11
9558,297914,2020-01-15 19:15:00,wahoo,Zwift - Tour de Zwift // Pro-Am Invitational (A),Sram Dzero,Wahoo Kickr,441,411,30
10671,297914,2020-01-23 19:14:59,wahoo,Zwift - Tour de Zwift // Pro-Am Invitational,SRM,Wahoo Kickr,440,427,13
10981,297914,2020-01-26 06:00:00,wahoo,Zwift - KISS at Race 100 - EU (A),SRM,Wahoo Kickr,390,377,13
11895,297914,2020-01-31 19:15:00,wahoo,Zwift - Tour de Zwift // Pro-Am Invitational (A),SRM,Wahoo Kickr,397,383,14
12490,297914,2020-02-04 19:14:58,wahoo,Zwift - Tour de Zwift // Pro-Am Invitational (A),SRM,Wahoo Kickr,421,411,10
12792,297914,2020-02-06 18:59:59,wahoo,Zwift - KALAS Cup - Round 2 (A),SRM,Wahoo Kickr,423,413,10
13182,297914,2020-02-09 14:14:54,wahoo,Zwift - KISS at Race 100 - Americas (A),SRM,Wahoo Kickr,388,361,27
13765,297914,2020-02-13 18:59:59,wahoo,Zwift - KALAS Cup - Round 3 (A),SRM,Wahoo Kickr,390,380,10
14974,297914,2020-02-20 18:59:59,wahoo,Zwift - KALAS Cup - Round 4 (A),Sram Dzero,Wahoo Kickr,390,384,6
15818,297914,2020-02-25 19:14:49,wahoo,Zwift - Feltet.dk Race Series (A),Sram Dzero,Wahoo Kickr,339,328,11
15903,297914,2020-02-27 18:59:59,wahoo,Zwift - KALAS Cup - Round 5 (A),Sram Dzero,Wahoo Kickr,383,379,4
16973,297914,2020-03-05 18:59:48,wahoo,Zwift - KALAS Cup - Round 6 (A),Sram Dzero,Wahoo Kickr,383,377,6
17860,297914,2020-03-12 18:59:52,wahoo,KALAS Cup - Round 7,Sram Dzero,Wahoo Kickr,372,371,1
22016,297914,2020-04-04 12:44:59,wahoo,Zwift - WTRL iTT Series  (A),Sram Dzero,Wahoo Kickr,411,400,11
23317,297914,2020-04-09 18:09:58,wahoo,Zwift - London International // Zwift Classic (A),Sram Dzero,Wahoo Kickr,432,424,8
25830,297914,2020-04-17 18:10:51,wahoo,Zwift - Richmond Challenge // Zwift Classic (A),Sram Dzero,Wahoo Kickr,400,390,10
28030,297914,2020-04-25 18:10:00,wahoo,Zwift - Crit City Slam // Zwift Classic (A),Sram Dzero,Wahoo Kickr,392,386,6
34078,297914,2020-05-12 18:14:33,wahoo,Zwift - UNO X CUP powered by DCU & Feltet.dk (A),Sram Dzero,Wahoo Kickr,406,400,6
39152,297914,2020-06-02 18:13:59,wahoo,Zwift - UNO X CUP powered by DCU & Feltet.dk (A),Sram Dzero,Wahoo Kickr,394,384,10
40590,297914,2020-06-09 18:13:48,wahoo,Zwift - UNO X CUP powered by DCU & Feltet.dk (A),Sram Dzero,Wahoo Kickr,396,386,10
44973,297914,2020-07-05 04:59:41,wahoo,Zwift - KISS at Race 100 - EU (A),Sram Dzero,Wahoo Kickr,349,341,8
55516,297914,2020-09-16 11:19:58,wahoo,Zwift - 3R Volcano Circuit Flat Race - 6 Laps (27km/16.8mi 120m) (A),Sram Dzero,Wahoo Kickr,362,356,6
55939,297914,2020-09-17 18:29:56,wahoo,Zwift - Invitational League // Qualifying Race #2 (Men) ,Sram Dzero,Wahoo Kickr,354,346,8
56459,297914,2020-09-20 12:59:57,wahoo,Zwift - Invitational League // Qualifying Race #3 (Men) (A),Sram Dzero,Wahoo Kickr,389,378,11
57732,297914,2020-09-23 17:44:56,wahoo,Zwift - DCU powered by Feltet.dk (A),Sram Dzero,Wahoo Kickr,402,390,12
57733,297914,2020-09-26 13:19:53,wahoo,Zwift - 3R Innsbruckring Flat Race - 5 Laps (44km/27.3mi 385m) (A),Sram Dzero,Wahoo Kickr,357,336,21
58587,297914,2020-09-30 17:44:49,wahoo,Zwift - DCU powered by Feltet.dk (A),Sram Dzero,Wahoo Kickr,365,349,16
60221,297914,2020-10-07 17:44:44,wahoo,Zwift - DCU powered by Feltet.dk (A),Sram Dzero,Wahoo Kickr,381,372,9
62145,297914,2020-10-13 17:14:46,wahoo,Zwift - Zwift Racing League | WTRL,Sram Dzero,Wahoo Kickr,400,393,7
63557,297914,2020-10-20 17:22:18,wahoo,Zwift - Zwift Racing League | WTRL - EMEA E (MEN) - TTT Grp 1,Sram Dzero,Wahoo Kickr,386,378,8
67620,297914,2020-11-03 18:34:22,wahoo,Zwift - Zwift Racing League | WTRL - Men&#039;s EMEA E1 DIVISION 1 (A),Sram Dzero,Wahoo Kickr,391,381,10
69807,297914,2020-11-10 18:14:41,wahoo,Zwift - Zwift Racing League | WTRL - EMEA E1 (MEN) -  Division 1 (A),Sram Dzero,Wahoo Kickr,434,417,17
70339,297914,2020-11-11 19:04:57,wahoo,Zwift - DBR HEINO CUP III (A),Sram Dzero,Wahoo Kickr,388,388,0
70875,297914,2020-11-12 18:29:55,wahoo,Zwift - FUSION ECT BEUNSTOPPABLE Racing Series (A),Sram Dzero,Wahoo Kickr,335,335,0
71330,297914,2020-11-14 11:14:55,wahoo,Zwift - 3R Tick Tock Flat Race - 2 Lap (36km/22.4mi 100m) (A),Sram Dzero,Wahoo Kickr,334,326,8
72375,297914,2020-11-17 18:23:22,wahoo,Zwift - Zwift Racing League | WTRL - Men&#039;s EMEA E1 DIVISION 1 (A),Sram Dzero,Wahoo Kickr,379,380,-1
73208,297914,2020-11-19 19:29:54,wahoo,Zwift - World Championships Experience // Danish Cycling Federation,Sram Dzero,Wahoo Kickr,376,375,1
73529,297914,2020-11-20 15:14:56,wahoo,Zwift - 3R Sand and Sequoias Race (A),Sram Dzero,Wahoo Kickr,376,377,-1
74250,297914,2020-11-22 14:14:55,wahoo,Zwift - KISS 100 Race Series - Americas (A),Sram Dzero,Wahoo Kickr,406,412,-6
75028,297914,2020-11-24 18:14:52,wahoo,Zwift - Zwift Racing League | WTRL - Men&#039;s EMEA E1 DIVISION 1,Sram Dzero,Wahoo Kickr,408,417,-9
77326,297914,2020-11-29 14:14:45,wahoo,Zwift - KISS 100 Race Series - Americas (A),Sram Dzero,Wahoo Kickr,326,330,-4
78140,297914,2020-12-01 18:24:23,wahoo,Zwift - Zwift Racing League | WTRL - Men&#039;s EMEA E1 DIVISION 1 (A),Sram Dzero,Wahoo Kickr,388,392,-4
79079,297914,2020-12-03 18:29:51,wahoo,Zwift - FUSION DECEMBER CUP (A),Sram Dzero,Wahoo Kickr,398,401,-3
80180,297914,2020-12-06 14:14:53,wahoo,Zwift - KISS 100 Race Series - Americas (A),Sram Dzero,Wahoo Kickr,343,345,-2
80809,297914,2020-12-08 18:14:52,wahoo,Zwift - Zwift Racing League | WTRL - Men&#039;s EMEA E1 DIVISION 1 (A),Sram Dzero,Wahoo Kickr,395,398,-3
82639,297914,2020-12-13 05:59:50,wahoo,Zwift - KISS 100 Race Series - EU (A),Sram Dzero,Wahoo Kickr,373,376,-3
83592,297914,2020-12-15 18:24:24,wahoo,Zwift - Zwift Racing League | WTRL - Men&#039;s EMEA E1 DIVISION 1 (A),Sram Dzero,Wahoo Kickr,380,383,-3
92969,297914,2021-01-07 18:29:34,wahoo,Zwift - FUSION WINTER CUP (A),Sram Dzero,Wahoo Kickr v5,407,411,-4
97106,297914,2021-01-14 18:29:45,wahoo,Zwift - FUSION WINTER CUP (A),Sram Dzero,Wahoo Kickr v5,406,404,2
101037,297914,2021-01-21 18:29:52,wahoo,Zwift - FUSION WINTER CUP (A),Sram Dzero,Wahoo Kickr v5,364,367,-3
103496,297914,2021-01-26 18:14:48,wahoo,Zwift - Zwift Racing League | WTRL - Men&#039;s/Mixed EMEA E1 DIVISION 1 (A),Sram Dzero,Wahoo Kickr v5,396,401,-5
104753,297914,2021-01-28 18:29:58,wahoo,Zwift - FUSION WINTER CUP (A),Sram Dzero,Wahoo Kickr v5,356,356,0
107368,297914,2021-02-02 18:14:52,wahoo,Zwift - Zwift Racing League | WTRL - Men&#039;s/Mixed EMEA E1 DIVISION 1 (A),Sram Dzero,Wahoo Kickr v5,402,410,-8
108992,297914,2021-02-04 18:29:54,wahoo,Zwift - FUSION WINTER CUP (A),Sram Dzero,Wahoo Kickr v5,400,406,-6
111654,297914,2021-02-09 18:23:14,wahoo,Zwift - Zwift Racing League | WTRL - Men&#039;s/Mixed EMEA E1 DIVISION 1 (A),Sram Dzero,Wahoo Kickr v5,408,407,1
113056,297914,2021-02-11 18:29:54,wahoo,Zwift - FUSION WINTER CUP (A),Sram Dzero,Wahoo Kickr v5,363,363,0
116013,297914,2021-02-16 18:14:48,wahoo,Zwift - Zwift Racing League | WTRL - Men&#039;s/Mixed EMEA E1 DIVISION 1 (A),Sram Dzero,Wahoo Kickr v5,435,439,-4
117863,297914,2021-02-18 18:29:53,wahoo,Zwift - FUSION WINTER CUP (A),Sram Dzero,Wahoo Kickr v5,357,356,1
119669,297914,2021-02-23 18:14:47,wahoo,Zwift - Zwift Racing League | WTRL - Men&#039;s/Mixed EMEA E1 DIVISION 1 (A),Sram Dzero,Wahoo Kickr v5,389,388,1
120370,297914,2021-02-24 18:45:30,wahoo,Zwift - Scandinavian Cup 2021 - Round 1 - Men (A),Sram Dzero,Wahoo Kickr v5,355,358,-3
120840,297914,2021-02-25 18:29:53,wahoo,Zwift - FUSION WINTER CUP (A),Sram Dzero,Wahoo Kickr v5,410,413,-3
123683,297914,2021-03-03 18:44:47,wahoo,Zwift - Scandinavian Cup 2021 - Round 2 - Men (A),Sram Dzero,Wahoo Kickr v5,372,379,-7
124653,297914,2021-03-05 19:04:53,wahoo,Zwift - Zwift Racing League | WTRL Battle Royale Playoff - Men&#039;s Points Race (A),Sram Dzero,Wahoo Kickr v5,386,397,-11
125232,297914,2021-03-06 19:56:38,wahoo,Zwift - Zwift Racing League | WTRL Battle Royale Playoff - Men&#039;s TTT (A),Sram Dzero,Wahoo Kickr v5,399,400,-1
127577,297914,2021-03-10 18:44:50,wahoo,Zwift - Scandinavian Cup 2021 - Round 3 - Men (A),Sram Dzero,Wahoo Kickr v5,368,380,-12
129258,297914,2021-03-16 18:29:40,wahoo,Zwift - CeramicSpeed Race Series: Open Race (A),Sram Dzero,Wahoo Kickr v5,416,424,-8
52403,683717,2020-08-28 22:59:42,wahoo,Zwift - Off The MAAP Stage 1 Race (A),Quarq,Wahoo Kickr (Zwift) ,416,403,13
52649,683717,2020-08-30 13:14:51,wahoo,Zwift - KISS at Race 100 - Americas (A),Quarq,Wahoo Kickr (Zwift) ,462,469,-7
53578,683717,2020-09-05 19:14:54,wahoo,Zwift - Herd Summer Racing League Race 3 (A),Quarq,Wahoo Kickr (Zwift) ,420,418,2
54873,683717,2020-09-13 13:14:51,wahoo,Zwift - KISS at Race 100 - Americas (A),Quarq,Wahoo Kickr (Zwift) ,451,449,2
55852,683717,2020-09-17 18:29:49,wahoo,Zwift - Invitational League // Qualifying Race #2 (Men) ,Quarq,Wahoo Kickr (Zwift) ,395,407,-12
56567,683717,2020-09-20 12:59:47,wahoo,Zwift - Invitational League // Qualifying Race #3 (Men) (A),Quarq,Wahoo Kickr (Zwift) ,434,426,8
57220,683717,2020-09-24 15:14:56,wahoo,Zwift - OH MY CRIT! - The Double Race 1/2 (A),Garmin Vector 3,Wahoo Kickr (Zwift) ,412,423,-11
60304,683717,2020-10-08 15:15:13,wahoo,Zwift - OH MY CRIT! - The Double Race 1/2 (A),Quarq,Wahoo Kickr (Zwift) ,408,400,8
60312,683717,2020-10-08 16:04:48,wahoo,Zwift - OH MY CRIT! - The Double Race 2/2 (A),Quarq via Garmin 520,Wahoo Kickr (Zwift) ,437,424,13
61512,683717,2020-10-09 22:09:52,wahoo,Zwift - ZA Road Race #1: 4 - 5 w/kg,Quarq via Garmin 520,Wahoo Kickr (Zwift) ,426,422,4
61646,683717,2020-10-13 18:44:56,wahoo,Zwift - Zwift Racing League | WTRL,Quarq via Garmin 520,Wahoo Kickr (Zwift) ,439,439,0
62916,683717,2020-10-18 16:59:59,wahoo,Zwift - ZA Road 2020 - Segment Ride #1: Innsbruck Course,Quarq via Garmin 520,Wahoo Kickr (Zwift) ,435,424,11
63499,683717,2020-10-20 18:49:56,wahoo,Zwift - Zwift Racing League | WTRL - EMEA (MEN) - TTT Grp 2 (A),Quarq via Garmin 520,Wahoo Kickr (Zwift) ,406,404,2
64404,683717,2020-10-23 16:09:53,wahoo,Zwift - ZA Road - Race #2 (A),Quarq via Garmin 520,Wahoo Kickr (Zwift) ,444,436,8
65065,683717,2020-10-26 16:44:54,wahoo,Zwift - FZR Segment Killer Race (A),Quarq via Garmin 520,Wahoo Kickr (Zwift) ,479,480,-1
66115,683717,2020-10-29 16:14:53,wahoo,Zwift - OH MY CRIT! - The Double Race 1/2 (A),Quarq via Garmin 520,Wahoo Kickr (Zwift) ,473,471,2
66116,683717,2020-10-29 17:04:53,wahoo,Zwift - OH MY CRIT! - The Double Race 2/2 (A),Quarq via Garmin 520,Wahoo Kickr (Zwift) ,394,390,4
66744,683717,2020-10-31 16:00:00,wahoo,Zwift - ZA Road 2020 - Segment Ride #2: Three Sisters Course,Quarq via Garmin 520,Wahoo Kickr (Zwift) ,476,467,9
67716,683717,2020-11-03 20:04:52,wahoo,Zwift - Zwift Racing League | WTRL - Men&#039;s EMEA W1 DIVISION 1 (A),Quarq via Garmin 520,Wahoo Kickr (Zwift) ,427,431,-4
68632,683717,2020-11-06 19:00:31,wahoo,Zwift -  Tour De Spartacus  (E),Quarq via Garmin 520,Wahoo Kickr (Zwift) ,496,492,4
68895,683717,2020-11-07 19:03:46,wahoo,Zwift -  Tour De Spartacus  (E),Quarq via Garmin 520,Wahoo Kickr (Zwift) ,426,425,1
69150,683717,2020-11-08 19:03:46,wahoo,Zwift -  Tour De Spartacus  (E),Quarq via Garmin 520,Wahoo Kickr (Zwift) ,468,465,3
69898,683717,2020-11-10 19:44:43,wahoo,Zwift - Zwift Racing League | WTRL - EMEA W1 (MEN) -  Division 1 (A),Quarq via Garmin 520,Wahoo Kickr (Zwift) ,475,465,10
72996,683717,2020-11-19 16:14:38,wahoo,Zwift - OH MY CRIT! - The Double Race 1/2 (A),Quarq via Garmin 520,Wahoo Kickr (Zwift) ,425,406,19
74304,683717,2020-11-22 17:19:53,wahoo,Zwift - 3R Racing (A),Quarq via Garmin 520,Wahoo Kickr (Zwift) ,481,460,21
75141,683717,2020-11-24 19:44:51,wahoo,Zwift - Zwift Racing League | WTRL - Men&#039;s EMEA W1 DIVISION 1,Quarq via Garmin 520,Wahoo Kickr (Zwift) ,418,437,-19
75297,683717,2020-11-25 00:44:52,wahoo,Zwift - 3R Innsbruckring Sprint Race - 1 Lap (8.8km/5.5mi 77m) (A),Quarq via Garmin 520,Wahoo Kickr (Zwift) ,449,450,-1
76038,683717,2020-11-26 18:11:52,wahoo,Zwift - WTRL NOPINZ WORLD TTT CHAMPIONSHIPS - Zone 4 (C),Quarq via Garmin 520,Wahoo Kickr (Zwift) ,427,431,-4
83741,683717,2020-12-13 15:24:51,wahoo,Zwift - 3R Watopia 65km Race - 6 laps (40mi 324m) (A),Quarq via Garmin 520,Wahoo Kickr (Zwift) ,375,354,21
84737,683717,2020-12-17 16:14:47,wahoo,Zwift - OH MY CRIT! - The Double Race 1/2 (A),Quarq via Garmin 520,Wahoo Kickr (Zwift) ,414,396,18
84738,683717,2020-12-17 17:04:47,wahoo,Zwift - OH MY CRIT! - The Double Race 2/2 (A),Quarq via Garmin 520,Wahoo Kickr (Zwift) ,415,397,18
85475,683717,2020-12-20 15:39:46,wahoo,Zwift - ZA Tri: TT Race - 40k ,Quarq via Garmin 520,Wahoo Kickr (Zwift) ,382,374,8
86671,683717,2020-12-23 18:54:46,wahoo,Zwift - USA Cycling Race League by Indoor Specialist (A),Quarq via Garmin 520,Wahoo Kickr (Zwift) ,391,375,16
92820,683717,2021-01-07 18:21:53,wahoo,Zwift -  Kiss Racing Team / FastFitnessTips iTT series (E),Quarq via Garmin 520,Wahoo Kickr (Zwift) ,451,447,4
45863,526982,2020-07-11 05:00:00,neo,Zwift - EVO CC Vortex Interval Ride [~3-3.8w/kg avg] (B),Quarq dFour91 Climbing,Tacx Neo 1 Home,346,344,2
46061,526982,2020-07-12 16:00:51,neo,Zwift - L&#039;Etape du Tour Stage 2 - Open,Quarq dFour91 Climbing,Tax Neo 1 Rochat,367,371,-4
46108,526982,2020-07-13 04:30:00,neo,Zwift - EVO CC Vortex Interval Ride [~3-3.8w/kg avg] (B),Quarq dFour91 Climbing,Tax Neo 1 Rochat,341,335,6
46940,526982,2020-07-19 10:00:54,neo,Zwift - L&#039;Etape du Tour Stage 3 - Open,Quarq dFour91 Steel,Tax Neo 1 Rochat,318,318,0
47008,526982,2020-07-20 04:30:19,neo,Zwift - EVO CC Vortex Interval Ride [~3-3.8w/kg avg] (B),Quarq dFour91 Steel,Tax Neo 1 Rochat,339,324,15
47176,526982,2020-07-21 16:29:56,neo,Zwift - EVO CC Sprint Race Series  (A),Quarq D Zero Stealth,Tax Neo 1 Rochat,400,390,10
47177,526982,2020-07-21 16:59:58,neo,Zwift - EVO CC Altibajos Group Ride with hilly after party [3-4.0 w/kg avg] (B),Quarq D Zero Stealth,Tax Neo 1 Rochat,311,299,12
47253,526982,2020-07-22 04:29:42,neo,Zwift - EVO CC Vortex Interval Ride [~3-3.8w/kg avg] (B),Quarq D Zero Stealth,Tax Neo 1 Rochat,276,265,11
47389,526982,2020-07-23 04:45:02,neo,Zwift - EVO CC Flux Ride [1.5 - 2.0w/kg avg] (D),Quarq D Zero Stealth,Tax Neo 1 Rochat,259,248,11
47450,526982,2020-07-23 17:03:48,neo,Zwift - Frappe,Quarq D Zero Stealth,Tax Neo 1 Rochat,346,337,9
47501,526982,2020-07-24 04:29:55,neo,Zwift - EVO CC Vortex Interval Ride [~3-3.8w/kg avg] (B),Quarq D Zero Stealth,Tax Neo 1 Rochat,295,294,1
47558,526982,2020-07-24 16:29:54,neo,Zwift - EVO CC Sprint Race Series  (A),Quarq D Zero Stealth,Tax Neo 1 Rochat,397,390,7
51442,526982,2020-08-22 05:00:02,neo,Zwift - EVO CC Vortex Interval Ride [~3-3.8w/kg avg] (B),Quarq dFour91 Climbing,Tacx Neo 1 Home,325,321,4
51495,526982,2020-08-24 10:39:39,neo,Zwift - ZWC Hill Climb Battle (A),Quarq D Zero Stealth,Tacx Neo Office,383,378,5
52312,526982,2020-08-28 04:29:59,neo,Zwift - EVO CC Vortex Interval Ride [~3-3.8w/kg avg] (B),Quarq D Zero Stealth,Tacx Neo Office,320,322,-2
53734,526982,2020-09-07 10:39:38,neo,Zwift - ZWC Hill Climb Battle (A),Quarq D Zero Stealth,Tacx Neo Office,377,377,0
54942,526982,2020-09-12 04:59:56,neo,Zwift - EVO CC Vortex Interval Ride [~3-3.8w/kg avg] (B),Quarq dFour91 Climbing,Tacx Neo 1 Home,335,328,7
56063,526982,2020-09-18 04:19:22,neo,Zwift - EVO CC Vortex Interval Ride [~3-3.8w/kg avg] (B),Quarq D Zero Stealth,Tacx Neo Office,302,305,-3
56745,526982,2020-09-22 04:19:37,neo,Zwift - EVO CC Vortex Interval Ride [~3-3.8w/kg avg] (B),Quarq D Zero Stealth,Tacx Neo Office,309,310,-1
56747,526982,2020-09-19 04:55:41,neo,Zwift - EVO CC Vortex Interval Ride [~3-3.8w/kg avg] (B),Quarq dFour91 Climbing,Tacx Neo 1 Home,360,359,1
58718,526982,2020-10-01 10:53:18,neo,Zwift - DIRT Doozy Race (A),Quarq D Zero Stealth,Tacx Neo Office,428,417,11
58975,526982,2020-10-02 04:24:29,neo,Zwift - EVO CC Vortex Interval Ride [~3-3.8w/kg avg] (B),Quarq D Zero Stealth,Tacx Neo Office,328,329,-1
59160,526982,2020-10-02 16:03:11,neo,Zwift - EVO CC Sprint Race Series  (A),Quarq dFour91 Climbing,Tax Neo 1 Rochat,402,388,14
59162,526982,2020-10-03 04:43:34,neo,Zwift - EVO CC Vortex Interval Ride [~3-3.8w/kg avg] (B),Quarq dFour91 Climbing,Tax Neo 1 Rochat,379,366,13
59527,526982,2020-10-05 04:24:25,neo,Zwift - EVO CC Vortex Interval Ride [~3-3.8w/kg avg] (B),Quarq D Zero Stealth,Tacx Neo Office,315,312,3
59719,526982,2020-10-06 04:21:06,neo,Zwift - EVO CC Vortex Interval Ride [~3-3.8w/kg avg] (B),Quarq D Zero Stealth,Tacx Neo Office,312,312,0
59971,526982,2020-10-06 16:10:01,neo,Zwift - Yorkshire,Quarq D Zero Stealth,Tacx Neo Office,392,388,4
59972,526982,2020-10-07 04:25:05,neo,Zwift - EVO CC Vortex Interval Ride [~3-3.8w/kg avg] (B),Quarq D Zero Stealth,Tacx Neo Office,324,321,3
60213,526982,2020-10-08 04:24:41,neo,Zwift - EVO CC Vortex Interval Ride [~3-3.8w/kg avg] (B),Quarq D Zero Stealth,Tacx Neo Office,320,315,5
60500,526982,2020-10-09 04:22:17,neo,Zwift - EVO CC Vortex Interval Ride [~3-3.8w/kg avg] (B),Quarq D Zero Stealth,Tacx Neo Office,326,318,8
61081,526982,2020-10-09 16:04:31,neo,Zwift - EVO CC Sprint Race Series  (A),Quarq dFour91 Climbing,Tax Neo 1 Rochat,396,385,11
61083,526982,2020-10-10 04:51:44,neo,Zwift - EVO CC Vortex Interval Ride [~3-3.8w/kg avg] (B),Quarq dFour91 Climbing,Tax Neo 1 Rochat,373,362,11
61085,526982,2020-10-12 04:23:03,neo,Zwift - EVO CC Vortex Interval Ride [~3-3.8w/kg avg] (B),Quarq D Zero Stealth,Tacx Neo Office,358,350,8
61740,526982,2020-10-13 18:16:17,neo,Zwift - Zwift Racing League | WTRL,Quarq dFour91 Climbing,Tax Neo 1 Rochat,382,368,14
61741,526982,2020-10-14 04:25:02,neo,Zwift - EVO CC Vortex Interval Ride [~3-3.8w/kg avg] (B),Quarq D Zero Stealth,Tacx Neo Office,288,281,7
62961,526982,2020-10-17 04:53:59,neo,Zwift - EVO CC Vortex Interval Ride [~3-3.8w/kg avg] (B),Quarq dFour91 Climbing,Tax Neo 1 Rochat,376,362,14
62963,526982,2020-10-19 04:23:41,neo,Zwift - EVO CC Vortex Interval Ride [~3-3.8w/kg avg] (B),Quarq D Zero Stealth,Tacx Neo Office,379,377,2
63685,526982,2020-10-20 18:16:03,neo,Zwift - Zwift Racing League | WTRL - EMEA (MEN) - TTT Grp 1 (C),Quarq dFour91 Climbing,Tax Neo 1 Rochat,365,357,8
63687,526982,2020-10-21 04:22:18,neo,Zwift - EVO CC Vortex Interval Ride [~3-3.8w/kg avg] (B),Quarq D Zero Stealth,Tacx Neo Office,320,314,6
64321,526982,2020-10-23 04:23:21,neo,Zwift - EVO CC Vortex Interval Ride [~3-3.8w/kg avg] (B),Quarq D Zero Stealth,Tacx Neo Office,332,329,3
64454,526982,2020-10-23 16:08:59,neo,Zwift - EVO CC Sprint Race Series  (A),Quarq dFour91 Climbing,Tax Neo 1 Rochat,392,383,9
64983,526982,2020-10-26 05:22:25,neo,Quarq D Zero Stealth / Tacx Neo Office,Quarq D Zero Stealth,Tacx Neo Office,339,334,5
65527,526982,2020-10-27 19:06:12,neo,Zwift - Zwift Racing League | WTRL - EMEA W (MEN) -  Division 1 (A),Quarq dFour91 Climbing,Tax Neo 1 Rochat,366,365,1
65974,526982,2020-10-29 05:21:23,neo,Zwift - EVO CC Vortex Interval Ride [~3-3.8w/kg avg] (B),Quarq dFour91 Climbing,Tax Neo 1 Rochat,347,331,16
66326,526982,2020-10-30 05:24:20,neo,Zwift - EVO CC Vortex Interval Ride [~3-3.8w/kg avg] (B),Quarq dFour91 Climbing,Tax Neo 1 Rochat,384,375,9
67118,526982,2020-11-02 05:23:45,neo,Zwift - EVO CC Vortex Interval Ride [~3-3.8w/kg avg] (B),Quarq dFour91 Climbing,Tax Neo 1 Rochat,362,349,13
67460,526982,2020-11-03 05:22:06,neo,Zwift - EVO CC Core Interval Ride [2.5-3.0w/kg avg] (C),Quarq dFour91 Climbing,Tax Neo 1 Rochat,339,325,14
67707,526982,2020-11-03 19:18:38,neo,Zwift - Zwift Racing League | WTRL - Men&#039;s EMEA W1 DIVISION 1 (A),Quarq dFour91 Climbing,Tax Neo 1 Rochat,380,368,12
67979,526982,2020-11-05 05:19:11,neo,Zwift - EVO CC Vortex Interval Ride [~3-3.8w/kg avg] (B),Quarq dFour91 Climbing,Tax Neo 1 Rochat,338,321,17
68414,526982,2020-11-06 05:24:25,neo,Zwift - EVO CC Vortex Interval Ride [~3-3.8w/kg avg] (B),Quarq dFour91 Climbing,Tax Neo 1 Rochat,385,373,12
68554,526982,2020-11-06 16:44:14,neo,Zwift - EVO CC Sprint Race Series  (A),Quarq dFour91 Climbing,Tax Neo 1 Rochat,411,396,15
68680,526982,2020-11-07 05:51:25,neo,Zwift - EVO CC Vortex Interval Ride [~3-3.8w/kg avg] (B),Quarq dFour91 Climbing,Tax Neo 1 Rochat,331,323,8
69214,526982,2020-11-09 05:19:31,neo,Zwift - EVO CC Vortex Interval Ride [~3-3.8w/kg avg] (B),Quarq dFour91 Climbing,Tax Neo 1 Rochat,327,318,9
70039,526982,2020-11-10 18:52:22,neo,Zwift - Zwift Racing League | WTRL - EMEA W1 (MEN) -  Division 1 (A),Quarq dFour91 Climbing,Tax Neo 1 Rochat,421,404,17
70476,526982,2020-11-12 05:21:25,neo,Zwift - EVO CC Vortex Interval Ride [~3-3.8w/kg avg] (B),Quarq dFour91 Climbing,Tax Neo 1 Rochat,371,352,19
70990,526982,2020-11-13 05:23:09,neo,Zwift - EVO CC Vortex Interval Ride [~3-3.8w/kg avg] (B),Quarq dFour91 Climbing,Tax Neo 1 Rochat,366,354,12
71110,526982,2020-11-13 16:59:45,neo,Zwift - EVO CC Sprint Race Series  (A),Quarq dFour91 Climbing,Tax Neo 1 Rochat,412,399,13
71229,526982,2020-11-14 05:50:52,neo,Zwift - EVO CC Vortex Interval Ride [~3-3.8w/kg avg] (B),Quarq dFour91 Climbing,Tax Neo 1 Rochat,360,344,16
71841,526982,2020-11-16 05:20:46,neo,Zwift - EVO CC Vortex Interval Ride [~3-3.8w/kg avg] (B),Quarq dFour91 Climbing,Tax Neo 1 Rochat,368,355,13
72047,526982,2020-11-17 05:27:20,neo,Zwift - EVO CC Core Interval Ride [2.5-3.0w/kg avg] (C),Quarq dFour91 Climbing,Tax Neo 1 Rochat,290,282,8
72355,526982,2020-11-17 18:58:56,neo,Zwift - Zwift Racing League | WTRL - Men&#039;s EMEA W1 DIVISION 1 (A),Quarq dFour91 Climbing,Tax Neo 1 Rochat,368,362,6
72475,526982,2020-11-18 05:34:17,neo,Zwift - EVO CC Core Interval Ride [2.5-3.0w/kg avg] (C),Quarq dFour91 Climbing,Tax Neo 1 Rochat,347,337,10
72833,526982,2020-11-19 05:22:47,neo,Zwift - EVO CC Vortex Interval Ride [~3-3.8w/kg avg] (B),Quarq dFour91 Climbing,Tax Neo 1 Rochat,381,371,10
73364,526982,2020-11-20 05:18:15,neo,Zwift - EVO CC Vortex Interval Ride [~3-3.8w/kg avg] (B),Quarq dFour91 Climbing,Tax Neo 1 Rochat,337,337,0
73558,526982,2020-11-20 16:37:57,neo,Zwift - EVO CC / Le Col - Sprint Race Series (A),Quarq dFour91 Climbing,Tax Neo 1 Rochat,392,392,0
73719,526982,2020-11-21 05:50:06,neo,Zwift - EVO CC Vortex Interval Ride [~3-3.8w/kg avg] (B),Quarq dFour91 Climbing,Tax Neo 1 Rochat,303,304,-1
74425,526982,2020-11-23 05:23:05,neo,Zwift - EVO CC Vortex Interval Ride [~3-3.8w/kg avg] (B),Quarq dFour91 Climbing,Tax Neo 1 Rochat,316,316,0
74830,526982,2020-11-24 05:34:33,neo,Zwift - EVO CC Core Interval Ride [2.5-3.0w/kg avg] (C),Quarq dFour91 Climbing,Tax Neo 1 Rochat,273,261,12
75222,526982,2020-11-24 19:31:48,neo,Zwift - Zwift Racing League | WTRL - Men&#039;s EMEA W1 DIVISION 1,Quarq dFour91 Climbing,Tax Neo 1 Rochat,390,376,14
75345,526982,2020-11-25 05:26:54,neo,Zwift - EVO CC Vortex Interval Ride [~3-3.8w/kg avg] (B),Quarq dFour91 Climbing,Tax Neo 1 Rochat,307,296,11
75761,526982,2020-11-26 05:23:06,neo,Zwift - EVO CC Vortex Interval Ride [~3-3.8w/kg avg] (B),Quarq dFour91 Climbing,Tax Neo 1 Rochat,358,342,16
76355,526982,2020-11-27 05:24:46,neo,Zwift - EVO CC Vortex Interval Ride [~3-3.8w/kg avg] (B),Quarq dFour91 Climbing,Tax Neo 1 Rochat,342,328,14
76694,526982,2020-11-27 16:38:11,neo,Zwift - EVO CC / Le Col - Sprint Race Series (A),Quarq dFour91 Climbing,Tax Neo 1 Rochat,400,400,0
76695,526982,2020-11-28 05:52:49,neo,Quarq dFour91 Climbing / Tax Neo 1 Rochat,Quarq dFour91 Climbing,Tax Neo 1 Rochat,344,331,13
76123,9021,2020-11-26 19:05:18,wahoo,Zwift - WTRL NOPINZ WORLD TTT CHAMPIONSHIPS - Zone 9 (E),Specialized Powercranks,Wahoo KICKR,271,263,8
122969,688960,2021-03-02 18:26:04,wahoo,Zwift - Zwift Racing League | WTRL - Men&#039;s/Mixed EMEA E2 DIVISION 1 (A),Quarq,Kickr,339,353,-14
124598,688960,2021-03-05 19:05:24,wahoo,Zwift - Zwift Racing League | WTRL Battle Royale Playoff - Men&#039;s Points Race (A),Quarq,Kickr,367,367,0
124604,688960,2021-03-05 19:02:13,wahoo,Zwift - Zwift Racing League | WTRL Battle Royale Playoff - Men&#039;s Points Race (A),Quarq,Kickr,357,367,-10
30490,204402,2020-05-02 07:56:55,wahoo,Zwift - DBR Sufferday League (A),SRM ,WAHOO Kickr Core,479,455,24
34070,204402,2020-05-12 18:15:21,wahoo,(Only part of race due to corrupted datafile) ,SRM ,WAHOO Kickr Core,462,460,2
34743,204402,2020-05-14 16:43:24,wahoo,Zwift - WTRL Team Time Trial Premier League,SRM,WAHOO Kickr Core,470,446,24
36662,204402,2020-05-21 17:18:42,wahoo,Zwift - WTRL Team Time Trial Premier League,SRM,WAHOO Kickr Core,453,434,19
37848,204402,2020-05-26 17:48:13,wahoo,Zwift - UNO X CUP powered by DCU & Feltet.dk (A),Zwift/SRM,WAHOO Kickr Core,513,491,22
38633,204402,2020-05-30 08:25:28,wahoo,DBR Sufferday League,Zwift/SRM,WAHOO Kickr Core,471,458,13
39121,204402,2020-06-02 17:56:04,wahoo,Zwift - UNO X CUP powered by DCU & Feltet.dk (A),Zwift/SRM,WAHOO Kickr Core,485,460,25
40577,204402,2020-06-09 17:38:20,wahoo,Zwift - UNO X CUP powered by DCU & Feltet.dk (A),Zwift / SRM,WAHOO Kickr Core,462,444,18
55038,204402,2020-09-14 17:15:32,wahoo,Zwift - Invitational League // Qualifying Race #1,SRM,WAHOO Kickr Core,436,440,-4
56430,204402,2020-09-20 12:19:31,wahoo,Zwift - Invitational League // Qualifying Race #3 (Men) (A) - Dropout with 1000 meters to the finish....,SRM to Garmin 510,WAHOO Kickr Core to Zwift,451,453,-2
57043,204402,2020-09-23 17:15:38,wahoo,DCU powered by Feltet.dk,SRM,WAHOO Kickr Core,409,414,-5
58181,204402,2020-09-29 08:22:46,wahoo,Zwift - Three Sisters Test ,SRM to Garmin 520 Plus,WAHOO Kickr Core to Zwift,521,499,22
60122,204402,2020-10-07 17:04:44,wahoo,Zwift - DCU powered by Feltet.dk (A),SRM,WAHOO Kickr Core,457,441,16
62260,204402,2020-10-15 17:33:08,wahoo,WTRL Team Time Trial - Zone 5,SRM to Garmin 520 Plus,WAHOO Kickr Core,434,437,-3
63124,204402,2020-10-19 17:30:12,wahoo,Zwift - Premier Division // Zwift Racing League (men) ,2inPower to Garmin 520,WAHOO Kickr Core,424,450,-26
65204,204402,2020-10-26 19:22:06,wahoo,Zwift - Premier Division // Zwift Racing League (men) (A),Garmin/SRM,WAHOO Kickr Core,478,449,29
66169,204402,2020-10-29 17:38:58,wahoo,WTRL Team Time Trial Platinum League,Garmin/SRM,Wahoo Kickr v5,436,430,6
66401,204402,2020-10-30 12:00:34,wahoo,Zwift - 3R Greater London 8 Hilly Race - 1 Lap (23.8km/14.8mi 238m) (A),SRM,Wahoo Kickr v5,450,448,2
67294,204402,2020-11-02 18:29:53,wahoo,Zwift - Premier Division // Zwift Racing League (men) (A),Garmin / SRM,Wahoo Kickr v5,459,452,7
67959,204402,2020-11-04 18:34:33,wahoo,DCU – Feltet.dk November series,SRM / Garmin,Wahoo Kickr v5,498,493,5
68246,204402,2020-11-05 18:23:27,wahoo,Zwift - TTT Premier League,SRM / Garmin,Wahoo Kickr v5,448,436,12
69443,204402,2020-11-09 19:23:32,wahoo,Premier Division // Zwift Racing League (men),SRM / Garmin,Wahoo Kickr v5,503,491,12
71604,204402,2020-11-15 09:19:59,wahoo,Zwift - Open: 2020 El Giro de Rigo - Official Route,SRM / Garmin,Wahoo Kickr v5,457,449,8
71965,204402,2020-11-16 18:21:20,wahoo,Zwift - Premier Division // Zwift Racing League (men) (A),SRM / Garmin,Wahoo Kickr v5,459,448,11
72661,204402,2020-11-18 18:17:38,wahoo,Zwift - DCU – Feltet.dk November series (A),SRM / Garmin,Wahoo Kickr v5,431,423,8
76478,204402,2020-11-26 18:02:42,wahoo,Zwift - WTRL NOPINZ WORLD TTT CHAMPIONSHIPS - Zone 6 (C),Garmin / SRM,Wahoo Kickr &#039;18,462,455,7
77696,204402,2020-11-30 18:31:37,wahoo,Zwift - Premier Division // Zwift Racing League (men) (A),Garmin / SRM,Wahoo Kickr v5,452,454,-2
84464,204402,2020-12-17 17:51:50,wahoo,FUSION DECEMBER CUP,Zwift / SRM,Wahoo Kickr v5,432,428,4
85054,204402,2020-12-19 11:56:54,wahoo,Zwift - DIRT Dadurday Chase Race  (A),SRM,Wahoo Kickr v5,401,397,4
87403,204402,2020-12-26 08:49:05,wahoo,Zwift - DBR Saturday Race (A),SRM ,Wahoo Kicker v5,457,452,5
87410,204402,2020-12-26 08:49:05,wahoo,Zwift - 3R Tick Tock Flat Race - 2 Lap (36km/22.4mi 100m) (A),SRM,Wahoo Kickr v5,419,414,5
88495,204402,2020-12-29 08:45:06,wahoo,Zwift - Three Sisters Performance Test,SRM to Garmin 520,Wahoo Kickr v5 to Zwift,501,498,3
88503,204402,2020-12-29 08:45:06,wahoo,Zwift - Japan Zwift Tuesday Race (A),SRM to Garmin 520,Wahoo Kickr v5 to Zwift,370,367,3
92979,204402,2021-01-07 18:02:49,wahoo,Zwift - FUSION WINTER CUP (A),SRM to Garmin 520,Wahoo Kickr v5 to Zwift,406,404,2
95009,204402,2021-01-11 18:29:40,wahoo,Zwift - Premier Division // Zwift Racing League (men) (A),SRM to Garmin 520,Wahoo Kickr v5 to Zwift,430,427,3
96463,204402,2021-01-13 18:02:30,wahoo,Zwift - Danmarks Cykle Union & Partners 1/6 (A),SRM to Garmin 520,Wahoo Kickr v5 to Zwift,477,475,2
97942,204402,2021-01-16 09:13:21,wahoo,Zwift - DBR SufferDay League III (A),SRM to Garmin 520,Wahoo Kickr v5 to Zwift,477,477,0
99240,204402,2021-01-18 19:12:50,wahoo,Zwift - Premier Division // Zwift Racing League (men) (A),SRM to Garmin 520,Wahoo Kickr v5 to Zwift,454,455,-1
99542,204402,2021-01-19 07:23:15,wahoo,Zwift - ZHQ FutureWorks Crit City Race - Anti-sandbagging (A),SRM to Garmin 520,Wahoo Kickr v5 to Zwift,498,498,0
100345,204402,2021-01-20 18:13:40,wahoo,Zwift - Danmarks Cykle Union & Partners 2/6 (A),SRM to Garmin 520,Wahoo Kickr v5 to Zwift,452,455,-3
101774,204402,2021-01-23 08:00:16,wahoo,Zwift - DBR SufferDay League III (A),SRM to Garmin 520,Wahoo Kickr v5 to Zwift,429,433,-4
102933,204402,2021-01-25 18:26:28,wahoo,Zwift - Premier Division // Zwift Racing League (men) (A),SRM to Garmin 520,Wahoo Kickr v5 to Zwift,460,475,-15
104195,204402,2021-01-27 18:07:30,wahoo,Zwift - Danmarks Cykle Union & Partners 3/6 (A),SRM to Garmin 520,Wahoo Kickr v5 to Zwift,479,476,3
104756,204402,2021-01-28 17:57:44,wahoo,Zwift - FUSION WINTER CUP (A),SRM to Garmin 520,Wahoo Kickr v5 to Zwift,474,468,6
105158,204402,2021-01-29 14:40:41,wahoo,Zwift - BST Mountaingoat Race (A),SRM to Garmin 520,Wahoo Kickr v5 to Zwift,464,460,4
109857,204402,2021-02-06 09:07:31,wahoo,Zwift - DBR SufferDay League III - Vanvittigt projekt! ,SRM to Garmin 520,Wahoo Kickr v5 to Zwift,430,426,4
111067,204402,2021-02-08 18:40:15,wahoo,Zwift - Premier Division // Zwift Racing League (men) (A),SRM to Garmin 520,Wahoo Kickr v5 to Zwift,467,470,-3
112307,204402,2021-02-10 17:49:55,wahoo,Zwift - Danmarks Cykle Union & Partners 5/6 (A),SRM to Garmin 520,Wahoo Kickr v5 to Zwift,480,485,-5
115400,204402,2021-02-15 19:22:33,wahoo,Zwift - Premier Division // Zwift Racing League (men) (A),SRM to Garmin 520,Wahoo Kickr v5 to Zwift,457,458,-1
115717,204402,2021-02-16 10:15:42,wahoo,Zwift - ZHQ FutureWorks Crit City Race - Anti-sandbagging (A),SRM to Garmin 520,Wahoo Kickr v5 to Zwift,453,450,3
116716,204402,2021-02-17 18:01:11,wahoo,Zwift - Danmarks Cykle Union & Partners 6/6 (A),SRM to Garmin 520,Wahoo Kickr v5 to Zwift,452,451,1
119151,204402,2021-02-22 18:27:31,wahoo,Zwift - Premier Division // Zwift Racing League (men) (A),SRM to Garmin 520,Wahoo Kickr v5 to Zwift,446,442,4
127146,204402,2021-03-11 18:08:46,wahoo,Zwift - FUSION SPRING CUP (A),SRM to Garmin 520,Wahoo Kickr v5 to Zwift,429,424,5
129223,204402,2021-03-16 17:43:23,wahoo,Zwift - CeramicSpeed Race Series: Open Race (A),SRM to Garmin 520,Wahoo Kickr v5 to Zwift,466,462,4
51696,701096,2020-08-25 17:33:57,neo,Zwift - WTRL Gravel Series (E),Favero Assioma ,Tacx Neo,236,242,-6
64672,701096,2020-10-24 11:21:01,neo,ZADA - Three sisters Dual Recording,Favero Assioma ,Tacx Neo,248,243,5
66948,701096,2020-11-01 09:47:23,neo,Three Sister Zada Test,Favero Assioma ,Tacx Neo,251,245,6
96744,701198,2021-01-12 19:54:03,neo,Zwift - Zwift Racing League | WTRL - Men&#039;s/Mixed EMEA W2 DIVISION 2 (B),Powertap P1,Tacx Neo,301,325,-24
96748,701198,2021-01-12 19:53:34,neo,Zwift - Zwift Racing League | WTRL - Men&#039;s/Mixed EMEA W2 DIVISION 2 (B),Powertap P1,Tacx Neo,301,325,-24
51199,242439,2020-08-22 08:05:03,neo,Zwift - 3R Flat Race - Paris - Lutece Express (A),left side 4iiii,Neo,340,318,22
51279,242439,2020-08-22 16:00:00,wahoo,Zwift - Off The MAAP Stage 3 - Longer Ride with Matt Stephens,left side 4iiii,Kickr,314,323,-9
112747,691334,2021-02-04 18:29:53,wahoo,Zwift - British Cycling Time Trial Series (B),STAGES,Kickr,198,207,-9
75019,704941,2020-11-24 18:10:17,wahoo,Zwift - Zwift Racing League | WTRL - Men&#039;s EMEA E1 DIVISION 1,Assioma Favero Duo,Wahoo Kickr Core,372,346,26
80805,704941,2020-12-08 18:11:03,wahoo,Zwift - Zwift Racing League | WTRL - Men&#039;s EMEA E1 DIVISION 1 (B),Assioma Favero Duo,Wahoo Kickr Core,354,348,6
115861,704941,2021-02-16 18:09:46,wahoo,Zwift - Zwift Racing League | WTRL - Men&#039;s/Mixed EMEA E1 DIVISION 4 (A),Assioma Favero Duo,Wahoo Kickr Core,372,372,0
90428,317323,2021-01-02 19:38:52,wahoo,Assioma - Kickr // Dual Power Check,Assomia_01022021_London,Kickr_01022021_London,278,267,11
124708,317323,2021-03-05 18:58:21,wahoo,Kickr2018 vs Assomio Pedal Power Comparison,Assioma DUO Pedals,6379435144_kickr,257,263,-6
14017,148884,2020-02-14 06:22:40,neo,Zwift - Kick it into the Middle - 90 (RC Version) - Xert,Garmin Vector 3,Tacx Neo,286,295,-9
14277,148884,2020-02-13 18:43:41,neo,Zwift - 02/13/2020,Garmin Vector 3,Tacx Neo,294,314,-20
14278,148884,2020-02-13 06:27:04,neo,Zwift - Watopia,4544736056,Tacx Neo,248,247,1
14279,148884,2020-02-13 06:27:04,neo,Zwift - Watopia,Garmin Vector 3,Tacx Neo,248,247,1
14397,148884,2020-02-17 18:33:58,neo,Zwift - SSI-2xHdSt20x87_94RupRdn,Garmin Vector 3,Tacx Neo,318,325,-7
14451,148884,2020-02-18 06:30:21,neo,Zwift - Kick it into the Middle - 90 (RC Version) - Xert,Garmin Vector 3,Tacx Neo,294,302,-8
14573,148884,2020-02-18 18:38:52,neo,Zwift - SMART - Taxman - Xert,Garmin Vector 3,Tacx Neo,308,317,-9
14637,148884,2020-02-19 06:26:06,neo,Zwift - Kick it into the Middle - 90 (RC Version) - Xert,Garmin Vector 3,Tacx Neo,292,303,-11
14808,148884,2020-02-20 06:25:50,neo,Zwift - Kick it into the Middle 100 (RC further extended Version) - Xert,Garmin Vector 3,Tacx Neo,291,302,-11
15614,148884,2020-02-25 18:38:38,neo,Zwift - Repeated Attacks - Xert,Garmin Vector 3,Tacx Neo,372,380,-8
15668,148884,2020-02-26 05:59:48,neo,Zwift - Kick it into the Middle 100 (RC further extended Version) - Xert,Garmin Vector 3,Tacx Neo,298,302,-4
15821,148884,2020-02-27 06:24:24,neo,Zwift - Kick it into the Middle 100 (RC further extended Version) - Xert,Garmin Vector 3,Tacx Neo,297,303,-6
15905,148884,2020-02-27 18:45:03,neo,Zwift - London,Garmin Vector 3,Tacx Neo,234,237,-3
15969,148884,2020-02-28 06:27:13,neo,Zwift - SMART - Lucy in the Sky with Diamonds - 90 - Xert,Garmin Vector 3,Tacx Neo,278,279,-1
16504,148884,2020-03-02 18:37:08,neo,Zwift - SMART - Taxman - Xert,Garmin Vector 3,Tacx Neo,308,317,-9
16537,148884,2020-03-03 06:29:21,neo,Zwift - SMART - Save Yourself - 120 - Xert,Garmin Vector 3,Tacx Neo,295,288,7
16632,148884,2020-03-03 18:38:59,neo,Zwift - SSI-2xHdSt20x87_94RupRdn,Garmin Vector 3,Tacx Neo,320,324,-4
16729,148884,2020-03-04 06:21:15,neo,Zwift - Oreo Cookie Blues - Xert,Garmin Vector 3,Tacx Neo,316,317,-1
16808,148884,2020-03-04 17:55:04,neo,Zwift - Watopia,Garmin Vector 3,Tacx Neo,275,275,0
16864,148884,2020-03-05 06:23:21,neo,Zwift - SMART - Save Yourself - 120 - Xert,Garmin Vector 3,Tacx Neo,291,289,2
17047,148884,2020-03-06 06:24:06,neo,Zwift - Kick it into the Middle - 90 (RC Version) - Xert,Garmin Vector 3,Tacx Neo,298,302,-4
17389,148884,2020-03-09 19:10:10,neo,Zwift - Stage 1 Race (B) - Tour of Watopia 2020,Garmin Vector 3,Tacx Neo,381,374,7
17427,148884,2020-03-10 06:30:11,neo,Zwift - SMART - Save Yourself - 120 - Xert,Garmin Vector 3,Tacx Neo,290,289,1
17552,148884,2020-03-10 18:43:44,neo,Zwift - SMART - Taxman - Xert,Garmin Vector 3,Tacx Neo,310,316,-6
17624,148884,2020-03-11 06:21:32,neo,Zwift - Kick it into the Middle - 90 (RC Version) - Xert,Garmin Vector 3,Tacx Neo,303,301,2
17719,148884,2020-03-11 18:48:27,neo,Zwift - Watopia,Garmin Vector 3,Tacx Neo,270,272,-2
17758,148884,2020-03-12 06:22:26,neo,Zwift - SMART - Stuck in the Middle - 60 - Xert,Garmin Vector 3,Tacx Neo,304,302,2
17903,148884,2020-03-13 06:21:47,neo,Zwift - Kick it into the Middle - 90 (RC Version) - Xert,Garmin Vector 3,Tacx Neo,298,302,-4
17977,148884,2020-03-12 18:30:35,neo,Zwift - SMART - Lucy in the Sky with Diamonds - 60 - Xert,Garmin Vector 3,Tacx Neo,284,280,4
18312,148884,2020-03-16 18:45:48,neo,Zwift - SMART - Lucy in the Sky with Diamonds - 60 - Xert,Garmin Vector 3,Tacx Neo,279,279,0
18347,148884,2020-03-17 06:21:40,neo,Zwift - SMART - Save Yourself - 120 - Xert,Garmin Vector 3,Tacx Neo,288,289,-1
18463,148884,2020-03-17 19:10:06,neo,Zwift - Stage 3 Race (B) - Tour of Watopia 2020,Garmin Vector 3,Tacx Neo,338,339,-1
18524,148884,2020-03-18 06:19:58,neo,Zwift - SMART - Lucy in the Sky with Diamonds - 90 - Xert,Garmin Vector 3,Tacx Neo,278,274,4
18608,148884,2020-03-18 18:38:22,neo,Zwift - SMART - Lucy in the Sky with Diamonds - 60 - Xert,Garmin Vector 3,Tacx Neo,268,266,2
18640,148884,2020-03-19 06:26:47,neo,Zwift - SMART - Save Yourself - 120 - Xert,Garmin Vector 3,Tacx Neo,291,289,2
44498,148884,2020-07-02 05:28:39,neo,Zwift - Yorkshire,Garmin Vector 3,Tacx Neo,344,338,6
44500,148884,2020-07-02 06:30:12,neo,Zwift - Yorkshire,Garmin Vector 3,Tacx Neo,250,249,1
47539,148884,2020-07-23 05:56:58,neo,Zwift - Virtual Tour de France - A - Stage 6 Discovery Ride,Garmin Vector 3,Tacx Neo,376,366,10
48029,148884,2020-07-28 17:50:59,neo,Zwift - Richmond,Garmin Vector 3,Tacx Neo,304,299,5
48088,148884,2020-07-29 05:45:43,neo,Zwift - Yorkshire,Garmin Vector 3,Tacx Neo,309,311,-2
50748,148884,2020-08-19 17:17:34,neo,Zwift - London,Garmin Vector 3,Tacx Neo,364,367,-3
50811,148884,2020-08-20 05:24:11,neo,Zwift - Opener 3 into Free Ride - Xert,Garmin Vector 3,Tacx Neo,285,283,2
50812,148884,2020-08-20 05:58:58,neo,Zwift - Off The MAAP Stage 2 - Longer Ride,Garmin Vector 3,Tacx Neo,325,319,6
51699,148884,2020-08-25 17:25:54,neo,Zwift - Richmond,Garmin Vector 3,Tacx Neo,320,322,-2
51947,148884,2020-08-26 05:24:25,neo,Zwift - France,Garmin Vector 3,Tacx Neo,303,305,-2
52103,148884,2020-08-27 05:30:16,neo,Zwift - France,Garmin Vector 3,Tacx Neo,343,345,-2
59227,148884,2020-10-03 09:58:48,neo,Zwift Academy Road: Workout 1 | Aerobic Power,PowerTap P1,Tacx Neo,358,361,-3
59254,148884,2020-10-03 12:59:00,neo,Zwift - ZA Road Group Ride (A),PowerTap P1,Tacx Neo,256,253,3
59405,148884,2020-10-04 09:03:50,neo,Zwift - Newbury Velo Road Race (B),PowerTap P1,Tacx Neo,332,328,4
59567,148884,2020-10-05 09:33:43,neo,Zwift - Innsbruck,PowerTap P1,Tacx Neo,299,302,-3
64659,148884,2020-10-24 13:15:55,neo,Zwift - LSD Edit - 120 - Xert,Garmin Vector 3,Tacx Neo,281,283,-2
64847,148884,2020-10-25 09:57:20,neo,Zwift Academy Road: Workout 3 | VO2 Capacity,Garmin Vector 3,Tacx Neo,388,377,11
64849,148884,2020-10-25 11:06:26,neo,Zwift - ZA Road - Race #2 (B),Garmin Vector 3,Tacx Neo,335,327,8
65128,148884,2020-10-26 16:56:43,neo,Zwift - Stuck in the Middle - 60 - Xert,Garmin Vector 3,Tacx Neo,304,306,-2
65754,148884,2020-10-27 10:11:25,neo,Zwift - Watopia,Garmin Vector 3,Tacx Neo,326,329,-3
66083,148884,2020-10-29 15:00:39,neo,Zwift - France,Garmin Vector 3,Tacx Neo,319,316,3
66400,148884,2020-10-30 06:29:50,neo,Zwift - Kick it into the Middle 100 - Xert,Garmin Vector 3,Tacx Neo,297,305,-8
66671,148884,2020-10-31 10:24:09,neo,Zwift - Watopia,Garmin Vector 3,Tacx Neo,326,323,3
66920,148884,2020-11-01 11:12:55,neo,Zwift - Yorkshire,Garmin Vector 3,Tacx Neo,299,291,8
66923,148884,2020-11-01 09:59:41,neo,Zwift - 11/01/2020,Garmin Vector 3,Tacx Neo,273,258,15
66925,148884,2020-11-01 09:29:46,neo,Zwift - Lionel Birnie&#039;s Meetup,Garmin Vector 3,Tacx Neo,253,249,4
67123,148884,2020-11-02 06:26:14,neo,Zwift - LSD  Edit - 90 - Xert,Garmin Vector 3,Tacx Neo,286,278,8
67249,148884,2020-11-02 18:17:45,neo,Zwift - Rowe & King - Monday Mixer,Garmin Vector 3,Tacx Neo,303,299,4
67822,148884,2020-11-03 06:28:28,neo,Zwift - Take Me To Church 90- Xert,Garmin Vector 3,Tacx Neo,293,297,-4
68536,148884,2020-11-06 06:29:55,neo,Zwift - Opener 3 into Free Ride - Xert,Garmin Vector 3,Tacx Neo,306,302,4
68541,148884,2020-11-06 16:59:43,neo,Zwift - Primed FTP,Garmin Vector 3,Tacx Neo,350,345,5
69070,148884,2020-11-08 13:58:37,neo,Zwift - ZA Road 2020 - Segment Ride #1: Three Sisters Course,Garmin Vector 3,Tacx Neo,352,345,7
69221,148884,2020-11-09 06:32:36,neo,Zwift - LSD - 90 edit 2- Xert,Garmin Vector 3,Tacx Neo,273,269,4
69360,148884,2020-11-09 17:43:14,neo,Zwift - KATT Race by WKG (B),Garmin Vector 3,Tacx Neo,328,322,6
69573,148884,2020-11-10 06:56:39,neo,Zwift Academy Road: Workout 6 | Alternative Sprints,Garmin Vector 3,Tacx Neo,294,282,12
69783,148884,2020-11-10 18:14:37,neo,Zwift - 15min Warm-up into Free Ride,Garmin Vector 3,Tacx Neo,301,302,-1
70160,148884,2020-11-11 06:39:00,neo,Zwift - LSD - 90 edit 2- Xert,Garmin Vector 3,Tacx Neo,275,269,6
70301,148884,2020-11-11 18:29:32,neo,Zwift - Stew Downing&#039;s Meetup - 2019 UCI Worlds Harrogate Circuit,Garmin Vector 3,Tacx Neo,289,280,9
70732,148884,2020-11-12 18:29:15,neo,Zwift - WKG Winter League 2020 / 2021  (B),Garmin Vector 3,Tacx Neo,340,331,9
71052,148884,2020-11-13 06:29:37,neo,Zwift - 15min Warm-up into Free Ride,Garmin Vector 3,Tacx Neo,304,302,2
71359,148884,2020-11-14 10:08:40,neo,Zwift - LSD - 90 edit 2- Xert,Garmin Vector 3,Tacx Neo,274,269,5
71615,148884,2020-11-15 10:12:57,neo,Zwift - Garmin Never Stop Cycling // Stage 3 - Gravel // Guest Rider - Meng Yang - Open Category,Garmin Vector 3,Tacx Neo,329,317,12
71863,148884,2020-11-16 06:30:53,neo,Zwift - LSD - 90 edit 2- Xert,Garmin Vector 3,Tacx Neo,277,270,7
72016,148884,2020-11-17 06:55:28,neo,Zwift Academy Road: Workout 7 | VO2 Development,Garmin Vector 3,Tacx Neo,360,358,2
72017,148884,2020-11-16 19:00:02,neo,Zwift - WKG Winter League 2020 / 2021  (B),Garmin Vector 3,Tacx Neo,326,318,8
75347,148884,2020-11-25 06:26:35,neo,Zwift - LSD  Edit - 90 - Xert,PowerTap P1,Tacx Neo,289,278,11
75568,148884,2020-11-25 19:02:53,neo,WKG Winter League 2020 / 2021 ,PowerTap P1,Tacx Neo,388,388,0
75588,148884,2020-11-25 18:17:59,neo,Zwift - Opener 3 into Free Ride - Xert,PowerTap P1,Tacx Neo,282,276,6
75803,148884,2020-11-26 06:29:37,neo,Zwift - LSD - 90 edit 2- Xert,PowerTap P1,Tacx Neo,274,269,5
81152,148884,2020-12-09 18:54:47,neo,Zwift - MINI CRIT by WKG (B),PowerTap P1,Tacx Neo,373,358,15
81378,148884,2020-12-10 06:30:05,neo,Zwift - Save Yourself - 120 - Xert,PowerTap P1,Tacx Neo,306,293,13
107085,148884,2021-02-02 06:30:11,neo,Zwift - Watopia,PowerTap P1,Tacx Neo,269,260,9
107426,148884,2021-02-02 18:35:28,neo,Zwift - UK Armed Forces Cycling Community Race Night (B),PowerTap P1,Tacx Neo,343,330,13
107864,148884,2021-02-03 06:26:30,neo,Zwift - Watopia,PowerTap P1,Tacx Neo,262,252,10
108215,148884,2021-02-03 17:59:17,neo,Zwift - TDZ Stage 7: Longer Ride,PowerTap P1,Tacx Neo,329,317,12
108640,148884,2021-02-04 06:29:32,neo,Zwift - Watopia,PowerTap P1,Tacx Neo,263,252,11
108951,148884,2021-02-04 17:52:55,neo,Zwift - 15min Warm-up into Free Ride,PowerTap P1,Tacx Neo,332,302,30
109214,148884,2021-02-05 06:28:18,neo,Zwift - Watopia,PowerTap P1,Tacx Neo,263,254,9
109890,148884,2021-02-06 10:28:31,neo,Zwift - Cycling Weekly Winter Lockdown RR Series (B),Garmin Vector 3,Tacx Neo,355,341,14
110390,148884,2021-02-07 09:32:26,neo,Zwift - Zwift Fondo Series: Ultima Fondo,Garmin Vector 3,Tacx Neo,317,295,22
110767,148884,2021-02-08 06:28:55,neo,Zwift - Watopia,Garmin Vector 3,Tacx Neo,263,257,6
111015,148884,2021-02-08 17:58:31,neo,Zwift - TDZ Stage 8: Group Ride,Garmin Vector 3,Tacx Neo,289,280,9
111300,148884,2021-02-09 06:28:31,neo,Zwift - Watopia,Garmin Vector 3,Tacx Neo,271,267,4
111661,148884,2021-02-09 18:35:29,neo,Zwift - UK Armed Forces Cycling Community Race Night (B),Garmin Vector 3,Tacx Neo,344,332,12
112019,148884,2021-02-10 06:32:21,neo,Zwift - Watopia,Garmin Vector 3,Tacx Neo,263,257,6
112301,148884,2021-02-10 18:14:15,neo,Zwift - Watopia,Garmin Vector 3,Tacx Neo,286,274,12
112629,148884,2021-02-11 06:30:30,neo,Zwift - Watopia,Garmin Vector 3,Tacx Neo,257,253,4
113291,148884,2021-02-12 06:29:25,neo,Zwift - Watopia,Garmin Vector 3,Tacx Neo,262,250,12
114108,148884,2021-02-13 10:28:29,neo,Zwift - Cycling Weekly Winter Lockdown RR Series (B),Garmin Vector 3,Tacx Neo,360,350,10
114690,148884,2021-02-14 10:29:29,neo,Zwift - ODZentury Sunday Endurance Ride (B),Garmin Vector 3,Tacx Neo,346,339,7
115000,148884,2021-02-15 06:27:13,neo,Zwift - Watopia,Garmin Vector 3,Tacx Neo,260,256,4
115215,148884,2021-02-15 18:05:06,neo,Zwift - Watopia,Garmin Vector 3,Tacx Neo,283,279,4
115588,148884,2021-02-16 06:31:11,neo,Zwift - Watopia,Garmin Vector 3,Tacx Neo,298,287,11
115910,148884,2021-02-16 18:35:26,neo,Zwift - UK Armed Forces Cycling Community Race Night (B),Tacx Neo,Tacx Neo,358,347,11
116371,148884,2021-02-17 06:29:46,neo,Zwift - Watopia,Garmin Vector 3,Tacx Neo,258,254,4
116703,148884,2021-02-17 18:29:20,neo,Zwift - Ian H DCC&#039;s Meetup - Achterbahn,Garmin Vector 3,Tacx Neo,280,292,-12
116995,148884,2021-02-18 06:30:46,neo,Zwift - Watopia,Garmin Vector 3,Tacx Neo,260,256,4
122762,148884,2021-03-02 06:30:26,neo,Zwift - Watopia,PowerTap P1,Tacx Neo,270,258,12
123029,148884,2021-03-02 18:06:52,neo,Zwift - Watopia,PowerTap P1,Tacx Neo,281,271,10
123364,148884,2021-03-03 06:31:22,neo,Zwift - Watopia,PowerTap P1,Tacx Neo,283,269,14
123661,148884,2021-03-03 18:04:53,neo,Zwift - Watopia,PowerTap P1,Tacx Neo,274,264,10
123832,148884,2021-03-04 06:31:54,neo,Zwift - Watopia,PowerTap P1,Tacx Neo,269,259,10
124088,148884,2021-03-04 18:09:19,neo,Zwift - Watopia,PowerTap P1,Tacx Neo,285,274,11
124976,148884,2021-03-05 06:34:05,neo,Zwift - Watopia,Garmin Vector 3,Tacx Neo,263,252,11
125964,148884,2021-03-09 06:30:54,neo,Zwift - Watopia,PowerTap P1,Tacx Neo,269,257,12
126221,148884,2021-03-09 18:05:46,neo,Zwift - 4wk FTP Booster Week 1 Day 1 - HIT 80% FTP #1,PowerTap P1,Tacx Neo,309,306,3
126386,148884,2021-03-10 06:30:18,neo,Zwift - Watopia,PowerTap P1,Tacx Neo,263,251,12
126629,148884,2021-03-10 18:11:36,neo,Zwift - 4wk FTP Booster Week 1 Day 2 - HIT 45sec #1,PowerTap P1,Tacx Neo,325,323,2
126837,148884,2021-03-11 06:32:31,neo,Zwift - Watopia,PowerTap P1,Tacx Neo,271,261,10
127100,148884,2021-03-11 18:15:10,neo,Zwift - 4wk FTP Booster Week 1 Day 3 - Tempo into Sprints,PowerTap P1,Tacx Neo,342,339,3
127353,148884,2021-03-12 06:28:49,neo,Zwift - Watopia,PowerTap P1,Tacx Neo,265,254,11
10534,700044,2020-01-22 23:59:52,neo,Zwift - Tour de Zwift: Stage 3 Group Ride - Long Distance,Stages,Neo,390,388,2
10942,700044,2020-01-25 23:00:00,neo,Zwift - Tour de Zwift: Stage 4 Group Ride - Long Distance,stages,Neo,310,304,6
20108,147461,2020-03-28 08:51:04,neo,Matando O Corpo ZESP,Power2max NG,Tacx Neo,368,359,9
20682,147461,2020-03-30 16:48:35,neo,Zwift - Stage 1 - Longer Ride - Tour of Watopia 2020,Power2max NG,Tacx Neo,365,349,16
92374,660428,2021-01-06 17:30:04,wahoo,Asiomo Favero dual / Wahoo Kickr,Asiomo Favero dual,Wahoo Kickr,284,300,-16
94354,660428,2021-01-10 10:24:36,wahoo,210110a,Asiomo Favero dual,Wahoo Kickr,307,329,-22
94356,660428,2021-01-10 11:01:05,wahoo,210110b,Asiomo Favero dual,Wahoo Kickr,252,271,-19
120024,549943,2021-02-23 12:23:16,wahoo,Zwift - Drop Out kurz vorm Ziel....,Favero Assioma Uno,Wahoo Kickr,316,298,18
71256,736506,2020-11-14 08:35:20,wahoo,Zwift - London Dynamo Park Ride (E),Assioma Duo,Smart Kickr,223,206,17
71665,736506,2020-11-15 13:10:15,wahoo,Zwift - Women Only: 2020 El Giro de Rigo - Shorter Route,Assioma Duo,Kickr,209,203,6
72561,736506,2020-11-17 19:22:45,wahoo,Zwift - Zwift Racing League | WTRL - Women&#039;s EMEA W1 DIVISION 1 (A),Assioma Duo,Kickr (section without dropouts) ,215,207,8
73100,736506,2020-11-19 18:36:52,wahoo,Zwift - Vienna,Assioma Duo,Kickr,232,220,12
73785,736506,2020-11-21 08:30:18,wahoo,Zwift - London Dynamo Park Ride (E),Assioma Duo,Kickr,220,214,6
75193,736506,2020-11-24 19:14:39,wahoo,Zwift - Zwift Racing League | WTRL - Women&#039;s EMEA W1 DIVISION 1,2020-11-24-19-14-39,Kickr,206,217,-11
76091,736506,2020-11-26 18:43:01,wahoo,Zwift - WTRL NOPINZ WORLD TTT CHAMPIONSHIPS - Zone 6 (E),Assioma Duo,Kickr,233,226,7
90070,736506,2021-01-02 08:30:01,wahoo,Zwift - London Dynamo Park Ride (E),Assioma Duo,Kickr,197,195,2
117466,736506,2021-02-18 18:51:49,wahoo,Zwift - Frappe,Assioma Duo,Kickr,225,215,10
98697,726143,2021-01-17 19:26:18,wahoo,Zwift - Paris,Smarttap,Wahoo Kickr,311,311,0
99168,726143,2021-01-18 19:20:16,wahoo,Zwift - Team TFC Mad Monday Winter Series (A),Smarttap,Wahoo Kickr,314,313,1
103012,726143,2021-01-25 19:19:59,wahoo,Zwift - Team TFC Mad Monday Winter Series (A),Smarttap,Wahoo Kickr,299,301,-2
111164,726143,2021-02-08 19:19:59,wahoo,Zwift - Team TFC Mad Monday Winter Series (A),PowerTap Dual,Wahoo Kickr,327,328,-1
116731,726143,2021-02-17 18:44:56,wahoo,Zwift - Danmarks Cykle Union & Partners 6/6 (A),PowerTap Dual,Wahoo Kickr,360,359,1
118428,726143,2021-02-20 08:04:59,wahoo,Zwift - 3R Weekend Race Club - Race 1 (A),PowerTap Dual,Wahoo Kickr,364,368,-4
119432,726143,2021-02-22 19:19:58,wahoo,Zwift - Team TFC Mad Monday Winter Series (A),PowerTap Dual,Wahoo Kickr,348,349,-1
120381,726143,2021-02-24 18:44:30,wahoo,Zwift - Scandinavian Cup 2021 - Round 1 - Men (A),PowerTap Dual,Wahoo Kickr,351,341,10
125856,726143,2021-03-08 19:19:56,wahoo,Zwift - Team TFC Mad Monday Race Series (high-end categories) (A),PowerTap Dual,Wahoo Kickr,368,369,-1
67330,727590,2020-10-29 23:46:06,wahoo,Zwift - Vienna,PowerTap P2 Pedals,Wahoo Kickr,262,266,-4
67759,727590,2020-11-04 00:48:01,wahoo,Zwift - Zwift Racing League | WTRL - Women&#039;s AMERICAS E DIVISION 1 (A),PowerTap P2 Pedals,Wahoo Kickr,269,272,-3
72413,727590,2020-11-18 00:39:29,wahoo,Zwift - Zwift Racing League | WTRL - Women&#039;s AMERICAS E DIVISION 1 (A),PowerTap P2 Pedals,Wahoo Kickr,258,255,3
73313,727590,2020-11-20 00:43:30,neo,Zwift - Vienna,PowerTap P2 Pedals,Neo,255,242,13
75275,727590,2020-11-25 00:30:00,neo,Zwift - Zwift Racing League | WTRL - Women&#039;s AMERICAS E DIVISION 1,PowerTap P2 Pedals,Neo,273,270,3
75992,727590,2020-11-26 17:59:00,neo,Zwift - WTRL NOPINZ WORLD TTT CHAMPIONSHIPS - Zone 3 (E),PowerTap P2 Pedals,Neo,258,254,4
78278,727590,2020-12-02 00:39:31,neo,Zwift - Zwift Racing League | WTRL - Women&#039;s AMERICAS E DIVISION 1 (A),PowerTap P2 Pedals,Neo,276,268,8
79214,727590,2020-12-04 00:48:02,neo,Zwift - WTRL Team Time Trial - Zone 10 (E),PowerTap P2 Pedals,Neo,263,255,8
83769,727590,2020-12-16 00:39:31,neo,Zwift - Zwift Racing League | WTRL - Women&#039;s AMERICAS E DIVISION 1 (A),PowerTap P2 Pedals,Neo,273,265,8
84573,727590,2020-12-18 00:40:59,neo,Zwift - WTRL Team Time Trial - Zone 10 (E),PowerTap P2 Pedals,Neo,262,258,4
85965,727590,2020-12-09 00:30:00,neo,Zwift - Zwift Racing League | WTRL - Women&#039;s AMERICAS E DIVISION 1 (A),PowerTap P2 Pedals,Neo,283,283,0
95197,727590,2021-01-11 19:18:28,neo,Zwift - Premier Division // Zwift Racing League (women) (A),PowerTap P2 Pedals,Neo,304,279,25
99090,727590,2021-01-18 18:26:33,neo,Zwift - Premier Division // Zwift Racing League (women) (A),PowerTap P2 Pedals,Neo,267,258,9
103054,727590,2021-01-25 19:19:17,neo,Zwift - Premier Division // Zwift Racing League (women) (A),PowerTap P2 Pedals,Neo,294,283,11
106802,727590,2021-02-01 18:26:00,neo,Zwift - Premier Division // Zwift Racing League (women) (A),PowerTap P2 Pedals,Neo,293,281,12
111125,727590,2021-02-08 19:18:22,neo,Zwift - Premier Division // Zwift Racing League (women) (A),PowerTap P2 Pedals,Neo,287,277,10
115293,727590,2021-02-15 18:29:12,neo,Zwift - Premier Division // Zwift Racing League (women) (A),PowerTap P2 Pedals,Neo,295,289,6
119231,727590,2021-02-22 19:32:34,neo,Zwift - Premier Division // Zwift Racing League (women) (A),PowerTap P2 Pedals,Neo,263,260,3
122517,727590,2021-03-01 18:38:47,neo,Zwift - Premier Division // Zwift Racing League (women) (A),PowerTap P2 Pedals,Neo,268,263,5
51126,204713,2020-08-21 17:29:58,wahoo,Zwift - 4wk FTP Booster Week 2 Day 6 - Tempo with accelerations #2,Giant Power Pro,Wahoo Kickr Core,255,241,14
69249,204713,2020-11-04 18:30:00,wahoo,Zwift - FTP Test (shorter),Giant Power Pro,Wahoo Kickr Core,370,347,23
109455,204713,2021-02-05 18:00:21,wahoo,Zwift - Aquecimento pré prova,Giant Power Pro,Wahoo Kickr Core,351,328,23
110396,204713,2021-02-07 09:36:11,wahoo,Zwift - Watopia,Giant Power Pro,Wahoo Kickr Core,295,273,22
111213,204713,2021-02-08 18:00:01,wahoo,Zwift - TDZ Stage 8: Group Ride,Giant Power Pro,Wahoo Kickr Core,217,197,20
113570,204713,2021-02-12 18:34:59,wahoo,Zwift - Newbury Velo Crit (A),Giant Power Pro,Wahoo Kickr Core,347,327,20
116113,204713,2021-02-16 18:32:29,wahoo,Zwift - TDZ Stage 3: Standard Ride,Giant Power Pro,Wahoo Kickr Core,345,323,22
117854,204713,2021-02-19 18:37:36,wahoo,Zwift - TT Warm up - 18h10,Giant Power Pro,Wahoo Kickr Core,363,343,20
120473,204713,2021-02-24 18:30:00,wahoo,Zwift - 3R Race - France Petit Boucle - 45KM (A),Giant Power Pro,Wahoo Kickr Core,342,317,25
122684,204713,2021-03-01 18:00:00,wahoo,Zwift - Carlos Matias (CFB Triatlo)&#039;s Meetup - Everything Bagel,Giant Power Pro,Wahoo Kickr Core,245,222,23
123723,204713,2021-03-03 19:01:16,wahoo,Zwift - Zwift NL Race Day (B),Giant Power Pro,Wahoo Kickr Core,365,338,27
126712,204713,2021-03-10 18:29:26,wahoo,Zwift - 3R Race - France Petit Boucle - 45KM (B),Giant Power Pro,Wahoo Kickr Core,336,325,11
6423,725699,2019-12-14 18:05:15,wahoo,3R Three Sisters Hilly Race (A),Assioma,Kickr,299,314,-15
9598,725699,2020-01-15 17:00:09,wahoo,Tour De Zwift: Stage 1 Long Distance,Assioma,Kickr,326,315,11
9748,725699,2020-01-17 05:00:18,wahoo,Zwift - SAS - Friday Fush & Chups (C),Assioma,Kickr,254,248,6
12307,725699,2020-02-03 17:30:23,wahoo,Tour De Zwift Stage 6 Long Distance,Assioma,Kickr,294,286,8
16517,725699,2020-02-11 17:04:57,wahoo,Fang Mountain +1,Assioma,Kickr,281,285,-4
16691,725699,2020-03-02 16:51:50,wahoo,A & R,Assioma,Kickr,270,287,-17
16692,725699,2020-03-03 16:33:49,wahoo,Mount Alyeska +1,Assioma,Kickr,277,296,-19
16811,725699,2020-03-04 12:29:38,wahoo,Zwift Riders Germany Recovery Ride ,Assioma,Kickr,198,203,-5
17505,725699,2020-03-09 16:43:47,wahoo,Basin,Assioma,Kickr,299,307,-8
19896,725699,2020-03-27 05:00:18,wahoo,SAS Friday Fush & Chups (C),Assioma,Kickr,268,258,10
21846,725699,2020-04-03 05:00:18,wahoo,SAS Friday Fush & Chups - Dropout and Chase!,Assioma,Kickr,261,263,-2
21848,725699,2020-04-03 18:00:19,wahoo,Haute Route Watopia Stage 1,Assioma,Kickr,294,292,2
22414,725699,2020-04-05 18:00:06,wahoo,Zwift -  Haute Route Watopia Stage 3 (E),Assioma,Kickr,298,302,-4
23918,725699,2020-04-12 00:16:53,wahoo,PRL Half,Assioma,Kickr,268,270,-2
24117,725699,2020-04-12 19:45:01,wahoo,SAS Sub 2.5 (C),Assioma,Kickr,168,169,-1
24999,725699,2020-04-15 18:33:14,wahoo,Deeside Thistle and Moray Firth APR Race (A),Assioma,Kickr,288,289,-1
25443,725699,2020-04-17 06:00:19,wahoo,Zwift - SAS - Friday Fush & Chups (C),Assioma,Kickr,243,244,-1
25685,725699,2020-04-17 20:11:28,wahoo,Zwift - Ashley Dawson Ⓥ (VZT)&#039;s Meetup - Figure 8 Reverse,Assioma,Kickr,293,297,-4
26517,725699,2020-04-20 04:06:28,wahoo,Zwift - Team Italy Morning Early Ride (D),Assioma,Kickr,177,188,-11
49918,725699,2020-08-14 06:07:55,wahoo,Zwift - SAS - Fush & Chups (C),Assioma,Kickr,203,201,2
50196,725699,2020-08-15 18:39:47,wahoo,Antelope,Assioma,Kickr,268,267,1
50198,725699,2020-08-15 23:05:00,wahoo,Ascenders 3.0 ,Assioma,Kickr,216,207,9
51045,725699,2020-08-21 06:00:00,wahoo,SAS Friday Fush n Chups,Assioma/Zwift,Kickr,235,224,11
51147,725699,2020-08-22 00:15:57,wahoo,Off The MAAP Stage 3 - Longer Ride,Assioma,Kickr,279,262,17
51584,725699,2020-08-24 17:47:41,wahoo,London,Assioma,Kickr,252,245,7
54219,725699,2020-09-09 18:00:52,wahoo,Zwift - Watopia,Assioma,Kickr V5,197,200,-3
54660,725699,2020-09-11 21:15:58,wahoo,Zwift - TBR 101 - Endurance (C),Assioma,Kickr V5,270,260,10
56950,725699,2020-09-21 18:05:23,wahoo,France,Assioma,Kickr V5,260,259,1
57120,725699,2020-09-23 18:03:39,wahoo,Zwift - Watopia,Assioma,Kickr V5,199,194,5
61374,725699,2020-10-12 21:17:34,wahoo,Zwift - Watopia,Assioma,Kickr V5,304,290,14
63628,725699,2020-10-19 17:04:58,wahoo,Zwift - Watopia,Assioma,Kickr,301,293,8
66321,725699,2020-10-29 20:59:17,wahoo,Zwift - SAS FUSH & CHUPS (C),Assioma,Kickr V5,218,210,8
73280,725699,2020-11-18 16:59:17,wahoo,Zwift - EVO CC Mini Vamos! 90 Min Ride Cat C [~2.8-3.2w/kg avg] (C),Assioma,Kickr V5,198,193,5
73284,725699,2020-11-17 17:12:15,wahoo,Zwift - Summit City Zwift League Endurance Ride,Assioma,Kickr V5,288,273,15
74059,725699,2020-11-22 01:00:22,wahoo,Zwift - Herd Beginner Racing Series (E),Assioma/Zwift,Kickr V5,312,297,15
77166,725699,2020-11-29 00:59:55,wahoo,HERD Beginner Racing Series (E),Assioma,Kickr V5,336,325,11
85280,725699,2020-12-20 00:59:56,wahoo,Zwift - Herd Beginner Racing Series (E),Assioma/Zwift,Kickr V5,332,320,12
86607,725699,2020-12-23 17:25:47,wahoo,Zwift - Watopia,Assioma/Zwift,Kickr V5,201,193,8
87295,725699,2020-12-25 22:49:54,wahoo,Zwift - Watopia,Assioma/Zwift,Kickr V5,309,296,13
87575,725699,2020-12-26 17:43:20,wahoo,Zwift - Watopia,Assioma/Zwift,Kickr V5,242,233,9
87660,725699,2020-12-27 01:00:13,wahoo,Zwift - Herd Beginner Racing Series (E),Assioma/Zwift,Kickr V5,357,351,6
88824,725699,2020-12-29 23:53:14,wahoo,Zwift - Watopia,Assioma/Zwift,Kickr V5,282,280,2
89102,725699,2020-12-30 17:15:10,wahoo,Zwift - L3GION & Tekkerz + Rapha Festive 500  (C),Assioma/Zwift,Kickr V5,200,197,3
89982,725699,2021-01-01 22:50:12,wahoo,Zwift - Herd Beginner Racing Series (E),Assioma/Zwift,Kickr V5,368,360,8
89985,725699,2021-01-01 20:48:43,wahoo,Zwift - Watopia,Assioma/Zwift,Kickr V5,305,301,4
90364,725699,2021-01-02 17:11:45,wahoo,Zwift - The HERD Rehab Ride (D),Assioma/Zwift,Kickr V5,258,253,5
93069,725699,2021-01-07 21:00:24,wahoo,Zwift - TDZ Stage 1: Longer Ride,Assioma/Zwift,Kickr V5,204,200,4
98325,725699,2021-01-17 00:32:07,wahoo,Zwift - Herd Beginner Racing Series,Assioma/Zwift,Kickr V5,355,349,6
101629,725699,2021-01-19 17:26:35,wahoo,Zwift - Watopia,Assioma Duo,Kickr V5,199,197,2
102121,725699,2021-01-24 01:00:08,wahoo,Herd Beginner Racing Series (E),Assioma Duo,Kickr V5,355,351,4
103879,725699,2021-01-27 03:02:38,wahoo,WTRL Racing League (A),Assioma Duo,Kickr V5,365,367,-2
117469,725699,2021-02-18 17:21:03,wahoo,Zwift - TDZ Stage 8: Group Ride,Assioma Duo,Kickr V5,270,257,13
118538,725699,2021-02-20 23:55:16,wahoo,Zwift - Herd Beginner Racing Series (E),Assioma Duo,Kickr V5,357,363,-6
121930,725699,2021-02-28 01:00:15,wahoo,Herd BeginnerRacing Series (E),Assioma Duo,Kickr V5,401,388,13
122957,725699,2021-03-02 17:25:07,wahoo,Zwift - Watopia,Assioma Duo,Kickr V5,209,207,2
124569,725699,2021-03-05 17:34:43,wahoo,Zwift - Watopia,Assioma Duo,Kickr V5,203,196,7
125596,725699,2021-03-07 22:19:05,wahoo,Zwift - Watopia,Assioma Duo,Kickr V5,307,301,6
128519,725699,2021-03-12 17:46:03,wahoo,Zwift - Watopia,Assioma Duo,Kickr V5,258,260,-2
128862,725699,2021-03-15 21:41:23,wahoo,Zwift - Watopia,Assioma Duo,Kickr V5,300,299,1
54541,685122,2020-09-10 17:48:42,neo,WTRL TTT Frappe,Assioma Duo,Neo OG,432,450,-18
55219,685122,2020-09-14 17:34:08,neo,Tacx Neo OG / Assioma Duo,Assioma Duo,Tacx Neo OG,479,458,21
55484,685122,2020-09-16 06:23:57,neo,C-E,Assioma Duo,Neo OG,453,452,1
56074,685122,2020-09-17 18:16:39,neo,Quals #2,Assioma Duo,Tacx Neo OG,466,461,5
56680,685122,2020-09-21 18:09:49,neo,Neo Og vs Vector 3,Garmin Vector 3,Neo OG,403,404,-1
82150,656633,2020-12-12 04:49:18,neo,NeoStageTest,stage_v_neo,neo_v_stages,230,237,-7
82151,656633,2020-12-12 09:00:56,neo,Neo V Stages 8pm,StagesNeo8,NeoStages8,230,237,-7
48305,710447,2020-07-30 09:16:49,wahoo,The Lamb Chop p/b Black Sheep (A),Rotor Xplova,Kickr,325,332,-7
48466,710447,2020-08-01 00:59:35,wahoo,Zwift - Norseman Festival of Climbing: Ride #5 (E),Rotor Xplova,Kickr,334,337,-3
49262,710447,2020-08-08 05:30:00,wahoo,Zwift - XRS Races - The Saturday Classic (A),Rotor Xplova,Kickr,394,400,-6
81386,710447,2020-12-10 08:30:23,wahoo,KISS Race Series - Down Under,Rotor Xplova,Kickr,300,303,-3
82148,710447,2020-12-12 05:05:01,wahoo,3R Watopia Hilly Reverse Race - 3 Laps (27.5km/17.1mi 300m),Rotor Xplova,Kickr,324,310,14
82999,710447,2020-12-14 04:09:58,wahoo,Zwift - 3R Watopia Flat Route Race - 4 Laps (40.5km/25.1mi 216m) (A),Rotor Xplova,Kickr,361,355,6
96167,710447,2021-01-13 08:30:17,wahoo,Zwift - Flanders Endurance Series (E),Rotor Xplova,Kickr,333,334,-1
107017,710447,2021-02-01 23:35:03,wahoo,Zwift - 3R 50km LONDON-Greater London Flat Race (52km/32.4mi) (A),Rotor Xplova,Kickr,342,339,3
108517,710447,2021-02-04 00:00:26,wahoo,Zwift - Open - Movistar Team Challenge Community Qualifier Race #2,Rotor Xplova,Kickr,364,367,-3
111902,710447,2021-02-10 00:14:16,wahoo,Zwift - Bike Surgeon Cycling Chasing Daylight Series (A),Rotor Xplova,Kickr,298,301,-3
112552,710447,2021-02-10 23:05:16,wahoo,Zwift - 3R Volcano Flat Reverse 50k Race - 4 Laps (48.8km/30.7mi 184m) (A),Rotor Xplova,Kickr,341,346,-5
112553,710447,2021-02-11 00:44:15,wahoo,Zwift - ZHR Hare & Hounds (A),Rotor Xplova,Kickr,296,292,4
119328,710447,2021-02-22 23:35:14,wahoo,Zwift - 3R 50km LONDON-Greater London Flat Race (52km/32.4mi) (A),Rotor Xplova,Kickr,314,341,-27
119942,710447,2021-02-24 00:14:01,wahoo,Zwift - Bike Surgeon Cycling Chasing Daylight Series (A),Rotor Xplova,Kickr,307,314,-7
120518,710447,2021-02-25 01:15:04,wahoo,Zwift - Bullseye Points Race by Herd Racing League (A),Rotor Xplova,Kickr,328,331,-3
120519,710447,2021-02-25 00:00:15,wahoo,Zwift - EVR Definitely Not the WTNC (A),Rotor Xplova,Kickr,342,337,5
120980,710447,2021-02-26 00:00:24,wahoo,Zwift - Haute Route Watopia 2021 Stage 1 (A),Rotor Xplova,Kickr,361,366,-5
121352,710447,2021-02-27 00:00:01,wahoo,Zwift - Haute Route Watopia 2021 Stage 2 (A),Rotor Xplova,Kickr,351,355,-4
121936,710447,2021-02-28 01:00:14,wahoo,Zwift - Haute Route Watopia 2021 Stage 3 (A),Rotor Xplova,Kickr,347,349,-2
122323,710447,2021-03-01 09:15:14,wahoo,Zwift - 3R Watopia Flat Route Race - 4 Laps (41km/25.5mi 216m) (A),Rotor Xplova,Kickr,308,310,-2
122805,710447,2021-03-02 09:20:10,wahoo,Zwift - The After Party Race (A),Rotor Xplova,Kickr,397,402,-5
123787,710447,2021-03-04 01:05:14,wahoo,(signal lost few secs) Cycling Canada Wednesday Night Race Series (A),Rotor Xplova,Kickr,368,370,-2
124733,710447,2021-03-06 00:05:06,wahoo,Zwift - 3R & ZID Merdeka La Reine Hilly Race - Round 3 of 4 (A),Rotor Xplova,Kickr,356,364,-8
125705,710447,2021-03-08 11:30:14,wahoo,Zwift - 3R Innsbruckring Flat Race - 3 Laps (26.4km/16.4mi 231m) (A),Rotor Xplova,Kickr,329,335,-6
129896,710447,2021-03-18 00:30:12,wahoo,Zwift - Austin Driveway Series Criterium (A),Rotor Xplova,Kickr,303,303,0
109397,638820,2021-02-03 18:19:09,wahoo,Zwift - Danmarks Cykle Union & Partners 4/6 (A),Power2Max,Wahoo Kickr v5,418,419,-1
110464,638820,2021-02-06 08:56:06,wahoo,Zwift - DBR SufferDay League III (A),Power2Max,Wahoo Kickr v5,417,421,-4
112443,638820,2021-02-10 17:55:50,wahoo,Zwift - Danmarks Cykle Union & Partners 5/6 (A),Power2Max,Wahoo Kickr v5,440,445,-5
114056,638820,2021-02-13 09:19:12,wahoo,Zwift - DBR SufferDay League III (A),Power2Max,Wahoo Kickr v5,432,430,2
117014,638820,2021-02-17 09:14:52,wahoo,Zwift - Danmarks Cykle Union & Partners 6/6 (A),Power2Max,Wahoo Kickr v5,408,395,13
120698,638820,2021-02-24 18:32:06,wahoo,Zwift - Scandinavian Cup 2021 - Round 1 - Men (A),Power2Max,Wahoo Kickr v5,425,414,11
123703,638820,2021-03-03 18:18:26,wahoo,Zwift - Scandinavian Cup 2021 - Round 2 - Men (A),Gaint Wattmåler,Wahoo Kickr v5,449,434,15
126829,638820,2021-03-10 18:27:52,wahoo,Zwift - Scandinavian Cup 2021 - Round 3 - Men (A),Gaint Wattmåler,Wahoo Kickr v5,448,423,25
21651,679852,2020-04-03 06:51:25,neo, Haute Route Watopia Stage 1,Garmin Vector 3,Tacx Neo,373,375,-2
21652,679852,2020-03-31 11:55:56,neo,Zwift - Stage 2 Race (A) - Tour of Watopia 2020,Garmin Vector 3,Tacx Neo,382,375,7
6198,399270,2019-12-13 22:47:53,wahoo,Kickr18 Test / Indoor Sprint Crash,Assioma Duo (Comparison),Kickr18 (Zwift),292,283,9
6261,399270,2019-12-14 15:07:22,wahoo,Zwift - OH CRIT!! - Saturday Smash Series (A),Assioma Duo (Comparison),Kickr18 (Zwift),347,338,9
6638,399270,2019-12-18 18:52:28,wahoo,Zwift - DBR HEINO CUP (A),Assioma Duo (Zwift),Kickr18 (Comparison),421,413,8
6753,399270,2019-12-19 19:54:50,wahoo,Zwift - Lamb Chop Series  (A),Assioma Duo (Zwift),Kickr18 (Comparison),387,378,9
54491,719003,2020-09-10 10:35:01,wahoo,Zwift - Japan ZWIFT Hill Climb Race (A),Assioma,kickr core,306,310,-4
54668,719003,2020-09-11 23:10:49,wahoo,ASIA 120km Endurance Ride,Assioma,kickr core,272,265,7
62412,719003,2020-10-15 10:34:49,wahoo,Zwift - Japan ZWIFT Hill Climb Race (A),Assioma,kickr core,310,302,8
64738,719003,2020-10-20 11:09:46,wahoo,Zwift - Japan Zwift Tuesday Race (A),Assioma,kickr core,299,312,-13
65387,719003,2020-10-26 09:14:46,wahoo,Zwift - 3R Watopia Flat Route Race - 4 Laps (41km/25.5mi 216m) (A),Assioma,kickr core,299,286,13
65388,719003,2020-10-27 11:09:53,wahoo,Zwift - Japan Zwift Tuesday Race (A),Assioma,kickr core,258,256,2
74420,719003,2020-11-22 23:05:15,wahoo,Zwift - 3R Achterbahn Climbing Race (47.4km/29.5mi 988m) (A),Assioma,kickr core,301,298,3
99594,719003,2021-01-19 08:56:01,wahoo,Zwift - Zwift Racing League | WTRL - Men&#039;s/Mixed APAC DIVISION 2 (A),Assioma,kickr core,291,302,-11
102159,719003,2021-01-21 10:34:48,wahoo,Zwift - Japan ZWIFT Hill Climb Race (A),Assioma,kickr core,301,320,-19
102161,719003,2021-01-23 22:55:41,wahoo,Zwift - 3R & TWELVE Squared 144 Challenge (A),Assioma,kickr core,304,317,-13
104531,719003,2021-01-26 10:33:48,wahoo,Zwift - Japan Zwift Tuesday Race (A),Assioma,kickr core,320,326,-6
104532,719003,2021-01-27 09:29:23,wahoo,Zwift - TDZ Stage 5: Longer Ride,Assioma,kickr core,301,298,3
104534,719003,2021-01-28 10:22:19,wahoo,Zwift - Japan ZWIFT Hill Climb Race (A),Assioma,kickr core,311,314,-3
105073,719003,2021-01-29 09:59:52,wahoo,Zwift - TDZ Stage 6: Longer Ride,Assioma,kickr core,276,270,6
106594,719003,2021-02-01 10:03:10,wahoo,Zwift - TDZ Stage 6: Shorter Ride,Assioma,kickr core,208,206,2
106596,719003,2021-01-31 06:15:02,wahoo,Zwift - 3R Gotham Grind Flat Race - 2 Laps (18.5km/11.6mi 58m) (A),Assioma,kickr core,272,273,-1
106599,719003,2021-01-31 05:05:12,wahoo,Zwift - 3R Volcano Flat Race - 3 Laps (36.6km/22.7mi 138m) (A),Assioma,kickr core,276,275,1
107178,719003,2021-02-02 08:45:53,wahoo,Zwift - Zwift Racing League | WTRL - Men&#039;s/Mixed APAC DIVISION 2 (A),Assioma,kickr core,308,308,0
107179,719003,2021-02-02 10:01:59,wahoo,Zwift - TDZ Stage 6: Standard Ride,Assioma,kickr core,227,221,6
108707,719003,2021-02-04 10:35:01,wahoo,Zwift - Japan ZWIFT Hill Climb Race (A),Assioma,kickr core,305,306,-1
109649,719003,2021-02-06 06:29:51,wahoo,Zwift - XRS Races - The Saturday Classic (A),Assioma,kickr core,305,306,-1
110330,719003,2021-02-07 08:03:02,wahoo,Zwift - TDZ Stage 7: Shorter Ride,Assioma,kickr core,277,286,-9
111333,719003,2021-02-09 08:55:58,wahoo,Zwift - Zwift Racing League | WTRL - Men&#039;s/Mixed APAC DIVISION 2 (A),Assioma,kickr core,315,308,7
111337,719003,2021-02-09 08:02:59,wahoo,Zwift - TDZ Stage 8: Group Ride,Assioma,kickr core,191,195,-4
111343,719003,2021-02-09 09:53:00,wahoo,Zwift - Peel Cycling - Morning Chase (A),Assioma,kickr core,275,279,-4
114610,719003,2021-02-14 06:29:54,wahoo,Zwift - XRS Races: a Longer and Hard race (A),Assioma,kickr core,322,318,4
115658,719003,2021-02-16 08:47:18,wahoo,Zwift - Zwift Racing League | WTRL - Men&#039;s/Mixed APAC DIVISION 2 (A),Assioma,kickr core,284,285,-1
118096,719003,2021-02-19 22:05:28,wahoo,Zwift - PartyAnimal 80 palapala #1 (B),Assioma,kickr core,294,293,1
119395,719003,2021-02-23 08:45:40,wahoo,Zwift - Zwift Racing League | WTRL - Men&#039;s/Mixed APAC DIVISION 2 (A),Assioma,kickr core,271,268,3
123901,719003,2021-03-04 10:34:28,wahoo,Zwift - Japan ZWIFT Hill Climb Race (A),Assioma,kickr core,323,325,-2
124762,719003,2021-03-06 06:29:51,wahoo,Zwift - XRS Races - The Saturday Classic (A),Assioma,kickr core,297,298,-1
125300,719003,2021-03-07 05:04:54,wahoo,Zwift - 3R Volcano Flat Race - 3 Laps (36.6km/22.7mi 138m) (A),Assioma,kickr core,232,231,1
126030,719003,2021-03-09 11:10:06,wahoo,Zwift - Japan Zwift Tuesday Race (A),Assioma,kickr core,282,294,-12
126873,719003,2021-03-11 10:35:14,wahoo,Zwift - Japan ZWIFT Hill Climb Race (A),Assioma,kickr core,320,328,-8
127696,719003,2021-03-13 06:29:49,wahoo,Zwift - XRS Races - The Saturday Classic (A),Assioma,kickr core,301,301,0
128997,719003,2021-03-16 11:09:52,wahoo,Zwift - Japan Zwift Tuesday Race (A),Assioma,kickr core,270,275,-5
31780,703388,2020-05-05 18:39:55,wahoo,Zwift - 3R Spring Loaded Race Series - Round 6of6 (A),4iiii Precision 2.0 Shimano 105,Wahoo Kickr 18,400,410,-10
34088,703388,2020-05-12 18:39:58,wahoo,Zwift - 3R & Wahoo Ride Real Race Series - Round 1 of 7 (A),4iiii Precision 2.0 Shimano 105,Kickr 18 - Bolt,348,361,-13
34396,703388,2020-05-13 17:55:02,wahoo,Zwift - USA Cycling Race League by Indoor Specialist (A),4iiii Precision 2.0 Shimano 105,Kickr 18 - Bolt,390,407,-17
36133,703388,2020-05-19 18:39:56,wahoo,Full Whack! - 3R & Wahoo Ride Real Race Series - Round 2 of 7 (A),4iiii Precision 2.0 Shimano 105,Kickr 18 - Bolt,388,397,-9
124397,733554,2021-03-05 11:32:13,wahoo,Zwift - dual rec baseline,Assioma,Kickr,248,269,-21
124577,733554,2021-03-05 19:34:49,wahoo,Zwift - calibrate,Assioma,Kickr,276,261,15
126015,733554,2021-03-09 10:53:35,wahoo,Zwift - ac-w3-m2,Assioma,Kickr,273,251,22
105355,727576,2021-01-27 00:27:49,wahoo,Zwift - Zwift Racing League | WTRL - Men&#039;s/Mixed AMERICAS E DIVISION 1 (B),PowerTap P1 Pedals,Wahoo Kickr 2021,359,361,-2
60255,518974,2020-10-08 08:57:18,wahoo,Zwift - WTRL Team Time Trial - Zone 2 (C),Assioma,Kickr Core,259,267,-8
64330,518974,2020-10-22 09:01:43,wahoo,Zwift - Frappe,Assioma,Kickr Core,296,297,-1
69226,518974,2020-11-08 06:55:48,wahoo,Zwift - Zwift Fondo Series 2020/21: Gran Fondo ,Assioma,Kickr Core,291,301,-10
86958,518974,2020-12-24 10:04:51,wahoo,Zwift - WTRL Team Time Trial - Zone 2 (C),Assioma,Kickr Core,268,277,-9
96072,518974,2021-01-12 17:45:36,wahoo,Zwift Racing League WTRL EMEA E1 DIV 2,Assioma,Kickr Core,304,306,-2
110560,518974,2021-02-07 06:38:59,wahoo,Zwift - SZR Aktivitus 2h 2021.5,Assioma,Kickr Core,266,275,-9
110583,518974,2021-02-06 07:47:36,wahoo,Zwift - Herd Beginner Racing Series (E),Assioma,Kickr Core,269,277,-8
110592,518974,2021-02-02 17:52:16,wahoo,Zwift - Zwift Racing League | WTRL - Men&#039;s/Mixed EMEA E1 DIVISION 2 (A),Assioma,Kickr Core,326,330,-4
110879,518974,2021-02-08 05:14:23,wahoo,Zwift - EVO CC Vortex Interval Ride [~3-3.8w/kg avg] (B),Assioma,Kickr Core,267,280,-13
124510,518974,2021-03-05 12:43:41,wahoo,Zwift - Zwift Fast Fridays: Tempus Fugit Time Trial (E),Assioma,Kickr Core,300,298,2
124017,736243,2021-03-04 18:00:58,wahoo,Zwift - 03/04/2021,p2m s-type,Kickr Core,283,281,2
127122,736243,2021-03-11 18:57:18,wahoo,Zwift - Flanders The BZR Ronde Spring Classics League (A),p2m NGeco,Kickr Core,420,427,-7
39551,745808,2020-06-02 16:41:30,neo,Zwift - Watopia,Vector 3,Neo,178,194,-16
40025,745808,2020-06-06 12:28:38,neo,Zwift - Watopia - Tacx Neo 60798 - 75 rpm,Vector 3,Tacx Neo 60798,195,204,-9
105983,724812,2021-01-30 16:30:35,neo,Zwift - Veganuary21 Stage 5 iTT (B),Precision 4iiii,Tacx Neo,333,331,2
110603,762149,2021-02-07 16:32:01,wahoo,kickr v5 / Assioma duo,Assioma duo,kickr v5,316,313,3
49156,772194,2020-08-07 03:04:47,wahoo,Zwift - 3R Greater London Flat Race - 2 Laps (28.5km/17.7mi 90m) (A),Dura ace power meter,Kickr,354,369,-15
102648,772194,2021-01-25 02:59:52,wahoo,Zwift - TDZ Stage 5: Longer Ride,Assioma duo,Kickr,343,362,-19
129188,772194,2021-03-16 18:30:17,wahoo,Zwift - CeramicSpeed Race Series: Open Race (A),Assioma duo,Kickr,388,395,-7
28683,771995,2020-04-28 11:10:22,wahoo,Zwift - Crit City Slam Race // Zwift Classic (A),garmin vector 3,Wahoo kickr (zwift),407,394,13
31582,771995,2020-05-05 13:23:52,wahoo,Zwift - Crit City Race (A),Garmin vector 3,Wahoo kickr,408,418,-10
48286,771995,2020-07-30 11:09:50,wahoo,Zwift - EMU Japan Short Race (A),Stages,Wahoo kickr,409,413,-4
51400,771995,2020-08-23 17:13:20,wahoo,Zwift - 3R Greater London 8 Hilly Race - 1 Lap (23.8km/14.8mi 238m) (A),Stages,Wahoo kickr,435,436,-1
99036,771995,2021-01-18 17:52:36,wahoo,Zwift -  DBR Monday Race (A),Stages,Wahoo kickr,380,406,-26
119076,771995,2021-02-22 17:55:14,wahoo,Zwift -  DBR Monday Race (A),power2max,Wahoo kickr,380,390,-10
126925,771995,2021-03-11 10:38:18,wahoo,Zwift - KISS Race Series - Americas AM (A),power2max,Wahoo kickr,391,405,-14
127932,771995,2021-03-13 12:44:55,wahoo,Zwift - WTRL Racing (A),power2max,Wahoo kickr,429,446,-17
129914,771995,2021-03-17 18:29:53,wahoo,Zwift - 3R Race - France Petit Boucle - 45KM (A),power2max,Wahoo kickr,367,383,-16
41320,27060,2020-06-13 01:29:57,wahoo,Zwift - 3R LaGuardia Loop Reverse Flat Race - 6 Laps (19.1km/11.9 162m) (A),Favero Assioma Duo,KICKR18 (MY2019),281,278,3
41569,27060,2020-06-14 05:28:00,wahoo,Zwift - XRS Races: a Longer and Hard race (A),Favero Assioma Duo,KICKR18 (MY2019),302,303,-1
41766,27060,2020-06-15 07:56:21,wahoo,Zwift - SAS- Pi & Sauce (C),Favero Assioma Duo,KICKR18 (MY2019),204,205,-1
43899,27060,2020-06-28 07:28:29,wahoo,Very easy intervals,Favero Assioma Duo,KICKR18 (MY2019),166,166,0
44755,27060,2020-07-04 03:55:32,wahoo,Zwift - Zwift Fondo 2020 Series (Southern Hemisphere) (C),Favero Assioma Duo,KICKR18 (MY2019),277,275,2
45195,27060,2020-07-07 08:12:11,wahoo,Knickerbocker,Favero Assioma Duo,KICKR18 (MY2019),232,225,7
45750,27060,2020-07-10 08:34:28,wahoo,Zwift - Crit City Race (A),Favero Assioma Duo,KICKR18 (MY2019),283,277,6
46099,27060,2020-07-13 01:33:21,wahoo,Road to Ruins sprints,Favero Assioma Duo,KICKR18 (MY2019),170,171,-1
46551,27060,2020-07-16 08:50:47,wahoo,Rookie errors,Favero Assioma Duo,KICKR18 (MY2019),292,289,3
46903,27060,2020-07-19 05:57:00,wahoo,Zwift - L&#039;Etape du Tour Stage 3 - Open,Favero Assioma Duo,KICKR18 (MY2019),289,284,5
47089,27060,2020-07-21 00:42:52,wahoo,Zwift - TFC Mad Monday Summer Series (3 of 10) (A),Favero Assioma Duo,KICKR18 (MY2019),289,286,3
47716,27060,2020-07-26 08:31:54,wahoo,Mighty Metropolitan,Favero Assioma Duo,KICKR18 (MY2019),289,280,9
48537,27060,2020-08-02 03:14:03,wahoo,Zwift - 3R Watopia Flat Route Race - 3 Laps (30.3km/18.8mi 162m) (A),Favero Assioma Duo,KICKR18 (MY2019),286,286,0
49017,27060,2020-08-06 09:13:01,wahoo,Zwift - The Lamb Chop p/b Black Sheep (A),Favero Assioma Duo,KICKR18 (MY2019),285,283,2
49342,27060,2020-08-09 04:57:01,wahoo,Zwift - KISS at Race 100 - EU (A),Favero Assioma Duo,KICKR18 (MY2019),264,267,-3
49526,27060,2020-08-11 08:26:46,wahoo,Zwift - Aero Army Wyn TT Series (A),Favero Assioma Duo,KICKR18,291,289,2
50640,27060,2020-08-19 07:56:01,wahoo,Zwift - Off The MAAP Stage 2 Race (A),Favero Assioma Duo,KICKR18 (MY2019),288,284,4
51048,27060,2020-08-21 07:53:34,wahoo,Zwift - Off The MAAP Stage 3 Race (A),Favero Assioma Duo,KICKR18 (MY2019),286,281,5
52709,27060,2020-08-30 23:04:08,wahoo,3R Achterbahn Climbing Race (47.4km/29.5mi 988m) (A),Favero Assioma Duo,KICKR18 (MY2019),278,275,3
52805,27060,2020-09-01 00:15:17,wahoo,Zwift - The Bump Sprint Race (A),Favero Assioma Duo,KICKR18 (MY2019),279,273,6
53318,27060,2020-09-03 22:58:03,wahoo,Zwift - Koa Sports League Warrior Race (A),Favero Assioma Duo,KICKR18 (MY2019),274,270,4
54296,27060,2020-09-10 09:13:47,wahoo,Zwift - Cycling Australia&#039;s The Chop by AHDR (A),Favero Assioma Duo,KICKR18 (MY2019),272,270,2
54495,27060,2020-09-10 23:41:20,wahoo,Zwift - Crit City Race (A),Favero Assioma Duo,KICKR18 (MY2019),277,274,3
57596,27060,2020-09-26 02:09:08,wahoo,Zwift - EVR America West (A),Favero Assioma Duo,KICKR18 (MY2019),256,255,1
57871,27060,2020-09-27 08:59:58,wahoo,Zwift - Newbury Velo Road Race (A) - Nothing after half way,Favero Assioma Duo,KICKR18 (MY2019),276,270,6
58148,27060,2020-09-29 04:00:52,wahoo,Zwift - 3R Innsbruckring Flat Race - 3 Laps (26.4km/16.4mi 231m) (A),Favero Assioma Duo,KICKR18 (MY2019),303,285,18
60204,27060,2020-10-08 05:00:06,wahoo,Zwift - 3R Flat Race - FRANCE - Casse-Pattes - 1 Laps (A),Favero Assioma Duo,KICKR18 (MY2019),326,307,19
60475,27060,2020-10-08 21:06:26,wahoo,Zwift - ZA Road Race #1: 4 - 5 w/kg,Favero Assioma Duo,KICKR18 (MY2019),263,255,8
60894,27060,2020-10-11 01:35:59,wahoo,Zwift Academy Road: Workout 3 | VO2 Capacity,Favero Assioma Duo,KICKR18 (MY2019),295,291,4
61106,27060,2020-10-12 08:52:36,wahoo,Zwift - MET-5 Race (A),Favero Assioma Duo,KICKR18 (MY2019),243,245,-2
66366,27060,2020-10-30 10:02:52,wahoo,Zwift - ZA Road - Race #2 (A),Favero Assioma Duo,KICKR18 (MY2019),289,279,10
69568,27060,2020-11-10 05:50:10,wahoo,Zwift Academy Tri: Bike Workout 3 | VO2max Short Intervals,Favero Assioma Duo,KICKR18 (MY2019),265,263,2
70026,27060,2020-11-11 04:25:41,wahoo,Chill spin,Favero Assioma Duo,KICKR18 (MY2019),149,147,2
70508,27060,2020-11-12 09:05:40,wahoo,Zwift - Koa Sports League Race (A),Favero Assioma Duo,KICKR18 (MY2019),264,272,-8
70951,27060,2020-11-13 03:34:05,wahoo,Zwift - ZA Tri: TT Race - 40k,Favero Assioma Duo,KICKR18 (MY2019),253,263,-10
75122,27060,2020-11-24 19:10:25,wahoo,Zwift Academy Tri:  Bike Workout 5 | VO2max Long Intervals,Favero Assioma Duo,KICKR V4 (2019),242,241,1
75786,27060,2020-11-26 08:16:45,wahoo,Zwift - The Chop by AHDR (A),Favero Assioma Duo,KICKR V4 (2019),284,281,3
76374,27060,2020-11-27 08:00:59,wahoo,Zwift - 3R Lagurdia Super Sprint Race - 1 Lap (3.7km/2.6mi 27m) (A),Favero Assioma Duo,KICKR V4 (2019),287,280,7
76588,27060,2020-11-27 18:56:25,wahoo,Zwift - Focus: Colours of PARI - Shorter Ride,Favero Assioma Duo,KICKR V4 (2019),265,258,7
76717,27060,2020-11-28 06:56:50,wahoo,Zwift - Focus: Colours of PARI - Shorter Ride,Favero Assioma Duo,KICKR V4 (2019),267,273,-6
77189,27060,2020-11-29 06:55:35,wahoo,Zwift - Focus: Colours of PARI - Longer Ride,Favero Assioma Duo,KICKR V4 (2019),268,278,-10
77880,27060,2020-12-01 08:48:15,wahoo,Zwift - Zwift Racing League | WTRL - Men&#039;s APAC DIVISION 1 (A),Favero Assioma Duo,KICKR V4 (2019),301,311,-10
79199,27060,2020-12-04 01:57:55,wahoo,ZHQ FutureWorks Circuit Race - Anti-sandbagging,Favero Assioma Duo,KICKR V4 (2019),262,270,-8
79974,27060,2020-12-06 03:07:26,wahoo,Zwift - 3R Watopia Flat Route Race - 3 Laps (30.3km/18.8mi 162m) (A),Favero Assioma Duo,KICKR V4 (2019),256,266,-10
80642,27060,2020-12-08 08:40:04,wahoo,Zwift - Zwift Racing League | WTRL - Men&#039;s APAC DIVISION 1 (A),Favero Assioma Duo,KICKR V4 (2019),286,290,-4
82609,27060,2020-12-13 06:05:36,wahoo,Zwift - XRS Races: a Longer and Hard race (A),Favero Assioma Duo,KICKR V4 (2019),287,289,-2
83358,27060,2020-12-15 08:32:39,wahoo,Zwift - Zwift Racing League | WTRL - Men&#039;s APAC DIVISION 1 (A),Favero Assioma Duo,KICKR V4 (2019),280,295,-15
85636,27060,2020-12-21 02:56:07,wahoo,Zwift - Tour of New York Stage 3 - Open Longer,Favero Assioma Duo,KICKR V4 (2019),270,276,-6
86371,27060,2020-12-23 08:25:11,wahoo,Zwift - Climbers Day p/b dPAC.fit & Precision Hydration (A),Favero Assioma Duo,KICKR V4 (2019),285,285,0
88417,27060,2020-12-29 02:25:04,wahoo,Four Horsemen,Favero Assioma Duo,KICKR V4 (2019),228,218,10
89180,27060,2020-12-30 19:56:18,wahoo,Race abandoned - need to get to work,Favero Assioma Duo,KICKR V4 (2019),281,272,9
90473,27060,2021-01-03 01:06:31,wahoo,Zwift - 3R Volcano Circuit Flat Race - 4 Laps (18.9km/11.7mi 80m) (A),Favero Assioma Duo,KICKR V4 (2019),259,261,-2
91968,27060,2021-01-05 21:52:45,wahoo,Zwift - TDZ Stage 1: Longer Ride,Favero Assioma Duo,KICKR V4 (2019),204,202,2
94241,27060,2021-01-10 07:18:38,wahoo,Zwift - CANYON ESPORTS LEQP BADGE HUNTER TAKEOVER (C),Favero Assioma Duo,KICKR V4 (2019),223,214,9
95365,27060,2021-01-12 08:22:08,wahoo,Zwift - Zwift Racing League | WTRL - Men&#039;s/Mixed APAC DIVISION 1 (A),Favero Assioma Duo,KICKR V4 (2019),317,294,23
96705,27060,2021-01-14 06:50:09,wahoo,Zwift - TDZ Stage 2: Longer Ride,Favero Assioma Duo,KICKR V4 (2019),224,216,8
97625,27060,2021-01-15 21:47:56,wahoo,Zwift - Tour de Oz - Men&#039;s Stage 1 ,Favero Assioma Duo,KICKR V4 (2019),279,269,10
98326,27060,2021-01-17 00:58:41,wahoo,Zwift - TDZ Stage 3: Shorter Ride,Favero Assioma Duo,KICKR V4 (2019),226,213,13
98829,27060,2021-01-18 05:11:49,wahoo,Serpentine 8,Favero Assioma Duo,KICKR V4 (2019),150,149,1
99453,27060,2021-01-19 08:34:05,wahoo,Zwift - Zwift Racing League | WTRL - Men&#039;s/Mixed APAC DIVISION 1 (A),Favero Assioma Duo,KICKR V4 (2019),271,269,2
103227,27060,2021-01-26 08:27:33,wahoo,Zwift - Zwift Racing League | WTRL - Men&#039;s/Mixed APAC DIVISION 1 (A),Favero Assioma Duo,KICKR V4 (2019),298,288,10
103864,27060,2021-01-27 05:01:41,wahoo,Zwift - TDZ Stage 5: Shorter Ride,Favero Assioma Duo,KICKR V4 (2019),231,227,4
106004,27060,2021-01-31 07:01:32,wahoo,Zwift - TDZ Stage 6: Standard Ride,Favero Assioma Duo,KICKR V4 (2019),248,236,12
107107,27060,2021-02-02 08:31:18,wahoo,Zwift - Zwift Racing League | WTRL - Men&#039;s/Mixed APAC DIVISION 1 (A),Favero Assioma Duo,KICKR V4 (2019),303,293,10
112022,27060,2021-02-10 07:59:56,wahoo,Zwift - TDZ Stage 8: Group Ride,Favero Assioma Duo,KICKR V4 (2019),201,198,3
114486,27060,2021-02-14 05:23:04,wahoo,Zwift - TDZ Stage 7: Shorter Ride,Favero Assioma Duo,KICKR V4 (2019),240,238,2
115600,27060,2021-02-16 08:37:02,wahoo,Zwift - Zwift Racing League | WTRL - Men&#039;s/Mixed APAC DIVISION 1 (A),Favero Assioma Duo,KICKR V4 (2019),300,293,7
116774,27060,2021-02-17 19:00:42,wahoo,Zwift - Zwift Duathlon League - Bike,Favero Assioma Duo,KICKR V4 (2019),262,256,6
119377,27060,2021-02-23 08:31:57,wahoo,Zwift - Zwift Racing League | WTRL - Men&#039;s/Mixed APAC DIVISION 1 (A),Favero Assioma Duo,KICKR V4 (2019),278,280,-2
120541,27060,2021-02-25 02:47:54,wahoo,Zwift - Zwift Duathlon League - Bike (B),Favero Assioma Duo,KICKR V4 (2019),272,271,1
122259,27060,2021-02-28 22:55:00,wahoo,Zwift - Haute Route Watopia 2021 Stage 3 (A),Favero Assioma Duo,KICKR V4 (2019),265,270,-5
122790,27060,2021-03-02 08:44:58,wahoo,Zwift - Zwift Racing League | WTRL - Men&#039;s/Mixed APAC DIVISION 1 (A),Favero Assioma Duo,KICKR V4 (2019),268,272,-4
123875,27060,2021-03-04 09:52:31,wahoo,Petit Boucle,Favero Assioma Duo,KICKR V4 (2019),163,164,-1
38772,776835,2020-05-24 21:16:02,wahoo,Zwift - The Wringer,Zwift,KICKR18,323,317,6
26892,43895,2020-04-22 08:05:55,neo,Race + Intervals (Neo vs Vector),Vector,Neo,289,281,8
27200,43895,2020-04-23 08:29:59,neo,Neo / Vector,Vector,Neo,281,286,-5
37524,427114,2020-05-19 17:16:24,neo,Zwift - Tour for All Invitational Race // Women (Sooooo dead),Favero Assioma Duo,Tacx Neo,286,271,15
37561,427114,2020-05-25 08:57:23,neo,Zwift - HWC Pedal Mafia Social Ride (Donut sprints),Favero Assioma Duo,Tacx Neo,173,164,9
37863,427114,2020-05-26 17:09:58,neo,Zwift - Tour for All Invitational Race // Women (A as in Absolutely useless),Favero Assioma Duo,Tacx Neo,291,272,19
38013,427114,2020-05-27 08:52:40,neo,Zwift - AHDR p/b Giant (Birthday Katie for Giantess),Favero Assioma Duo,Tacx Neo,285,268,17
38516,427114,2020-05-29 09:00:18,neo,"Zwift - AHDRL Redback Race (team podium in A, GC win)",Favero Assioma Duo,Tacx Neo,258,249,9
38692,427114,2020-05-30 14:25:44,neo,"Crit City Race (8th in B, 1st woman overall)",Favero Assioma Duo,Tacx Neo,279,262,17
42172,427114,2020-06-17 14:24:06,neo,Zwift - Crit City Race (Experiment),Favero Assioma Duo,Tacx Neo,287,270,17
44173,427114,2020-06-30 08:24:42,neo,Zwift - SRAM Send it Series - Race 8 - Women&#039;s (E),Favero Assioma Duo,Tacx Neo,292,293,-1
45419,427114,2020-07-07 17:33:58,neo,Zwift - WTRL Empowerment Series (E),Favero Assioma Duo,Tacx Neo,286,270,16
46335,427114,2020-07-14 17:14:39,neo,Zwift - WTRL Empowerment Series (3rd),Favero Assioma Duo,Tacx Neo,284,263,21
47599,427114,2020-07-24 17:30:44,neo,Zwift - Tour De Boudicca (A),Favero Assioma Duo,Tacx Neo,293,271,22
48182,427114,2020-07-29 17:42:53,neo,USA Cycling Race League for TURBO (6th),Favero Assioma Duo,Tacx Neo,276,252,24
50385,427114,2020-08-17 08:24:52,neo,Off the MAAP Invitational Race // Stage 2 (Women),Favero Assioma Duo,Tacx Neo,289,274,15
72049,427114,2020-11-16 19:35:20,wahoo,Zwift - Premier Division // Zwift Racing League (women) - course recon ,Favero Assioma Duo,Kickr 603c,237,225,12
96424,818481,2021-01-13 17:42:58,wahoo,Zwift - TDZ Stage 2: Standard Ride,Wii,Kickr v5,287,292,-5
126688,818481,2021-03-10 18:04:00,wahoo,Zwift - 3R Race - France Petit Boucle - 45KM (B),Wii,Kickr v5,287,303,-16
106423,800272,2021-01-31 20:28:19,wahoo,Zwift - Richmond,Favero to Edge 1030,Wahoo Kickr to Zwift,291,303,-12
106883,800272,2021-02-01 19:47:00,wahoo,Zwift - Premier Division // Zwift Racing League (men) (A),Favero to Edge 1030,Wahoo Kickr to Zwift,390,382,8
110970,800272,2021-02-08 19:13:05,wahoo,Zwift - Premier Division // Zwift Racing League (men) (A),Favero to Edge 1030,Wahoo Kickr to Zwift,393,386,7
115346,800272,2021-02-15 19:58:00,wahoo,Zwift - Premier Division // Zwift Racing League (men) (A),Favero to Edge 1030,Wahoo Kickr to Zwift,406,420,-14
122540,800272,2021-03-01 19:57:00,wahoo,Zwift - Premier Division // Zwift Racing League (men) (A),Favero to Edge 1030,Wahoo Kickr to Zwift,375,369,6
48184,363993,2020-07-29 18:24:59,wahoo,Zwift - Deeside Thistle and Moray Firth Race (B),Assioma Duo,Kickr,341,328,13
49738,363993,2020-08-12 18:24:58,wahoo,Zwift - Deeside Thistle and Moray Firth Race (B),Assioma Duo,Kickr,332,323,9
10759,805190,2020-01-24 11:08:33,wahoo,Zwift - Tour de Zwift: Stage 4 Race (B),Favero Assioma Duo,Wahoo Kickr,304,297,7
12116,805190,2020-02-02 11:08:33,wahoo,Zwift - Tour de Zwift: Stage 6 Race (B),Favero Assioma Duo,Wahoo Kickr,298,288,10
12248,805190,2020-02-02 19:08:19,wahoo,Zwift - Tour de Zwift: Stage 6 Race (B),Favero Assioma Duo,Wahoo Kickr,300,292,8
12790,805190,2020-02-06 18:58:34,wahoo,Zwift - KALAS Cup - Round 2 (B),Favero Assioma Duo,Wahoo Kickr,310,303,7
12896,805190,2020-02-07 11:08:25,wahoo,Zwift - Tour de Zwift: Stage 7 Race (B),Favero Assioma Duo,Wahoo Kickr,310,304,6
15451,805190,2020-02-24 18:12:16,wahoo,Zwift - DBR Winter Cup (B),Favero Assioma Duo,Wahoo Kickr,310,305,5
17214,805190,2020-03-07 13:42:37,wahoo,Zwift - WTRL Winter Racing League - Series 2 STAGE 4 (B),Favero Assioma Duo,Wahoo Kickr,301,288,13
17425,805190,2020-03-09 18:11:21,wahoo,Zwift - DBR Winter Cup (B),Favero Assioma Duo,Wahoo Kickr,297,290,7
17577,805190,2020-03-10 19:10:30,wahoo,Zwift - Feltet.dk Race Series (B),Favero Assioma Duo,Wahoo Kickr,291,280,11
21543,805190,2020-04-02 17:56:41,wahoo,Zwift - KALAS Cup - Round 10 (B),Favero Assioma Duo,Wahoo Kickr,301,298,3
69787,805190,2020-11-10 18:09:43,wahoo,Zwift - Zwift Racing League | WTRL - EMEA E1 (MEN) -  Division 1 (B),Favero Assioma Duo,Wahoo Kickr,314,305,9
78396,805190,2020-12-01 18:22:23,wahoo,Zwift - Zwift Racing League | WTRL - Men&#039;s EMEA E2 DIVISION 2 (B),Favero Assioma Duo,Wahoo Kickr,284,279,5
79157,805190,2020-12-03 18:20:36,wahoo,Zwift - FUSION DECEMBER CUP (B),Favero Assioma Duo,Wahoo Kickr,288,272,16
81083,805190,2020-12-08 18:06:56,wahoo,Zwift - Zwift Racing League | WTRL - Men&#039;s EMEA E1 DIVISION 1 (B),Favero Assioma Duo,Wahoo Kickr,309,297,12
96721,805190,2021-01-13 18:35:48,wahoo,Zwift - Danmarks Cykle Union & Partners 1/6 (B),Favero Assioma Duo,Wahoo Kickr,297,288,9
98043,805190,2021-01-16 09:18:42,wahoo,Zwift - DBR SufferDay League III (B),Favero Assioma Duo,Wahoo Kickr,280,276,4
103705,805190,2021-01-26 18:07:38,wahoo,Zwift - Zwift Racing League | WTRL - Men&#039;s/Mixed EMEA E1 DIVISION 1 (B),Favero Assioma Duo,Wahoo Kickr,291,281,10
104308,805190,2021-01-27 18:37:44,wahoo,Zwift - Danmarks Cykle Union & Partners 3/6 (B),Favero Assioma Duo,Wahoo Kickr,321,312,9
105994,805190,2021-01-30 09:20:30,wahoo,Zwift - DBR SufferDay League III (B),Favero Assioma Duo,Wahoo Kickr,278,272,6
107610,805190,2021-02-02 18:06:54,wahoo,Zwift - Zwift Racing League | WTRL - Men&#039;s/Mixed EMEA E1 DIVISION 1 (B),Favero Assioma Duo,Wahoo Kickr,294,277,17
117635,805190,2021-02-16 18:08:53,wahoo,Zwift - Zwift Racing League | WTRL - Men&#039;s/Mixed EMEA E1 DIVISION 1 (B),Favero Assioma Duo,Wahoo Kickr,310,302,8
125247,805190,2021-03-05 18:53:51,wahoo,Zwift - Zwift Racing League | WTRL Division Championships - Men&#039;s Points Race (A),Favero Assioma Duo,Wahoo Kickr,284,278,6
129350,805190,2021-03-16 18:23:05,wahoo,Zwift - CeramicSpeed Race Series: Open Race (B),Favero Assioma Duo,Wahoo Kickr,271,263,8
125984,795200,2021-03-09 08:45:00,wahoo,Zwift - WTRL Racing (B),Assioma DUO,Kickr V5,419,411,8
56768,281491,2020-09-21 07:59:59,wahoo,Zwift - DR Test (New Wahoo Kickr 2018 + Assiomas),Assiomas,Kickr,310,298,12
31371,106059,2020-05-04 17:53:59,neo,Zwift - Yorkshire,Favero,Neo,301,304,-3
117679,95405,2021-02-19 12:15:20,wahoo,Zwift - TDZ Stage 2: Longer Ride,Stages PM,KICKR Trainer,366,354,12
118631,95405,2021-02-21 10:00:14,wahoo,Zwift - Climbers Day p/b dPAC.fit & Precision Hydration (B),Stages PM,KICKR Trainer,344,325,19
121442,95405,2021-02-27 09:07:24,wahoo,Zwift - 3R Endurance Series p/b OTE Sports (B),Stages PM,KICKR Trainer,349,339,10
122330,95405,2021-03-01 11:19:27,wahoo,Zwift - DIRT Monday Morning Blues Ride (C),Stages PM,KICKR Trainer,287,275,12
122780,95405,2021-03-02 08:56:08,wahoo,Zwift - Zwift Racing League | WTRL - Men&#039;s/Mixed APAC DIVISION 1 (B),Stages PM,KICKR Trainer,335,330,5
123429,95405,2021-03-03 11:20:00,wahoo,Zwift - 3R Volcano Circuit Flat Race - 6 Laps (27km/16.8mi 120m) (B),Stages PM,KICKR Trainer,334,326,8
125379,95405,2021-03-07 12:31:13,wahoo,Zwift - ZHQ FutureWorks Crit City Race - Anti-sandbagging (B),Stages PM,KICKR Trainer,372,357,15
128652,95405,2021-03-15 11:19:57,wahoo,Zwift - Crit City Race (A),Stages PM,KICKR Trainer,355,340,15
84725,430101,2020-12-18 14:34:12,neo,Vector / NEO,Vector,NEO,215,199,16
86104,430101,2020-12-22 14:16:04,neo,Vector / NEO,Vector,NEO,212,195,17
86482,430101,2020-12-23 14:21:49,neo,Vector / NEO,Vector,NEO,275,259,16
87801,430101,2020-12-27 12:10:07,neo,Vector / NEO,Vector,NEO,207,189,18
89377,430101,2020-12-31 11:45:44,neo,Vector / NEO,Vector,NEO,266,255,11
90277,430101,2021-01-02 15:15:44,neo,Vector / NEO,Vector,NEO,274,263,11
90569,430101,2021-01-03 09:42:39,neo,Vector / NEO,Vector,NEO,253,241,12
91701,430101,2021-01-05 14:18:15,neo,Vector / NEO,Vector,NEO,240,224,16
92789,430101,2021-01-07 15:50:33,neo,Vector / NEO,Vector,NEO,245,237,8
93979,430101,2021-01-09 16:04:19,neo,Vector / NEO,Vector,NEO,268,258,10
94507,430101,2021-01-10 15:14:39,neo,Vector / NEO,Vector,NEO,257,247,10
95536,430101,2021-01-12 14:24:15,neo,Vector / NEO,Vector,NEO,245,241,4
98485,430101,2021-01-17 11:39:52,neo,Vector New / NEO,Vector New,NEO,263,241,22
108265,430101,2021-02-03 18:35:08,neo,Vector2 / NEO,Vector2,NEO,303,288,15
111484,430101,2021-02-09 17:03:08,neo,Assioma Favero uno / NEO,Assioma Favero uno,NEO,178,168,10
112327,430101,2021-02-10 18:35:00,neo,Assioma Favero uno / NEO,Assioma Favero uno,NEO,307,288,19
112786,430101,2021-02-11 14:12:09,neo,Assioma Favero uno / NEO,Assioma Favero uno,NEO,252,238,14
34503,755713,2020-05-14 00:44:49,wahoo,Zwift - USA Cycling Race League by Indoor Specialist (A),Pioneer L,Kickr,384,396,-12
36499,755713,2020-05-21 00:44:54,wahoo,Zwift - USA Cycling Race League by Indoor Specialist (A),Pioneer L,Kickr,387,383,4
54246,755713,2020-09-09 23:29:51,wahoo,Zwift - Austin Driveway Series Criterium (A),Pioneer L,Kickr,354,347,7
57135,755713,2020-09-23 23:29:50,wahoo,Zwift - Austin Driveway Series Criterium (A),Pioneer L,Kickr,381,382,-1
58654,755713,2020-09-30 23:29:40,wahoo,Zwift - Austin Driveway Series Criterium (A),Pioneer L,Kickr,358,360,-2
60189,755713,2020-10-07 23:29:58,wahoo,Zwift - Austin Driveway Series Criterium (A),Pioneer L,Kickr,367,372,-5
68642,755713,2020-11-06 18:59:53,wahoo,Zwift - TFC Autumn Race Series (A),Pioneer L,Kickr,411,405,6
69998,755713,2020-11-11 00:45:08,wahoo,Zwift - Zwift Racing League | WTRL - AMERICAS E (MEN) -  Division 1 (A),Pioneer L,Kickr,433,418,15
70418,755713,2020-11-12 01:05:09,wahoo,Zwift - Cycling Canada Wednesday Night Race Series (A),Pioneer L,Kickr,371,379,-8
72796,755713,2020-11-19 01:04:51,wahoo,Zwift - Cycling Canada Wednesday Night Race Series (A),Pioneer L,Kickr,392,391,1
81299,755713,2020-12-10 00:30:12,wahoo,Zwift - Austin Driveway Series Criterium (A),Pioneer L,Kickr,346,346,0
81300,755713,2020-12-09 00:45:21,wahoo,Zwift - Zwift Racing League | WTRL - Men&#039;s AMERICAS E DIVISION 1 (A),Pioneer L,Kickr,346,360,-14
87953,755713,2020-12-27 18:00:00,wahoo,Zwift - Alex TenElshof [Finesse]&#039;s Meetup - Three Sisters,Assioma,Kickr,395,395,0
94989,755713,2021-01-11 19:14:34,wahoo,Zwift - Premier Division // Zwift Racing League (men) (A),Assioma,Kickr,382,374,8
100567,755713,2021-01-21 01:04:49,wahoo,Zwift - Cycling Canada Wednesday Night Race Series (A),Assioma,Kickr,380,376,4
102908,755713,2021-01-25 19:04:22,wahoo,Zwift - Premier Division // Zwift Racing League (men) (A),Assioma,Kickr,410,401,9
104369,755713,2021-01-28 01:04:59,wahoo,Zwift - Cycling Canada Wednesday Night Race Series (A),Assioma,Kickr,413,410,3
106911,755713,2021-02-01 20:06:44,wahoo,Zwift - Premier Division // Zwift Racing League (men) (A),Assioma,Kickr,381,385,-4
108522,755713,2021-02-04 01:04:23,wahoo,Zwift - Lance Watson Championship Intervals,Assioma,Kickr,374,374,0
112370,755713,2021-02-10 19:00:21,wahoo,Zwift - Movistar Team Challenge // Round 1 (A),Assioma,Kickr,364,371,-7
113625,755713,2021-02-12 18:59:06,wahoo,Zwift - Movistar Team Challenge // Round 1 (men),Assioma,Kickr,414,407,7
119111,755713,2021-02-22 19:08:46,wahoo,Zwift - Premier Division // Zwift Racing League (men) (A),Assioma,Kickr,345,349,-4
120708,755713,2021-02-25 17:04:01,wahoo,Zwift - OH MY CRIT!! - The Double Race 2/2 (A),Assioma,Kickr,384,386,-2
129882,755713,2021-03-18 00:04:13,wahoo,Zwift - Cycling Canada Wednesday Night Race Series (A),Assioma,Kickr,388,384,4
61186,796021,2020-10-12 17:16:15,neo,Zwift - DBR Ride´N´Roll League (B),SRAM S975 Quarq,Tacx Neo 1,394,369,25
85820,183967,2020-12-21 18:31:29,wahoo,#273 - Zwift - Team CLS Racing - Fast &#039;n&#039; Festive S7 (C),Assioma Duo,Wahoo Kickr,333,321,12
86255,183967,2020-12-22 19:16:47,wahoo,#274 - Work done for the year :) 2,Assioma Duo,Wahoo Kickr,348,339,9
86943,183967,2020-12-24 11:33:08,wahoo,#276 - Coco Christmas Rollout,Assioma Duo,Wahoo Kickr,231,222,9
12270,29613,2020-02-03 17:10:01,wahoo,Zwift - Tour de Zwift: Stage 6 Race (A),Wahoo kickr recorded from garmin 810,Wahoo Kickr 2015,337,340,-3
112131,29613,2021-02-10 11:44:58,wahoo,10.02 2h dual recording P1 vs Wahoo kickr,p1,Wahoo Kickr 2015,273,291,-18
112186,29613,2021-02-10 17:06:49,wahoo,p1 vs wahoo po naciagnieciu paska 10.02,p1,Wahoo Kickr 2015,187,197,-10
112645,29613,2021-02-11 08:18:37,wahoo,11.02 P1 vs wahoo,p1,Wahoo Kickr 2015,248,252,-4
113427,29613,2021-02-12 14:54:30,wahoo,Zwift - Kompensacja 1h,p1,Wahoo Kickr 2015,163,173,-10
113868,29613,2021-02-13 10:00:01,wahoo,Zwift - Cycling Ireland One Day Classic - Scratch Race (A),p1,Wahoo Kickr 2015,324,332,-8
114634,29613,2021-02-14 09:09:56,wahoo,tlen 14.02,p1,Wahoo Kickr 2015,224,234,-10
116317,29613,2021-02-16 18:19:24,wahoo,WTRL 16.02,p1,Wahoo Kickr 2015,303,324,-21
119445,29613,2021-02-23 11:07:38,wahoo,Zwift - 3-4x8&#039; z5,p1,Wahoo Kickr 2015,339,345,-6
120167,29613,2021-02-24 11:44:21,wahoo,"WT 24.02, OVAL",p1,Wahoo Kickr 2015,233,244,-11
35197,815325,2020-05-16 07:05:23,wahoo,Zwift - 3R Watopia Magnificent 8 Race - 1 Lap (A),Garmin Vector Pedal,Wahoo Kickr Power,305,305,0
35198,815325,2020-05-16 07:04:01,wahoo,Zwift - 3R Watopia Magnificent 8 Race - 1 Lap (A),Garmin Vector Pedal,Wahoo Kickr Power,316,305,11
36145,815325,2020-05-19 18:15:41,wahoo,Zwift - Tour for All Invitational Race // Women (A),Garmin Vector Pedal,Wahoo Kickr Power,324,311,13
36989,815325,2020-05-23 07:02:48,wahoo,Wahoo Kickr Power / Garmin Vector Pedal,Garmin Vector Pedal,Wahoo Kickr Power,292,294,-2
37857,815325,2020-05-26 18:14:31,wahoo,Zwift - Tour for All Invitational Race // Women (A),Garmin Vector Pedal,Wahoo Kickr Power,324,315,9
43240,815325,2020-06-23 17:33:12,wahoo,Zwift - WTRL Empowerment Series (E),Assioma Duo&#039;s,Wahoo Kickr Power,307,313,-6
52609,815325,2020-08-30 08:00:19,wahoo,Zwift -  Alpecin Cycling Series,Assioma Duo&#039;s,Wahoo Kickr Power,283,286,-3
53246,815325,2020-09-03 17:33:04,wahoo,Zwift - Vienna,Assioma Duo&#039;s,Wahoo Kickr Power,277,283,-6
55192,815325,2020-09-14 18:28:19,wahoo,Zwift - Invitational League // Qualifying Race #1 (Women),Assioma Duo&#039;s,Wahoo Kickr Power,312,309,3
55862,815325,2020-09-17 17:57:22,wahoo,Zwift - Invitational League // Qualifying Race #2 (Women) (A),Assioma Duo&#039;s,Wahoo Kickr Power,299,299,0
56483,815325,2020-09-20 13:29:12,wahoo,Invitational League // Qualifying Race #3 (Women),Assioma Duo&#039;s,Wahoo Kickr Power,305,309,-4
58854,815325,2020-10-01 18:03:02,wahoo,Zwift - Vienna,Assioma Duo&#039;s,Wahoo Kickr Power,299,305,-6
61207,815325,2020-10-12 17:41:42,wahoo,Premier Division // Zwift Racing League (women),Garmin Vector Pedal,Wahoo Kickr Power,312,325,-13
63174,815325,2020-10-19 19:12:08,wahoo,Zwift Racing League | WTRL - PREMIER DIVISION (WOMEN) - TTT,Assioma Duo&#039;s,Wahoo Kickr Power,303,306,-3
64343,815325,2020-10-23 10:07:28,wahoo,Zwift - ZA Road Race #2 (A),Assioma Duo&#039;s,Wahoo Kickr Power,284,287,-3
65118,815325,2020-10-26 19:02:11,wahoo,Premier Division // Zwift Racing League (women),Assioma Duo&#039;s,Wahoo Kickr Power,319,330,-11
67340,815325,2020-11-02 20:06:03,wahoo,Premier Division // Zwift Racing League (women),Assioma Duo&#039;s,Wahoo Kickr Power,307,311,-4
69376,815325,2020-11-09 19:02:41,wahoo,Premier Division // Zwift Racing League (women),Assioma Duo&#039;s,Wahoo Kickr Power,336,329,7
70761,815325,2020-11-12 18:39:40,wahoo,Zwift - Vienna,Assioma Duo&#039;s,Wahoo Kickr Power,289,288,1
72198,815325,2020-11-16 19:59:39,wahoo,Zwift - Premier Division // Zwift Racing League (women) (A),Assioma Duo&#039;s,Wahoo Kickr Power,287,294,-7
74631,815325,2020-11-23 18:51:30,wahoo,Zwift - Premier Division // Zwift Racing League (women) (A),Assioma Duo&#039;s,Wahoo Kickr Power,308,313,-5
77767,815325,2020-11-30 19:59:14,wahoo,Zwift - Premier Division // Zwift Racing League (women) (A),Assioma Duo&#039;s,Wahoo Kickr Power,294,297,-3
97370,815325,2021-01-15 10:23:18,wahoo,DIRT Friday Morning Sprintapalooza,Assioma Duo&#039;s,Wahoo Kickr Power,215,217,-2
99086,815325,2021-01-18 19:03:33,wahoo,Zwift - Premier Division // Zwift Racing League (women) (A),Assioma Duo&#039;s,Wahoo Kickr Power,316,317,-1
111128,815325,2021-02-08 19:54:26,wahoo,Premier Division // Zwift Racing League (women),Assioma Duo&#039;s,Wahoo Kickr Power,308,302,6
117703,815325,2021-02-19 10:22:47,wahoo,Zwift - DIRT Friday Morning Sprintapalooza (C),Assioma Duo&#039;s,Wahoo Kickr Power,241,239,2
122496,815325,2021-03-01 19:14:28,wahoo,Zwift - Premier Division // Zwift Racing League (women) (A),Assioma Duo&#039;s,Wahoo Kickr Power,293,293,0
125105,815325,2021-03-06 18:01:34,wahoo,The Iceni Womens Series ,Assioma Duo&#039;s,Wahoo Kickr Power,299,298,1
128090,815325,2021-03-13 17:55:06,wahoo,Zwift - The Iceni Women&#039;s Series (A),Assioma Duo&#039;s,Wahoo Kickr Power,298,293,5
37671,791736,2020-05-25 17:07:49,wahoo,DBR Wahoo League - (A),PowerTap P1 pedals,Wahoo kickr,353,374,-21
39967,791736,2020-06-06 08:30:16,wahoo,DBR SUFFERDAY LEAGUE - UBER PRETZEL,PowerTap P1 pedals,Wahoo kickr,428,410,18
40204,791736,2020-06-07 13:15:25,wahoo,KISS AT 100 - (A) / 3RD,PowerTap P1 pedals,Wahoo kickr,326,331,-5
40360,791736,2020-06-08 17:14:50,wahoo,DBR WAHOO LEAGUE (A) 1ST,PowerTap P1 pedals,Wahoo kickr,391,406,-15
40816,791736,2020-06-10 17:54:48,wahoo,USA CYCLING LEAGUE,PowerTap P1 pedals,Wahoo kickr,438,445,-7
41108,791736,2020-06-11 17:18:50,wahoo,BRT TEAM TIME TRIAL,PowerTap P1 pedals,Wahoo kickr,392,407,-15
43795,791736,2020-06-27 08:04:57,wahoo,3R UBER PRETZEL,PowerTap P1 pedals,Wahoo kickr,400,392,8
43982,791736,2020-06-28 13:15:17,wahoo,Zwift - KISS at Race 100 - Americas (A),PowerTap P1 pedals,Wahoo kickr,370,385,-15
55064,791736,2020-09-14 18:00:17,wahoo,Zwift - Invitational League // Qualifying Race #1,PowerTap P1 pedals,Wahoo kickr,348,381,-33
55572,791736,2020-09-16 17:27:56,wahoo,Zwift - DCU powered by Feltet.dk (A),PowerTap P1 pedals,Wahoo kickr,324,338,-14
55927,791736,2020-09-17 18:29:54,wahoo,Zwift - Invitational League // Qualifying Race #2 (Men) ,PowerTap P1 pedals,Wahoo kickr,343,356,-13
56156,791736,2020-09-18 16:00:27,wahoo,Zwift -  Stage 1 // Virtual Haute Route Ventoux  (A),PowerTap P1 pedals,Wahoo kickr,374,379,-5
56460,791736,2020-09-20 12:59:31,wahoo,Zwift - Invitational League // Qualifying Race #3 (Men) (A),PowerTap P1 pedals,Wahoo kickr,393,397,-4
99417,396725,2021-01-18 19:00:02,wahoo,Power2max NGEco / Wahoo Kickr Core 2021,Power2max NGEco,Wahoo Kickr Core 2021,393,398,-5
111278,396725,2021-02-08 17:18:22,wahoo,Zwift -  SCF SWE Cup Men (A),Power2max NGEco,Wahoo Kickr Core 2021,393,395,-2
119360,396725,2021-02-22 17:25:47,wahoo,Zwift -  SCF SWE Cup Men (A),Power2max NGEco,Wahoo Kickr Core 2021,427,458,-31
125786,396725,2021-03-08 17:13:24,wahoo,Zwift -  SCF SWE Cup Men (A),Power2max NGEco,Wahoo Kickr Core 2021,394,401,-7
110385,486949,2021-02-07 10:25:10,wahoo,Kickr check,4iiii,Wahoo Kickr,318,316,2
70249,601528,2020-11-10 19:06:03,wahoo,Zwift - Innsbruck,Stages gen2,kickr2017,275,296,-21
70370,601528,2020-10-05 17:04:09,wahoo,Zwift - DBR Ride´N´Roll League (A),Stages gen2,kick2018,319,320,-1
70377,601528,2020-09-21 10:39:55,wahoo,Zwift - ZWC Hill Climb Battle (A),Stages gen2,kick2018,337,336,1
70982,601528,2020-11-12 18:32:11,wahoo,Zwift - London,Stages gen2,kickr2017,346,357,-11
71137,601528,2020-11-13 17:59:59,wahoo,Zwift - KIRCHMAIR Race Series (A),Stages gen2,kickr2017,311,330,-19
71750,601528,2020-11-15 16:29:59,wahoo,Zwift - Crit City Race (A),Stages gen2,kickr2017,324,345,-21
72116,601528,2020-11-16 18:00:15,wahoo,Zwift - Mattias Willman - OIK&#039;s Meetup,Stages gen2,Kickr 5.0,244,258,-14
72634,601528,2020-11-18 18:00:00,wahoo,Zwift - MIDWEEK Autumn Series by SZR (A),Stages gen2,Kickr 5.0,324,338,-14
73590,601528,2020-11-20 18:47:16,wahoo,Zwift - Yorkshire,Stages gen2,Kickr 5.0,134,126,8
73593,601528,2020-11-20 18:30:00,wahoo,Zwift - KIRCHMAIR Race Series (A),Stages gen2,Kickr 5.0,293,304,-11
73596,601528,2020-11-20 17:59:58,wahoo,Zwift - KIRCHMAIR Race Series (A),Stages gen2,Kickr 5.0,326,338,-12
74079,601528,2020-11-21 08:30:02,wahoo,Zwift - Team CLS Drum &#039;n&#039; Base Club Ride (C),Stages gen2,Kickr 5.0,226,234,-8
74185,601528,2020-11-22 09:32:02,wahoo,Zwift - Test,Stages gen2,Kickr 5.0,289,299,-10
74614,601528,2020-11-23 18:14:59,wahoo,Zwift -  DBR Monday Race (A),Stages gen2,Kickr 5.0,312,319,-7
75682,601528,2020-11-25 18:01:08,wahoo,Zwift - Troskel - 4* 8/2 @300,Stages gen2,Kickr 5.0,289,301,-12
122127,601528,2021-02-28 16:33:06,wahoo,Zwift - London - Greatest London Flat - k,Stages gen2,Kickr 5.0 ny,233,244,-11
122131,601528,2021-02-28 15:40:30,wahoo,Zwift - London - Greater London Loop ,Stages gen2,Kickr 5.0 ny,244,253,-9
52612,802613,2020-08-30 09:30:29,wahoo,Next Step Tri Meetup,Powerpro,Kickr Core,306,306,0
96780,802613,2021-01-14 09:41:18,wahoo,WTRL TTT - TZP Team,Powerpro,Kickr Core,266,285,-19
74789,799917,2020-11-23 19:11:01,neo,Zwift - ZA Road Race #1: 3.2 - 4 w/kg,Garmin Vector 3,TacX Neo,311,320,-9
78225,799917,2020-12-01 19:50:51,wahoo,Zwift - Zwift Racing League | WTRL - Men&#039;s EMEA W1 DIVISION 1 (B),Garmin Vector,Wahoo Kickr,335,337,-2
81263,799917,2020-12-08 19:45:53,wahoo,Zwift - Zwift Racing League | WTRL - Men&#039;s EMEA W1 DIVISION 1 (B),Garmin Vector,Wahoo Kickr,335,336,-1
85634,799917,2020-12-21 03:04:56,neo,Zwift - 3R Figure 8 Hilly Race - 1 Lap (29.2km/18.1m 234m) (B),Vector 3S (BMC),TacX Neo,294,307,-13
91499,799917,2021-01-04 21:14:53,neo,Zwift - 3R Watopia Flat Route Reverse Race - 3 Laps (30.8km/19.1mi 162m) (B),Vector 3S (BMC),TacX Neo,310,321,-11
95123,825244,2021-01-11 19:57:03,wahoo,Zwift - Premier Division // Zwift Racing League (women) (A),Stages Powermeter,Wahoo Kickr,299,311,-12
99191,825244,2021-01-18 18:43:40,wahoo,Zwift - Premier Division // Zwift Racing League (women) (A),Stages Powermeter,Wahoo Kickr,331,309,22
99944,825244,2021-01-19 19:00:15,wahoo,Zwift - TDZ Stage 4: Longer Ride,Stages Powermeter,Wahoo Kickr,313,293,20
100959,825244,2021-01-21 18:54:48,wahoo,Zwift - Espresso,Stages Powermeter,Wahoo Kickr,293,275,18
103040,825244,2021-01-25 19:56:45,wahoo,Zwift - Premier Division // Zwift Racing League (women) (A),Stages Powermeter,Wahoo Kickr,344,312,32
104702,825244,2021-01-28 18:44:52,wahoo,Zwift - Espresso,Stages Powermeter,Wahoo Kickr,291,279,12
106800,825244,2021-02-01 18:36:31,wahoo,Zwift - Premier Division // Zwift Racing League (women) (A),Stages Powermeter,Wahoo Kickr,322,298,24
107489,825244,2021-02-02 18:25:35,wahoo,Zwift - The Carnival Race League Stage 5 with ZTPL.CC (A),Stages Powermeter,Wahoo Kickr,307,278,29
111126,825244,2021-02-08 19:49:46,wahoo,Zwift - Premier Division // Zwift Racing League (women) (A),Stages Powermeter,Wahoo Kickr,289,296,-7
113044,825244,2021-02-11 18:44:59,wahoo,Zwift - Espresso,Stages Powermeter,Wahoo Kickr,325,293,32
113680,825244,2021-02-12 18:49:44,wahoo,Zwift - Movistar Team Challenge // Round 1 (women),Stages Powermeter,Wahoo Kickr,350,323,27
115266,825244,2021-02-15 18:58:18,wahoo,Zwift - Premier Division // Zwift Racing League (women) (A),Stages Powermeter,Wahoo Kickr,330,308,22
116793,825244,2021-02-17 18:53:56,wahoo,Zwift - Movistar Team Challenge // Round 2 (women) - Race 3/4,Stages Powermeter,Wahoo Kickr,288,260,28
117320,825244,2021-02-18 18:47:29,wahoo,Zwift - Espresso,Stages Powermeter,Wahoo Kickr,304,276,28
117885,825244,2021-02-19 18:55:52,wahoo,Zwift - Movistar Team Challenge // Round 2 (women),Stages Powermeter,Wahoo Kickr,325,314,11
118344,825244,2021-02-20 13:58:16,wahoo,Zwift -  Zwift Insider Badge Hunters - The Uber Pretzel Edition (E),Stages Powermeter,Wahoo Kickr,301,289,12
119236,825244,2021-02-22 19:54:54,wahoo,Zwift - Premier Division // Zwift Racing League (women) (A),Stages Powermeter,Wahoo Kickr,295,287,8
120824,825244,2021-02-25 18:54:02,wahoo,Zwift - Espresso,Stages Powermeter,Wahoo Kickr,290,277,13
122473,825244,2021-03-01 19:14:37,wahoo,Zwift - Premier Division // Zwift Racing League (women) (A),Stages Powermeter,Wahoo Kickr,304,287,17
124082,825244,2021-03-04 18:46:33,wahoo,Zwift - Espresso,Stages Powermeter,Wahoo Kickr,302,290,12
124681,825244,2021-03-05 18:51:30,wahoo,Zwift - Ramp Test,Stages Powermeter,Wahoo Kickr,348,348,0
127112,825244,2021-03-11 18:46:29,wahoo,Zwift - Espresso,Stages Powermeter,Wahoo Kickr,307,278,29
128047,825244,2021-03-13 16:04:44,wahoo,Zwift - 3R Endurance Series p/b OTE Sports (A),Stages Powermeter,Wahoo Kickr,304,302,2
129209,825244,2021-03-16 18:32:28,wahoo,Zwift - Women Only // CeramicSpeed Race Series: Open Race,Stages Powermeter,Wahoo Kickr,336,303,33
112960,822269,2021-02-11 17:51:53,wahoo,Zwift - WTRL Team Time Trial - Zone 3 (D),Garmin Vector 3,Wahoo Kickr 18,332,329,3
113749,822269,2021-02-12 17:00:04,wahoo,Zwift - TDZ Stage 8: Group Ride,Garmin Vector 3,Wahoo Kickr 18,226,226,0
115197,822269,2021-02-15 17:08:08,wahoo,Zwift - TDZ Stage 4: Standard Ride,Garmin Vector 3,Wahoo Kickr 18,367,365,2
115773,822269,2021-02-16 13:14:53,wahoo,Zwift - TDZ Stage 6: Shorter Ride,Garmin Vector 3,Wahoo Kickr 18,274,263,11
64182,801900,2020-10-22 17:01:39,neo,Zwift - NYC,Assioma Duo,Tacx Neo,235,235,0
28698,799067,2020-04-27 17:47:40,wahoo,Zwift - Sweetness 70,Assioma Duo,Kickr Core,334,341,-7
31074,799067,2020-05-03 20:37:36,wahoo,Assioma Duo / Kickr Core,Assioma Duo,Kickr Core,291,282,9
31076,799067,2020-05-03 19:48:58,wahoo,Kickr Core / Assioma Duo,Assioma Duo,Kickr Core,243,247,-4
31975,799067,2020-05-05 19:34:02,wahoo,Assioma Duo / Kickr Core,Assioma Duo,Kickr Core,262,265,-3
31976,799067,2020-05-05 19:34:02,wahoo,Kickr Core / Assioma Duo,Assioma Duo,Kickr Core,297,299,-2
32566,799067,2020-05-07 19:24:05,wahoo,Kickr Core / Assioma Duo,Assioma Duo,Kickr Core,373,384,-11
32569,799067,2020-05-07 20:21:16,wahoo,Assioma Duo,Assioma Duo,Kickr Core,333,340,-7
33588,799067,2020-05-10 17:35:19,wahoo,Kickr Core / Assioma Duo,Assioma Duo,Kickr Core,334,342,-8
33877,799067,2020-05-11 20:33:16,wahoo,Assioma Duo / Kickr Core,Assioma Duo,Kickr Core,342,349,-7
34300,799067,2020-05-12 15:09:25,wahoo,Assioma Duo / Kickr Core,Assioma Duo,Kickr Core,324,324,0
128596,825891,2021-03-13 18:53:08,wahoo,Zwift - 2/1/2 @ 115/95/110 % * 5,assioma,Kickr v5,345,343,2
128597,825891,2021-03-12 09:13:35,wahoo,Zwift - Watopia,assioma,Kickr v5,213,209,4
128909,825891,2021-03-15 19:19:16,wahoo,Zwift - Team TFC Mad Monday Race Series (low-end categories) (A),assioma,Kickr v5,359,356,3
39843,6842,2020-06-05 17:45:51,wahoo,Zwift - London test 2,Vector,Kickr?,257,263,-6
39844,6842,2020-06-05 17:59:59,wahoo,Zwift - TeamPTz Friday&#039;s Race League (A),Vector,Kickr?,407,416,-9
40024,6842,2020-06-06 15:31:06,wahoo,Zwift - Zwift Fondo 2020 Series (Southern Hemisphere) (B),Vector,Kickr?,363,374,-11
65352,6842,2020-10-26 19:00:00,wahoo,Zwift - ZA Road 2020 - Segment Ride #1: Innsbruck Course,Vector,Kickr,370,396,-26
65572,6842,2020-10-27 19:44:31,wahoo,Zwift - Zwift Racing League | WTRL - EMEA W (MEN) -  Division 1 (A),Vector,Kickr,411,404,7
76165,6842,2020-11-26 19:07:16,wahoo,Zwift - WTRL NOPINZ WORLD TTT CHAMPIONSHIPS - Zone 8 (C),Vector,Kickr,389,408,-19
77516,6842,2020-11-29 16:59:54,wahoo,Zwift - Focus: Colours of PARI - Longer Ride,P2M,Kickr,362,365,-3
77517,6842,2020-11-29 18:15:04,wahoo,Zwift - Watopia,P2M,Kickr,223,225,-2
77518,6842,2020-11-28 19:59:52,wahoo,Zwift - Innsbruck,P2M,Kickr,218,219,-1
77519,6842,2020-11-28 17:46:02,wahoo,Zwift - Innsbruck,P2M,Kickr,221,234,-13
78236,6842,2020-12-01 19:53:41,wahoo,Zwift - Zwift Racing League | WTRL - Men&#039;s EMEA W1 DIVISION 1 (A),P2M,Kickr,425,427,-2
83117,6842,2020-12-13 14:14:08,wahoo,Zwift - KISS 100 Race Series - Americas (A),P2M,Kickr,407,413,-6
105591,6842,2021-01-30 10:28:22,wahoo,Zwift - Cycling Weekly Winter Lockdown RR Series,Vector,Kickr,382,397,-15
119820,6842,2021-02-23 19:39:34,wahoo,Zwift - Zwift Racing League | WTRL - Men&#039;s/Mixed EMEA W1 DIVISION 1 (A),Vector,Kickr,384,396,-12
121432,6842,2021-02-27 08:25:46,wahoo,Zwift - London Lockdown eRace Series: Race 2 (A),Vector,Kickr,382,405,-23
124238,6842,2021-03-04 21:14:59,wahoo,Zwift - Ferro A Fondo,Vector,Kickr,375,381,-6
124241,6842,2021-03-04 21:49:47,wahoo,Zwift - Paris,Vector,Kickr,180,185,-5
124649,6842,2021-03-05 19:03:40,wahoo,Zwift - Zwift Racing League | WTRL Battle Royale Playoff - Men&#039;s Points Race (A),Vector,Kickr,381,385,-4
125204,6842,2021-03-06 19:53:26,wahoo,Zwift - Zwift Racing League | WTRL Battle Royale Playoff - Men&#039;s TTT (A),Vector,Kickr,414,417,-3
129287,6842,2021-03-16 18:29:55,wahoo,Zwift - CeramicSpeed Race Series: Open Race (A),Vector,Kickr,416,433,-17
1015,833859,2019-02-24 15:08:48,wahoo,Zwift - USA National Championship - MEN 140th,Stages L (Lezyne),Zwift - KICKR Core,304,298,6
5855,833859,2019-12-09 18:30:38,wahoo,Zwift - Tour of London // Stage 1 (Long Distance) - 32nd of Many,Stages L (Lezyne),KICKR Core (Zwift),310,314,-4
10348,833859,2020-01-21 19:01:53,wahoo,Zwift - 3R Ultimate Racing League - Round 3 (B) - 8th,Favero Assioma Duo (Zwift),KICKR Core3 (1.0.12 firmware - Wahoo App),340,343,-3
14292,833859,2020-02-16 16:18:17,wahoo,Zwift - ZHR Audax 100km (Ride) (B),Favero Assioma Duo (Zwift),KICKR Core3 (1.0.12 firmware - Wahoo App),275,281,-6
15099,833859,2020-02-21 18:59:12,wahoo,Zwift - Tour of Innsbruck // Stage 1,Favero Assioma Duo (Garmin),KICKR Core3 (1.0.12 firmware - Zwift),271,277,-6
15231,833859,2020-02-22 18:52:27,wahoo,Zwift - Vatternrundan E-Sportive 6 (E),Favero Assioma Duo (Garmin),KICKR Core3 (1.0.12 firmware - Zwift),300,306,-6
15656,833859,2020-02-25 19:00:04,wahoo,Zwift - 3R SuperCRITical Race Series - Round 2of4 (A) ugh HRM spike,Favero Assioma Duo (Zwift),KICKR Core3 (1.0.12 firmware - Wahoo App),308,314,-6
15779,833859,2020-02-26 17:32:50,wahoo,Zwift - 3R 100 Steady Ride [~3.0w/kg avg] (B),Favero Assioma Duo (Zwift),KICKR Core3 (1.0.12 firmware - Wahoo App),283,294,-11
16043,833859,2020-02-28 18:52:13,wahoo,Zwift - AHDR Full Aussie Brekkie Roll (B),Favero Assioma Duo (Garmin),KICKR Core3 (1.0.12 firmware - Zwift),306,305,1
16144,833859,2020-02-29 15:07:17,wahoo,Zwift - OH CRIT!! - Saturday Smash Series (A) - 21st,Favero Assioma Duo (Zwift),KICKR Core3 (1.0.12 firmware - Wahoo App),343,344,-1
16350,833859,2020-03-01 16:45:27,wahoo,Zwift - Zwift Gran Fondo,Favero Assioma Duo (Garmin),KICKR Core3 (1.0.12 firmware - Zwift),318,321,-3
16658,833859,2020-03-03 19:37:09,wahoo,Zwift - 3R SuperCRITical Race Series - Round 3of4 (A) - 26th - over 4.0!,Favero Assioma Duo (Zwift),KICKR Core3 (1.0.12 firmware - Wahoo App),342,345,-3
16803,833859,2020-03-04 17:35:59,wahoo,Zwift - SZR Spring Race Series (A) - 1st!,Favero Assioma Duo (Zwift),KICKR Core3 (1.0.12 firmware - Wahoo App),348,351,-3
17011,833859,2020-03-05 18:59:46,wahoo,Zwift - KALAS Cup - Round 6 (A) - 52nd,Favero Assioma Duo (Zwift),KICKR Core3 (1.0.12 firmware - Wahoo App),343,356,-13
17399,833859,2020-03-09 16:09:31,wahoo,Zwift - Stage 1 Race (A) - Tour of Watopia 2020 - 7th,Favero Assioma Duo (Zwift),KICKR Core3 (1.0.12 firmware - Wahoo App),352,352,0
18205,833859,2020-03-15 16:08:44,wahoo,Zwift - ZHR Audax 100km (Ride) (A),Favero Assioma Duo (Garmin),KICKR Core#3 (v1.0.12-Zwift),306,305,1
18273,833859,2020-03-16 16:03:10,wahoo,Zwift - Stage 2 Race (A) - Tour of Watopia 2020 - 3rd - w/ pros!,Favero Assioma Duo (Zwift),KICKR Core#3 (v1.0.12-WahooApp),333,335,-2
19029,833859,2020-03-20 16:09:31,wahoo,Zwift - Stage 3 Race (A) - Tour of Watopia 2020,Favero Assioma Duo (Zwift),KICKR Core#3 (v1.0.12-WahooApp),343,347,-4
19277,833859,2020-03-22 16:03:53,wahoo,Zwift - ZHR Audax 100km (Ride) (A),Favero Assioma Duo (Garmin),KICKR Core#3 (v1.0.12-Zwift),309,309,0
19532,833859,2020-03-24 20:03:52,wahoo,Zwift - SZR Knightrider (D),Favero Assioma Duo (Garmin),KICKR Core#3 (v1.0.12-Zwift),203,204,-1
19597,833859,2020-03-25 17:49:20,wahoo,Zwift - USA Cycling Race League by Indoor Specialist  (A) - 7th,Favero Assioma Duo (Garmin),KICKR Core#3 (v1.0.12-Zwift),309,310,-1
20931,833859,2020-03-31 17:43:55,wahoo,Zwift - 3R Spring Loaded Race Series - Round 1of6 - 14th,Favero Assioma Duo (Garmin),KICKR Core#3 (v1.0.12-Zwift),337,341,-4
21432,833859,2020-04-02 16:01:26,wahoo,Zwift - OH CRIT!! - The Double Race - Race 2/2 (A) - 7th on zwift,Favero Assioma Duo (Garmin),KICKR Core#3 (v1.0.12-Zwift),355,361,-6
21571,833859,2020-04-02 22:39:21,wahoo,Zwift - Koa Sports League Warrior Race (A) - 9th,Favero Assioma Duo (Garmin),KICKR Core#3 (v1.0.12-Zwift),362,368,-6
21838,833859,2020-04-03 15:30:33,wahoo,Zwift -  Haute Route Watopia Stage 1 (E) 1??th? of many,Favero Assioma Duo (Garmin),KICKR Core#3 (v1.0.12-Zwift),325,330,-5
22074,833859,2020-04-04 15:33:04,wahoo,Zwift -  Haute Route Watopia Stage 2 (E) - 102ndZP of many,Favero Assioma Duo (Garmin),KICKR Core#3 (v1.0.12-Zwift),289,300,-11
22362,833859,2020-04-05 15:54:39,wahoo,Zwift -  Haute Route Watopia Stage 3 (E),Favero Assioma Duo (Garmin),KICKR Core#3 (v1.0.12-Zwift),307,312,-5
22622,833859,2020-04-06 18:30:43,wahoo,ZZRC Happy Hr - Pre-Factory Spindown Test,Favero Assioma Duo (Garmin),KICKR Core#3 (v1.0.12-Zwift),200,207,-7
22624,833859,2020-04-06 19:50:02,wahoo,Post-factory spindown test ride,Favero Assioma Duo (Garmin),KICKR Core#3 (v1.0.12-Zwift),197,197,0
22840,833859,2020-04-07 17:50:39,wahoo,Zwift - 3R Spring Loaded Race Series - Round 2of6 (A) - 54th,Favero Assioma Duo (Garmin),KICKR Core#3 (v1.0.12-Zwift),345,336,9
23065,833859,2020-04-08 17:49:57,wahoo,Zwift - USA Cycling Race League by Indoor Specialist  (A),Favero Assioma Duo (Garmin),KICKR Core#3 (v1.0.12-Zwift),354,354,0
23821,833859,2020-04-11 13:54:09,wahoo,Zwift - 3R Endurance Steady Ride [~3.0//2.5w/kg avg] (B),Favero Assioma Duo (Garmin),KICKR Core#3 (v1.0.12-Zwift),222,226,-4
24677,833859,2020-04-14 17:57:07,wahoo,Zwift - 3R Spring Loaded Race Series - Round 3of6 (A) - 94th,Favero Assioma Duo (Garmin),KICKR Core#3 (v1.0.12-Zwift),338,338,0
24942,833859,2020-04-15 17:28:00,wahoo,Zwift - USA Cycling Race League by Indoor Specialist  (A) - 51st,Favero Assioma Duo (Garmin),KICKR Core#3 (v1.0.12-Zwift),344,344,0
26319,833859,2020-04-19 14:50:26,wahoo,Zwift - ZHR Audax 200km (Ride) (A),Favero Assioma Duo (Garmin),KICKR Core#3 (v1.0.12-Zwift),237,240,-3
35144,833859,2020-05-15 20:03:25,wahoo,Zwift - AHDR Full Aussie Brekkie Roll (B),Favero Assioma Duo (Garmin),KICKR Core#3 (v1.0.12-Zwift),232,231,1
36755,833859,2020-05-21 17:44:03,wahoo,Zwift - WTRL Team Time Trial (E),Favero Assioma Duo (Garmin),KICKR Core#3 (v1.0.12-Zwift),332,335,-3
39194,833859,2020-06-02 18:06:43,wahoo,Zwift - MadHare Sportive Training (C),Favero Assioma Duo (Garmin),KICKR Core#3 (v1.0.12-Zwift),291,294,-3
44447,833859,2020-07-01 17:34:45,wahoo,Zwift - USA Cycling Race League by Indoor Specialist (A) - 29th,Favero Assioma Duo (Zwift),KICKR Core#3 (v1.0.13-WahooApp),333,334,-1
45688,833859,2020-07-09 18:29:51,wahoo,Zwift - Cycling Ireland Zwift Sprint Race (A) - 2nd,Favero Assioma Duo (Garmin),KICKR Core#3 (v1.0.13-Zwift),323,328,-5
45690,833859,2020-07-09 19:12:55,wahoo,Zwift - BRT Criterium Racing League (A) - 1st,Favero Assioma Duo (Garmin),KICKR Core#3 (v1.0.13-Zwift),342,343,-1
45849,833859,2020-07-10 20:12:43,wahoo,Zwift - AHDR Full Aussie Brekkie Roll (B),Favero Assioma Duo (Garmin),KICKR Core#3 (v1.0.13-Zwift),243,241,2
45988,833859,2020-07-11 15:40:24,wahoo,Zwift - L&#039;Etape du Tour Stage 2 - Open - 69th zp,Favero Assioma Duo (Garmin),KICKR Core#3 (v1.0.13-Zwift),329,332,-3
46364,833859,2020-07-14 18:31:53,wahoo,Zwift - 3R Turbocharged Team Race Series - Round 1 (A),Favero Assioma Duo (Garmin),KICKR Core#3 (v1.0.13-Zwift),355,347,8
46872,833859,2020-07-18 15:24:22,wahoo,Zwift - L&#039;Etape du Tour Stage 3 - Open,Favero Assioma Duo (Garmin),KICKR Core#3 (v1.0.13-Zwift),297,294,3
47195,833859,2020-07-21 18:25:48,wahoo,Zwift - 3R Turbocharged Team Race Series - Round 2 (A) - 50th,Favero Assioma Duo (Garmin),KICKR Core#3 (v1.0.13-Zwift),358,355,3
47346,833859,2020-07-22 18:52:15,wahoo,Zwift - Virtual Tour de France - A - Stage 6 Discovery Ride,Favero Assioma Duo (Garmin),KICKR Core#3 (v1.0.13-Zwift),327,332,-5
47444,833859,2020-07-23 16:03:02,wahoo,Zwift - OH MY CRIT! - The Double Race 2/2 (A),Favero Assioma Duo (Garmin),KICKR Core#3 (v1.0.13-Zwift),339,342,-3
47692,833859,2020-07-25 20:59:22,wahoo,Zwift - Cycling Australia&#039;s PretzHOLLE by AHDR (B),Favero Assioma Duo (Garmin),KICKR Core#3 (v1.0.13-Zwift),334,329,5
48043,833859,2020-07-28 18:02:19,wahoo,Zwift - 3R Turbocharged Team Race Series - Round 3 (A),Favero Assioma Duo (Garmin),KICKR Core#3 (v1.0.13-Zwift),330,330,0
48205,833859,2020-07-29 17:41:09,wahoo,Zwift - USA Cycling Race League by Indoor Specialist (A) - 54th,Favero Assioma Duo (Garmin),KICKR Core#3 (v1.0.13-Zwift),313,316,-3
48326,833859,2020-07-30 15:55:27,wahoo,Zwift - OH MY CRIT! - The Double Race 2/2 (A) - 7th,Favero Assioma Duo (Garmin),KICKR Core#3 (v1.0.13-Zwift),344,347,-3
48594,833859,2020-08-01 20:43:21,wahoo,Zwift - Cycling Australia&#039;s PretzHELL by AHDR (B),Favero Assioma Duo (Garmin),KICKR Core#3 (v1.0.13-Zwift),325,326,-1
48807,833859,2020-08-04 18:04:20,wahoo,Zwift - 3R Turbocharged Team Race Series - Round 4 (A) - 51st,Favero Assioma Duo (Garmin),KICKR Core#3 (v1.0.13-Zwift),339,341,-2
49078,833859,2020-08-06 15:57:38,wahoo,Zwift - OH MY CRIT! - The Double Race 2/2 (A) - 8th,Favero Assioma Duo (Garmin),KICKR Core#3 (v1.0.13-Zwift),308,310,-2
49242,833859,2020-08-07 19:25:41,wahoo,Zwift - Crit City Race (A),Favero Assioma Duo (Garmin),KICKR Core#3 (v1.0.13-Zwift),320,326,-6
49836,833859,2020-08-13 16:03:33,wahoo,Zwift - OH MY CRIT! - The Double Race 2/2 (A),Favero Assioma Duo (Garmin),KICKR Core#3 (v1.0.13-Zwift),360,359,1
50169,833859,2020-08-15 14:40:51,wahoo,Zwift - ZHQ Steering Race // FutureWorks (A),Favero Assioma Duo (Garmin),KICKR Core#3 (v1.0.13-Zwift),328,322,6
50929,833859,2020-08-20 15:56:34,wahoo,Zwift - OH MY CRIT! - The Double Race 2/2 (A),Favero Assioma Duo (Garmin),KICKR Core#3 (v1.0.13-Zwift),318,318,0
50956,833859,2020-08-20 16:38:18,wahoo,Zwift - Off The MAAP Stage 2 - Shorter Ride,Favero Assioma Duo (Garmin),KICKR Core#3 (v1.0.13-Zwift),321,325,-4
51281,833859,2020-08-22 15:00:15,wahoo,Zwift - ZHQ Steering Race // FutureWorks (A),Favero Assioma Duo (Garmin),KICKR Core#3 (v1.0.13-Zwift),321,317,4
51284,833859,2020-08-22 15:11:32,wahoo,Zwift - Off The MAAP Stage 3 - Shorter Ride,Favero Assioma Duo (Garmin),KICKR Core#3 (v1.0.13-Zwift),317,317,0
52080,833859,2020-08-26 16:45:28,wahoo,Zwift - 3R 100 Steady Ride [~3.0w/kg avg] (B),Favero Assioma Duo (Garmin),KICKR Core#3 (v1.0.13-Zwift),270,273,-3
52181,833859,2020-08-27 15:51:17,wahoo,Zwift - OH MY CRIT! - The Double Race 2/2 (A) - 13th,Favero Assioma Duo (Garmin),KICKR Core#3 (v1.0.13-Zwift),315,316,-1
52547,833859,2020-08-29 14:57:58,wahoo,Zwift - ZHQ Steering Race // FutureWorks (A),Favero Assioma Duo (Garmin),KICKR Core#3 (v1.0.13-Zwift),320,321,-1
52935,833859,2020-09-01 17:55:04,wahoo,Zwift - 3R Sundown Race Series - Round1 iTT (A) - 26th+?,Favero Assioma Duo (Garmin),KICKR Core#3 (v1.0.13-Zwift),318,315,3
53216,833859,2020-09-03 15:03:26,wahoo,Zwift - OH MY CRIT! - The Double Race 1/2 (A) - 8th,Favero Assioma Duo (Garmin),KICKR Core#3 (v1.0.13-Zwift),348,356,-8
53217,833859,2020-09-03 15:46:21,wahoo,Zwift - OH MY CRIT! - The Double Race 2/2 (A),Favero Assioma Duo (Garmin),KICKR Core#3 (v1.0.13-Zwift),325,330,-5
53480,833859,2020-09-04 17:16:29,wahoo,RGT race data Comparison (Stage 7 Vive La TDF),Favero Assioma Duo (Zwift),KICKR Core#3 (v1.0.13-RGT-2),303,301,2
53660,833859,2020-09-06 16:30:01,wahoo,Zwift - Crit City Race (A) - 2nd (pre-factory spindown),Favero Assioma Duo (Garmin),KICKR Core#3 (v1.0.13-Zwift),337,343,-6
53695,833859,2020-09-06 17:04:32,wahoo,Post-factory Spindown Data,Favero Assioma Duo (Garmin),KICKR Core#3 (v1.0.13-Zwift),188,187,1
53696,833859,2020-09-06 17:25:20,wahoo,Zwift - ZHCC SUB 2.0 (D) - Post-Factory Spindown Ride,Favero Assioma Duo (Garmin),KICKR Core#3 (v1.0.13-Zwift),173,177,-4
53982,833859,2020-09-08 17:50:17,wahoo,Zwift - 3R Sundown Race Series  (A) - 1st,Favero Assioma Duo (Garmin),KICKR Core#3 (v1.0.13-Zwift),358,354,4
54360,833859,2020-09-10 14:55:38,wahoo,Zwift - OH MY CRIT! - The Double Race 1/2 (A) - 15th,Favero Assioma Duo (Garmin),KICKR Core#3 (v1.0.13-Zwift),356,359,-3
54482,833859,2020-09-10 15:45:50,wahoo,Zwift - EVO CC Sprint Race Series  (A) - 1st,Favero Assioma Duo (Garmin),KICKR Core#3 (v1.0.13-Zwift),340,342,-2
55396,833859,2020-09-15 18:01:08,wahoo,3R Sundown Race Series ,Favero Assioma Duo (Garmin),KICKR Core#3 (v1.0.13-Zwift),325,328,-3
55437,833859,2020-09-15 19:36:14,wahoo,Zwift - AHDR Bacon Rolls with why Caffeine why? (B),Favero Assioma Duo (Garmin),KICKR Core#3 (v1.0.13-Zwift),327,329,-2
55756,833859,2020-09-17 14:53:35,wahoo,Zwift - OH MY CRIT! - The Double Race 1/2 (A) - 5th,Favero Assioma Duo (Garmin),KICKR Core#3 (v1.0.13-Zwift),341,344,-3
55762,833859,2020-09-17 15:49:11,wahoo,Zwift - OH MY CRIT! - The Double Race 2/2 (A) - 19th,Favero Assioma Duo (Garmin),KICKR Core#3 (v1.0.13-Zwift),342,344,-2
56171,833859,2020-09-18 15:56:49,wahoo,Zwift -  Stage 1 // Virtual Haute Route Ventoux  (A),Favero Assioma Duo (Garmin),KICKR Core#3 (v1.0.13-Zwift),336,338,-2
56305,833859,2020-09-19 15:42:52,wahoo,Zwift -  Stage 2 // Virtual Haute Route Ventoux  (A),Favero Assioma Duo (Garmin),KICKR Core#3 (v1.0.13-Zwift),301,299,2
56636,833859,2020-09-20 16:00:33,wahoo,Zwift -  Stage 3 // Virtual Haute Route Ventoux  (A),Favero Assioma Duo (Garmin),KICKR Core#3 (v1.0.13-Zwift),221,227,-6
56862,833859,2020-09-22 18:01:25,wahoo,Zwift - 3R Sundown Race Series  (A) - 1st,Favero Assioma Duo (Garmin),KICKR Core#3 (v1.0.13-Zwift),356,354,2
57229,833859,2020-09-24 15:07:59,wahoo,Zwift - OH MY CRIT! - The Double Race 1/2 (A),Favero Assioma Duo (Garmin),KICKR Core#3 (v1.0.13-Zwift),316,323,-7
57239,833859,2020-09-24 15:58:21,wahoo,Zwift - OH MY CRIT! - The Double Race 2/2 (A) - 10th,Favero Assioma Duo (Garmin),KICKR Core#3 (v1.0.13-Zwift),324,327,-3
57969,833859,2020-09-27 13:51:43,wahoo,Zwift - 3R Endurance Steady Ride [~3.0//2.5w/kg avg] (C),Favero Assioma Duo (Garmin),KICKR Core#3 (v1.0.13-Zwift),177,180,-3
58307,833859,2020-09-29 18:04:34,wahoo,Zwift - 3R Sundown Race Series  (A) - 24th,Favero Assioma Duo (Garmin),KICKR Core#3 (v1.0.13-Zwift),333,336,-3
58607,833859,2020-09-30 17:38:39,wahoo,Zwift - ZSUN Rising (C),Favero Assioma Duo (Garmin),KICKR Core#3 (v1.0.13-Zwift),354,353,1
58767,833859,2020-10-01 14:50:59,wahoo,Zwift - OH MY CRIT! - The Double Race 1/2 (A) - 17th,Favero Assioma Duo (Garmin),KICKR Core#3 (v1.0.13-Zwift),365,364,1
58781,833859,2020-10-01 16:01:27,wahoo,Zwift - OH MY CRIT! - The Double Race 2/2 (A) - 17th,Favero Assioma Duo (Garmin),KICKR Core#3 (v1.0.13-Zwift),341,339,2
59119,833859,2020-10-02 18:00:18,wahoo,Zwift - Newbury Velo Crit (A) - 4th,Favero Assioma Duo (Garmin),KICKR Core#3 (v1.0.13-Zwift),327,328,-1
59907,833859,2020-10-06 18:37:36,wahoo,Zwift - 3R Sundown Race Series - iTT (A) - 46th (don&#039;t do a race before an iTT!),Favero Assioma Duo (Garmin),KICKR Core#3 (v1.0.13-Zwift),294,297,-3
60300,833859,2020-10-08 15:05:00,wahoo,Zwift - OH MY CRIT! - The Double Race 1/2 (A) - 8th,Favero Assioma Duo (Garmin),KICKR Core#3 (v1.0.13-Zwift),340,344,-4
60321,833859,2020-10-08 15:46:26,wahoo,Zwift - OH MY CRIT! - The Double Race 2/2 (A) - 37thish,Favero Assioma Duo (Garmin),KICKR Core#3 (v1.0.13-Zwift),289,293,-4
62083,833859,2020-10-14 16:36:30,wahoo,Zwift - 3R 100 Steady Ride [~3.0w/kg avg] (B) - Core Calib,Favero Assioma Duo (Garmin),KICKR Core#3 (v1.0.13-Zwift),209,211,-2
62107,833859,2020-10-15 14:55:12,wahoo,Zwift - OH MY CRIT! - The Double Race 1/2 (A) - 2nd zp,Favero Assioma Duo (Garmin),KICKR Core#3 (v1.0.13-Zwift),346,351,-5
62139,833859,2020-10-15 15:52:07,wahoo,Zwift - OH MY CRIT! - The Double Race 2/2 (A) - 4th,Favero Assioma Duo (Garmin),KICKR Core#3 (v1.0.13-Zwift),354,351,3
62743,833859,2020-10-17 20:00:52,wahoo,Zwift - Cycling Australia&#039;s PretzHELL by AHDR (B),Favero Assioma Duo (Garmin),KICKR Core#3 (v1.0.13-Zwift),376,377,-1
63534,833859,2020-10-20 17:43:57,wahoo,Zwift - Zwift Racing League | WTRL - EMEA (MEN) - TTT Grp 2 (C),Favero Assioma Duo (Garmin),KICKR Core#3 (v1.0.13-Zwift),313,321,-8
64146,833859,2020-10-22 15:06:53,wahoo,Zwift - OH MY CRIT! - The Double Race 1/2 (A) - 7th,Favero Assioma Duo (Garmin),KICKR Core#3 (v1.0.13-Zwift),347,349,-2
64165,833859,2020-10-22 15:48:38,wahoo,Zwift - OH MY CRIT! - The Double Race 2/2 (A) - 18th,Favero Assioma Duo (Garmin),KICKR Core#3 (v1.0.13-Zwift),341,340,1
64712,833859,2020-10-24 19:53:42,wahoo,Zwift - Cycling Australia&#039;s PretzHELL by AHDR (B),Favero Assioma Duo (Garmin),KICKR Core#3 (v1.0.13-Zwift),342,340,2
64930,833859,2020-10-25 14:57:40,wahoo,Zwift - ZHR Audax (D),Favero Assioma Duo (Garmin),KICKR Core#3 (v1.0.13-Zwift),276,277,-1
65568,833859,2020-10-27 18:47:11,wahoo,Zwift - Zwift Racing League | WTRL - EMEA W (MEN) -  Division 6 (A) - tied 4th,Favero Assioma Duo (Garmin),KICKR Core#3 (v1.0.13-Zwift),337,345,-8
66080,833859,2020-10-29 15:51:26,wahoo,Zwift - OH MY CRIT! - The Double Race 1/2 (A) - 5th,Favero Assioma Duo (Garmin),KICKR Core#3 (v1.0.13-Zwift),346,348,-2
66111,833859,2020-10-29 16:43:24,wahoo,Zwift - OH MY CRIT! - The Double Race 2/2 (A) - 5th,Favero Assioma Duo (Garmin),KICKR Core#3 (v1.0.13-Zwift),340,340,0
67064,833859,2020-11-01 14:50:54,wahoo,Zwift - 3R Endurance Steady Ride [~3.0//2.5w/kg avg] (B),Favero Assioma Duo (Garmin),KICKR Core#3 (v1.0.13-Zwift),317,321,-4
67700,833859,2020-11-02 16:49:55,wahoo,Zwift - Zwift Racing League | WTRL - Men&#039;s EMEA W2 DIVISION 2 (A),Favero Assioma Duo (Garmin),KICKR Core#3 (v1.0.13-Zwift),316,322,-6
68163,833859,2020-11-05 15:50:58,wahoo,Zwift - OH MY CRIT! - The Double Race 1/2 (A) - 2nd,Favero Assioma Duo (Garmin),KICKR Core#3 (v1.0.13-Zwift),362,366,-4
68184,833859,2020-11-05 16:45:18,wahoo,Zwift - OH MY CRIT! - The Double Race 2/2 (A) - 7th,Favero Assioma Duo (Garmin),KICKR Core#3 (v1.0.13-Zwift),347,345,2
69968,833859,2020-11-10 18:39:12,wahoo,Zwift - Zwift Racing League | WTRL - EMEA W2 (MEN) -  Division 2 (A) - 29th,Favero Assioma Duo (Garmin),KICKR Core#3 (v1.0.13-Zwift),383,388,-5
70636,833859,2020-11-12 15:45:55,wahoo,Zwift - OH MY CRIT! - The Double Race 1/2 (A) - 9th,Favero Assioma Duo (Garmin),KICKR Core#3 (v1.0.13-Zwift),363,364,-1
70666,833859,2020-11-12 16:57:03,wahoo,Zwift - OH MY CRIT! - The Double Race 2/2 (A),Favero Assioma Duo (Garmin),KICKR Core#3 (v1.0.13-Zwift),298,302,-4
71118,833859,2020-11-13 17:13:18,wahoo,Zwift - Garmin Never Stop Cycling // Stage 2 TT - Recovery,Favero Assioma Duo (Garmin),KICKR Core#3 (v1.0.13-Zwift),163,167,-4
71457,833859,2020-11-14 15:00:28,wahoo,Zwift - 3R Endurance Steady Ride - Factory and Normal Spindown postride,Favero Assioma Duo (Garmin),KICKR Core#3 (v1.0.13-Zwift),203,209,-6
71739,833859,2020-11-15 17:04:31,wahoo,Zwift - Open: 2020 El Giro de Rigo - Official Route,Favero Assioma Duo (Garmin),KICKR Core#3 (v1.0.13-Zwift),324,322,2
72144,833859,2020-11-16 17:12:41,wahoo,Zwift - ZZRC Wrecked Legs - Recovery Ride (C),Favero Assioma Duo (Garmin),KICKR Core#3 (v1.0.13-Zwift),249,244,5
72298,833859,2020-11-17 18:55:36,wahoo,Zwift - Zwift Racing League | WTRL - Men&#039;s EMEA W2 DIVISION 2 (A),Favero Assioma Duo (Garmin),KICKR Core#3 (v1.0.13-Zwift),309,312,-3
72992,833859,2020-11-19 15:58:32,wahoo,Zwift - OH MY CRIT! - The Double Race 1/2 (A) - 5th,Favero Assioma Duo (Garmin),KICKR Core#3 (v1.0.13-Zwift),363,359,4
73034,833859,2020-11-19 16:54:56,wahoo,Zwift - OH MY CRIT! - The Double Race 2/2 (A) - 7th,Favero Assioma Duo (Garmin),KICKR Core#3 (v1.0.13-Zwift),356,356,0
74324,833859,2020-11-22 17:11:38,wahoo,Zwift - 3R Racing (A) - Petit Boucle Recon - 4th,Favero Assioma Duo (Garmin),KICKR Core#3 (v1.0.13-Zwift),381,381,0
74572,833859,2020-11-23 16:42:25,wahoo,Zwift - INC Steady State 45min - Group Training Ride 2.5 - 3.0w Average (C),Favero Assioma Duo (Garmin),KICKR Core#3 (v1.0.13-Zwift),195,196,-1
75205,833859,2020-11-24 18:51:38,wahoo,Zwift - Zwift Racing League | WTRL - Men&#039;s EMEA W1 DIVISION 2 (A) - 3rd,Favero Assioma Duo (Garmin),KICKR Core#3 (v1.0.13-Zwift),384,383,1
75921,833859,2020-11-26 15:51:53,wahoo,Zwift - OH MY CRIT! - The Double Race 1/2 (A) - 9th,Favero Assioma Duo (Garmin),KICKR Core#3 (v1.0.13-Zwift),356,353,3
75946,833859,2020-11-26 16:58:02,wahoo,Zwift - OH MY CRIT! - The Double Race 2/2 (A) - 13th,Favero Assioma Duo (Garmin),KICKR Core#3 (v1.0.13-Zwift),325,325,0
80472,833859,1999-11-30 17:17:59,wahoo,Zwift - INC Steady State 45min - Group Training Ride 2.5 - 3.0w Average (C),Favero Assioma Duo (Garmin),KICKR Core#3 (v1.0.13-Zwift),205,207,-2
80961,833859,2020-12-08 19:31:42,wahoo,Zwift - Zwift Racing League | WTRL - Men&#039;s EMEA W1 DIVISION 2 (A) - 23rd,Favero Assioma Duo (Garmin),KICKR Core#3 (v1.0.13-Zwift),341,336,5
81292,833859,2020-12-09 16:50:49,wahoo,Zwift - INC Steady State 45min - Group Training Ride 2.5 - 3.0w/kg Average (C),Favero Assioma Duo (Garmin),KICKR Core#3 (v1.0.13-Zwift),211,210,1
81499,833859,2020-12-10 15:55:14,wahoo,Zwift - OH MY CRIT! - The Double Race 1/2 (A) - 20th,Favero Assioma Duo (Garmin),KICKR Core#3 (v1.0.13-Zwift),343,341,2
81546,833859,2020-12-10 16:47:55,wahoo,Zwift - OH MY CRIT! - The Double Race 2/2 (A) - 18th,Favero Assioma Duo (Garmin),KICKR Core#3 (v1.0.13-Zwift),337,338,-1
83692,833859,2020-12-15 18:47:48,wahoo,Zwift - Zwift Racing League | WTRL - Men&#039;s EMEA W1 DIVISION 2 (A),Favero Assioma Duo (Garmin),KICKR Core#3 (v1.0.13-Zwift),317,315,2
84362,833859,2020-12-17 16:00:33,wahoo,Zwift - OH MY CRIT! - The Double Race 1/2 (A),Favero Assioma Duo (Garmin),KICKR Core#3 (v1.0.13-Zwift),341,337,4
84363,833859,2020-12-17 16:00:33,wahoo,Zwift - OH MY CRIT! - The Double Race 2/2 (A),Favero Assioma Duo (Garmin),KICKR Core#3 (v1.0.13-Zwift),320,318,2
86961,833859,2020-12-24 16:01:41,wahoo,Zwift - OH MY CRIT! - The Double Race 1/2 (A) - 36th,Favero Assioma Duo (Garmin),KICKR Core#3 (v1.0.13-Zwift),349,349,0
86994,833859,2020-12-24 17:03:03,wahoo,Zwift - OH MY CRIT! - The Double Race 2/2 (A) - 27th,Favero Assioma Duo (Garmin),KICKR Core#3 (v1.0.13-Zwift),342,341,1
89522,833859,2020-12-31 15:47:55,wahoo,Zwift - OH MY CRIT! - The Double Race 1/2 (A) - 28th,Favero Assioma Duo (Garmin),KICKR Core#3 (v1.0.13-Zwift),326,326,0
89560,833859,2020-12-31 17:02:21,wahoo,Zwift - OH MY CRIT! - The Double Race 2/2 (A) - 25th,Favero Assioma Duo (Garmin),KICKR Core#3 (v1.0.13-Zwift),333,333,0
93119,833859,2021-01-07 16:03:43,wahoo,Zwift - OH MY CRIT! - The Double Race 1/2 (A) - 32nd,Favero Assioma Duo (Garmin),KICKR Core#3 (v1.0.13-Zwift),337,339,-2
95866,833859,2021-01-12 18:52:34,wahoo,Zwift - Zwift Racing League | WTRL - Men&#039;s/Mixed EMEA W1 DIVISION 1 (A) - 37th,Favero Assioma Duo (Garmin),KICKR Core#3 (v1.0.13-Zwift),360,339,21
97664,833859,2021-01-15 18:48:28,wahoo,Zwift - TDZ Stage 3: Longer Ride,Favero Assioma Duo (Garmin),KICKR Core#3 (v1.0.13-Zwift),289,289,0
99838,833859,2021-01-19 18:52:57,wahoo,Zwift - Zwift Racing League | WTRL - Men&#039;s/Mixed EMEA W1 DIVISION 1 (A),Favero Assioma Duo (Garmin),KICKR Core#3 (v1.0.13-Zwift),325,329,-4
100472,833859,2021-01-20 17:58:11,wahoo,Zwift - TDZ Stage 4: Longer Ride,Favero Assioma Duo (Garmin),KICKR Core#3 (v1.0.13-Zwift),302,303,-1
100893,833859,2021-01-21 16:55:00,wahoo,Zwift - OH MY CRIT! - The Double Race 2/2 (A) - 15th,Favero Assioma Duo (Garmin),KICKR Core#3 (v1.0.13-Zwift),351,352,-1
100895,833859,2021-01-21 16:55:00,wahoo,Zwift - TDZ Stage 4: Shorter Ride,Favero Assioma Duo (Garmin),KICKR Core#3 (v1.0.13-Zwift),335,338,-3
102146,833859,2021-01-23 17:54:10,wahoo,Zwift - TDZ Stage 4: Longer Ride - 3rd,Favero Assioma Duo (Garmin),KICKR Core#3 (v1.0.13-Zwift),322,324,-2
103694,833859,2021-01-26 18:54:38,wahoo,Zwift - Zwift Racing League | WTRL - Men&#039;s/Mixed EMEA W1 DIVISION 1 (A) - 52nd,Favero Assioma Duo (Garmin),KICKR Core#3 (v1.0.13-Zwift),364,369,-5
104620,833859,2021-01-28 16:58:46,wahoo,Zwift - OH MY CRIT!! - The Double Race 2/2 (A) - 5th,Favero Assioma Duo (Garmin),KICKR Core#3 (v1.0.13-Zwift),358,358,0
107567,833859,2021-02-02 19:03:14,wahoo,Zwift - Zwift Racing League | WTRL - Men&#039;s/Mixed EMEA W1 DIVISION 1 (A) - 54th,Favero Assioma Duo (Garmin),KICKR Core#3 (v1.0.13-Zwift),349,340,9
108791,833859,2021-02-04 16:55:35,wahoo,Zwift - OH MY CRIT!! - The Double Race 2/2 (A) - 17th,Favero Assioma Duo (Garmin),KICKR Core#3 (v1.0.13-Zwift),360,360,0
109111,833859,2021-02-04 19:29:36,wahoo,Mighty Metropolitan - Skyrocket TTT practice,Favero Assioma Duo (Garmin),KICKR Core#3 (v1.0.13-Zwift),349,351,-2
111767,833859,2021-02-09 19:04:41,wahoo,Zwift - Zwift Racing League | WTRL - Men&#039;s/Mixed EMEA W1 DIVISION 1 (A),Favero Assioma Duo (Garmin),KICKR Core#3 (v1.0.13-Zwift),350,351,-1
116110,833859,2021-02-16 19:00:02,wahoo,Zwift - Zwift Racing League | WTRL - Men&#039;s/Mixed EMEA W1 DIVISION 1 (A) - 51st,Favero Assioma Duo (Garmin),KICKR Core#3 (v1.0.13-Zwift),368,366,2
117428,833859,2021-02-18 18:21:54,wahoo,Zwift - ZZRC Happy Hour and a Bit (C),Favero Assioma Duo (Garmin),KICKR Core#3 (v1.0.13-Zwift),245,244,1
118512,833859,2021-02-20 19:56:47,wahoo,Zwift - PretzHELL by AHDR (C),Favero Assioma Duo (v4.75 - Garmin),KICKR Core#3 (v1.0.13-Zwift),337,336,1
118826,833859,2021-02-21 17:48:15,wahoo,Zwift - Stages of DIRT (E) - 32nd,Favero Assioma Duo (v4.75 - Garmin),KICKR Core#3 (v1.0.13-Zwift),301,301,0
119781,833859,2021-02-23 18:48:24,wahoo,Zwift - Zwift Racing League | WTRL - Men&#039;s/Mixed EMEA W1 DIVISION 1 (A) - 28th,Favero Assioma Duo (v4.75-Garmin),KICKR Core#3 (v1.0.13-Zwift),364,364,0
120396,833859,2021-02-24 17:43:29,wahoo,Zwift - 3R 100 Steady Ride (B),Favero Assioma Duo (v4.75-Garmin),KICKR Core#3 (v1.0.13-Zwift),292,290,2
120871,833859,2021-02-25 19:05:54,wahoo,Zwift - Marcel Schubert [WTRL Skyrocket]&#039;s Meetup - Greatest London Flat,Favero Assioma Duo (v4.75-Garmin),KICKR Core#3 (v1.0.13-Zwift),315,316,-1
121298,833859,2021-02-26 18:54:16,wahoo,Zwift - Haute Route Watopia 2021 Stage 1 (A),Favero Assioma Duo (v4.75-Garmin),KICKR Core#3 (v1.0.13-Zwift),334,337,-3
121697,833859,2021-02-27 14:57:07,wahoo,Zwift - Haute Route Watopia 2021 Stage 2 (A),Favero Assioma Duo (v4.75-Garmin),KICKR Core#3 (v1.0.13-Zwift),301,299,2
123159,833859,2021-03-02 19:03:14,wahoo,Zwift - Zwift Racing League | WTRL - Men&#039;s/Mixed EMEA W1 DIVISION 1 (A),Favero Assioma Duo (v4.75-Garmin),KICKR Core#3 (v1.0.13-Zwift),331,336,-5
124568,833859,2021-03-05 18:05:37,wahoo,Zwift - Newbury Velo Crit (A) - 1st,Favero Assioma Duo (v4.75-Garmin),KICKR Core#3 (v1.0.13-Zwift),319,318,1
128725,833859,2021-03-15 16:59:26,wahoo,Zwift - Ventouro Social Group Ride (C),Favero Assioma Duo (v4.75-Garmin),KICKR Core#3 (v1.0.13-Zwift),345,348,-3
10130,62584,2020-01-20 15:16:06,wahoo,Zwift - 3R Volcano Circuit Sprint Flat Race -On a Gravel bike (B),Assioma pedals,Wahoo Kickr Core,267,283,-16
10136,62584,2020-01-20 16:08:01,wahoo,Zwift - 3R Classique Reverse Flat Race - 4 Laps (26.9km/16.7mi 57m) (B),Assioma pedals,Wahoo Kickr Core,243,259,-16
10219,62584,2020-01-21 09:23:41,wahoo,Zwift - Wahoo Kickr Core vs Assioma Pedals correct ca,Assioma pedals,Wahoo Kickr Core,174,181,-7
10227,62584,2020-01-21 09:59:53,wahoo,Zwift - 3R Ultimate Racing League - Round 3 (B),Assioma pedals,Wahoo Kickr Core,247,265,-18
10850,62584,2020-01-25 08:29:38,wahoo,Zwift - VZT Tofu Tornado XL (B),Assioma pedals,Wahoo Kickr Core,284,282,2
11028,62584,2020-01-26 13:05:28,wahoo,Zwift - Watopia,Assioma pedals,Wahoo Kickr Core,208,215,-7
11141,62584,2020-01-27 09:32:30,wahoo,Zwift - Over Unders,Assioma pedals,Wahoo Kickr Core,224,228,-4
11829,62584,2020-01-31 16:06:47,wahoo,Zwift - London,Assioma pedals,Wahoo Kickr Core,217,229,-12
12029,62584,2020-02-01 12:57:19,wahoo,Zwift - Watopia,Assioma pedals,Wahoo Kickr Core,247,242,5
14872,62584,2020-02-20 10:39:18,wahoo,Zwift - Warm up,Assioma pedals,Wahoo Kickr Core,245,261,-16
24031,62584,2020-04-11 14:54:07,wahoo,Watopia 2nd,Wahoo Kickr Core,Wahoo Kickr Core,266,276,-10
29853,62584,2020-04-30 19:07:07,wahoo,Zwift - Kickr vs Pedals,Assioma pedals,Wahoo Kickr Core,173,168,5
29859,62584,2020-04-30 18:38:55,wahoo,Zwift - WTRL Team Time Trial (D),Assioma pedals,Wahoo Kickr Core,251,249,2
30153,62584,2020-05-01 15:30:42,wahoo,Zwift - TEAM VEGAN Cake Break (C),Assioma pedals,Wahoo Kickr Core,187,180,7
30164,62584,2020-05-01 14:35:22,wahoo,Zwift - NYC,Assioma pedals,Wahoo Kickr Core,273,272,1
42557,62584,2020-06-18 18:57:55,wahoo,Zwift - Frappe,Assioma pedals,Wahoo Kickr Core,249,258,-9
45938,62584,2020-07-09 18:45:07,wahoo,Zwift - Frappe,Assioma pedals,Wahoo Kickr Core,257,262,-5
48366,62584,2020-07-30 18:46:05,wahoo,Zwift - WTRL Team Time Trial (D),Assioma pedals,Wahoo Kickr Core,270,275,-5
61239,62584,2020-10-12 18:30:01,wahoo,Zwift - TEAM VEGAN Rice &#039;n&#039; Easy (D),Assioma pedals,Wahoo Kickr Core,150,154,-4
61571,62584,2020-10-13 15:31:13,wahoo,Zwift - TEAM VEGAN Tofu Tornado (B),Assioma pedals,Wahoo Kickr Core,261,272,-11
62325,62584,2020-10-15 18:46:16,wahoo,Zwift - Espresso,Assioma pedals,Wahoo Kickr Core,268,276,-8
64278,62584,2020-10-22 18:51:01,wahoo,Zwift - Espresso,Assioma pedals,Wahoo Kickr Core,285,288,-3
102578,857978,2021-01-24 20:38:44,wahoo,kicker test,stages,kicker,330,315,15
119290,857978,2021-02-22 19:19:53,wahoo,Zwift - Team TFC Mad Monday Winter Series (A),quarq dfour,kicker,330,321,9
119292,857978,2021-02-19 20:25:05,wahoo,Zwift - 3R Innsbruckring Flat Race - 4 Laps (35.2km/21.9mi 308m) (A),quarq dfour,kicker,341,333,8
120344,857978,2021-02-24 19:08:00,wahoo,Zwift - TUZ Winter Chase Race League Round 6 (A),quarq dfour,kicker,346,335,11
121861,857978,2021-02-27 19:30:52,wahoo,Zwift - 3R Endurance Series p/b OTE Sports (A),quarq dfour,kicker,357,361,-4
124199,857978,2021-03-04 20:00:23,wahoo,Zwift - KISS Race Series - EU PM (A),quarq dfour,kicker,344,352,-8
124950,857978,2021-03-06 09:29:57,wahoo,Zwift - DBR SufferDay League III (A),quarq dfour,kicker,339,336,3
14121,417762,2020-02-15 13:10:14,wahoo,Zwift - The BMTR Fundo (A),Garmin Vector 3,Wahoo Kickr Core,298,299,-1
14537,417762,2020-02-18 17:59:59,wahoo,Zwift - ZRG Winter Race Series 6/10 - Crit London Classique (A),Garmin Vector 3,Wahoo Kickr Core,333,331,2
15072,417762,2020-02-21 18:00:01,wahoo,Zwift - Tour of Innsbruck // Stage 1,Garmin Vector 3,Wahoo Kickr Core,325,333,-8
15187,417762,2020-02-22 13:30:00,wahoo,Zwift - Tour of Innsbruck // Stage 2 ,Garmin Vector 3,Wahoo Kickr Core,311,313,-2
15296,417762,2020-02-23 13:00:00,wahoo,Zwift - Tour of Innsbruck // Stage 3,Garmin Vector 3,Wahoo Kickr Core,338,338,0
19017,417762,2020-03-21 12:00:00,wahoo,Zwift - Stage 4 - Longer Ride - Tour of Watopia 2020,Garmin Vector 3,Wahoo Kickr Core,316,330,-14
24577,417762,2020-04-14 09:11:39,wahoo,Zwift - 3R Spring Loaded Race Series - Round 3of6 (A),Garmin Vector 3,Wahoo Kickr Core,371,378,-7
25810,417762,2020-04-18 09:04:55,wahoo,Zwift - 3R Innsbruckring Flat Race - 5 Laps (44km/27.3mi 385m) (A),Garmin Vector 3,Wahoo Kickr Core,335,353,-18
30911,417762,2020-05-03 11:44:51,wahoo,Zwift - Crit City Race (A),Garmin Vector 3,Wahoo Kickr Core,348,355,-7
35263,417762,2020-05-16 10:08:54,wahoo,Zwift - Tour for All 2020: Stage 4 Longer Race A/B,Garmin Vector 3,Wahoo Kickr Core,327,335,-8
36035,417762,2020-05-19 15:04:52,wahoo,Zwift - 3R & Wahoo Ride Real Race Series - Round 2 of 7 (A),Garmin Vector 3,Wahoo Kickr Core,349,358,-9
37603,417762,2020-05-25 11:19:31,wahoo,Zwift - Crit City Race (A),Garmin Vector 3,Wahoo Kickr Core,352,361,-9
37645,417762,2020-05-25 17:14:29,wahoo,Zwift - DBR Wahoo League (A),Garmin Vector 3,Wahoo Kickr Core,370,380,-10
41452,417762,2020-06-13 14:15:00,wahoo,Zwift - OH CRIT!! - Saturday Smash Series (A),Garmin Vector 3,Wahoo Kickr Core,350,360,-10
42431,417762,2020-06-18 15:15:00,wahoo,Zwift - OH CRIT!! - Lockdown Series - Round 3 Race 1 (A),Garmin Vector 3,Wahoo Kickr Core,362,363,-1
42841,417762,2020-06-20 14:15:00,wahoo,Zwift - OH CRIT!! - Saturday Smash Series (A),Garmin Vector 3,Wahoo Kickr Core,338,349,-11
43229,417762,2020-06-23 15:04:11,wahoo,Zwift - 3R & Wahoo Ride Real Race Series - Round 6 of 7 (A),Garmin Vector 3,Wahoo Kickr Core,374,375,-1
43556,417762,2020-06-25 15:15:00,wahoo,Zwift - OH MY CRIT! - The Double Race 1/2 (A),Garmin Vector 3,Wahoo Kickr Core,341,352,-11
43557,417762,2020-06-25 16:05:00,wahoo,Zwift - OH MY CRIT! - The Double Race 2/2 (A),Garmin Vector 3,Wahoo Kickr Core,304,309,-5
44232,417762,2020-06-30 15:30:00,wahoo,Zwift - TEAM VEGAN Tofu Tornado (A),Garmin Vector 3,Wahoo Kickr Core,330,330,0
44552,417762,2020-07-02 15:15:00,wahoo,Zwift - OH MY CRIT! - The Double Race 1/2 (A),Garmin Vector 3,Wahoo Kickr Core,359,366,-7
44831,417762,2020-07-04 11:00:55,wahoo,Zwift - L&#039;Etape du Tour Stage 1 - Open,Garmin Vector 3,Wahoo Kickr Core,334,333,1
45265,417762,2020-07-07 15:05:00,wahoo,Zwift - 3R Volcano Circuit Flat Race - 8 Laps (35.2km/21.9mi 160m) (A),Garmin Vector 3,Wahoo Kickr Core,351,357,-6
45629,417762,2020-07-09 15:15:01,wahoo,Zwift - OH MY CRIT! - The Double Race 1/2 (A),Garmin Vector 3,Wahoo Kickr Core,372,380,-8
46023,417762,2020-07-11 09:00:59,wahoo,Zwift - L&#039;Etape du Tour Stage 2 - Open,Garmin Vector 3,Wahoo Kickr Core,356,352,4
46626,417762,2020-07-16 15:15:00,wahoo,Zwift - OH MY CRIT! - The Double Race 1/2 (A),Garmin Vector 3,Wahoo Kickr Core,370,390,-20
46821,417762,2020-07-18 11:01:00,wahoo,Zwift - L&#039;Etape du Tour Stage 3 - Open,Garmin Vector 3,Wahoo Kickr Core,316,314,2
47985,417762,2020-07-28 14:03:46,wahoo,Zwift - Zwift Time Trial Tuesday: Tempus Fugit (E),Garmin Vector 3,Wahoo Kickr Core,357,357,0
48779,417762,2020-08-04 15:04:59,wahoo,Zwift - 3R Turbocharged Team Race Series - Round 4 (A),Garmin Vector 3,Wahoo Kickr Core,350,356,-6
49834,417762,2020-08-13 15:15:01,wahoo,Zwift - OH MY CRIT! - The Double Race 1/2 (A),Garmin Vector 3,Wahoo Kickr Core,379,381,-2
50142,417762,2020-08-15 14:15:00,wahoo,Zwift - OH MY CRIT - Saturday Smash Race (A),Garmin Vector 3,Wahoo Kickr Core,396,402,-6
50536,417762,2020-08-18 15:05:00,wahoo,Zwift - 3R Turbocharged Team Race Series - Round 6 (A),Garmin Vector 3,Wahoo Kickr Core,363,375,-12
51063,417762,2020-08-21 09:34:59,wahoo,Zwift - TBR Burrito Race (A),Garmin Vector 3,Wahoo Kickr Core,345,348,-3
51260,417762,2020-08-22 14:14:59,wahoo,Zwift - OH MY CRIT - Saturday Smash Race* (A),Garmin Vector 3,Wahoo Kickr Core,370,370,0
51632,417762,2020-08-25 09:59:59,wahoo,Zwift - Off The MAAP Stage 4 Race (A),Garmin Vector 3,Wahoo Kickr Core,335,358,-23
51971,417762,2020-08-26 12:00:00,wahoo,Zwift - TTR Mini RACE (A),Garmin Vector 3,Wahoo Kickr Core,374,379,-5
51978,417762,2020-08-26 12:29:59,wahoo,Zwift - 3R LaGuardia Loop Flat Race - 10 Laps (28.3km/17.6mi 270m) (A),Garmin Vector 3,Wahoo Kickr Core,360,361,-1
52164,417762,2020-08-27 15:14:59,wahoo,Zwift - OH MY CRIT! - The Double Race 1/2 (A),Garmin Vector 3,Wahoo Kickr Core,372,375,-3
53075,417762,2020-09-02 14:59:54,wahoo,Zwift - Sydkysten / KST Race (A),Garmin Vector 3,Wahoo Kickr Core,328,333,-5
53203,417762,2020-09-03 15:15:00,wahoo,Zwift - OH MY CRIT! - The Double Race 1/2 (A),Garmin Vector 3,Wahoo Kickr Core,370,374,-4
53548,417762,2020-09-05 14:14:59,wahoo,Zwift - OH MY CRIT - Saturday Smash Race (A),Garmin Vector 3 S,Wahoo Kickr Core,350,361,-11
53640,417762,2020-09-06 11:20:00,wahoo,Ottawa  Top speed race,Garmin Vector 3 S,Wahoo Kickr Core,378,399,-21
53900,417762,2020-09-08 09:59:59,wahoo,Zwift - KISS at Race - Americas AM (A),Garmin Vector 3 S,Wahoo Kickr Core,357,348,9
53933,417762,2020-09-08 15:04:59,wahoo,Zwift - 3R Sundown Race Series  (A),Garmin Vector 3 S,Wahoo Kickr Core,356,353,3
54126,417762,2020-09-09 14:59:59,wahoo,Zwift - Sydkysten / KST Race (A),Garmin Vector 3 S,Wahoo Kickr Core,357,361,-4
54553,417762,2020-09-11 09:35:00,wahoo,Zwift - TBR Burrito Race (A),Garmin Vector 3 S,Wahoo Kickr Core,378,380,-2
54598,417762,2020-09-11 15:14:59,wahoo,Zwift - 3R Sand and Sequoias Race (A),Garmin Vector 3 S,Wahoo Kickr Core,358,359,-1
57011,417762,2020-09-23 16:59:59,wahoo,Zwift - MIDWEEK Autumn Series by SZR (A),Garmin Vector 3 S,Wahoo Kickr Core,334,364,-30
57440,417762,2020-09-25 09:34:59,wahoo,Zwift - TBR Burrito Race (A),Garmin Vector 3 S,Wahoo Kickr Core,372,382,-10
58086,417762,2020-09-28 18:19:59,wahoo,Zwift - TFC Mad Monday Autumn Series (A),Garmin Vector 3 S,Wahoo Kickr Core,341,352,-11
58428,417762,2020-09-30 09:44:59,wahoo,Zwift - USA Cycling Race League by Indoor Specialist (A),Garmin Vector 3 S,Wahoo Kickr Core,360,369,-9
58776,417762,2020-10-01 16:05:00,wahoo,Zwift - OH MY CRIT! - The Double Race 2/2 (A),Garmin Vector 3 S,Wahoo Kickr Core,352,353,-1
58777,417762,2020-10-01 15:15:00,wahoo,Zwift - OH MY CRIT! - The Double Race 1/2 (A),Garmin Vector 3 S,Wahoo Kickr Core,398,400,-2
59214,417762,2020-10-03 10:44:54,wahoo,Zwift - Into the Red by RELENTLESS (A),Garmin Vector 3 S,Wahoo Kickr Core,362,380,-18
59382,417762,2020-10-04 10:30:00,wahoo,Zwift - Stages of DIRT (A),Garmin Vector 3 S,Wahoo Kickr Core,343,360,-17
59829,417762,2020-10-06 17:09:59,wahoo,Zwift - 3R Volcano KOM After Party Race - 2 laps + climb (40.2km/25mi 286m) (A),Garmin Vector 3 S,Wahoo Kickr Core,364,380,-16
60070,417762,2020-10-07 16:00:00,wahoo,Zwift - FrenchyFuzion Criterium League (A),Garmin Vector 3 S,Wahoo Kickr Core,329,342,-13
60545,417762,2020-10-09 10:04:59,wahoo,Zwift - 3R Innsbruckring Flat Race - 4 Laps (35.2km/21.9mi 308m) (A),Garmin Vector 3 S,Wahoo Kickr Core,367,381,-14
60751,417762,2020-10-10 10:44:59,wahoo,Zwift - Into the Red by RELENTLESS (A),Garmin Vector 3 S,Wahoo Kickr Core,329,345,-16
61530,417762,2020-10-13 17:14:59,wahoo,Zwift - Zwift Racing League | WTRL,Garmin Vector 3 S,Wahoo Kickr Core,367,384,-17
62125,417762,2020-10-15 15:15:00,wahoo,Zwift - OH MY CRIT! - The Double Race 1/2 (A),Garmin Vector 3 S,Wahoo Kickr Core,360,371,-11
62596,417762,2020-10-17 11:10:00,wahoo,Zwift - ZA Road Race #1: 4 - 5 w/kg,Garmin Vector 3 S,Wahoo Kickr Core,354,370,-16
63012,417762,2020-10-19 14:15:00,wahoo,Zwift - 3R Classique Reverse Flat Race - 5 Laps (32km/20.1mi 76m) (A),Garmin Vector 3 S,Wahoo Kickr Core,315,338,-23
63809,417762,2020-10-21 16:59:59,wahoo,Zwift - MIDWEEK Autumn Series by SZR (A),Garmin Vector 3 S,Wahoo Kickr Core,355,374,-19
66606,417762,2020-10-31 10:45:00,wahoo,Zwift - Into the Red by RELENTLESS (A),Garmin Vector 3 S,Wahoo Kickr Core,369,381,-12
66933,417762,2020-11-01 13:04:59,wahoo,Zwift - 3R Watopia Flat Route Race - 4 Laps (40.5km/25.1mi 216m) (A),Garmin Vector 3 S,Wahoo Kickr Core,366,379,-13
68534,417762,2020-11-06 17:00:00,wahoo,Zwift - Skoda presents: Ride with the InternationElles (E),Garmin Vector 3 S,Wahoo Kickr Core,230,237,-7
68754,417762,2020-11-07 11:09:59,wahoo,Zwift - ZA Road Race #1: 4 - 5 w/kg,Garmin Vector 3 S,Wahoo Kickr Core,346,354,-8
69316,417762,2020-11-09 16:09:59,wahoo,Zwift - 3R Classique Reverse Flat Race - 4 Laps (26.9km/16.7mi 57m) (A),Garmin Vector 3 S,Wahoo Kickr Core,351,361,-10
69718,417762,2020-11-10 17:10:00,wahoo,Zwift - 3R Volcano KOM After Party Race - 2 laps + climb (40.2km/25mi 286m) (A),Garmin Vector 3 S,Wahoo Kickr Core,362,374,-12
72092,417762,2020-11-17 11:09:59,wahoo,Zwift - Japan Zwift Tuesday Race (A),Garmin Vector 3 S,Wahoo Kickr Core,373,384,-11
73020,417762,2020-11-19 16:14:59,wahoo,Zwift - OH MY CRIT! - The Double Race 1/2 (A),Garmin Vector 3 S,Wahoo Kickr Core,378,391,-13
74195,417762,2020-11-22 13:05:00,wahoo,Zwift - 3R Watopia Flat Route Race - 4 Laps (40.5km/25.1mi 216m) (A),Garmin Vector 3 S,Wahoo Kickr Core,366,381,-15
75010,417762,2020-11-24 18:15:00,wahoo,Zwift - Zwift Racing League | WTRL - Men&#039;s EMEA E1 DIVISION 1,Garmin Vector 3 S,Wahoo Kickr Core,367,382,-15
76798,417762,2020-11-28 10:44:52,wahoo,Zwift - Into the Red by RELENTLESS (A),Garmin Vector 3 S,Wahoo Kickr Core,366,380,-14
78571,417762,2020-12-02 18:00:04,wahoo,Zwift - MIDWEEK Winter Series by SZR (A),Garmin Vector 3 S,Wahoo Kickr Core,365,375,-10
80777,417762,2020-12-08 18:15:00,wahoo,Zwift - Zwift Racing League | WTRL - Men&#039;s EMEA E1 DIVISION 1 (A),Garmin Vector 3 S,Wahoo Kickr Core,397,395,2
82342,417762,2020-12-12 14:00:00,wahoo,Zwift - MGCC hosts Ontario Cycling Association Virtual Challenge #1,Garmin Vector 3 S,Wahoo Kickr Core,346,361,-15
83110,417762,2020-12-14 16:09:59,wahoo,Zwift - 3R Classique Reverse Flat Race - 4 Laps (26.9km/16.7mi 57m) (A),Garmin Vector 3 S,Wahoo Kickr Core,338,348,-10
83487,417762,2020-12-15 16:04:59,wahoo,Zwift - 3R Volcano Circuit Flat Race - 8 Laps (35.2km/21.9mi 160m) (A),Garmin Vector 3 S,Wahoo Kickr Core,360,374,-14
85062,417762,2020-12-19 12:59:59,wahoo,Zwift - Tour of New York Stage 2 - Open Longer,Garmin Vector 3 S,Wahoo Kickr Core,373,386,-13
87153,417762,2020-12-25 11:59:59,wahoo,Zwift - Best Buddies Challenge - TGIF Ride (E),Garmin Vector 3 S,Wahoo Kickr Core,403,419,-16
87861,417762,2020-12-27 15:25:00,wahoo,Zwift - 3R Watopia 65km Race - 6 laps (40mi 324m) (A),Garmin Vector 3 S,Wahoo Kickr Core,363,378,-15
88183,417762,2020-12-28 14:14:59,wahoo,Zwift - 3R Classique Reverse Flat Race - 5 Laps (32km/20.1mi 76m) (A),Garmin Vector 3 S,Wahoo Kickr Core,345,360,-15
88945,417762,2020-12-30 11:59:59,wahoo,Zwift - TTR Mini RACE (A),Garmin Vector 3 S,Wahoo Kickr Core,345,358,-13
89381,417762,2020-12-31 12:25:00,wahoo,Zwift - EMU Japan Race (A),Garmin Vector 3 S,Wahoo Kickr Core,333,345,-12
90215,417762,2021-01-02 13:19:59,wahoo,Zwift - 3R Innsbruckring Flat Race - 5 Laps (44km/27.3mi 385m) (A),Garmin Vector 3 S,Wahoo Kickr Core,309,318,-9
90614,417762,2021-01-03 11:44:59,wahoo,Zwift - Crit City Race (A),Garmin Vector 3 S,Wahoo Kickr Core,361,379,-18
91243,417762,2021-01-04 16:09:59,wahoo,Zwift - 3R Classique Reverse Flat Race - 4 Laps (26.9km/16.7mi 57m) (A),Garmin Vector 3 S,Wahoo Kickr Core,353,368,-15
91818,417762,2021-01-05 18:55:00,wahoo,Zwift - Team Italy & Frenchy Fuzion League (A),Garmin Vector 3 S,Wahoo Kickr Core,392,410,-18
93394,417762,2021-01-08 17:00:05,wahoo,Zwift - Zwift Fast Fridays: Bologna Time Trial (E),Garmin Vector 3 S,Wahoo Kickr Core,361,395,-34
95639,417762,2021-01-12 18:26:57,wahoo,Zwift - Zwift Racing League | WTRL - Men&#039;s/Mixed EMEA E2 DIVISION 4 (A),Garmin Vector 3 S,Wahoo Kickr Core,352,351,1
96763,417762,2021-01-14 10:59:58,wahoo,Zwift - KISS Race Series - Americas AM (A),Garmin Vector 3 S,Wahoo Kickr Core,317,328,-11
97442,417762,2021-01-15 15:14:59,wahoo,Zwift - 3R Sand and Sequoias Race (A),Garmin Vector 3 S,Wahoo Kickr Core,349,363,-14
98006,417762,2021-01-16 14:29:59,wahoo,Zwift - VACA Saturday Smackdown (A),Garmin Vector 3 S,Wahoo Kickr Core,361,369,-8
99717,417762,2021-01-19 18:33:58,wahoo,Zwift - Zwift Racing League | WTRL - Men&#039;s/Mixed EMEA E2 DIVISION 4 (A),Garmin Vector 3 S,Wahoo Kickr Core,346,357,-11
100241,417762,2021-01-20 15:59:59,wahoo,Zwift - Sydkysten Race (A),Garmin Vector 3 S,Wahoo Kickr Core,324,335,-11
101433,417762,2021-01-22 17:00:00,wahoo,Zwift -  ZRG-CC 2021 Series (A),Garmin Vector 3 S,Wahoo Kickr Core,331,345,-14
101894,417762,2021-01-23 14:30:00,wahoo,Zwift - VACA Saturday Smackdown (A),Garmin Vector 3 S,Wahoo Kickr Core,366,383,-17
103462,417762,2021-01-26 18:26:58,wahoo,Zwift - Zwift Racing League | WTRL - Men&#039;s/Mixed EMEA E2 DIVISION 4 (A),Garmin Vector 3 S,Wahoo Kickr Core,347,371,-24
104466,417762,2021-01-28 11:00:00,wahoo,Zwift - KISS Race Series - Americas AM (A),Garmin Vector 3 S,Wahoo Kickr Core,382,378,4
107325,417762,2021-02-02 18:27:00,wahoo,Zwift - Zwift Racing League | WTRL - Men&#039;s/Mixed EMEA E2 DIVISION 4 (A),Garmin Vector 3 S,Wahoo Kickr Core,365,392,-27
114071,417762,2021-02-13 12:59:57,wahoo,Zwift - 111 - Strongman racing series (A),Garmin Vector 3 S,Wahoo Kickr Core,360,374,-14
115843,417762,2021-02-16 18:26:59,wahoo,Zwift - Zwift Racing League | WTRL - Men&#039;s/Mixed EMEA E2 DIVISION 4 (A),Garmin Vector 3 S,Wahoo Kickr Core,398,411,-13
117186,417762,2021-02-18 16:15:22,wahoo,Zwift - OH MY CRIT!! - The Double Race 1/2 (A),Garmin Vector 3 S,Wahoo Kickr Core,379,375,4
117193,417762,2021-02-18 17:04:59,wahoo,Zwift - OH MY CRIT!! - The Double Race 2/2 (A),Garmin Vector 3 S,Wahoo Kickr Core,379,390,-11
118300,417762,2021-02-20 16:05:58,wahoo,Zwift - 3R Endurance Series p/b OTE Sports- Stage 1 (A),Garmin Vector 3 S,Wahoo Kickr Core,344,353,-9
119573,417762,2021-02-23 18:26:59,wahoo,Zwift - Zwift Racing League | WTRL - Men&#039;s/Mixed EMEA E2 DIVISION 4 (A),Garmin Vector 3 S,Wahoo Kickr Core,341,351,-10
120230,417762,2021-02-24 15:59:59,wahoo,Zwift - Sydkysten Race (A),Garmin Vector 3 S,Wahoo Kickr Core,334,345,-11
120621,417762,2021-02-25 10:59:59,wahoo,Zwift - KISS Race Series - Americas AM (New Pack Dynamics) (A),6331039644_ACTIVITY,Wahoo Kickr Core,345,356,-11
120703,417762,2021-02-25 17:04:59,wahoo,Zwift - OH MY CRIT!! - The Double Race 2/2 (A),Garmin Vector 3 S,Wahoo Kickr Core,379,385,-6
121679,417762,2021-02-27 16:05:59,wahoo,Zwift - 3R Endurance Series p/b OTE Sports (A),Garmin Vector 3 S,Wahoo Kickr Core,375,386,-11
122389,417762,2021-03-01 16:09:59,wahoo,Zwift - 3R Classique Reverse Flat Race - 4 Laps (26.9km/16.7mi 57m) (A),Garmin Vector 3 S,Wahoo Kickr Core,308,322,-14
123535,417762,2021-03-03 17:59:59,wahoo,Zwift - MIDWEEK Crit Race Series by SZR (A),Garmin Vector 3 S,Wahoo Kickr Core,355,367,-12
123879,417762,2021-03-04 10:59:59,wahoo,Zwift - KISS Race Series - Americas AM (New Pack Dynamics) (A),Garmin Vector 3 S,Wahoo Kickr Core,337,349,-12
124392,417762,2021-03-05 11:19:59,wahoo,Zwift - 3R LaGuardia Loop Reverse Flat Race - 8 Laps (24.5km/15.2mi 216m) (A),Garmin Vector 3 S,Wahoo Kickr Core,361,373,-12
125045,417762,2021-03-06 16:06:00,wahoo,Zwift - 3R Endurance Series p/b OTE Sports (A),Garmin Vector 3 S,Wahoo Kickr Core,330,338,-8
125434,417762,2021-03-07 15:24:59,wahoo,Zwift - 3R Watopia 65km Race - 6 laps (40mi 324m) (A),Garmin Vector 3 S,Wahoo Kickr Core,347,354,-7
126523,417762,2021-03-10 17:59:59,wahoo,Zwift - MIDWEEK Crit Race Series by SZR (A),Garmin Vector 3 S,Wahoo Kickr Core,367,378,-11
127002,417762,2021-03-11 17:04:59,wahoo,Zwift - OH MY CRIT!! - The Double Race 2/2 (A),Garmin Vector 3 S,Wahoo Kickr Core,353,369,-16
127544,417762,2021-03-12 17:59:59,wahoo,Zwift - KIRCHMAIR Race Series (A),Garmin Vector 3 S,Wahoo Kickr Core,349,365,-16
129135,417762,2021-03-16 18:29:59,wahoo,Zwift - CeramicSpeed Race Series: Open Race (A),Garmin Vector 3 S,Wahoo Kickr Core,354,349,5
7460,863566,2019-12-23 14:12:06,wahoo,Zwift - 3R Classique Reverse Flat Race - 5 Laps (32km/20.1mi 76m) (A),SRM Origin Carbon,Wahoo Kickr,344,343,1
7461,863566,2019-12-23 14:12:06,wahoo,Zwift - 3R Volcano Circuit Sprint Flat Race - 1 Lap (6.6km/4.1mi 20m) (A),SRM Origin Carbon,Wahoo Kickr,335,343,-8
7462,863566,2019-12-28 08:41:34,wahoo,Zwift - Danmarks Cykle Union Punchers Special (A),SRM Origin Carbon,Wahoo Kickr,390,388,2
7561,863566,2019-12-29 08:31:25,wahoo,Zwift - Danmarks Cykle Union Racing League (A),SRM Origin Carbon,Wahoo Kickr,386,383,3
7936,863566,2019-12-31 07:49:05,wahoo,Zwift - KISS at Race - Down Under (A),SRM Origin Carbon,Wahoo Kickr,411,395,16
7937,863566,2019-12-31 07:49:05,wahoo,Zwift - Ultimate - Goodbye 2019 By 3R (A),SRM Origin Carbon,Wahoo Kickr,364,351,13
7938,863566,2020-01-02 15:53:37,wahoo,Zwift - OH CRIT!! - The Double Race - Race 1/2 (A),SRM Origin Carbon,Wahoo Kickr,351,344,7
7939,863566,2020-01-02 15:53:37,wahoo,Zwift - OH CRIT!! - The Double Race - Race 2/2 (A),SRM Origin Carbon,Wahoo Kickr,345,344,1
8065,863566,2020-01-04 14:35:12,wahoo,Zwift - OH CRIT!! - Saturday Smash Series (A),SRM Origin Carbon,Wahoo Kickr,384,376,8
8607,863566,2020-01-08 17:54:59,wahoo,Zwift - FIETS Magazine Race Series (A),Quarq Elsa,Wahoo Kickr,379,370,9
9351,863566,2020-01-14 17:23:48,wahoo,Zwift - Danmarks Cykle Union 2020 Cup (A),Quarq Elsa,Wahoo Kickr,365,352,13
9939,863566,2020-01-18 08:03:51,wahoo,Zwift - Danmarks Cykle Union 2020 Cup (A),Quarq Elsa,Wahoo Kickr,351,340,11
11347,863566,2020-01-28 17:47:50,wahoo,Zwift - Danmarks Cykle Union 2020 Cup (A),Quarq Elsa,Wahoo Kickr,375,362,13
11685,863566,2020-01-29 17:40:37,wahoo,Zwift - DBR Wednesday Race (A),Quarq Elsa,Wahoo Kickr,387,371,16
22173,863566,2020-04-05 08:00:21,wahoo,Zwift - Ronde van Zwift (A),SRM Origin Carbon (Zwift),Wahoo Kickr (Garmin 1030),377,381,-4
23564,863566,2020-04-09 17:10:12,wahoo,Zwift - London International // Zwift Classic (A),SRM Origin Carbon (Zwift),Wahoo Kickr (Garmin 1030),365,362,3
37368,863566,2020-05-24 04:35:36,wahoo,Zwift - KISS at Race 100 - EU (A),SRM Origin Carbon (Zwift),Wahoo Kickr (Garmin 1030),390,382,8
94198,812036,2021-01-09 18:59:29,wahoo,Zwift - TDZ Stage 2: Longer Ride,Stages Gen 1 Left Crank,Kickr Gen 3,343,353,-10
96049,812036,2021-01-13 02:58:59,wahoo,Zwift - Zwift Racing League | WTRL - Men&#039;s/Mixed AMERICAS W DIVISION 1 (A),Stages Gen 1 Left Crank,Kickr Gen 3,311,324,-13
108788,812036,2021-02-03 02:56:10,wahoo,Zwift - Zwift Racing League | WTRL - Men&#039;s/Mixed AMERICAS W DIVISION 1 (A),Stages Gen 1 Left Crank,Kickr Gen 3,364,368,-4
121935,812036,2021-02-27 18:58:23,wahoo,Zwift - Haute Route Watopia 2021 Stage 2 (A),Stages Gen 1 Left Crank,Kickr Gen 3,337,343,-6
23278,537335,2020-04-09 16:20:01,neo,Bracasse cup 4/4,Pédales Assioma,Tacx Neo,382,376,6
24320,537335,2020-04-13 16:20:02,neo,Zwift - The Cauberg Royal Classic Mens Workout,Pédales Assioma,Tacx Neo,320,325,-5
71848,859222,2020-11-14 14:45:49,wahoo,Zwift - Crit City Race (B),Assioma Duo,Wahoo Kickr v5,326,327,-1
55211,729332,2020-09-14 17:59:50,wahoo,Zwift - Invitational League // Qualifying Race #1,Garmin Vector 3 - Garmin 820 Edge,Wahoo Kickr 5 - Zwift,373,378,-5
56582,729332,2020-09-20 12:59:51,wahoo,Zwift - Invitational League // Qualifying Race #3 (Men) (A),Garmin Vector 3 - Garmin 820 Edge,Wahoo Kickr 5 - Zwift,428,420,8
58639,729332,2020-09-30 18:44:59,wahoo,ZADA - Three Sisters Test,Garmin Vector 3 - Garmin 820 Edge,Wahoo Kickr 5 - Zwift,449,454,-5
62313,729332,2020-10-15 18:14:57,wahoo,Zwift - Pre Event Ride // Swedish Cycling Federation,Garmin Vector 3 - Garmin 820 Edge,Wahoo Kickr 5 - Zwift,366,366,0
63163,729332,2020-10-19 18:20:17,wahoo,Zwift - Premier Division // Zwift Racing League (men) ,Garmin Vector 3 - Garmin Edge 820,Wahoo Kickr 5 - Zwift,422,416,6
67392,729332,2020-11-02 19:15:42,wahoo,Zwift - Premier Division // Zwift Racing League (men) (A),Garmin Vector 3 - Garmin Edge 820,Wahoo Kickr 5 - Zwift,398,393,5
69519,729332,2020-11-09 19:59:49,wahoo,Zwift - Premier Division // Zwift Racing League (men) (A),Garmin Vector 3 - Garmin Edge 820,Wahoo Kickr 5 - Zwift,435,436,-1
72392,729332,2020-11-16 19:07:22,wahoo,Zwift - Premier Division // Zwift Racing League (men) (A),Garmin Vector 3 - Garmin Edge 820,Wahoo Kickr 5 - Zwift,407,404,3
74755,729332,2020-11-23 19:59:51,wahoo,Zwift - Premier Division // Zwift Racing League (men) (A),Garmin Vector 3 - Garmin Edge 820,Wahoo Kickr 5 - Zwift,443,438,5
76558,729332,2020-11-26 19:47:51,wahoo,Zwift - WTRL NOPINZ WORLD TTT CHAMPIONSHIPS - Zone 10 (C),Garmin Vector 3 - Garmin Edge 820,Wahoo Kickr 5 - Zwift,396,399,-3
77805,729332,2020-11-30 19:12:22,wahoo,Zwift - Premier Division // Zwift Racing League (men) (A),Garmin Vector 3 - Garmin Edge 820,Wahoo Kickr 5 - Zwift,431,431,0
95192,729332,2021-01-11 19:14:47,wahoo,Zwift - Premier Division // Zwift Racing League (men) (A),Garmin Vector 3 - Garmin Edge 820,Wahoo Kickr 5 - Zwift,363,368,-5
97187,729332,2021-01-14 19:50:55,wahoo,Zwift - WTRL Team Time Trial - Zone 9 (C),Garmin Vector 3 - Garmin Edge 820,Wahoo Kickr 5 - Zwift,417,412,5
99329,729332,2021-01-18 19:51:16,wahoo,Zwift - Premier Division // Zwift Racing League (men) (A),Garmin Vector 3 - Garmin Edge 820,Wahoo Kickr 5 - Zwift,424,423,1
101117,729332,2021-01-21 19:47:52,wahoo,Zwift - WTRL Team Time Trial - Zone 9 (C),Garmin Vector 3 - Garmin Edge 820,Wahoo Kickr 5 - Zwift,416,415,1
103089,729332,2021-01-25 19:04:50,wahoo,Zwift - Premier Division // Zwift Racing League (men) (A),Garmin Vector 3 - Garmin Edge 820,Wahoo Kickr 5 - Zwift,449,444,5
106988,729332,2021-02-01 20:06:51,wahoo,Zwift - Premier Division // Zwift Racing League (men) (A),Garmin Vector 3 - Garmin Edge 820,Wahoo Kickr 5 - Zwift,381,389,-8
109077,729332,2021-02-04 19:43:53,wahoo,Zwift - WTRL Team Time Trial - Zone 9 (C),Garmin Vector 3 - Garmin Edge 820,Wahoo Kickr 5 - Zwift,401,409,-8
109511,729332,2021-02-05 15:29:56,wahoo,Zwift - BST Mountaingoat Race (A),Garmin Vector 3 - Garmin Edge 820,Wahoo Kickr 5 - Zwift,430,430,0
111215,729332,2021-02-08 19:18:20,wahoo,Zwift - Premier Division // Zwift Racing League (men) (A),Garmin Vector 3 - Garmin Edge 820,Wahoo Kickr 5 - Zwift,427,427,0
112506,729332,2021-02-10 18:59:54,wahoo,Zwift - Movistar Team Challenge // Round 1 (A),Garmin Vector 3 - Garmin Edge 820,Wahoo Kickr 5 - Zwift,369,356,13
113721,729332,2021-02-12 18:59:49,wahoo,Zwift - Movistar Team Challenge // Round 1 (men),Garmin Vector 3 - Garmin Edge 820,Wahoo Kickr 5 - Zwift,460,455,5
115475,729332,2021-02-15 20:01:53,wahoo,Zwift - Premier Division // Zwift Racing League (men) (A),Garmin Vector 3 - Garmin Edge 820,Wahoo Kickr 5 - Zwift,435,429,6
116880,729332,2021-02-17 18:59:54,wahoo,Zwift - Movistar Team Challenge // Round 2 (men) - Race 3/4,Garmin Vector 3 - Garmin Edge 820,Wahoo Kickr 5 - Zwift,370,367,3
117942,729332,2021-02-19 18:59:54,wahoo,Zwift - Movistar Team Challenge // Round 2 (men),Garmin Vector 3 - Garmin Edge 820,Wahoo Kickr 5 - Zwift,444,441,3
119306,729332,2021-02-22 19:09:51,wahoo,Zwift - Premier Division // Zwift Racing League (men) (A),Garmin Vector 3 - Garmin Edge 820,Wahoo Kickr 5 - Zwift,365,369,-4
122679,729332,2021-03-01 20:15:47,wahoo,Zwift - Premier Division // Zwift Racing League (men) (A),Garmin Vector 3 - Garmin Edge 820,Wahoo Kickr 5 - Zwift,422,410,12
124234,729332,2021-03-04 19:39:57,wahoo,Zwift - Movistar Team Challenge // Points Race (men),Garmin Vector 3 - Garmin Edge 820,Wahoo Kickr 5 - Zwift,367,368,-1
124235,729332,2021-03-04 18:59:59,wahoo,Zwift - Ramp Test,Garmin Vector 3 - Garmin Edge 820,Wahoo Kickr 5 - Zwift,449,449,0
126751,729332,2021-03-10 18:44:51,wahoo,Zwift - Scandinavian Cup 2021 - Round 3 - Men (A),Garmin Vector 3 - Garmin Edge 820,Wahoo Kickr 5 - Zwift,417,412,5
128942,729332,2021-03-15 19:00:04,wahoo,Zwift -  SCF SWE Cup Men (A),Garmin Vector 3 - Garmin Edge 820,Wahoo Kickr 5 - Zwift,377,393,-16
129394,729332,2021-03-16 19:02:53,wahoo,Zwift - 3R Omnium Event - Race 2 - iTT (E),Garmin Vector 3 - Garmin Edge 820,Wahoo Kickr 5 - Zwift,446,442,4
12905,868022,2020-02-07 12:05:09,wahoo,Zwift - 3R Greater London 8 Hilly Race - 1 Lap (23.8km/14.8mi 238m) (C),Garmin Vector 3,Wahoo Kickr Core,257,259,-2
13272,868022,2020-02-10 17:33:04,wahoo,Zwift - ZHR Zwift Handicap Race (D),Garmin Vector 3,Wahoo Kickr Core,246,253,-7
53126,868022,2020-09-02 18:55:36,wahoo,Zwift - MINI CRIT by WKG (C),Garmin Vector 3,Wahoo Kickr Core,265,262,3
86756,834206,2020-12-23 18:46:00,wahoo,201223 kickr18 / 201223 favero assioma duo,201223 favero assioma duo,201223 kickr18,279,266,13
48,265502,2019-08-13 18:10:00,wahoo,Zwift - FUSION ECT Racing League (A) #21,Wahoo Bolt - Quarq Dfour,Kickr Core - Zwift,390,393,-3
5378,265502,2019-12-03 18:15:03,wahoo,Zwift - Danmarks Cykle Union Racing League (A),P2M NGeco - Zwift,Kickr 18 - Wahoo Bolt,406,405,1
6117,265502,2019-12-12 18:55:02,wahoo,Zwift - Team Italy Superveloce Race (A) #3 no PU,P2M NGeco - Zwift,Kickr 18 - Wahoo Bolt,373,370,3
6504,265502,2019-12-17 18:15:01,wahoo,Zwift - Danmarks Cykle Union Racing League (A) #10 skide ITT,P2M NGeco - Zwift,Kickr 18 - Wahoo Bolt,391,385,6
6614,265502,2019-12-18 18:20:01,wahoo,Zwift - Crit City Race (A) #2,P2M NGeco - Zwift,Kickr 18 - Wahoo Bolt,362,352,10
6897,265502,2019-12-21 09:00:01,wahoo,Zwift - Danmarks Cykle Union Sprinters Special (A) #2 HRM messUp,P2M NGeco - Zwift,Kickr 18 - Wahoo Bolt,339,335,4
7002,265502,2019-12-22 09:00:03,wahoo,Zwift - Danmarks Cykle Union Racing League (A) #3,P2M NGeco - Zwift,Kickr 18 - Wahoo Bolt,343,342,1
7115,265502,2019-12-23 14:15:12,wahoo,Zwift - 3R Classique Reverse Flat Race - 5 Laps (32km/20.1mi 76m) (A) #1,P2M NGeco - Zwift,Kickr 18 - Wahoo Bolt,345,344,1
7229,265502,2019-12-25 10:09:51,wahoo,Zwift - Watopia,P2M NGeco - Zwift,Kickr 18 - Wahoo Bolt,329,335,-6
7411,265502,2019-12-27 15:15:03,wahoo,Zwift - 3R Sand and Sequoias Race (A) #2,P2M NGeco - Zwift,Kickr 18 - Wahoo Bolt,373,370,3
7534,265502,2019-12-29 09:00:02,wahoo,Zwift - Danmarks Cykle Union Racing League (A) #3,P2M NGeco - Zwift,Kickr 18 - Wahoo Bolt,358,361,-3
7620,265502,2019-12-30 10:20:02,wahoo,Zwift - 3R Volcano Flat Reverse Race - 3 Laps (36.6km/22.7mi 138m) (A),P2M NGeco - Zwift,Kickr 18 - Wahoo Bolt,365,364,1
8030,265502,2020-01-04 12:00:03,wahoo,Zwift - HBR17 by Herd Racing League (Europe) (E) #2,P2M NGeco - Zwift,Kickr 18 - Wahoo Bolt,335,339,-4
8311,265502,2020-01-07 18:55:03,wahoo,Zwift - Team Italy Gladiators Race (A) ,P2M NGeco - Zwift,Kickr 18 - Wahoo Bolt,401,402,-1
8612,265502,2020-01-09 17:30:03,wahoo,Zwift - Danmarks Cykle Union 2020 Cup (A)#5 TeamWork FTW,P2M NGeco - Zwift,Kickr 18 - Wahoo Bolt,397,398,-1
8822,265502,2020-01-11 10:30:03,wahoo,Zwift - 3R Volcano Climb Race - 1 Lap (22.4km/14mi 204m) (A) #1,P2M NGeco - Zwift,Kickr 18 - Wahoo Bolt,392,394,-2
8929,265502,2020-01-12 09:00:03,wahoo,Zwift - Danmarks Cykle Union 2020 Cup (A) #3,P2M NGec-1o - Zwift,Kickr 18 - Wahoo Bolt,360,364,-4
9510,265502,2020-01-15 19:15:08,wahoo,Zwift - Tour de Zwift // Pro-Am Invitational (A),P2M NGeco - Zwift,Kickr 18 - Wahoo Bolt,436,439,-3
9695,265502,2020-01-16 18:55:01,wahoo,Zwift - Team Italy Superveloce Race (A) #1,P2M NGeco - Zwift,Kickr 18 - Wahoo Bolt,370,371,-1
10672,265502,2020-01-23 19:15:00,wahoo,Tour de Zwift // Pro-Am Invitational #killerRoute,P2M NGeco - Zwift,Kickr 18 - Wahoo Bolt,399,401,-2
10968,265502,2020-01-26 09:00:01,wahoo,Danmarks Cykle Union 2020 Cup (A) #4,P2M NGeco - Zwift,Kickr 18 - Wahoo Bolt,404,405,-1
11181,265502,2020-01-27 18:15:17,wahoo,Zwift - 01/27/2020,P2M NGeco - Zwift,Kickr 18 - Wahoo Bolt,394,393,1
11338,265502,2020-01-28 18:00:01,wahoo,Kickr 18 - Wahoo Bolt / P2M NGeco - Zwift,P2M NGeco - Zwift,Kickr 18 - Wahoo Bolt,390,392,-2
11526,265502,2020-01-29 19:05:03,wahoo,DBR Wednesday Race,P2M NGeco - Zwift,Kickr 18 - Wahoo Bolt,414,414,0
11871,265502,2020-01-31 19:14:59,wahoo,Tour de Zwift // Pro-Am Invitational (A),P2M NGeco - Zwift,Kickr 18 - Wahoo Bolt,440,441,-1
12618,265502,2020-02-05 19:05:01,wahoo,DBR Race,P2M NGeco - Zwift,Kickr 18 - Wahoo Bolt,362,366,-4
12745,265502,2020-02-06 17:30:01,wahoo,Zwift - Danmarks Cykle Union 2020 Cup (A) #1,P2M NGeco - Zwift,Kickr 18 - Wahoo Bolt,366,365,1
12970,265502,2020-02-08 10:30:01,wahoo,Zwift - 3R Volcano Climb Race - 1 Lap (22.4km/14mi 204m) (A) #1,P2M NGeco - Zwift,Kickr 18 - Wahoo Bolt,398,398,0
13106,265502,2020-02-09 09:01:01,wahoo,Zwift - Danmarks Cykle Union 2020 Cup (A) #2,P2M NGeco - Zwift,Kickr 18 - Wahoo Bolt,332,335,-3
13393,265502,2020-02-11 18:01:01,wahoo,Zwift - Danmarks Cykle Union 2020 Cup (A) #3,P2M NGeco - Zwift,Kickr 18 - Wahoo Bolt,396,399,-3
13708,265502,2020-02-13 18:30:02,wahoo,Zwift - FUSION ECT BEUNSTOPPABLE Racing Series (A) #2,P2M NGeco - Zwift,Kickr 18 - Wahoo Bolt,364,367,-3
14372,265502,2020-02-17 18:00:02,wahoo,Zwift - 3R Gotham Grind Flat Race - 3 Laps (27.8km/17.4mi 87m) (A) #1,P2M NGeco - Zwift,Kickr 18 - Wahoo Bolt,327,331,-4
14514,265502,2020-02-18 17:10:02,wahoo,Zwift - 3R Volcano KOM After Party Race - 2 laps + climb (40.2km/25mi 286m) (A) #7 skide bakke :),P2M NGeco - Zwift,Kickr 18 - Wahoo Bolt,410,412,-2
15138,265502,2020-02-22 08:45:02,wahoo,Zwift - Crit City Race (A) #1,P2M NGeco - Zwift,Kickr 18 - Wahoo Bolt,361,360,1
15596,265502,2020-02-25 19:15:01,wahoo,Zwift - Feltet.dk Race Series (A) #27 fail-event!,P2M NGeco - Zwift,Kickr 18 - Wahoo Bolt,371,379,-8
15865,265502,2020-02-27 16:45:00,wahoo,Zwift - Mikkeller and Friends Race (A) #10,P2M NGeco - Zwift,Kickr 18 - Wahoo Bolt,388,390,-2
16464,265502,2020-03-02 17:31:02,wahoo,Zwift - Danmarks Cykle Union 2020 Cup (A) #1 TAK til Jeppe for sublimt teamwork!,P2M NGeco - Zwift,Kickr 18 - Wahoo Bolt,347,350,-3
16626,265502,2020-03-03 19:15:02,wahoo,Zwift - Feltet.dk Race Series (A) #7,P2M NGeco - Zwift,Kickr 18 - Wahoo Bolt,408,408,0
16918,265502,2020-03-05 17:31:00,wahoo,Zwift - Danmarks Cykle Union 2020 Cup (A) #2,P2M NGeco - Zwift,Kickr 18 - Wahoo Bolt,369,377,-8
17131,265502,2020-03-07 10:29:59,wahoo,3R Volcano Climb Race - 1 Lap (22.4km/14mi 204m),P2M NGeco - Zwift,Kickr 18 - Wahoo Bolt,395,398,-3
17487,265502,2020-03-10 18:01:03,wahoo,Zwift - Danmarks Cykle Union 2020 Cup (A),P2M NGeco - Zwift,Kickr 18 - Wahoo Bolt,415,416,-1
17821,265502,2020-03-12 19:15:01,wahoo,Zwift - Tour of Watopia Pro-Am Men&#039;s Race #1 (A),P2M NGeco - Zwift,Kickr 18 - Wahoo Bolt,371,395,-24
18290,265502,2020-03-16 17:31:01,wahoo,Zwift - Danmarks Cykle Union 2020 Cup (A) #1,P2M NGeco - Zwift,Kickr 18 - Wahoo Bolt,333,333,0
19407,265502,2020-03-24 18:00:58,wahoo,Zwift - Danmarks Cykle Union 2020 Cup (A),P2M NGeco - Zwift,Kickr 18 - Wahoo Bolt,358,359,-1
19610,265502,2020-03-25 19:04:59,wahoo,Zwift - DBR Wednesday Race (A) #9 failer :),P2M NGeco - Zwift,Kickr 18 - Wahoo Bolt,387,388,-1
20897,265502,2020-03-31 18:15:00,wahoo,Zwift - Feltet.dk Race Series (A) #39,P2M NGeco - Zwift,Kickr 18 - Wahoo Bolt,385,386,-1
25598,265502,2020-04-17 18:11:01,wahoo,Zwift - Richmond Challenge // Zwift Classic (A) :/,Quarq Dfour - Zwift,Kickr 18 - Wahoo Bolt,431,417,14
33204,265502,2020-05-10 10:10:00,wahoo,Zwift - 3R Sand & Sequoias - 1 Lap (20km/12.5mi 173m) (A) #2,Quarq Dfour - Zwift,Kickr 18 - Wahoo Bolt,379,373,6
35827,265502,2020-05-18 17:15:01,wahoo,Zwift - DBR Wahoo League (A) #6 #DQ-NoHRM che�ck DualRecording,Quarq Dfour - Zwift,Kickr 18 - Wahoo Bolt,400,388,12
37289,265502,2020-05-24 07:10:00,wahoo,Zwift - 3R Figure 8 Hilly Race - 1 Lap (29.2km/18.1m 234m) (A) #1,Quarq Dfour - Zwift,Kickr 18 - Wahoo Bolt,342,340,2
40838,265502,2020-06-10 18:05:01,wahoo,Zwift - DBR Boerkop Cykler Cup (A) #2,Quarq Dfour - Zwift,Kickr 18 - Wahoo Bolt,379,372,7
41359,265502,2020-06-13 08:30:02,wahoo,Zwift - DBR Saturday Race  (A) #1,Quarq Dfour - Zwift,Kickr 18 - Wahoo Bolt,375,369,6
41995,265502,2020-06-16 18:15:00,wahoo,Zwift - UNO X CUP powered by DCU & Feltet.dk (A) #13 hot hot hot..!!!,Quarq Dfour - Zwift,Kickr 18 - Wahoo Bolt,400,393,7
42589,265502,2020-06-19 12:50:00,wahoo,Zwift - KISS at Race - Pacific AM (A) #2,Quarq Dfour - Zwift,Kickr 18 - Wahoo Bolt,338,331,7
44947,265502,2020-07-05 07:35:05,wahoo,Zwift - ZHR Masters Weekender (A) #2,Quarq Dfour - Zwift,Kickr 18 - Wahoo Bo-3lt,362,353,9
47747,265502,2020-07-26 11:45:00,wahoo,Zwift - Crit City Race (A) #1,Quarq Dfour - Zwift,Kickr 18 - Wahoo Bolt,376,366,10
50746,265502,2020-08-19 18:00:00,wahoo,Zwift - Off The MAAP Stage 2 Race (A) #2,Quarq Dfour - Zwift,Kickr 18 - Wahoo Bolt,403,395,8
50935,265502,2020-08-20 14:40:02,wahoo,Zwift - Team Italy Specialissima Race (A) #1,Quarq Dfour - Zwift,Kickr 18 - Wahoo Bolt,393,387,6
51214,265502,2020-08-22 10:30:01,wahoo,Zwift - 3R Volcano Climb Race - 1 Lap (22.4km/14mi 204m) (A) #2,Quarq Dfour - Zwift,Kickr 18 - Wahoo Bolt,413,411,2
51517,265502,2020-08-24 14:15:01,wahoo,Zwift - 3R Classique Reverse Flat Race - 5 Laps (32km/20.1mi 76m) (A) #2,Quarq Dfour - Wahoo Bolt,Kickr 18 - Wahoo Bolt,333,331,2
52161,265502,2020-08-27 14:05:01,wahoo,Zwift - 3R Classique Flat Race - 6 Laps (37.7km/23.4mi 114m) (A) #2,Quarq Dfour - Zwift,Kickr 18 - Wahoo Bolt,357,352,5
52448,265502,2020-08-29 08:30:01,wahoo,Zwift - DBR Saturday Race  (A) #14,Quarq Dfour - Zwift,Kickr 18 - Wahoo Bolt,401,398,3
52767,265502,2020-08-31 18:20:01,wahoo,Zwift - TFC Mad Monday Summer Series (9 of 10) (A) #9 ,Quarq Dfour - Zwift,Kickr 18 - Wahoo Bolt,394,385,9
53768,265502,2020-09-07 18:20:00,wahoo,Zwift - TFC Mad Monday Summer Series (10 of 10) (A) #30 ouch a hill finish!!!,Quarq Dfour - Wahoo Bolt,Kickr 18 - Wahoo Bolt,384,375,9
55595,265502,2020-09-16 18:25:00,wahoo,Zwift - 09/16/2020,Quarq Dfour - Wahoo Bolt,Kickr 18 - Wahoo Bolt,328,322,6
55875,265502,2020-09-17 18:30:00,wahoo,"Zwift - Invitational League // Qualifying Race #2 (Men) #100 Everyone disappaered 2,5 k from finish line!!!",Quarq Dfour - Wahoo Bolt,Kickr 18 - Wahoo Bolt,396,388,8
57617,265502,2020-09-26 08:05:01,wahoo,Zwift - 3R Flat Race (A) #2,Quarq Dfour - Zwift,Kickr 18 - Wahoo Bolt,366,363,3
58541,265502,2020-09-30 17:45:01,wahoo,Zwift - DCU powered by Feltet.dk (A) #3,Quarq Dfour - Zwift,Kickr 18 - Wahoo Bolt,373,373,0
59356,265502,2020-10-04 08:00:01,wahoo,Zwift - Paceheads Race (30.2km / 255hm) (A) #2,Quarq Dfour - Zwift,Kickr 18 - Wahoo Bolt,363,366,-3
59837,265502,2020-10-06 16:59:58,wahoo,Zwift - ZRG Race (A) #1,Quarq Dfour - Zwift,Kickr 18 - Wahoo Bolt,348,321,27
60401,265502,2020-10-08 18:29:58,wahoo,Zwift - Cycling Ireland Zwift Sprint Race (A) #1,Quarq Dfour - Zwift,Kickr 18 - Wahoo Bolt,340,316,24
60694,265502,2020-10-10 06:59:59,wahoo,Zwift - ZHQ Beta Crit City Race (A) #1,Quarq Dfour - Zwift,Kickr 18 - Wahoo Bolt,381,376,5
60945,265502,2020-10-11 10:10:00,wahoo,Zwift - 3R Sand & Sequoias - 1 Lap (20km/12.5mi 173m) (A),Quarq Dfour - Zwift,Kickr 18 - Wahoo Bolt,364,351,13
60946,265502,2020-10-11 11:04:59,wahoo,Zwift - 3R Innsbruckring Sprint Race - 1 Lap (8.8km/5.5mi 77m) (A) #2,Quarq Dfour - Zwift,Kickr 18 - Wahoo Bolt,384,366,18
61553,265502,2020-10-13 17:15:04,wahoo,Zwift - Zwift Racing League | WTRL #35,Quarq Dfour - Zwift,Kickr 18 - Wahoo Bolt,398,391,7
61831,265502,2020-10-14 14:35:02,wahoo,Zwift - 3R Sand & Sequoias - 1 Lap (20km/12.5mi 173m) (A) #2,Quarq Dfour - Zwift,Kickr 18 - Wahoo Bolt,365,339,26
62427,265502,2020-10-16 12:05:00,wahoo,Zwift - 3R Greater London 8 Hilly Race - 1 Lap (23.8km/14.8mi 238m) (A) #3 Freaking Box Hill,P2M NGeco - Zwift,Kickr 18 - Wahoo Bolt,429,429,0
62573,265502,2020-10-17 09:04:59,wahoo,Zwift - 3R Hilly Race (A) #1,P2M NGeco - Zwift,Kickr 18 - Wahoo Bolt,337,337,0
63516,265502,2020-10-20 17:22:58,wahoo,Zwift - Zwift Racing League | WTRL - EMEA E (MEN) - TTT Grp 1 OUCH...!!!,P2M NGeco - Zwift,Kickr 18 - Wahoo Bolt,383,360,23
65092,265502,2020-10-26 18:15:01,wahoo,Zwift - DBR Ride´N´Roll League (A)#2,P2M NGeco - Zwift,Kickr 18 - Wahoo Bolt,375,363,12
65401,265502,2020-10-27 15:05:00,wahoo,Zwift - 3R Volcano Circuit Flat Race - 8 Laps (35.2km/21.9mi 160m) (A) #1,P2M NGeco - Zwift,Kickr 18 - Wahoo Bolt,360,335,25
65758,265502,2020-10-28 15:05:01,wahoo,Zwift - 3R LaGurardia Super Sprint Race - 1 Lap (3.7km/2.6mi 27m) (A) #2 #niceOneTom :),P2M NGeco - Zwift,Kickr 18 - Wahoo Bolt,420,392,28
66114,265502,2020-10-29 17:29:59,wahoo,Zwift - EVO CC Sprint Race Series  (A) #1,P2M NGeco - Zwift,Kickr 18 - Wahoo Bolt,342,334,8
66587,265502,2020-10-31 10:30:01,wahoo,Zwift - 3R Volcano Climb Race - 1 Lap (22.4km/14mi 204m) (A) #2 DBR K. Farup taking the win on the wheel of a flier..!!!,P2M NGeco - Zwift,Kickr 18 - Wahoo Bolt,397,387,10
67551,265502,2020-11-03 16:40:01,wahoo,Zwift - Team Italy Specialissima Race (A) #1,Quarq Dfour - Zwift,Kickr V5 - Wahoo Bolt,371,353,18
68219,265502,2020-11-05 18:45:01,wahoo,Zwift - XRS - ZTR Thursday Night Race (A) #2,Quarq Dfour - Zwift,Kickr V5 - Wahoo Bolt,350,338,12
68786,265502,2020-11-07 13:59:58,wahoo,ZA Road Group Ride,Quarq Dfour - Zwift,Kickr V5 - Wahoo Bolt,263,258,5
69381,265502,2020-11-09 18:35:01,wahoo,Zwift - XRS Races: Monday&#039;s blues (A) #1,P2M NGeco - Zwift,Kickr V5 - Wahoo Bolt,393,380,13
69682,265502,2020-11-10 15:01:51,wahoo,Zwift - 2x5 og 15 min SST,P2M NGeco - Zwift,Kickr V5 - Wahoo Bolt,315,310,5
70175,265502,2020-11-11 15:04:59,wahoo,Zwift - 3R LaGurardia Super Sprint Race - 1 Lap (3.7km/2.6mi 27m) (A),P2M NGeco - Zwift,Kickr V5 - Wahoo Bolt,370,361,9
70841,265502,2020-11-12 18:29:59,wahoo,Zwift - FUSION ECT BEUNSTOPPABLE Racing Series (A) #4 Lock FTW!,P2M NGeco - Zwift,Kickr V5 - Wahoo Bolt,341,332,9
71560,265502,2020-11-15 08:34:59,wahoo,Zwift - ZHR Masters Weekender (A) #1,P2M NGeco - Zwift,Kickr V5 - Wahoo Bolt,328,318,10
72224,265502,2020-11-17 18:23:30,wahoo,Zwift - Zwift Racing League | WTRL - Men&#039;s EMEA E1 DIVISION 1 (A) #toasted,P2M NGeco - Zwift,Kickr V5 - Wahoo Bolt,390,380,10
72568,265502,2020-11-18 14:35:01,wahoo,Zwift - 3R Sand & Sequoias - 1 Lap (20km/12.5mi 173m) (A) #1,Quarq Dfour - Zwift,Kickr V5 - Wahoo Bolt,355,351,4
74075,265502,2020-11-22 08:04:58,wahoo,Zwift - 3R Volcano Circuit - 6 Laps (A),Quarq Dfour - Zwift,Kickr V5 - Wahoo Bolt,356,348,8
75008,265502,2020-11-24 18:14:59,wahoo,Zwift - Zwift Racing League | WTRL - Men&#039;s EMEA E1 DIVISION 1 #skideBakke og alt for ho�j puls...,Quarq Dfour - Zwift,Kickr V5 - Wahoo Bolt,394,387,7
75903,265502,2020-11-26 14:04:58,wahoo,3R Classique Flat Race - 6 Laps (37.7km/23.4mi 114m) #2 + 10 x 40/20,P2M NGeco - Zwift,Kickr V5 - Wahoo Bolt,362,356,6
76440,265502,2020-11-27 12:05:00,wahoo,Zwift - 3R Greater London 8 Hilly Race - 1 Lap (23.8km/14.8mi 238m) (A) #1 F... Box Hill!!!,P2M NGeco - Zwift,Kickr V5 - Zwift,416,411,5
76778,265502,2020-11-28 10:00:00,wahoo,Zwift - Cycling Ireland Zwift League Rd 3 (A) #1 Hell Yeah,P2M NGeco - Zwift,Kickr V5 - Wahoo Bolt,392,391,1
77210,265502,2020-11-29 08:34:59,wahoo,Zwift - ZHR Masters Weekender (A) #3 GCC team win!,P2M NGeco - Zwift,Kickr V5 - Wahoo Bolt,368,356,12
77652,265502,2020-11-30 18:29:59,wahoo,Zwift - Team KST ,P2M NGeco - Zwift,Kickr V5 - Wahoo Bolt,371,365,6
79020,265502,2020-12-03 18:30:00,wahoo,Zwift - FUSION DECEMBER CUP (A) #7 Lock FTW,P2M NGeco - Zwift,Kickr V5 - Zwift,342,329,13
79664,265502,2020-12-05 10:30:25,wahoo,Zwift - Easy SST 1 hour,P2M NGeco - Zwift,Kickr V5 - Zwift,319,313,6
80026,265502,2020-12-06 10:09:35,wahoo,Zwift - 3R Sand & Sequoias - 1 Lap (20km/12.5mi 173m) (A) #3 ,P2M NGeco - Zwift,Kickr V5 - Wahoo Bolt,354,346,8
81150,265502,2020-12-09 19:00:24,wahoo,Zwift - Newbury Velo Midweek TT (E) #1 TT snavs,Quarq Dfour - Zwift,Kickr V5 - Zwift,386,379,7
81638,265502,2020-12-10 18:27:37,wahoo,Zwift - FUSION DECEMBER CUP (A) #11 Volcano Monster,Quarq Dfour - Zwift,Kickr V5 - Zwift,409,401,8
82613,265502,2020-12-13 08:28:23,wahoo,Zwift - ZHQ FutureWorks Circuit Race - Anti-sandbagging (A),Quarq Dfour - Zwift,Kickr V5 - Wahoo Bolt,323,316,7
83486,265502,2020-12-15 16:01:36,wahoo,Zwift - 3R Volcano Circuit Flat Race - 8 Laps (35.2km/21.9mi 160m) (A),Quarq Dfour - Zwift,Kickr V5 - Zwift,382,378,4
85357,265502,2020-12-20 09:12:24,wahoo,Zwift - ZHR Audax (D) #tonser,Quarq Dfour - Zwift,Kickr V5 - Zwift,330,326,4
85698,265502,2020-12-21 11:28:02,wahoo,Zwift - 30/30,Quarq Dfour - Zwift,Kickr V5 - Zwift,370,362,8
86038,265502,2020-12-22 11:07:22,wahoo,Zwift - Japan Zwift Tuesday Race (A) #5 Volcano hurt 6:01,Quarq Dfour - Zwift,Kickr V5 - Zwift,428,424,4
87688,265502,2020-12-27 08:28:10,wahoo,Zwift - ZHQ FutureWorks Circuit Race - Anti-sandbagging (A),Quarq Dfour - Zwift,Kickr V5 - Wahoo App,334,333,1
88284,265502,2020-12-28 18:13:16,wahoo,Zwift -  DBR Monday Race (A) #10 prygl af Vulkanen!,Quarq Dfour - Zwift,Kickr V5 - Wahoo App,417,411,6
88707,265502,2020-12-29 18:53:09,wahoo,Zwift - Team Italy & Frenchy Fuzion League (A) #32 flere prygl pa vulkanen!,Quarq Dfour - Zwift,Kickr V5 - Wahoo App,415,409,6
89862,265502,2021-01-01 17:28:02,wahoo,Zwift - EVO CC / Le Col - Sprint Race Series (A) #1,Quarq Dfour - Zwift,Kickr V5 - Wahoo App,347,346,1
90558,265502,2021-01-03 09:03:34,wahoo,Zwift - Newbury Velo Road Race (A) #9 shittyLegs,Quarq Dfour - Zwift,Kickr V5 - Wahoo App,390,378,12
91729,265502,2021-01-05 16:02:04,wahoo,Zwift - 3R Volcano Circuit Flat Race - 8 Laps (35.2km/21.9mi 160m) (A) #9,Quarq Dfour - Zwift,Kickr V5 - Wahoo App,366,354,12
92928,265502,2021-01-07 18:28:28,wahoo,Zwift - FUSION WINTER CUP (A) #8,Quarq Dfour - Zwift,Kickr V5 - Wahoo App,379,369,10
93718,265502,2021-01-09 10:27:39,wahoo,Zwift - 3R Volcano Climb Race - 1 Lap (22.4km/14mi 204m) (A) #1,Quarq Dfour - Zwift,Kickr V5 - Wahoo App,398,389,9
95632,265502,2021-01-12 18:12:18,wahoo,Zwift - Zwift Racing League | WTRL - Men&#039;s/Mixed EMEA E1 DIVISION 1 (A),Quarq Dfour - Zwift,Kickr V5 - Wahoo App,387,378,9
97788,265502,2021-01-16 09:57:52,wahoo,Zwift - Cycling Ireland Zwift League Rd 8 (A) #2,Quarq Dfour - Zwift,Kickr V5 - Wahoo App,348,342,6
99702,265502,2021-01-19 18:15:00,wahoo,Zwift - Zwift Racing League | WTRL - Men&#039;s/Mixed EMEA E1 DIVISION 1 (A),Quarq Dfour - Zwift,Kickr V5 - Wahoo App,371,365,6
101694,265502,2021-01-23 10:27:51,wahoo,Zwift - 3R Volcano Climb Race - 1 Lap (22.4km/14mi 204m) (A) #2,Quarq Dfour - Zwift,Kickr V5 - Wahoo App,417,409,8
102949,265502,2021-01-25 19:18:00,wahoo,Zwift - Team TFC Mad Monday Winter Series (A) #2,Quarq Dfour - Zwift,Kickr V5 - Wahoo App,370,365,5
104722,265502,2021-01-28 18:27:44,wahoo,Zwift - 01/28/2021,Quarq Dfour - Zwift,Kickr V5 - Zwift,372,367,5
105466,265502,2021-01-30 10:42:21,wahoo,Zwift - Into the Red by RELENTLESS (A) #1,Zwift,Kickr V5 - Wahoo App,366,359,7
109700,265502,2021-02-06 10:28:15,wahoo,Zwift - Cycling Weekly Winter Lockdown RR Series (A) #7 - nasty route!,Quarq Dfour - Zwift,Kickr V5 - Zwift,392,386,6
111691,265502,2021-02-09 19:26:39,wahoo,Zwift - British Cycling Race Series (A) #5,Quarq Dfour - Zwift,Kickr V5 - Zwift,376,370,6
115221,265502,2021-02-15 18:57:58,wahoo,Zwift -  SCF SWE Cup Men (A),Quarq Dfour - Zwift,Kickr V5 - Wahoo App,414,428,-14
116674,265502,2021-02-17 18:38:18,wahoo,Zwift - Danmarks Cykle Union & Partners 6/6 (A) #45 all for Lock!,Quarq Dfour - Wahoo Bolt,Kickr V5 - Zwift,347,358,-11
117269,265502,2021-02-18 18:57:03,wahoo,Zwift - Team KST ,Quarq Dfour - Wahoo Bolt,Kickr V5 - Zwift,362,367,-5
117710,265502,2021-02-19 13:48:12,wahoo,Zwift - KISS Race Series - Pacific AM (A) #5,Quarq Dfour - Wahoo Bolt,Kickr V5 - Zwift,402,403,-1
118141,265502,2021-02-20 10:28:09,wahoo,"Zwift - Cycling Weekly Winter Lockdown RR Series (A) #DNF WTF Zwift & Wahoo, huge dropouts!!!!",Quarq Dfour - Wahoo Bolt,Kickr V5 - Zwift,354,354,0
118585,265502,2021-02-21 09:57:15,wahoo,Zwift - DBR Sunday Race (A),Quarq Dfour - Zwift,Kickr V5 - Wahoo App,348,348,0
121975,265502,2021-02-28 09:14:16,wahoo,Zwift - Fantasy Nutrinovex Rice by PETA-Z (E),Quarq Dfour - Wahoo Bolt,Kickr V5 - Zwift,370,361,9
122391,265502,2021-03-01 16:07:47,wahoo,Zwift - 3R Classique Reverse Flat Race - 4 Laps (26.9km/16.7mi 57m) (A) #2,Quarq Dfour - Zwift,Kickr V5 - Wahoo App,335,320,15
122872,265502,2021-03-02 15:28:07,wahoo,Zwift - Team Draft Innsbruckring Race (A),Quarq Dfour - Zwift,Kickr V5 - Zwift,343,330,13
123988,265502,2021-03-04 17:02:38,wahoo,Zwift - OH MY CRIT!! - The Double Race 2/2 (A) #15,Quarq Dfour - Zwift,Kickr V5 - Wahoo App,400,395,5
125318,265502,2021-03-07 09:03:11,wahoo,Zwift - Newbury Velo Road Race (A) #6 gummiben,Quarq Dfour - Zwift,Kickr V5 - Wahoo App,376,371,5
127435,265502,2021-03-12 13:32:31,wahoo,Zwift - Crit City Race (A) #2,Quarq Dfour - Wahoo Bolt,Kickr V5 - Zwift,367,368,-1
129614,265502,2021-03-17 14:57:32,wahoo,UKAF Race night hosting the ACU Champs,Quarq Dfour - Zwift,Kickr V5 - Zwift,370,365,5
80566,7953,2020-12-07 21:29:04,wahoo,Zwift - Crit City Race (C),Stages Gen 3,2018 Kickr,279,279,0
81914,7953,2020-12-08 21:01:46,wahoo,Zwift - 3R Volcano Flat Reverse Race - 3 Laps (36.6km/22.7mi 138m) (C),Stages Gen 3,2018 Kickr,268,277,-9
81961,7953,2020-12-11 16:01:58,wahoo,Zwift - 3R Volcano Flat Race - 3 Laps (36.6km/22.7mi 138m) (C),Stages Gen 3,2018 Kickr,264,271,-7
82545,7953,2020-12-12 15:13:22,wahoo,Zwift - ZHR Afternoon Tea Race (C),Stages Gen 3,2018 Kickr,250,262,-12
83100,7953,2020-12-13 15:19:53,wahoo,Zwift - 3R Watopia 65km Race - 6 laps (40mi 324m) (C),Stages Gen 3,2018 Kickr,247,250,-3
83983,7953,2020-12-16 15:58:57,wahoo,Zwift - 3R Tick Tock Flat Race - 2 Lap (36km/22.4mi 100m) (C),Stages Gen 3,2018 Kickr,249,264,-15
93062,7953,2021-01-07 19:49:27,wahoo,Zwift - KISS Race Series - EU PM (C),Stages Gen 3,2018 Kickr,243,250,-7
7162,867040,2019-12-23 15:15:46,wahoo,Stages / Kickr core,Stages,Kickr core,328,342,-14
7225,867040,2019-12-25 08:59:53,wahoo,Stages / Kickr core,Stages,Kickr core,304,327,-23
8300,867040,2020-01-07 15:29:48,wahoo,Kickr core / Stages,Stages,Kickr core,311,337,-26
8986,867040,2020-01-12 08:59:44,wahoo,Zwift - Danmarks Cykle Union 2020 Cup (A),Stages,Kickr core,298,324,-26
13596,859868,2020-02-12 18:59:53,wahoo,Zwift - Zwift NL Community race - Alles uit de kast (A),Powertap P2 Pedals,Kickr,358,373,-15
13652,859868,2020-02-13 10:44:30,wahoo,Zwift - Crit City Race (A),Powertap P2 Pedals,Kickr,360,373,-13
13653,859868,2020-02-13 11:14:21,wahoo,Zwift - 3R Classique Flat Race - 4 Laps (26.9km/16.7mi 76m) (A),Powertap P2 Pedals,Kickr,361,375,-14
14191,859868,2020-02-16 09:29:39,wahoo,Zwift - Tour de Zwift: Stage 7 - Long Distance,Powertap P1,Kickr,313,314,-1
14193,859868,2020-02-16 10:15:51,wahoo,Zwift - Tour de Zwift: Stage 4 Race (B),Powertap P1,Kickr,394,396,-2
14671,859868,2020-02-19 10:44:46,wahoo,Zwift - DIRT & IS: Baker&#039;s Dozen (A),Powertap P1,Kickr,358,361,-3
14871,859868,2020-02-20 11:29:43,wahoo,Zwift - 2x10x1&#039;1&#039; vo2max,Powertap P1,Kickr,340,341,-1
17070,859868,2020-03-06 13:49:37,wahoo,Kiss at race ,Powertap P1,Kickr,384,385,-1
26390,859868,2020-04-20 08:59:52,wahoo,Zwift - MET-5 Race (A),Powertap P1,Kickr,362,377,-15
26585,859868,2020-04-21 09:05:14,wahoo,Zwift - 3R Spring Loaded Race Series - Round 4of6 (A),Powertap P1,Kickr,367,384,-17
31515,859868,2020-05-05 09:03:50,wahoo,Zwift - 3R Spring Loaded Race Series - Round 6of6 (A),Powertap P1,Kickr,393,395,-2
32114,859868,2020-05-06 17:56:04,wahoo,Zwift - Zwift NL League - Woensdagavond Competitie (A),Powertap P1,Kickr,393,394,-1
36430,859868,2020-05-20 17:58:58,wahoo,Zwift - Zwift NL League - Woensdagavond Competitie (A),Powertap P1,Kickr,402,405,-3
39401,859868,2020-06-03 17:59:40,wahoo,Zwift - Zwift NL League - Woensdagavond Competitie (A),Powertap P1,Kickr,386,401,-15
43952,859868,2020-06-28 13:22:15,wahoo,Zwift - Herd Summer Racing League Race 3 (A),Powertap P1,Kickr,367,379,-12
50511,859868,2020-08-18 09:56:10,wahoo,Zwift - Off The MAAP Stage 2 Race (A),Powertap P1,Kickr,352,364,-12
51338,859868,2020-08-23 09:04:21,wahoo,Zwift - Newbury Velo Road Race (A),Powertap P1,Kickr,378,392,-14
54306,859868,2020-09-10 09:15:36,wahoo,Zwift - Cycling Australia&#039;s The Chop by AHDR (A),Powertap P1,Kickr,350,366,-16
56780,859868,2020-09-22 09:03:30,wahoo,Zwift - 3R Sundown Race Series  (A),Powertap P1,Kickr,380,394,-14
61000,859868,2020-10-11 13:03:46,wahoo,Zwift - KISS at Race 100 - Americas (A),Powertap P1,Kickr,388,388,0
63094,859868,2020-10-19 17:35:38,wahoo,Zwift - Premier Division // Zwift Racing League (men) ,Powertap P1,Kickr Core,388,398,-10
67321,859868,2020-11-02 18:18:07,wahoo,Zwift - Premier Division // Zwift Racing League (men) (A),Powertap P1,Kickr Core,399,405,-6
71657,859868,2020-11-15 12:50:55,wahoo,Zwift - Rigo Urán: 2020 El Giro de Rigo - Official Route,Powertap P1,Kickr,374,390,-16
84702,859868,2020-12-18 13:02:02,wahoo,Zwift - Tour of New York Stage 1 - Open Longer,Powertap P1,Kickr,375,366,9
109958,859868,2021-02-06 14:56:05,wahoo,Zwift - OH MY CRIT!! - Saturday Smash Race (A),Powertap P1,Kickr,381,390,-9
111615,859868,2021-02-09 17:48:05,wahoo,Zwift - Zwift Racing League | WTRL - Men&#039;s/Mixed EMEA E2 DIVISION 4 (A),Powertap P1,Kickr,399,407,-8
112735,859868,2021-02-11 11:28:57,wahoo,Zwift - TDZ Stage 8: Group Ride,Powertap P1,Kickr,374,370,4
115040,859868,2021-02-15 08:31:56,wahoo,Zwift - TDZ Stage 4: Longer Ride,Powertap P1,Kickr,351,354,-3
118057,859868,2021-02-20 07:01:34,wahoo,Zwift - FZR Masters Race (A),Powertap P1,Kickr,392,408,-16
125626,869835,2021-03-07 16:59:59,wahoo,Zwift - MISTRZOSTWA ZTPL.CC (E),Favero Assioma Duo,Kick Core,367,362,5
46890,824378,2020-07-19 01:29:57,neo,Zwift - Clubteam Weekend Race (A),Assioma to CA600,Tacx Neo Smart to ZWIFT,300,305,-5
64750,824378,2020-10-25 05:04:55,neo,Zwift - 3R Volcano Flat Race - 3 Laps (36.6km/22.7mi 138m) (A),Assioma to CA-600,Tacx Neo Smart to ZWIFT,296,293,3
65333,824378,2020-10-27 08:44:55,neo,Zwift - Zwift Racing League | WTRL - APAC (MEN) -  Division 1 (A),Assioma to CA-600,Tacx Neo Smart to ZWIFT,289,296,-7
83386,824378,2020-12-15 08:55:32,neo,Zwift - Zwift Racing League | WTRL - Men&#039;s APAC DIVISION 1 (A),Assioma to CA-600,Tacx Neo Smart to ZWIFT,292,295,-3
99468,824378,2021-01-19 08:51:03,neo,Zwift - Zwift Racing League | WTRL - Men&#039;s/Mixed APAC DIVISION 1 (A),Assioma Duo to CA-600,Tacx Neo Smart to ZWIFT,284,289,-5
103245,824378,2021-01-26 08:44:06,neo,Zwift - Zwift Racing League | WTRL - Men&#039;s/Mixed APAC DIVISION 1 (A),Assioma Duo to CA-600,Tacx Neo Smart to ZWIFT,308,319,-11
107135,824378,2021-02-02 08:44:01,neo,Zwift - Pre-Training Plan/22min,Assioma Duo to CA-600,Tacx Neo Smart to ZWIFT,303,306,-3
111387,824378,2021-02-09 08:51:04,neo,Zwift - Zwift Racing League | WTRL - Men&#039;s/Mixed APAC DIVISION 1 (A),Assioma Duo to CA-600,Tacx Neo Smart to ZWIFT,299,304,-5
111388,824378,2021-02-09 11:09:50,neo,Zwift - Japan Zwift Tuesday Race (A),Assioma Duo to CA-600,Tacx Neo Smart to ZWIFT,300,302,-2
115620,824378,2021-02-16 08:44:32,neo,Zwift - Zwift Racing League | WTRL - Men&#039;s/Mixed APAC DIVISION 1 (A),Assioma Duo to CA-600,Tacx Neo Smart to ZWIFT,317,318,-1
118115,824378,2021-02-20 09:59:56,neo,Zwift - Kenta Endo  [TEAM FINS/NGT]&#039;s Meetup - Tick Tock,Assioma Duo to CA-600,Tacx Neo Smart to ZWIFT,310,310,0
119391,824378,2021-02-23 08:44:30,neo,Zwift - Zwift Racing League | WTRL - Men&#039;s/Mixed APAC DIVISION 1 (A),Assioma Duo to CA-600,Tacx Neo Smart to ZWIFT,277,280,-3
122798,824378,2021-03-02 08:50:39,neo,Zwift - Zwift Racing League | WTRL - Men&#039;s/Mixed APAC DIVISION 1 (A),Assioma Duo to CA-600,Tacx Neo Smart to ZWIFT,300,299,1
49416,877473,2020-08-08 11:43:14,neo,NEO vs Stages,stages dura ace,tacx neo,323,343,-20
61408,719818,2020-10-12 18:43:36,neo,Zwift - Premier Division // Zwift Racing League (men) ,SRAM Quarq,Tacx NEO,407,394,13
67433,719818,2020-11-02 19:03:59,neo,Premier Division // Zwift Racing League (men) (A) race 4 TTT,Tacx NEO,Tacx NEO,395,405,-10
69564,719818,2020-11-09 19:59:53,neo,Premier Division // Zwift Racing League (men) (A),SRAM Quarq,Tacx NEO,462,450,12
71993,719818,2020-11-16 19:02:53,neo,Premier Division // Zwift Racing League (men) (A) race 6 TTT,Tacx NEO,Tacx NEO,387,382,5
74829,719818,2020-11-23 19:59:49,neo,Premier Division // Zwift Racing League (men) (A),SRAM Quarq,Tacx NEO,455,442,13
77738,719818,2020-11-30 19:07:37,neo,Premier Division // Zwift Racing League (men) (A),SRAM Quarq,Tacx NEO,402,389,13
95333,719818,2021-01-11 19:14:12,neo,Premier Division // Zwift Racing League - race 1,SRAM Quarq,Tacx NEO,426,409,17
119908,646577,2021-02-23 22:17:38,wahoo,Z2 2h,4iiii,Kickr,251,237,14
120520,646577,2021-02-25 00:07:29,wahoo,La Classique du Clan Knox (A),4iiii,Kickr,395,384,11
123776,646577,2021-03-04 00:00:24,wahoo,La Classique du Clan Knox (A),4iiii,Kickr,368,374,-6
129892,646577,2021-03-17 23:04:17,wahoo,La Classique du Clan Knox (A),4iiii,Kickr,388,377,11
26346,812964,2020-04-20 05:39:52,neo,Ace Cycles TTT Route Recon,S-Works Power Crank,Tacx Neo,252,257,-5
42363,812964,2020-06-17 16:00:59,neo,Zwift - SSAT Ace Cycles Virtual Racing Series (B),Quarq,Tacx Neo,282,288,-6
109302,812964,2021-02-05 08:23:54,neo,Zwift - VO2max session,Garmin Pedals,Tacx Neo,250,256,-6
85330,892762,2020-12-20 08:02:55,neo,Zwift - Watopia,Favero Assioma Duo,Tacx Neo Smartbike,208,213,-5
85719,892762,2020-12-21 12:07:09,neo,Zwift - Three Sisters Zada test ,Favero Assioma Duo,Tacx Neo Smartbike,453,463,-10
102937,892762,2021-01-25 18:22:00,neo,Zwift - Premier Division // Zwift Racing League (men) (A),Favero Assioma Duo,Tacx Neo Smartbike,425,443,-18
106926,892762,2021-02-01 19:13:43,neo,Zwift - Premier Division // Zwift Racing League (men) (A),Favero Assioma Duo,Tacx Neo Smartbike,387,411,-24
108762,892762,2021-02-04 15:38:23,neo,Zwift - 5x8 min ftp,Favero Assioma Duo,Tacx Neo Smartbike,373,383,-10
109332,892762,2021-02-05 14:58:25,neo,Zwift - 15minST10sek650,Favero Assioma Duo,Tacx Neo Smartbike,311,321,-10
110586,892762,2021-02-07 17:02:49,neo,Zwift - Watopia,Favero Assioma Duo,Tacx Neo Smartbike,390,397,-7
111073,892762,2021-02-08 18:26:42,neo,Zwift - Premier Division // Zwift Racing League (men) (A),Favero Assioma Duo,Tacx Neo Smartbike,417,432,-15
115411,892762,2021-02-15 18:53:06,neo,Zwift - Premier Division // Zwift Racing League (men) (A),Favero Assioma Duo,Tacx Neo Smartbike,440,458,-18
118986,892762,2021-02-21 17:13:32,neo,Zwift - Watopia,Favero Assioma Duo,Tacx Neo Smartbike,393,402,-9
119159,892762,2021-02-22 18:24:53,neo,Zwift - Premier Division // Zwift Racing League (men) (A),Favero Assioma Duo,Tacx Neo Smartbike,374,392,-18
120373,892762,2021-02-24 17:52:58,neo,Zwift - Scandinavian Cup 2021 - Round 1 - Men (A),Favero Assioma Duo,Tacx Neo Smartbike,401,415,-14
122647,892762,2021-03-01 19:24:39,neo,Zwift - Premier Division // Zwift Racing League (men) (A),Favero Assioma Duo,Tacx Neo Smartbike,402,414,-12
123609,892762,2021-03-03 18:09:23,neo,Zwift - Scandinavian Cup 2021 - Round 2 - Men (A),Favero Assioma Duo,Tacx Neo Smartbike,403,414,-11
126650,892762,2021-03-10 17:53:16,neo,Zwift - Scandinavian Cup 2021 - Round 3 - Men (A),Favero Assioma Duo,Tacx Neo Smartbike,426,443,-17
129755,892762,2021-03-17 17:56:42,neo,Zwift - Scandinavian Cup 2021 - Round 4 - Men (A),Favero Assioma Duo,Tacx Neo Smartbike,383,403,-20
12600,519127,2020-02-05 19:32:21,neo,Zwift - Calibration test v1.0,Polar pedal,Neo Åke,249,267,-18
22831,616230,2020-04-07 16:01:28,wahoo,Sweet spot X3,Assioma Duo,Kickr,300,294,6
33365,616230,2020-05-10 08:14:57,wahoo,Meet up ,Assioma Duo,Kickr,300,301,-1
70857,616230,2020-11-12 17:33:00,wahoo,Vo2 max billat,Assioma Duo,Kickr,397,393,4
84786,616230,2020-12-18 18:29:09,wahoo,Island,xCADEY,Kickr,238,238,0
98444,616230,2021-01-17 07:58:35,wahoo,Zwift - TDZ Stage 3: Shorter Ride,Assioma Duo,Kickr,246,247,-1
123493,616230,2021-03-02 17:42:28,wahoo,Zwift - Zwift Racing League | WTRL - Men&#039;s/Mixed EMEA E1 DIVISION 6 (A),Assioma Duo,Kickr,352,349,3
21177,896125,2020-04-01 15:09:02,neo,SMART - Lucy in the Sky with Diamonds - 60 - Xert,Assioma,Neo,176,176,0
21532,896125,2020-04-02 17:19:22,neo,WTRL Team Time Trial - Zone2,Assioma,Neo,266,266,0
23347,896125,2020-04-09 17:29:25,neo,WTRL Team Foudre Time Trial (Latte),Assioma,Neo,254,257,-3
25328,896125,2020-04-16 17:17:03,neo,Neo / Assioma,Assioma,Neo,252,250,2
26542,896125,2020-04-20 18:22:18,neo,TFC 2 of 6,Assioma,Neo,296,303,-7
30970,571157,2020-05-03 14:00:59,wahoo,Zwift - Castelli Series (B),Stages Power Meter,Kicker Wahoo,338,362,-24
103366,571157,2021-01-26 12:17:58,wahoo,Zwift - Threshold 4x10min @90%,Stages Power Meter,Kicker Wahoo,292,300,-8
49153,41212,2020-08-07 01:34:27,neo,Zwift - 4wk FTP Booster Week 3 Day 5 - 40/20&#039;s into Threshold,Stages,Neo,283,270,13
23795,891264,2020-04-11 14:02:18,wahoo,The P race,Assioma Duo,KickR,302,305,-3
23824,891264,2020-04-11 15:19:49,wahoo,Kickr vs. Assioma 6 min,Assioma Duo,KickR,169,165,4
74489,850691,2020-11-23 12:27:59,wahoo,Zwift - ZHQ FutureWorks Crit City Race - Anti-sandbagging (A),Assioma Duo,Kickr V5,348,353,-5
74908,850691,2020-11-24 12:18:00,wahoo,Zwift - British Cycling Race Series (A),Assioma Duo,Kickr V5,339,335,4
75829,850691,2020-11-26 11:52:45,wahoo,Zwift - DIRT Doozy Race (A),Assioma Duo,Kickr V5,351,348,3
76854,850691,2020-11-28 12:08:22,wahoo,Zwift - DIRT Dadurday Chase Race  (A),Assioma Duo,Kickr V5,345,344,1
77944,850691,2020-12-01 12:12:57,wahoo,Zwift - Zwift Mexicanisimo  (A),Assioma Duo,Kickr V5,332,328,4
78838,850691,2020-12-03 11:52:03,wahoo,Zwift - DIRT Doozy Race (A),Assioma Duo,Kickr V5,353,353,0
83410,850691,2020-12-15 12:02:47,wahoo,Zwift - 3R Gotham Grind Flat Race - 2 Laps (18.5km/11.6mi 58m) (A),Assioma Duo,Kickr V5,337,338,-1
84215,850691,2020-12-17 11:53:16,wahoo,Zwift - DIRT Doozy Race (A),Assioma Duo,Kickr V5,353,363,-10
85042,850691,2020-12-19 12:07:39,wahoo,Zwift - DIRT Dadurday Chase Race  (A),Assioma Duo,Kickr V5,350,357,-7
85703,850691,2020-12-21 12:27:40,wahoo,Zwift - ZHQ FutureWorks Crit City Race - Anti-sandbagging (A),Assioma Duo,Kickr V5,350,355,-5
91657,850691,2021-01-05 12:00:29,wahoo,Zwift - TDZ Stage 1: Standard Ride,Assioma Duo,Kickr V5,367,371,-4
92657,850691,2021-01-07 11:53:09,wahoo,Zwift - DIRT Doozy Race (A),Assioma Duo,Kickr V5,360,363,-3
103296,850691,2021-01-26 12:03:22,wahoo,Zwift - 3R Gotham Grind Flat Race - 2 Laps (18.5km/11.6mi 58m) (A),Assioma Duo,Kickr V5,345,344,1
105512,850691,2021-01-30 12:07:38,wahoo,Zwift - DIRT Dadurday Chase Race  (A),Assioma Duo,Kickr V5,335,339,-4
121846,850691,2021-02-27 19:58:41,wahoo,Zwift - Herd Beginner Racing Series (E),Assioma Duo,Kickr V5,379,379,0
122811,850691,2021-03-02 12:02:59,wahoo,Zwift - 3R Gotham Grind Flat Race - 2 Laps (18.5km/11.6mi 58m) (A),Assioma Duo,Kickr V5,341,339,2
124900,850691,2021-03-06 11:58:13,wahoo,Zwift - Herd Beginner Racing Series (E),Assioma Duo,Kickr V5,366,368,-2
126045,850691,2021-03-09 12:03:09,wahoo,Zwift - 3R Gotham Grind Flat Race - 2 Laps (18.5km/11.6mi 58m) (A),Assioma Duo,Kickr V5,357,354,3
126894,850691,2021-03-11 11:53:32,wahoo,Zwift - DIRT Doozy Race (A),Assioma Duo,Kickr V5,331,330,1
127869,850691,2021-03-13 12:07:48,wahoo,Zwift - Welcome to the DIRT Dadurday Chase Race. (A),Assioma Duo,Kickr V5,337,337,0
11104,899039,2020-01-26 20:10:59,wahoo,Zwift - Tour de Zwift: Stage 4 Race (B),Inpeak Ultegra R8000,Wahoo Kickr Core,363,379,-16
11168,899039,2020-01-27 14:19:03,wahoo,Zwift - Wytrzymalosc silowa 5x5,Inpeak Ultegra R8000,Wahoo Kickr Core,368,366,2
11276,899039,2020-01-28 10:31:50,wahoo,Zwift - Watopia,Inpeak Ultegra R8000,Wahoo Kickr Core,231,240,-9
11477,899039,2020-01-29 09:10:59,wahoo,Zwift - Tour de Zwift: Stage 5 Race (B),Inpeak Ultegra R8000,Wahoo Kickr Core,346,352,-6
12126,899039,2020-02-02 13:11:00,wahoo,Zwift - Tour de Zwift: Stage 6 Race (B),Inpeak Ultegra R8000,Wahoo Kickr Core,367,363,4
12293,899039,2020-02-03 19:12:47,wahoo,Zwift - Vo2max - 40s/20s,Inpeak Ultegra R8000,Wahoo Kickr Core,357,361,-4
12815,899039,2020-02-06 19:20:52,wahoo,Zwift - Sprinty  - trening szybk. 1,Inpeak Ultegra R8000,Wahoo Kickr Core,289,287,2
12964,899039,2020-02-08 08:11:17,wahoo,Zwift - Tour de Zwift: Stage 7 Race (B),Inpeak Ultegra R8000,Wahoo Kickr Core,375,371,4
13196,899039,2020-02-09 18:15:37,wahoo,Zwift - 3R Watopia Hilly Reverse Race - 4 Laps (36.7km/22.8mi 400m) (B),Inpeak Ultegra R8000,Wahoo Kickr Core,348,350,-2
13452,899039,2020-02-11 19:28:42,wahoo,Krotki przejazd przed kalibracja,Inpeak Ultegra R8000,Wahoo Kickr Core,278,280,-2
13455,899039,2020-02-11 19:40:59,wahoo,Zwift - 3R Ultimate Racing League - Round 6 (B),Inpeak Ultegra R8000,Wahoo Kickr Core,347,351,-4
13743,899039,2020-02-13 19:01:20,wahoo,Zwift - Tour de Zwift: Stage 1 Short Distance,Inpeak Ultegra R8000,Wahoo Kickr Core,374,371,3
14404,899039,2019-11-04 18:43:42,wahoo,Zwift - Ramp Test,Inpeak Ultegra R8000,Wahoo Kickr Core,432,436,-4
14406,899039,2020-02-17 20:10:27,wahoo,Zwift - GGCC Glasgow Green Cycle Club Race Series (C),Inpeak Ultegra R8000,Wahoo Kickr Core,343,355,-12
15092,899039,2020-02-21 18:35:09,wahoo,Zwift - Watopia,Inpeak Ultegra R8000,Wahoo Kickr Core,341,341,0
15198,899039,2020-02-22 10:29:59,wahoo,Zwift - 3R Volcano Climb Race - 1 Lap (22.4km/14mi 204m) (B),Inpeak Ultegra R8000,Wahoo Kickr Core,378,377,1
15508,899039,2020-02-24 19:37:02,wahoo,ZHR Zwift Handicap Race,Inpeak Ultegra R8000,Wahoo Kickr Core,403,401,2
16163,899039,2020-02-29 09:20:56,wahoo,TT 2x15,Inpeak Ultegra R8000,Wahoo Kickr Core,387,375,12
16498,899039,2020-03-02 18:55:18,wahoo,Zwift - Anaeroby - 20s/20s,Inpeak Ultegra R8000,Wahoo Kickr Core,367,368,-1
17183,899039,2020-03-07 13:15:24,wahoo,Zwift - Team ODZ RACE (D),Inpeak Ultegra R8000,Wahoo Kickr Core,359,366,-7
18146,899039,2020-03-15 10:09:56,wahoo,Zwift - 3R Sand & Sequoias - 1 Lap (20km/12.5mi 173m) (B),Inpeak Ultegra R8000,Wahoo Kickr Core,363,362,1
18147,899039,2020-03-11 19:20:29,wahoo,Zwift - ZTPL.CC CoffeeRide (B),Inpeak Ultegra R8000,Wahoo Kickr Core,338,343,-5
18484,899039,2020-03-17 19:35:13,wahoo,Zwift - Watopia,Inpeak Ultegra R8000,Wahoo Kickr Core,273,268,5
19003,899039,2020-03-20 19:10:50,wahoo,Zwift - Stage 3 Race (B) - Tour of Watopia 2020,Inpeak Ultegra R8000,Wahoo Kickr Core,383,381,2
19633,899039,2020-03-25 19:09:55,wahoo,Zwift - Stage 5 Race (A) - Tour of Watopia 2020,Inpeak Ultegra R8000,Wahoo Kickr Core,378,375,3
20935,899039,2020-03-31 17:35:17,wahoo,ZTPL.CC Tour Stage 5,Inpeak Ultegra R8000,Wahoo Kickr Core,348,352,-4
22837,899039,2020-04-07 18:09:37,wahoo,Zwift - TT -2x15,Inpeak Ultegra R8000,Wahoo Kickr Core,366,358,8
27893,899039,2020-04-25 10:29:58,wahoo,Zwift - 3R Volcano Climb Race - 1 Lap (22.4km/14mi 204m) (B),Inpeak Ultegra R8000,Wahoo Kickr Core,372,370,2
34966,899039,2020-05-14 09:21:17,wahoo,Zwift - Watopia,Inpeak Ultegra R8000,Wahoo Kickr Core,364,359,5
48954,899039,2020-08-05 18:35:04,wahoo,Zwift - BRT Time Trial League (B),Inpeak Ultegra R8000,Wahoo Kickr Core,375,364,11
52052,899039,2020-08-26 18:29:44,wahoo,British Cycling Crit City Series,Inpeak Ultegra R8000,Wahoo Kickr Core,364,366,-2
65398,899039,2020-10-27 13:32:18,wahoo,ZHQ FutureWorks Circuit Race - Anti-sandbagging (C) came back after COVID-19,Inpeak Ultegra R8000,Wahoo Kickr Core,333,332,1
66428,899039,2020-10-30 12:04:50,wahoo,Zwift - 3R Greater London 8 Hilly Race - 1 Lap (23.8km/14.8mi 238m) (B),Inpeak Ultegra R8000,Wahoo Kickr Core,359,357,2
70064,899039,2020-11-10 18:29:56,wahoo,Zwift - ZTPL.CC 3daysINhell Stage 3 (E),Inpeak Ultegra R8000,Wahoo Kickr Core,333,337,-4
71582,899039,2020-11-13 18:30:25,wahoo,Zwift - BRT Ages Racing League (A),Inpeak Ultegra R8000,Wahoo Kickr Core,380,380,0
71589,899039,2020-11-15 10:00:01,wahoo,Zwift - ZTPL.CC CLASSIC Challenge (B),Inpeak Ultegra R8000,Wahoo Kickr Core,340,339,1
72293,899039,2020-11-17 18:29:56,wahoo,Zwift - ZTPL.CC 3daysINhell vol2 Stage 1 (E),Inpeak Ultegra R8000,Wahoo Kickr Core,347,345,2
73734,899039,2020-11-20 18:50:05,wahoo,Zwift - Team CLS Racing - Hills &#039;n&#039; Thrills S5 (E),Inpeak Ultegra R8000,Wahoo Kickr Core,376,380,-4
75496,899039,2020-11-24 18:55:28,wahoo,Zwift - Team Italy & Frenchy Fuzion League (B),Inpeak Ultegra R8000,Wahoo Kickr Core,339,338,1
80099,899039,2020-12-06 11:31:10,wahoo,Zwift - Stages of DIRT (B),Inpeak Ultegra R8000,Wahoo Kickr Core,356,355,1
88732,899039,2020-12-29 18:29:52,wahoo,Zwift - ZTPL.CC Classic Race (E),Inpeak Ultegra R8000,Wahoo Kickr Core,369,376,-7
89913,899039,2021-01-01 12:20:19,wahoo,Zwift - Peak-PTY Climb Challenge Fridays (B),Inpeak Ultegra R8000,Wahoo Kickr Core,366,365,1
90936,899039,2021-01-03 19:34:57,wahoo,Zwift - 3R LaGuardia Super Sprint Race - 1 Lap (3.7km/2.6mi 27m) (B),Inpeak Ultegra R8000,Wahoo Kickr Core,437,436,1
93497,899039,2021-01-08 19:00:26,wahoo,Zwift - TDZ Stage 1: Longer Ride,Inpeak Ultegra R8000,Wahoo Kickr Core,392,390,2
94384,899039,2021-01-10 11:59:58,wahoo,Zwift - TDZ Stage 2: Longer Ride (2+3),Inpeak Ultegra R8000,Wahoo Kickr Core,355,354,1
95699,899039,2021-01-12 18:13:29,wahoo,Zwift - FTP Test,Inpeak Ultegra R8000,Wahoo Kickr Core,386,385,1
97595,899039,2021-01-15 18:59:58,wahoo,Zwift - TDZ Stage 3: Longer Ride,Inpeak Ultegra R8000,Wahoo Kickr Core,334,334,0
98479,899039,2021-01-17 11:53:58,wahoo,Zwift - Peel Cycling - Sunday Chase (B),Inpeak Ultegra R8000,Wahoo Kickr Core,350,357,-7
99780,899039,2021-01-19 18:30:11,wahoo,The Carnival Race League Stage 1 with ZTPL.CC,Inpeak Ultegra R8000,Wahoo Kickr Core,388,391,-3
101526,899039,2021-01-22 19:00:09,wahoo,Zwift - TDZ Stage 4: Longer Ride,Inpeak Ultegra R8000,Wahoo Kickr Core,359,359,0
102359,899039,2021-01-24 11:20:32,wahoo,STREFA 2,Inpeak Ultegra R8000,Wahoo Kickr Core,254,256,-2
103597,899039,2021-01-26 18:30:05,wahoo,Zwift - The Carnival Race League Stage 3 with ZTPL.CC (A),Inpeak Ultegra R8000,Wahoo Kickr Core,391,398,-7
107429,899039,2021-02-02 18:45:33,wahoo,Zwift - Wytrzymalosc silowa 5x5,Inpeak Ultegra R8000,Wahoo Kickr Core,374,369,5
109520,899039,2021-02-05 19:10:01,wahoo,Zwift - Anaerobic Capacity into VO2,Inpeak Ultegra R8000,Wahoo Kickr Core,394,403,-9
109623,899039,2021-02-05 20:24:59,wahoo,3R Innsbruckring Flat Race,Inpeak Ultegra R8000,Wahoo Kickr Core,285,287,-2
110409,899039,2021-02-07 11:52:00,wahoo,Zwift - Peel Cycling - Sunday Chase (C),Inpeak Ultegra R8000,Wahoo Kickr Core,349,341,8
111731,899039,2021-02-09 18:29:58,wahoo,Zwift - ZTPL.CC Winter League 2021 Stage 7,Inpeak Ultegra R8000,Wahoo Kickr Core,369,372,-3
113049,899039,2021-02-11 19:46:00,wahoo,Zwift - Crit City Race (B),Inpeak Ultegra R8000,Wahoo Kickr Core,414,408,6
116076,899039,2021-02-16 20:00:56,wahoo,crashe race,Inpeak Ultegra R8000,Wahoo Kickr Core,396,388,8
121297,899039,2021-02-26 19:34:54,wahoo,Zwift - 3R Watopia Hilly Race - 3 Laps (27km/16.8mi 300m) (B),Assioma Duo,Wahoo Kickr Core,374,379,-5
122077,899039,2021-02-28 12:00:45,wahoo,Zwift - TOWER 26 Race Series- 40K Bike Time Trial (E),Assioma Duo,Wahoo Kickr Core,348,347,1
124754,899039,2021-03-05 19:04:27,wahoo,Zwift - GPLAMA - ULTIMATE WARM UP,Assioma Duo - wahoo bolt,Wahoo Kickr Core,308,305,3
124755,899039,2021-03-05 19:34:58,wahoo,Zwift - 3R Watopia Hilly Race - 3 Laps (27km/16.8mi 300m) (B),Assioma Duo - wahoo bolt,Wahoo Kickr Core,404,394,10
126366,899039,2021-03-09 18:49:03,wahoo,Zwift - V02PWR ,Assioma Duo - wahoo bolt,Wahoo Kickr Core,339,335,4
126369,899039,2021-03-09 19:30:59,wahoo,British cycling race series,Assioma Duo - wahoo bolt,Wahoo Kickr Core,312,311,1
127627,899039,2021-03-12 19:20:51,wahoo,Zwift - Norseman workout: Geilo,Assioma Duo - wahoo bolt,Wahoo Kickr Core,363,360,3
127628,899039,2021-03-12 20:24:58,wahoo,3r Innsbruckring flat race,Assioma Duo - wahoo bolt,Wahoo Kickr Core,364,361,3
128337,899039,2021-03-14 11:29:55,wahoo,Zwift - Stages of DIRT (E),Assioma Duo - wahoo bolt,Wahoo Kickr Core,294,296,-2
45778,674292,2020-07-10 13:31:56,wahoo,Zwift - Crit City Race (A),quarq,KickR to zwift,383,369,14
45891,674292,2020-07-11 08:34:48,wahoo,Zwift - Crit City Race (A),5219210952,KickR to zwift,383,369,14
6339,863061,2019-12-15 13:44:44,wahoo,Zwift - Crit City Race (A),Sworks power cranks,Wahoo Kickr 2018,275,265,10
8330,863061,2020-01-07 18:54:49,wahoo,Zwift - Team Italy Gladiators Race (A),Sworks power cranks,Wahoo Kickr 2018,285,269,16
8798,863061,2020-01-10 15:14:45,wahoo,Zwift - 3R Sand and Sequoias Race (A),Sworks power cranks,Wahoo Kickr 2018,292,278,14
8820,863061,2020-01-11 09:04:42,wahoo,Zwift - 3R Classique Flat Race - 5 Laps (32.3km/20.1mi 95m) (A),Sworks power cranks,Wahoo Kickr 2018,272,259,13
9005,863061,2020-01-12 08:59:38,wahoo,Zwift - UKZwifters 100km Sportive (B),Sworks power cranks,Wahoo Kickr 2018,278,266,12
9568,863061,2020-01-14 17:58:48,wahoo,Zwift - Danmarks Cykle Union 2020 Cup (A),Sworks power cranks,Wahoo Kickr 2018,267,253,14
11235,863061,2020-01-27 18:39:54,wahoo,Zwift - Tour de Zwift: Stage 4 Race (A),Sworks power cranks,Wahoo Kickr 2018,301,290,11
11398,863061,2020-01-28 18:59:39,wahoo,Zwift - ZwiftTeamPL League – Classic Series (A),Sworks power cranks,Wahoo Kickr 2018,275,263,12
12025,863061,2020-02-01 14:59:30,wahoo,Zwift - The P Race (A),Sworks power cranks,Wahoo Kickr 2018,257,243,14
13430,863061,2020-02-11 07:59:43,wahoo,Zwift - KISS at Race - Down Under (A),Sworks power cranks,Wahoo Kickr 2018,281,263,18
13835,863061,2020-02-13 19:46:21,wahoo,Zwift - WTRL Team Time Trial (C),Sworks power cranks,Wahoo Kickr 2018,280,264,16
15254,863061,2020-02-22 08:31:30,wahoo,Zwift - Tour of Innsbruck // Stage 2 ,Sworks power cranks,Wahoo Kickr 2018,268,256,12
15256,863061,2020-02-23 08:44:36,wahoo,Zwift - Tour of Innsbruck // Stage 3,Sworks power cranks,Wahoo Kickr 2018,279,264,15
16270,863061,2020-03-01 10:04:42,wahoo,Zwift - Zwift Medio Fondo,Sworks power cranks,Wahoo Kickr 2018,271,257,14
17260,863061,2020-03-08 11:44:32,wahoo,Zwift - Crit City Race (A),Sworks power cranks,Wahoo Kickr 2018,276,271,5
18134,863061,2020-03-15 09:09:40,wahoo,Zwift - 3R Tour of Fire and Ice Hilly Race (25km/15.6mi 1166m) (A),Sworks power cranks,Wahoo Kickr 2018,247,243,4
19179,863061,2020-03-21 08:59:50,wahoo,Zwift - Stage 4 - Longer Ride - Tour of Watopia 2020,Sworks power cranks,Wahoo Kickr 2018,259,255,4
19668,863061,2020-03-25 15:59:38,wahoo,Zwift - Stage 5 - Longer Ride - Tour of Watopia 2020,Sworks power cranks,Wahoo Kickr 2018,272,271,1
21348,863061,2020-04-02 10:44:45,wahoo,Zwift - Crit City Race (A),Sworks power cranks,Wahoo Kickr 2018,281,269,12
21904,863061,2020-04-04 06:59:46,wahoo,Zwift -  Haute Route Watopia Stage 2 (E),Sworks power cranks,Wahoo Kickr 2018,252,245,7
22672,863061,2020-04-07 06:01:31,wahoo,Zwift - Zwift Time Trial Tuesday: Tempus Fugit (E),Sworks power cranks,Wahoo Kickr 2018,270,259,11
23547,863061,2020-04-10 13:34:37,wahoo,Zwift - Crit City Race (A),Sworks power cranks,Wahoo Kickr 2018,274,269,5
25909,863061,2020-04-18 07:59:38,wahoo,Zwift - Movistar Team Innsbruck UCI Worlds Ride with Alejandro Valverde (C),Sworks power cranks,Wahoo Kickr 2018,247,244,3
30644,863061,2020-05-02 09:08:59,wahoo,Zwift - Newbury Velo Weekend TT,Sworks power cranks,Wahoo Kickr 2018,278,271,7
32868,863061,2020-05-09 05:09:39,wahoo,Zwift - Tour for All 2020: Stage 2 Longer Race A/B,Sworks power cranks,Wahoo Kickr 2018,283,274,9
35327,863061,2020-05-16 05:09:44,wahoo,Zwift - Tour for All 2020: Stage 3 Longer Race A/B,Sworks power cranks,Wahoo Kickr 2018,301,288,13
35537,863061,2020-05-17 05:09:40,wahoo,Zwift - Tour for All 2020: Stage 4 Longer Race A/B,Sworks power cranks,Wahoo Kickr 2018,256,245,11
39929,863061,2020-06-06 08:45:03,wahoo,Zwift - Crit City Race (A),Sworks power cranks,Wahoo Kickr 2018,282,278,4
40107,863061,2020-06-07 05:04:33,wahoo,Zwift - 3R Volcano Flat Race - 3 Laps (36.6km/22.7mi 138m) (A),Sworks power cranks,Wahoo Kickr 2018,288,275,13
41426,863061,2020-06-13 05:29:53,wahoo,Zwift - XRS Races - The Saturday Classic (A),Sworks power cranks,Wahoo Kickr 2018,288,278,10
42784,863061,2020-06-20 07:39:38,wahoo,Zwift - Duathlon Race Series (A),Sworks power cranks,Wahoo Kickr 2018,277,268,9
44344,863061,2020-07-01 03:54:38,wahoo,Zwift - SZR Le Peloton (A),Sworks power cranks,Wahoo Kickr 2018,276,263,13
44791,863061,2020-07-04 05:00:37,wahoo,Zwift - L&#039;Etape du Tour Stage 1 - Open,Sworks power cranks,Wahoo Kickr 2018,264,256,8
44944,863061,2020-07-05 05:04:34,wahoo,Zwift - 3R Volcano Flat Race - 3 Laps (36.6km/22.7mi 138m) (A),Sworks power cranks,Wahoo Kickr 2018,280,269,11
45361,863061,2020-07-07 18:00:37,wahoo,Zwift - Virtual Tour de France - Open - Stage 1 Discovery Ride,Sworks power cranks,Wahoo Kickr 2018,288,277,11
45872,863061,2020-07-11 05:00:38,wahoo,Zwift - L&#039;Etape du Tour Stage 2 - Open,Sworks power cranks,Wahoo Kickr 2018,274,265,9
46019,863061,2020-07-12 06:00:44,wahoo,Zwift - L&#039;Etape du Tour Stage 2 - Open,Sworks power cranks,Wahoo Kickr 2018,283,274,9
46898,863061,2020-07-18 05:00:36,wahoo,Zwift - L&#039;Etape du Tour Stage 3 - Open,Sworks power cranks,Wahoo Kickr 2018,262,253,9
47871,863061,2020-07-25 08:14:43,wahoo,Zwift - ZHR Audax (D),Sworks power cranks,Wahoo Kickr 2018,257,249,8
47873,863061,2020-07-26 09:45:40,wahoo,Zwift - Stages of DIRT (A),Sworks power cranks,Wahoo Kickr 2018,276,264,12
48291,863061,2020-07-30 07:04:39,wahoo,Zwift - 3R Innsbruckring Flat Race - 5 Laps (44km/27.3mi 385m) (A),Sworks power cranks,Wahoo Kickr 2018,274,264,10
48297,863061,2020-07-29 11:36:44,wahoo,Zwift - CAT & MOUSE KZR CHASE RACE  (A),Sworks power cranks,Wahoo Kickr 2018,282,272,10
50088,863061,2020-08-15 04:59:42,wahoo,Zwift - Longer Ride - 7 Days of Tarmac SL7: Stage 3,Sworks power cranks,Wahoo Kickr 2018,257,248,9
51224,863061,2020-08-22 06:59:40,wahoo,Zwift - EVR Summer Series (A),Sworks power cranks,Wahoo Kickr 2018,262,255,7
52320,863061,2020-08-28 04:59:54,wahoo,Zwift - Off The MAAP Stage 1 - Longer Ride,Sworks power cranks,Wahoo Kickr 2018,275,262,13
53654,863061,2020-09-06 04:59:40,wahoo,Zwift - KISS at Race 100 - EU (A),Sworks power cranks,Wahoo Kickr 2018,275,257,18
54745,863061,2020-09-12 14:44:45,wahoo,Zwift - Crit City Race (A),Sworks power cranks,Wahoo Kickr 2018,285,267,18
54746,863061,2020-09-12 15:14:39,wahoo,Zwift - ZHR Afternoon Tea Race (A),Sworks power cranks,Wahoo Kickr 2018,250,233,17
55682,863061,2020-09-17 03:59:39,wahoo,Zwift - EVO CC Sprint Race Series  (A),Sworks power cranks,Wahoo Kickr 2018,282,264,18
62031,863061,2020-10-15 05:04:36,wahoo,Zwift - 3R Flat Race - FRANCE - Casse-Pattes - 1 Laps (A),Sworks power cranks,Wahoo Kickr 2018,288,271,17
62917,863061,2020-10-18 04:59:36,wahoo,Zwift - KISS at Race 100 - EU (A),Sworks power cranks,Wahoo Kickr 2018,266,249,17
63663,863061,2020-10-20 17:54:28,wahoo,Zwift - Team Italy & Frenchy Fuzion League (A),Sworks power cranks,Wahoo Kickr 2018,285,282,3
64530,863061,2020-10-24 05:04:37,wahoo,Zwift - 3R Watopia Hilly Reverse Race - 3 Laps (27.5km/17.1mi 300m) (A),Sworks power cranks,Wahoo Kickr 2018,270,265,5
65698,863061,2020-10-27 18:54:38,wahoo,Zwift - Team Italy & Frenchy Fuzion League (B),Sworks power cranks,Wahoo Kickr 2018,285,269,16
68936,863061,2020-11-01 13:15:41,wahoo,Zwift - KISS at Race 100 - Americas (B),Sworks power cranks,Wahoo Kickr 2018,277,258,19
68937,863061,2020-11-06 16:04:35,wahoo,Zwift - 3R Volcano Flat Race - 3 Laps (36.6km/22.7mi 138m) (B),Sworks power cranks,Wahoo Kickr 2018,282,265,17
68938,863061,2020-11-03 18:54:39,wahoo,Zwift - Team Italy & Frenchy Fuzion League (B),Sworks power cranks,Wahoo Kickr 2018,288,267,21
69559,863061,2020-11-09 19:20:41,wahoo,Zwift - TFC Mad Monday Autumn Series (B),Sworks power cranks,Wahoo Kickr 2018,276,255,21
75313,863061,2020-11-21 09:29:44,wahoo,Zwift - DBR Saturday Race (A),Sworks power cranks,Wahoo Kickr 2018,257,241,16
79981,863061,2020-12-05 13:19:33,wahoo,Zwift - 3R Innsbruckring Flat Race - 5 Laps (44km/27.3mi 385m) (A),Sworks power cranks,Wahoo Kickr 2018,279,271,8
80609,863061,2020-12-07 16:36:48,wahoo,Zwift - ZHR Zwift Handicap Race Europe (A),Sworks power cranks,Wahoo Kickr 2018,265,259,6
90229,863061,2021-01-02 11:14:38,wahoo,Zwift - 3R Tick Tock Flat Race - 2 Lap (36km/22.4mi 100m) (A),Sworks power cranks,Wahoo Kickr 2018,284,274,10
92531,863061,2021-01-05 18:54:39,wahoo,Zwift - Team Italy & Frenchy Fuzion League (B),Sworks power cranks,Wahoo Kickr 2018,285,282,3
94567,863061,2021-01-09 08:29:51,wahoo,Zwift - Flanders Endurance Series (E),Sworks power cranks,Wahoo Kickr 2018,287,273,14
95513,863061,2021-01-11 18:17:30,wahoo,Zwift - TRI247 Manic Monday Time Trial (E),Sworks power cranks,Wahoo Kickr 2018,270,262,8
96322,863061,2021-01-13 15:59:40,wahoo,Zwift - TDZ Stage 2: Longer Ride,Sworks power cranks,Wahoo Kickr 2018,278,264,14
100234,863061,2021-01-20 13:59:39,wahoo,Zwift - TDZ Stage 4: Longer Ride,Sworks power cranks,Wahoo Kickr 2018,282,279,3
102517,863061,2021-01-24 14:59:42,wahoo,Zwift - TDZ Stage 5: Longer Ride,Sworks power cranks,Wahoo Kickr 2018,272,271,1
107066,863061,2021-02-01 14:59:46,wahoo,Zwift - TDZ Stage 6: Longer Ride,Sworks power cranks,Wahoo Kickr 2018,271,255,16
110221,863061,2021-02-05 14:59:48,wahoo,Zwift - TDZ Stage 7: Longer Ride,Sworks power cranks,Wahoo Kickr 2018,275,266,9
110742,863061,2021-02-07 13:04:47,wahoo,Zwift - 3R Watopia Flat Route Race - 4 Laps (40.5km/25.1mi 216m) (A),Sworks power cranks,Wahoo Kickr 2018,271,280,-9
111285,863061,2021-02-08 15:59:41,wahoo,Zwift - TDZ Stage 8: Group Ride,Sworks power cranks,Wahoo Kickr 2018,263,259,4
114532,863061,2021-02-13 08:38:04,wahoo,Zwift - Chasing Cancellara Time Trial,Sworks power cranks,Wahoo Kickr 2018,281,270,11
118553,863061,2021-02-20 09:06:26,wahoo,Zwift - 3R Endurance Series p/b OTE Sports- Stage 1 (B),Sworks power cranks,Wahoo Kickr 2018,278,264,14
82047,827792,2020-12-11 18:06:40,neo,Neo / Assiomy,Assiomy,Neo,205,202,3
82631,827792,2020-12-13 07:35:24,neo,Zwift - 3R 100 Steady Ride [~3.0/2.5w/kg avg] (C),Assiomy,Neo,259,255,4
64767,902476,2020-10-25 07:00:02,wahoo,Quarq / Wahoo kickr v5,Quarq,Wahoo kickr v5,271,264,7
65103,902476,2020-10-26 18:03:05,wahoo,Quarq / Wahoo kickr v5,Quarq,Wahoo kickr v5,225,221,4
65432,902476,2020-10-27 18:16:59,wahoo,Quarq Dfour 110 GPX / Wahoo kickr v5,Quarq Dfour 110 GPX,Wahoo kickr v5,277,283,-6
66879,902476,2020-11-01 06:54:59,wahoo,Quarq Dfour 110 GPX / Wahoo kickr v5,Quarq Dfour 110 GPX,Wahoo kickr v5,246,243,3
68950,902476,2020-11-08 07:04:59,wahoo,Wahoo kickr v5 / Quarq Dfour 110 GPX,Quarq Dfour 110 GPX,Wahoo kickr v5,228,223,5
70035,902476,2020-11-10 18:16:51,wahoo,Wahoo kickr v5 / Quarq Dfour 110 GPX,Quarq Dfour 110 GPX,Wahoo kickr v5,288,286,2
74272,902476,2020-11-22 16:32:01,wahoo,Wahoo kickr v5 / Quarq Dfour 110 GPX,Quarq Dfour 110 GPX,Wahoo kickr v5,272,274,-2
79733,902476,2020-12-05 10:00:00,wahoo,Quarq Dfour 110 GPX / Wahoo kickr v5,Quarq Dfour 110 GPX,Wahoo kickr v5,268,263,5
90581,902476,2021-01-03 09:02:01,wahoo,Wahoo kickr v5 / Quarq Dfour 110 GPX,Quarq Dfour 110 GPX,Wahoo kickr v5,240,234,6
96106,642562,2021-01-12 17:32:02,wahoo,Wahoo Kickr Core / 4iii ,4iii ,Wahoo Kickr Core,332,333,-1
100095,642562,2021-01-19 17:23:28,wahoo,Wahoo Kickr Core / 4iii ,4iii ,Wahoo Kickr Core,336,342,-6
103915,642562,2021-01-26 17:39:56,wahoo,Wahoo Kickr Core / 4iii ,4iii ,Wahoo Kickr Core,328,334,-6
107843,642562,2021-02-02 18:17:00,wahoo,Wahoo Kickr Core / 4iii ,4iii ,Wahoo Kickr Core,355,361,-6
111704,642562,2021-02-09 18:24:18,wahoo,4iii  / Wahoo Kickr Core,4iii ,Wahoo Kickr Core,327,332,-5
112921,642562,2021-02-11 17:30:00,wahoo,Wahoo Kickr Core / 4iii ,4iii ,Wahoo Kickr Core,317,319,-2
115872,642562,2021-02-16 18:16:59,wahoo,Wahoo Kickr Core / 4iii ,4iii ,Wahoo Kickr Core,364,367,-3
119575,642562,2021-02-23 18:17:00,wahoo,Wahoo Kickr Core / 4iii ,4iii ,Wahoo Kickr Core,315,321,-6
65144,885157,2020-10-26 19:15:09,wahoo,Zwift - PACK Social + KOM After Party (D) without KOM ,Specialized 4iii,Wahoo Kickr v5,241,219,22
65831,885157,2020-10-28 18:44:26,wahoo,Douce France active recovery + Badge hunt,Specialized 4iii,Wahoo Kickr v5,186,193,-7
72208,885157,2020-11-17 18:29:49,wahoo,Zwift - BEAT Series: Omnium Crit Night - Event 1 - Scratch (E),Specialized 4iii,Kickr Core,271,276,-5
72222,885157,2020-11-17 19:14:51,wahoo,BEAT Series: Omnium Crit Night - Event 2 - TT,Specialized 4iii,Kickr Core,256,265,-9
75991,885157,2020-11-26 18:29:06,wahoo,Zwift - Warm up Protocol Edu Harms,Assioma Duo,Kickr Core,219,222,-3
76151,885157,2020-11-26 19:22:07,wahoo,WTRL TTT World Championships BRT Session Beers,Assioma Duo,Kickr Core,282,291,-9
76508,885157,2020-11-27 16:30:52,wahoo,Zwift - ZHQ FutureWorks Crit City Race - Anti-sandbagging (B),Assioma Duo,Kickr Core,288,300,-12
76850,885157,2020-11-28 12:18:18,wahoo,Zwift - New Workout,Assioma Duo,Kickr Core,208,213,-5
76892,885157,2020-11-28 12:45:56,wahoo,WTRL Race (B) pedalling backwards on any incline ,Assioma Duo,Kickr Core,267,277,-10
77199,885157,2020-11-29 09:00:52,wahoo,Zwift - BRT Breakfast Club (C),Assioma Duo,Kickr Core,150,154,-4
77640,885157,2020-11-30 18:59:52,wahoo,15 min race,Assioma Duo,Kickr Core,290,302,-12
78632,885157,2020-12-02 19:05:41,wahoo,Zwift - Build Me Up - Pedaling Drills,Assioma Duo,Kickr Core,200,206,-6
79049,885157,2020-12-03 19:17:14,wahoo,WTRL Team Time Trial - Zone 7,Assioma Duo,Kickr Core,266,272,-6
79653,885157,2020-12-05 09:59:51,wahoo,Zwift - 12/05/2020,Assioma Duo,Kickr Core,272,271,1
83600,885157,2020-12-15 19:14:53,wahoo,Zwift - Zwift NL - Easy roll - Rustig aan! (D),Assioma Duo,Kickr Core,239,240,-1
84044,885157,2020-12-16 19:25:40,wahoo,Zwift - Deeside Thistle and Moray Firth Race (B),Assioma Duo,Kickr Core,281,286,-5
84646,885157,2020-12-18 11:16:59,wahoo,Two Bridges Badge,Assioma Duo,Kickr Core,173,171,2
84657,885157,2020-12-18 11:36:29,wahoo,"Beach Island Loop (or that&#039;s what I was thinking whilst riding with Dan) Obviously it didnt work, well next time :) ",Assioma Duo,Kickr Core,150,150,0
85346,885157,2020-12-20 09:01:02,wahoo,Zwift - BRT Breakfast Club (C),Assioma Duo,Kickr Core,222,234,-12
85730,885157,2020-12-21 14:19:33,wahoo,Beach Island Loop 2nd Attempt�..yeaah ,Assioma Duo,Kickr Core,171,175,-4
86662,885157,2020-12-23 19:09:44,wahoo,Zwift - Bullseye Points Race by Herd Racing League (B),Assioma Duo,Kickr Core,261,263,-2
87404,885157,2020-12-26 12:07:47,wahoo,DIRT Dadurday Chase Race  (B) #Roadtorecovery #Motivation #BRT ,Assioma Duo,Kickr Core,265,267,-2
129773,885157,2021-03-17 18:50:01,wahoo,Zwift - Team CLS Badge Hunters (C),Assioma Duo,Kickr Core,213,227,-14
20278,480688,2020-03-26 18:20:17,wahoo,Zwift - ZTPL.CC Tour Stage 3 (E),STAGES,WAHOO KICKR,303,312,-9
20279,480688,2020-03-28 08:22:01,wahoo,Zwift - ZTPL.CC Tour Stage 4 (E),STAGES,WAHOO KICKR,334,334,0
20414,480688,2020-03-29 10:42:41,wahoo,Zwift - Watopia,STAGES,WAHOO KICKR,237,239,-2
26160,480688,2020-04-18 07:26:11,wahoo,Zwift - ZTPL.CC Tour2020 Stage 4 (E),STAGES,WAHOO KICKR,349,328,21
26161,480688,2020-04-16 17:09:50,wahoo,Zwift - ZTPL.CC Tour2020 Stage 3 (E),STAGES,WAHOO KICKR,344,346,-2
26162,480688,2020-04-14 17:29:26,wahoo,Zwift - ZTPLCCTour2020 Stage 2 (E),STAGES,WAHOO KICKR,359,342,17
26163,480688,2020-04-13 17:45:51,wahoo,Zwift - Richmond,STAGES,WAHOO KICKR,244,241,3
26164,480688,2020-04-12 06:56:46,wahoo,Zwift - Flanders-Roubaix (E),STAGES,WAHOO KICKR,321,316,5
26165,480688,2020-04-11 07:22:37,wahoo,Zwift - ZTPLCCTour2020 Stage 1 (E),STAGES,WAHOO KICKR,340,331,9
26166,480688,2020-04-05 16:47:49,wahoo,Zwift - Mitchelton-SCOTT ´Flanders Special&#039; Sunday Group Ride presented by BikeExchange (C),STAGES,WAHOO KICKR,239,241,-2
26167,480688,2020-04-04 07:05:31,wahoo,Zwift - ZTPL.CC Tour Stage 7 (E),STAGES,WAHOO KICKR,325,318,7
26168,480688,2020-04-02 17:32:24,wahoo,Zwift - ZTPL.CC Tour Stage 6 (E),STAGES,WAHOO KICKR,318,320,-2
13392,590093,2020-02-11 18:00:09,wahoo,Zwift - Danmarks Cykle Union 2020 Cup (A),Assioma Duo,Kickr 2018,372,379,-7
13619,590093,2020-02-13 02:29:10,wahoo,Zwift - SweatFest West Winter Race Series (A),Assioma Duo,Kickr 2018,354,354,0
36763,590093,2020-05-21 23:25:11,wahoo,Zwift - Austin Driveway Series Criterium (A),Assioma Duo,Kickr 2018,358,352,6
41331,590093,2020-06-12 23:39:17,wahoo,Zwift - EVR Americas (A),Assioma Duo,Kickr 2018,335,321,14
42047,590093,2020-06-16 18:38:16,wahoo,Zwift - 3R & Wahoo Ride Real Race Series - Round 5 of 7 (A),Assioma Duo,Kickr 2018,344,343,1
47370,590093,2020-07-22 23:27:30,wahoo,Zwift - Austin Driveway Series Criterium (A),Assioma Duo,Kickr 2018,365,342,23
63994,590093,2020-10-21 23:26:43,wahoo,Zwift - Austin Driveway Series Criterium (A),Assioma Duo,Kickr 2018,366,366,0
67772,590093,2020-11-04 03:06:00,wahoo,Zwift - Zwift Racing League | WTRL - Men&#039;s AMERICAS W DIVISION 1 (A),Assioma Duo,Kickr 2018,342,340,2
70013,590093,2020-11-11 02:58:55,wahoo,Zwift - Zwift Racing League | WTRL - AMERICAS W (MEN) -  Division 1 (A),Assioma Duo,Kickr 2018,408,408,0
82933,590093,2020-12-13 18:56:58,wahoo,Zwift - Zwift Fondo Series 2020/21 (B),Assioma Duo,Kickr 2018,351,344,7
83746,590093,2020-12-15 23:47:32,wahoo,Zwift - Midweek Criterium Race (A),Assioma Duo,Kickr 2018,349,339,10
86299,590093,2020-12-23 00:26:19,wahoo,Zwift - Watopia,Assioma Duo,Kickr 2018,131,127,4
87935,590093,2020-12-27 16:20:05,wahoo,Zwift - ZHR Audax (D),Assioma Duo,Kickr 2018,299,296,3
88744,590093,2020-12-29 19:38:49,wahoo,Zwift - Watopia 3 sisters  zada,Assioma Duo garmin,Kickr 2018,374,366,8
89510,590093,2020-12-31 16:08:03,wahoo,Zwift - OH MY CRIT! - The Double Race 1/2 (A),Assioma Duo garmin,Kickr 2018,358,350,8
89933,590093,2021-01-01 18:23:45,wahoo,Zwift - KIRCHMAIR Race Series (A),Assioma Duo karoo,Kickr 2018,325,322,3
89934,590093,2021-01-01 17:44:30,wahoo,Zwift - KIRCHMAIR Race Series (A),Assioma Duo,Kickr 2018,381,370,11
94089,590093,2021-01-09 18:57:34,wahoo,Zwift - EVR Winter Series (A),Assioma Duo,Kickr 2018,350,337,13
95623,590093,2021-01-12 18:08:25,wahoo,Zwift - Zwift Racing League | WTRL - Men&#039;s/Mixed EMEA E2 DIVISION 4 (A),Assioma Duo karoo,Kickr 2018,375,360,15
4261,861542,2019-11-14 17:04:59,wahoo,Zwift - OH CRIT!! - (A) 7th fun times! got impatient and jumped eary,Quarq D Zero,Wahoo Kickr,376,379,-3
80098,840055,2020-12-05 15:40:48,neo,Zwift - ZA Tri: TT Race - 20k,Assioma,Tacx Neo OG,305,307,-2
93195,840055,2021-01-07 20:19:49,neo,Zwift - 3R LaGuardia Loop Flat Race - 6 Laps (17.5km/10.9 162m) (B),Assioma,Tacx Neo OG,322,322,0
93204,840055,2021-01-03 13:59:50,neo,Zwift - Zwift Fondo Series 2020/21 (A),Assioma,Tacx Neo OG,319,320,-1
103949,840055,2021-01-26 19:53:46,neo,Zwift - Zwift Racing League | WTRL - Men&#039;s/Mixed EMEA W2 DIVISION 2 (B),Assioma,Tacx Neo OG,324,323,1
119852,840055,2021-02-23 19:53:47,neo,Zwift - Zwift Racing League | WTRL - Men&#039;s/Mixed EMEA W2 DIVISION 2 (B),Assioma,Tacx Neo OG,314,313,1
124363,840055,2021-03-04 20:00:48,neo,Zwift - KISS Race Series - EU PM (B),Assioma,Tacx Neo OG,307,306,1
65397,866219,2020-10-27 15:05:01,neo,Zwift - 3R iTT Race (A),Stages Gen2 L,Tacx NEO,359,356,3
128268,866219,2021-03-14 08:30:01,wahoo,Zwift - Flanders Endurance Race League Giro Di Grinta! (A),Stages Gen2 L,Wahoo Kickr V5,423,411,12
122271,893073,2021-03-01 01:24:51,wahoo,Kickr v5 / 4iiii,4iiii,Kickr v5,214,212,2
123289,893073,2021-03-03 00:26:54,wahoo,Zwift - ZHR Masters (C),4iiii,Kickr v5,335,339,-4
6431,340339,2019-12-16 18:49:43,wahoo,Zwift - Crit City Race (B),Favero Assioma Uno,Kickr Core,317,315,2
11369,340339,2020-01-28 18:29:05,wahoo,Zwift - Tour de Zwift: Stage 5 Race (B),Favero Assioma Uno,Kickr Core,316,307,9
11377,340339,2020-01-26 18:45:09,wahoo,Zwift - Tour de Zwift: Stage 4 Race (B),Favero Assioma Uno,Kickr Core,309,301,8
17379,340339,2020-03-09 18:26:36,wahoo,Zwift - Stage 1 Race (B) - Tour of Watopia 2020,Favero Assioma Uno & Polar Vantage V,Kickr Core,329,318,11
17383,340339,2020-02-05 18:46:52,wahoo,Zwift - Tour de Zwift: Stage 7 Race (B),Favero Assioma Uno & Polar Vantage V,Kickr Core,348,339,9
63668,340339,2020-10-20 16:48:39,wahoo,Zwift - Zwift Racing League | WTRL - EMEA E (MEN) - TTT Grp 3 (C),Favero Assioma Uno & Polar Vantage V,Kickr Core,312,310,2
63670,340339,2020-10-13 16:59:17,wahoo,Zwift - UK Armed Forces Cycling Community Race Night (B),Favero Assioma Uno & Polar Vantage V,Kickr Core,308,311,-3
65088,340339,2020-10-26 16:25:16,wahoo,Zwift - FZR Segment Killer Race (B),Favero Assioma Uno & Polar Vantage V,Kickr Core,344,348,-4
65089,340339,2020-10-22 16:59:06,wahoo,Zwift - Team Italy Superveloce Race (B),Favero Assioma Uno & Polar Vantage V,Kickr Core,333,328,5
65466,340339,2020-10-27 18:17:02,wahoo,Zwift - Zwift Racing League | WTRL - EMEA E (MEN) -  Division 3 (B),Favero Assioma Uno & Polar Vantage V,Kickr Core (Zwift),332,338,-6
100123,340339,2021-01-19 18:00:42,wahoo,Zwift - Zwift Racing League | WTRL - Men&#039;s/Mixed EMEA E1 DIVISION 3 (B),Favero Assioma Uno & Polar Vantage V,Kickr Core (Zwift),304,301,3
61495,890629,2020-10-13 16:12:20,neo,Easy Groupie,Ronde Left Side Power Meter,Tacx Neo,222,231,-9
62833,890629,2020-10-18 09:00:20,neo,Zwift - ZA Road 2020 - Segment Ride #1: Innsbruck Course,Ronde Left Side Power Meter,Tacx Neo,345,360,-15
64856,890629,2020-10-25 11:10:00,neo,Zwift - ZA Road - Race #2 (A),Ronde Left Side Power Meter,Tacx Neo,337,361,-24
66690,890629,2020-10-31 12:00:26,neo,Zwift - ZA Road 2020 - Segment Ride #1: Three Sisters Course,Ronde Left Side Power Meter,Tacx Neo,364,389,-25
68993,890629,2020-11-08 10:00:00,neo,Zwift - Climbers Day p/b dPAC.fit & Precision Hydration (A),Ronde Left Side Power Meter,Tacx Neo,317,329,-12
71587,890629,2020-11-15 10:05:00,neo,Zwift - Open: 2020 El Giro de Rigo - Official Route,Ronde Left Side Power Meter,Tacx Neo,343,353,-10
72595,890629,2020-11-18 16:00:01,neo,Zwift - Sydkysten / KST Race (A),Ronde Left Side Power Meter,Tacx Neo,301,316,-15
78931,890629,2020-12-03 17:04:25,neo,Zwift - OH MY CRIT! - The Double Race 2/2 (A) - Racing with the big boys,Ronde Left Side Power Meter,Tacx Neo,344,371,-27
80878,890629,2020-12-08 17:08:40,neo,Zwift - 3R Volcano KOM After Party Race - 2 laps + climb (40.2km/25mi 286m) (A),Ronde Left Side Power Meter,Tacx Neo,370,395,-25
81523,890629,2020-12-10 17:03:36,neo,Zwift - OH MY CRIT! - The Double Race 2/2 (A),Ronde Left Side Power Meter,Tacx Neo,342,371,-29
82203,890629,2020-12-12 08:57:17,neo,Zwift - ZTPL.CC Classic Race (E),Ronde Left Side Power Meter,Tacx Neo,331,344,-13
83510,890629,2020-12-15 17:09:34,neo,Zwift - 3R Volcano KOM After Party Race - 2 laps + climb (40.2km/25mi 286m) (A),Ronde Left Side Power Meter,Tacx Neo,362,385,-23
84330,890629,2020-12-17 16:58:45,neo,Zwift - OH MY CRIT! - The Double Race 2/2 (A),Ronde Left Side Power Meter,Tacx Neo,353,369,-16
93684,890629,2021-01-09 08:58:56,neo,Zwift - TDZ Stage 2,Ronde Left Side Power Meter,Tacx Neo,314,333,-19
98137,890629,2021-01-16 16:27:36,neo,Zwift - TEAM VEGAN Tofu Tornado (A),Ronde Left Side Power Meter,Tacx Neo,327,343,-16
108290,890629,2021-02-03 18:56:48,neo,Zwift - Open - Movistar Team Challenge Community Qualifier Race #1,Ronde Left Side Power Meter,Tacx Neo,336,349,-13
118135,890629,2021-02-20 09:05:17,neo,Zwift - Newbury Velo Weekend TT,Ronde Left Side Power Meter,Tacx Neo,336,340,-4
121488,890629,2021-02-27 07:59:09,neo,Zwift - Haute Route Watopia 2021 Stage 2 (A),Ronde Left Side Power Meter,Tacx Neo,331,345,-14
123117,890629,2021-03-02 19:48:52,neo,Zwift Racing League | WTRL - Men&#039;s/Mixed EMEA W1 DIVISION 3 (A),Ronde Left Side Power Meter,Tacx Neo,321,330,-9
127087,890629,2021-03-11 17:01:44,neo,Zwift - OH MY CRIT!! - The Double Race 2/2 (A),Ronde Left Side Power Meter,Tacx Neo,338,358,-20
65291,550860,2020-10-26 18:16:00,wahoo,Zwift - DBR Ride´N´Roll League (B),Garmin Vector 3,Wahoo Kicker 5.0,359,346,13
66181,550860,2020-10-28 19:06:01,wahoo,Zwift - DBR HEINO CUP III (B),Garmin Vector 3,Wahoo Kicker 5.0,346,348,-2
66417,550860,2020-10-30 12:20:22,wahoo,Zwift - Peak-PTY Climb Challenge Fridays (B),Garmin Vector 3,Wahoo Kicker 5.0,393,412,-19
66589,550860,2020-10-31 09:30:02,wahoo,Zwift - DBR Saturday Race (B),Garmin Vector 3,Wahoo Kicker 5.0,379,388,-9
67577,550860,2020-11-03 18:27:30,wahoo,Zwift Racing League | WTRL - Mens EMEA E1 DIVISION 1,Garmin Vector 3,Wahoo Kicker 5.0,379,376,3
67945,550860,2020-11-04 19:01:03,wahoo,Zwift - DCU – Feltet.dk November series,Garmin Vector 3,Wahoo Kicker 5.0,386,409,-23
69357,550860,2020-11-09 18:16:00,wahoo,Zwift -  DBR Monday Race (B),Garmin Vector 3,Wahoo Kicker 5.0,364,369,-5
70294,550860,2020-11-11 19:01:01,wahoo,Zwift - DCU – Feltet.dk November series (B),Garmin Vector 3,Wahoo Kicker 5.0,385,400,-15
72112,550860,2020-11-16 18:16:00,wahoo,Zwift -  DBR Monday Race (B),Garmin Vector 3,Wahoo Kicker 5.0,355,361,-6
72834,550860,2020-11-18 19:00:59,wahoo,Zwift - DCU – Feltet.dk November series (B),Garmin Vector 3,Wahoo Kicker 5.0,388,388,0
73147,550860,2020-11-19 19:30:59,wahoo,Zwift - World Championships Experience // Danish Cycling Federation,Garmin Vector 3,Wahoo Kicker 5.0,348,351,-3
74173,550860,2020-11-22 06:01:20,wahoo,Zwift - KISS 100 Race Series - EU (B),Garmin Vector 3,Wahoo Kicker 5.0,372,378,-6
78672,550860,2020-12-02 18:18:30,wahoo,Zwift - DBR Wednesday Race (B),Garmin Vector 3,Wahoo Kicker 5.0,373,363,10
88280,550860,2020-12-28 18:03:06,wahoo,Zwift -  DBR Monday Race (B),Garmin Vector 3,Wahoo Kicker 5.0,391,404,-13
89184,550860,2020-12-30 19:06:02,wahoo,Zwift - DBR Wednesday Race (B),Garmin Vector 3,Wahoo Kicker 5.0,407,413,-6
92587,550860,2021-01-06 18:16:19,wahoo,Zwift - DBR Wednesday Race (B),Garmin Vector 3,Wahoo Kicker 5.0,374,370,4
95854,550860,2021-01-12 18:15:51,wahoo,Zwift - Zwift Racing League | WTRL - Men&#039;s/Mixed EMEA E1 DIVISION 1 (B),Garmin Vector 3,Wahoo Kicker 5.0,363,348,15
98047,550860,2021-01-16 15:15:56,wahoo,Zwift - OH MY CRIT - Saturday Smash Race (B),Garmin Vector 3,Wahoo Kicker 5.0,360,372,-12
106067,550860,2021-01-31 10:00:56,wahoo,Zwift - DBR Sunday Race (B),Garmin Vector 3,Wahoo Kicker 5.0,408,414,-6
106752,550860,2021-02-01 18:15:59,wahoo,Zwift -  DBR Monday Race (B),Garmin Vector 3,Wahoo Kicker 5.0,349,363,-14
107314,550860,2021-02-02 18:15:59,wahoo,Zwift - Zwift Racing League | WTRL - Men&#039;s/Mixed EMEA E1 DIVISION 1 (B),Garmin Vector 3,Wahoo Kicker 5.0,384,397,-13
117346,550860,2021-02-18 18:07:02,wahoo,Zwift - FUSION WINTER CUP (B),Garmin Vector 3,Wahoo Kicker 5.0,402,405,-3
118152,550860,2021-02-20 09:30:16,wahoo,Zwift - DBR SufferDay League III (B),Garmin Vector 3,Wahoo Kicker 5.0,382,393,-11
119553,550860,2021-02-23 18:15:59,wahoo,Zwift - Zwift Racing League | WTRL - Men&#039;s/Mixed EMEA E1 DIVISION 1 (B),Garmin Vector 3,Wahoo Kicker 5.0,365,369,-4
122982,550860,2021-03-02 18:23:59,wahoo,Zwift - Zwift Racing League | WTRL - Men&#039;s/Mixed EMEA E1 DIVISION 1 (B),Garmin Vector 3,Wahoo Kicker 5.0,372,388,-16
124715,550860,2021-03-05 19:05:00,wahoo,Zwift - Zwift Racing League | WTRL Division Championships - Men&#039;s Points Race (A),Garmin Vector 3,Wahoo Kicker 5.0,381,394,-13
5328,732259,2019-12-02 18:00:10,wahoo,HT &gt; Zwift - 3R Gotham Grind Flat Race - 3 Laps (27.8km/17.4mi 87m) (B),Favero Assioma Uno,Wahoo Kickr Core,281,292,-11
9787,732259,2020-01-17 13:51:17,wahoo,HT &gt; Zwift - KISS at Race - Pacific AM (B),Favero Assioma Uno,Wahoo Kickr Core,287,280,7
9928,732259,2020-01-18 16:00:20,wahoo,HT &gt; Zwift - Tour de Zwift: Stage 2 Long Distance,Favero Assioma Uno,Wahoo Kickr Core,300,295,5
11309,732259,2020-01-28 17:01:13,wahoo,HT &gt; Zwift - Tour de Zwift: Stage 5 Short Distance,Favero Assioma Uno,Wahoo Kickr Core,308,301,7
18667,732259,2020-03-19 11:10:55,wahoo,HT &gt; Zwift - Stage 3 Race (B) - Tour of Watopia 2020,Favero Assioma Uno,Wahoo Kickr Core,318,325,-7
21394,732259,2020-04-02 12:47:48,wahoo,HT &gt; Zwift - Watopia,Favero Assioma Uno,Wahoo Kickr Core,247,250,-3
21716,732259,2020-04-03 12:57:50,wahoo,HT &gt; Zwift -  Haute Route Watopia Stage 1 (E),Favero Assioma Uno,Wahoo Kickr Core,305,307,-2
21965,732259,2020-04-04 08:59:44,wahoo,HT &gt; Zwift -  Haute Route Watopia Stage 2 (E),Favero Assioma Uno,Wahoo Kickr Core,266,278,-12
22147,732259,2020-04-05 06:59:41,wahoo,HT &gt; Zwift -  Haute Route Watopia Stage 3 (E),Favero Assioma Uno,Wahoo Kickr Core,291,294,-3
24482,732259,2020-04-14 10:00:00,wahoo,HT &gt; Zwift - DIRT Rolling Thunder Ride (C),Favero Assioma Uno,Wahoo Kickr Core,245,245,0
28719,732259,2020-04-28 15:00:10,wahoo,HT &gt; Zwift - Ramp Test,Favero Assioma Uno,Wahoo Kickr Core,368,360,8
34717,732259,2020-05-14 14:38:28,wahoo,HT &gt; Zwift - Team Italy Specialissima Race (B),Favero Assioma Uno,Wahoo Kickr Core,307,301,6
44935,732259,2020-07-04 09:00:27,wahoo,HT &gt; Zwift - L&#039;Etape du Tour Stage 1 (E),Favero Assioma Uno,Wahoo Kickr Core,289,292,-3
51965,732259,2020-08-26 10:03:11,wahoo,HT &gt; Zwift - 3R Road To Ruins Hilly Race - 1 Lap (29..2km/18.1mi 275m) (B),Favero Assioma Duo,Wahoo Kickr Core,326,338,-12
55519,732259,2020-09-15 16:06:16,wahoo,HT &gt; Zwift - Watopia,Favero Assioma Duo,Wahoo Kickr Core,258,263,-5
59983,732259,2020-10-06 13:58:56,wahoo,HT &gt; Zwift Academy Road: Workout 1 | Aerobic Power,Favero Assioma Duo,Wahoo Kickr Core,334,339,-5
60552,732259,2020-10-09 10:09:58,wahoo,ZA Road - Race #1,Favero Assioma Duo,Wahoo Kickr Core,296,308,-12
61117,732259,2020-10-12 09:43:47,wahoo,HT &gt; Zwift Academy Road: Workout 3 | VO2 Capacity,Favero Assioma Duo,Wahoo Kickr Core,352,357,-5
63001,732259,2020-10-17 08:55:17,wahoo,HT &gt; Zwift Academy Road: Workout 4 | Anaerobic Resilience,Favero Assioma Duo,Wahoo Kickr Core,247,254,-7
63003,732259,2020-10-08 10:05:27,wahoo,HT &gt; Zwift Academy Road: Workout 2 | Sprint Profile,Favero Assioma Duo,Wahoo Kickr Core,229,237,-8
63004,732259,2020-10-19 10:02:40,wahoo,HT &gt; Zwift Academy Road: Workout 5 | Primed FTP,Favero Assioma Duo,Wahoo Kickr Core,298,307,-9
63005,732259,2020-10-14 09:57:09,wahoo,HT  &gt; Zwift Academy Road: Workout 6 | Alternative Sprints,Favero Assioma Duo,Wahoo Kickr Core,235,241,-6
63338,732259,2020-10-20 09:49:59,wahoo,HT &gt; Zwift - SZR Lunch Race (B),Favero Assioma Duo,Wahoo Kickr Core,326,337,-11
64347,732259,2020-10-23 10:10:00,wahoo,HT &gt; Zwift - ZA Road - Race #2 (A),Favero Assioma Duo,Wahoo Kickr Core,331,337,-6
64855,732259,2020-10-25 12:09:05,wahoo,HT &gt; Zwift Academy Road: Workout 7 | VO2 Development,Favero Assioma Duo,Wahoo Kickr Core,310,309,1
65737,732259,2020-10-28 12:32:22,wahoo,HT &gt; Zwift Academy Road: Workout 8 | Anaerobic Depletion,Favero Assioma Duo,Wahoo Kickr Core,253,258,-5
66952,732259,2020-11-01 13:46:57,wahoo,HT &gt; Zwift - ZA Road 2020 - Segment Ride #1: Sand and Sequoias Course,Favero Assioma Duo,Wahoo Kickr Core,383,388,-5
67518,732259,2020-11-03 11:03:19,wahoo,HT &gt; Zwift - Japan Zwift Tuesday Race (A),Favero Assioma Duo,Wahoo Kickr Core,316,320,-4
71008,732259,2020-11-13 09:04:59,wahoo,HT &gt; Zwift - 3R Whole Lotta Lava Hilly Race - 2 Laps (28.9km/12.53mi 336m) (A),Favero Assioma Duo,Wahoo Kickr Core,312,307,5
81445,732259,2020-12-10 11:23:00,wahoo,HT &gt; Zwift - EMU Japan Short Race (A),Favero Assioma Duo,Wahoo Kickr Core,322,321,1
92146,732259,2021-01-06 11:00:00,wahoo,HT &gt; Zwift - TDZ Stage 1: Longer Ride,Favero Assioma Duo,Wahoo Kickr Core,310,309,1
96086,732259,2021-01-11 11:00:00,wahoo,Zwift - TDZ Stage 2: Longer Ride,Favero Assioma Duo,Wahoo Kickr Core,319,336,-17
110819,732259,2021-02-08 10:59:56,wahoo,Zwift - TDZ Stage 8: Group Ride,Favero Assioma Duo,Wahoo Kickr Core,344,344,0
6637,887278,2019-12-18 18:10:11,neo,Zwift - Crit City Race (C),Favero Assioma duo,Neo,235,236,-1
21640,887278,2020-04-02 16:54:34,neo,Zwift - Saris 2.0 Ride (D),Favero Assioma duo,Neo 1,197,199,-2
22751,887278,2020-04-07 16:10:15,neo,Zwift - Yorkshire Grand Prix Race (C),Favero Assioma duo,Neo 1,241,243,-2
23760,887278,2020-04-09 16:49:28,neo,Zwift - Saris 2.0 Ride (D),Favero Assioma duo,Neo 1,185,185,0
28574,887278,2020-04-27 16:31:52,neo,Zwift - Crit City Race (C),Favero Assioma duo,Neo 1,245,249,-4
40310,887278,2020-05-17 08:11:29,neo,Zwift - Tour for All 2020: Stage 4 Longer Race C/D,Favero Assioma duo,Neo 1,222,221,1
43059,887278,2020-06-21 15:02:07,neo,Zwift - The Alpe Dash by Herd Racing League (C),Favero Assioma duo,Neo 1,248,239,9
73907,887278,2020-11-21 17:23:04,neo,Zwift - test  av pedaler,Johans Favero Assioma duo,Neo 1,181,184,-3
74197,887278,2020-11-22 12:59:55,neo,Zwift - ZZRC Approx 1.5 W/Kg (D),Johans Favero Assioma duo,Neo 1,170,170,0
74201,887278,2020-11-22 14:14:42,neo,Zwift - test  av pedaler,Johans Favero Assioma duo,Neo 1,188,187,1
74973,887278,2020-11-24 16:49:57,neo,Zwift - The Herd Gallops (C),Favero Assioma duo,Neo 1,215,211,4
74980,887278,2020-11-24 18:14:56,neo,Zwift - test  av pedaler,Favero Assioma duo,Neo 1,161,159,2
84338,887278,2020-12-17 16:55:17,neo,Zwift - OH MY CRIT! - The Double Race 2/2 (C),Favero Assioma duo,Neo 1,273,269,4
101287,887278,2021-01-21 17:50:06,neo,Zwift - Hudik Triathlon Time Trial,Rebecka Favero Assioma duo,Neo 1,232,233,-1
115911,887278,2021-02-16 17:50:42,neo,Zwift - SZR iTT Winter Racing League (C),Favero Assioma duo,Neo 1,221,220,1
49813,534234,2020-08-12 17:56:08,wahoo,Zwift - USA Cycling Race League by Indoor Specialist (C),Stages Left,Wahoo Kickr V1,312,307,5
49814,534234,2020-08-12 18:24:06,wahoo,Zwift - Deeside Thistle and Moray Firth Race (C),Stages Left,Wahoo Kickr V1,284,281,3
75969,894711,2020-11-26 16:59:48,wahoo,Zwift - Richard Uhrina | www.kubicasport.eu&#039;s Meetup - Casse-Pattes,4iii power meter,Wahoo kickr core,358,360,-2
84350,894711,2020-12-17 17:03:29,wahoo,Zwift - Daniel Pechanek &#039;s Meetup - Tick Tock,4iii power meter,Wahoo kickr core,305,308,-3
84774,894711,2020-12-18 16:58:28,wahoo,Zwift - Petr Proschl4603&#039;s Meetup - Casse-Pattes,4iii power meter,Wahoo kickr core,359,347,12
95564,894711,2021-01-12 16:29:26,wahoo,Zwift - ZHQ FutureWorks Crit City Race - Anti-sandbagging (B),4iii power meter,Wahoo kickr core,340,335,5
99613,894711,2021-01-19 16:30:29,wahoo,Zwift - ZHQ FutureWorks Crit City Race - Anti-sandbagging (B),4iii power meter,Wahoo kickr core,347,337,10
16883,684221,2020-03-04 19:30:00,wahoo,Zwift - Zwift Beta Race (A),Srm Dura ace,Wahoo Kickr,350,353,-3
17833,684221,2020-03-12 19:15:20,wahoo,Zwift - Tour of Watopia Pro-Am Men&#039;s Race #1 (A) 5e plaats tussen de grote jongens,Srm Dura ace,Wahoo Kickr,376,386,-10
18148,684221,2020-03-15 13:05:01,wahoo,Zwift - 3R Watopia Flat Route Race - 4 Laps (40.5km/25.1mi 216m) (A),Favero assioma duo,Wahoo Kickr ( power source ),330,336,-6
18436,684221,2020-03-17 18:55:00,wahoo,Team Italy & Frenchy Fuzion League,Favero assioma duo,Wahoo Kickr ( zwift power source ),343,345,-2
18904,684221,2020-03-20 19:14:53,wahoo,Tour of Watopia Pro-Am Mens Race #2,Favero assioma duo,Wahoo Kickr ( zwift power source ),365,381,-16
19496,684221,2020-03-24 19:14:51,wahoo,Zwift - Tour of Watopia Pro-Am Men&#039;s Race #3 (A),Favero assioma duo,Wahoo Kickr ( zwift power source ),355,360,-5
19795,684221,2020-03-26 18:59:55,wahoo,Zwift - KALAS Cup - Round 9 (A),Srm Dura ace ( spare bike ),Wahoo Kickr ( zwift power source ),346,349,-3
21063,684221,2020-04-01 09:44:56,wahoo,Zwift - USA Cycling Race League by Indoor Specialist  (A) 3th place,Srm Dura ace ( spare bike ),Wahoo Kickr ( zwift power source ),317,331,-14
22774,684221,2020-04-07 17:54:58,wahoo,Zwift - Team Italy & Frenchy Fuzion League (A),Srm Dura ace ( spare bike ),Wahoo Kickr ( zwift power source ),368,361,7
23298,684221,2020-04-09 18:09:55,wahoo,Zwift - London International // Zwift Classic (A),Srm Dura ace ( spare bike ),Wahoo Kickr ( zwift power source ),387,390,-3
25612,684221,2020-04-17 18:10:52,wahoo,Zwift - Richmond Challenge // Zwift Classic (A),Srm Dura ace ( spare bike ),Wahoo Kickr ( zwift power source ),356,361,-5
25814,684221,2020-04-18 11:08:52,wahoo,Zwift - USA Cycling&#039;s Dadurday Chase Race by DIRT (A),Srm Dura ace ( spare bike ),Wahoo Kickr ( zwift power source ),336,346,-10
27184,684221,2020-04-23 07:04:57,wahoo,Zwift - 3R Innsbruckring Flat Race - 5 Laps (44km/27.3mi 385m) (A),Srm Dura ace ( spare bike ),Wahoo Kickr ( zwift power source ),316,324,-8
28033,684221,2020-04-25 18:10:00,wahoo,Zwift - Crit City Slam // Zwift Classic (A),Srm Dura ace ( spare bike ),Wahoo Kickr ( zwift power source ),370,375,-5
32068,684221,2020-05-06 17:55:12,wahoo,Zwift - USA Cycling Race League p/b Saris+ThePro&#039;sCloset  (A),Srm Dura ace ( spare bike ),Wahoo Kickr ( zwift power source ),346,364,-18
40798,684221,2020-06-10 17:55:14,wahoo,USA Cycling Race League by Saris/Pros Closet,Favero assioma duo,Wahoo Kickr ( zwift power source ),392,392,0
41794,684221,2020-06-15 12:01:23,wahoo,Zwift - ZADA 3 sisters test,Favero assioma duo,Wahoo Kickr ( zwift power source ),373,379,-6
52113,684221,2020-08-27 09:19:19,wahoo,Zwift - Cycling Australia&#039;s The Chop by AHDR (A),Favero assioma duo,Wahoo Kickr ( zwift power source ),363,369,-6
52904,684221,2020-09-01 17:29:59,wahoo,Zwift - WTRL Gravel Series (A) 3th,Favero assioma duo,Wahoo Kickr ( zwift power source ),349,352,-3
54390,684221,2020-09-10 17:21:03,wahoo,Zwift - Espresso,Favero assioma duo,Wahoo Kickr ( zwift power source ),341,350,-9
56404,684221,2020-09-20 12:59:59,wahoo,Invitational League // Qualifying Race #3 (Men),Favero assioma duo,Wahoo Kickr ( zwift power source ),352,349,3
57019,684221,2020-09-23 16:59:58,wahoo,Zwift - MIDWEEK Autumn Series by SZR (A) + cool down,Dura-Ace PM,Wahoo Kickr ( zwift power source ),338,343,-5
57726,684221,2020-09-26 14:14:59,wahoo,Zwift - OH MY CRIT - Saturday Smash Race (A),Favero assioma duo,Wahoo Kickr ( zwift power source ),328,333,-5
58521,684221,2020-09-30 17:00:00,wahoo,Zwift - MIDWEEK Autumn Series by SZR (A) + cooldown,Favero assioma duo,Wahoo Kickr ( zwift power source ),343,363,-20
59273,684221,2020-10-03 14:15:09,wahoo,Zwift - OH MY CRIT - Saturday Smash Race (A) + endurance,Favero assioma duo,Wahoo Kickr ( zwift power source ),384,392,-8
6662,595291,2019-12-18 19:04:57,wahoo,Zwift - DBR HEINO CUP (A),Assiomo PM,Wahoo Kickr,427,422,5
8486,595291,2020-01-08 19:00:02,wahoo,Zwift - FIETS Magazine Race Series (A),Assiomo PM,Wahoo Kickr,463,461,2
13030,595291,2020-02-08 15:14:50,wahoo,OH CRIT!! - Saturday Smash Series,Assiomo PM,Wahoo Kickr,337,337,0
13789,595291,2020-02-13 19:00:10,wahoo,KALAS Cup - Round 3,Assiomo PM,Wahoo Kickr,383,378,5
13791,595291,2019-12-29 12:00:00,wahoo,ZRG-Race-Series-10/10,Assiomo PM,Wahoo Kickr,431,441,-10
15103,595291,2020-02-21 18:00:37,wahoo,Tour of Innsbruck // Stage 1,Assiomo PM,Wahoo Kickr,444,442,2
15633,595291,2020-02-25 18:00:17,wahoo,ZRG Winter Race Series 7/10 - Muir and the Mountain,Assiomo PM,Wahoo Kickr,415,414,1
15858,595291,2020-02-27 17:05:15,wahoo,Zwift - OH CRIT!! - The Double Race - Race 2/2 (A),Assiomo PM,Wahoo Kickr,362,359,3
15887,595291,2020-02-27 18:59:55,wahoo,Zwift - KALAS Cup - Round 5 (A),Assiomo PM,Wahoo Kickr,384,380,4
16190,595291,2020-02-29 13:09:56,wahoo,Zwift - The BMTR Fundo (A),Assiomo PM,Wahoo Kickr,348,347,1
16238,595291,2020-03-01 08:00:02,wahoo,Zwift - Zwift Gran Fondo,Assiomo PM,Wahoo Kickr,362,365,-3
17554,595291,2020-03-10 19:15:01,wahoo,Feltet.dk Race Series,Assiomo PM,Wahoo Kickr,385,387,-2
19841,595291,2020-03-26 19:00:02,wahoo,KALAS Cup - Round 9,Assiomo PM,Wahoo Kickr,364,365,-1
31815,595291,2020-05-05 18:39:54,wahoo,3R Spring Loaded Race Series - Round 6of6,Assiomo PM,Wahoo Kickr,428,435,-7
34409,595291,2020-05-13 17:55:20,wahoo,USA Cycling Race League p/b Saris+TheProsCloset,Assiomo PM,Wahoo Kickr,371,371,0
43552,595291,2020-06-24 17:54:54,wahoo,USA Cycling Race League by Saris/Pros Closet,Assiomo PM,Wahoo Kickr,464,458,6
71276,595291,2020-11-14 09:05:26,wahoo,e-liga | eCycling league Austria Race 1,Assiomo PM,Wahoo Kickr,431,436,-5
76220,595291,2020-11-26 19:47:37,wahoo,WTRL NOPINZ WORLD TTT CHAMPIONSHIPS - Zone 10,Assiomo PM,Wahoo Kickr,401,392,9
76786,595291,2020-11-28 09:04:56,wahoo,e-liga I eCycling league Austria Race 2,Assiomo PM,Wahoo Kickr,375,394,-19
77356,595291,2020-11-29 14:14:57,wahoo,KISS 100 Race Series - Americas,Assiomo PM,Wahoo Kickr,328,333,-5
101697,595291,2021-01-23 09:04:25,wahoo,e-liga I eCycling league Austria Race 5,Assiomo PM,Wahoo Kickr,404,406,-2
109664,595291,2021-02-06 09:05:03,wahoo,e-liga | eCycling league Austria Race 6,Assiomo PM,Wahoo Kickr,362,363,-1
124882,595291,2021-03-06 09:04:36,wahoo,e-liga I eCycling league Austria Race 8,Assiomo PM,Wahoo Kickr,410,408,2
127800,595291,2021-03-13 09:05:30,wahoo,e-liga I eCycling league Austria Race 9,Assiomo PM,Wahoo Kickr,376,375,1
105823,909161,2021-01-30 17:00:02,wahoo,Zwift - The Carnival Race League Stage 4 with ZTPL.CC (A),Assioma duo,Kickr Core,322,319,3
74558,78206,2020-11-23 16:39:23,wahoo,Zwift - FZR Segment Killer Race (A),4III,Wahoo kicker,362,369,-7
75418,78206,2020-11-25 04:27:53,wahoo,Zwift - 3R Flat Race - NYC - Gotham Grind - 2 Laps (A),4III,Wahoo kicker,317,319,-2
77614,78206,2020-11-30 16:29:40,wahoo,Zwift - FZR Segment Killer Race (A),4III,Wahoo kicker,328,337,-9
81538,78206,2020-12-10 16:14:36,wahoo,Zwift - OH MY CRIT! - The Double Race 1/2 (A),4III,Wahoo kicker,322,335,-13
81539,78206,2020-12-10 16:14:36,wahoo,Zwift - OH MY CRIT! - The Double Race 2/2 (A),4III,Wahoo kicker,322,306,16
84780,78206,2020-12-18 17:52:25,wahoo,Zwift - KIRCHMAIR Race Series (A),4III,Wahoo kicker,343,356,-13
84782,78206,2020-12-18 17:52:25,wahoo,Zwift - KIRCHMAIR Race Series (A),4III,Wahoo kicker,326,341,-15
92296,223424,2021-01-05 14:59:50,neo,Zwift - TDZ Stage 1: Longer Ride,Garmin Vector 3s,Tacx Neo,317,319,-2
11367,407114,2020-01-28 17:41:17,wahoo,Zwift - Danmarks Cykle Union 2020 Cup (B),STAGES,KICKR,309,286,23
12637,407114,2020-02-05 19:03:06,wahoo,Zwift - DBR Wednesday Race (B),STAGES,KICKR,307,296,11
23783,407114,2020-04-11 08:06:22,wahoo,DBR Sufferday League,STAGES,KICKR,286,273,13
25886,407114,2020-04-18 08:03:07,wahoo,Zwift - DBR Sufferday League (A),STAGES L arm Gen2,KICKR V4,310,304,6
30544,407114,2020-05-02 08:08:49,wahoo,Zwift - DBR Sufferday League (A),STAGES L arm Gen2,KICKR V4,308,304,4
52120,407114,2020-08-24 17:16:01,wahoo,Zwift - DBR Monday Race  (B),STAGES L arm Gen2,KICKR V4,302,286,16
57664,407114,2020-09-26 08:14:53,wahoo,Zwift - DBR SufferDay League II (B),STAGES L arm Gen2,KICKR V4,304,291,13
58604,407114,2020-09-30 17:38:59,wahoo,Zwift - DBR Wednesday Race (B),STAGES L arm Gen2,KICKR V4,293,278,15
61233,407114,2020-10-12 17:01:48,wahoo,Zwift - DBR Ride´N´Roll League (B),STAGES L arm Gen2,KICKR V4,287,286,1
61969,407114,2020-10-14 18:06:01,wahoo,Zwift - DBR HEINO CUP III (B),STAGES L arm Gen2,KICKR V4,291,286,5
64027,407114,2020-10-21 17:23:35,wahoo,Zwift - DBR HEINO CUP III (B),STAGES L arm Gen2,KICKR V4,312,296,16
65889,407114,2020-10-28 18:34:42,wahoo,Zwift - DBR HEINO CUP III (B),STAGES L arm Gen2,KICKR V4,321,310,11
79477,407114,2020-11-30 18:05:06,wahoo,Zwift -  DBR Monday Race (B),STAGES L arm Gen2,KICKR V4,298,280,18
81949,407114,2020-12-10 18:30:55,wahoo,Zwift - FUSION DECEMBER CUP (B),STAGES L arm Gen2,KICKR V4,313,291,22
128800,407114,2021-03-15 18:05:18,wahoo,Zwift -  DBR Monday Race (A),STAGES L arm Gen2,KICKR V4,309,296,13
99460,928594,2021-01-12 12:47:58,wahoo,Zwift - TDZ Stage 2: Longer Ride,Assioma UNO,Kickr Gen3 2017,352,342,10
99579,928594,2021-01-19 13:35:00,wahoo,Zwift - Crit City Race (A),Assioma DUO,Kickr Gen3 2017,330,353,-23
99580,928594,2021-01-19 13:57:55,wahoo,Zwift - TDZ Stage 4: Longer Ride,Assioma DUO,Kickr Gen3 2017,305,323,-18
104421,928594,2021-01-26 13:16:02,wahoo,Zwift - TDZ Stage 5: Longer Ride,Assioma DUO,Kickr Gen3 2017,322,342,-20
104511,928594,2021-01-28 10:06:46,wahoo,Zwift - GCC January 2021-3,Assioma DUO,Kickr Gen3 2017,315,318,-3
105478,928594,2021-01-30 08:04:05,wahoo,Zwift - Jesper Stormholt&#039;s Meetup - Quatch Quest,Assioma DUO,Kickr Gen3 2017,310,322,-12
107226,928594,2021-02-02 12:46:52,wahoo,Zwift - TDZ Stage 6: Longer Ride,Assioma DUO,Kickr Gen3 2017,324,333,-9
108886,928594,2021-02-04 14:28:04,wahoo,Zwift-Gorby+,Assioma DUO,Kickr Gen4 2018,346,347,-1
109787,928594,2021-02-06 07:45:54,wahoo,Zwift - Jesper Stormholt&#039;s Meetup - Volcano Circuit,Assioma DUO,Kickr Gen4 2018,281,274,7
110414,928594,2021-02-07 08:15:54,wahoo,Zwift - GCC_February_1,Assioma DUO,Kickr Gen4 2018,314,302,12
111666,928594,2021-02-09 08:41:15,wahoo,Zwift - TDZ Stage 8: Group Ride,Assioma DUO,Kickr Gen4 2018,337,334,3
120160,928594,2021-02-24 10:05:28,wahoo,Zwift - Slaughter (non) Recovery POL,Assioma DUO,Kickr Gen3 2017,314,320,-6
63222,762038,2020-10-19 18:18:02,wahoo,Zwift - ZHR Zwift Handicap Race Britain (A),SRM PM7 (ANT+) - Zwift,Kickr (ANT+) - Garmin 920,422,422,0
63858,762038,2020-10-21 16:59:28,wahoo,Zwift - MIDWEEK Autumn Series by SZR (A),SRM PM7 (ANT+) - Garmin 830,Kickr (ANT+) - Zwift,388,382,6
64274,762038,2020-10-22 19:38:10,wahoo,Zwift - JETT Base Ride (2.7~4.5w/kg) (A),SRM PM7 (ANT+) - Zwift,Kickr - Garmin 510,352,353,-1
65091,762038,2020-10-26 18:16:15,wahoo,Zwift - TRI247 Manic Monday Time Trial (E),SRM PM7 (ANT+) - Garmin 830,Kickr (ANT+) - Zwift,390,386,4
65833,762038,2020-10-28 18:00:16,wahoo,Zwift - MIDWEEK Autumn Series by SZR (A),SRM PM7 (ANT+) - Garmin 830,Kickr (ANT+) - Zwift,406,400,6
66514,762038,2020-10-30 21:31:37,wahoo,Zwift - JETT 4k TT Race (E),SRM PM7 (ANT+) - Zwift,Kickr - Garmin 510,429,428,1
68323,762038,2020-11-04 17:59:37,wahoo,Zwift - MIDWEEK Autumn Series by SZR (A),SRM PM7 (ANT+) - Zwift,Kickr - Garmin 510,362,359,3
68327,762038,2020-11-05 19:28:54,wahoo,Zwift - JETT Base Ride (2.7~4.5w/kg) (A),SRM PM7 (ANT+) - Zwift,Kickr - Garmin 510,317,309,8
69364,762038,2020-11-09 17:44:54,wahoo,Zwift - KATT Race by WKG (A),SRM PM7 (ANT+) - Zwift,Kickr - Garmin 510,391,389,2
70901,762038,2020-11-12 19:17:19,wahoo,Zwift - JETT Base Ride (2.7~4.5w/kg) (A),SRM PM7 (ANT+) - Zwift,Kickr - Garmin 510,304,305,-1
72772,762038,2020-11-16 18:18:23,wahoo,Zwift - TRI247 Manic Monday Time Trial (E),SRM PM7 (ANT+) - Zwift,Kickr - Garmin 510,381,378,3
73317,762038,2020-11-20 02:03:58,wahoo,Zwift - Coach Powell - Zoom Interval Workout #20,SRM PM7 (ANT+) - Zwift,Kickr - Garmin 510,297,295,2
74637,762038,2020-11-23 17:45:22,wahoo,Zwift - KATT Race by WKG (A),SRM PM7 (ANT+) - Zwift,Kickr - Garmin 510,342,334,8
74805,762038,2020-11-24 02:00:02,wahoo,Zwift - Zoom/Zwift Interval Workout #21 w/ Coach Powell,SRM PM7 (ANT+) - Garmin 830,Kickr (ANT+) - Zwift,297,297,0
77825,762038,2020-11-30 23:37:01,wahoo,Zwift - ZHR Zwift Handicap Race Atlantic (A),SRM PM7 (ANT+) - Garmin 830,Kickr (ANT+) - Zwift,404,400,4
77837,762038,2020-12-01 02:09:14,wahoo,Zwift - Zoom/Zwift Interval Workout #23 w/ Coach Powell,SRM PM7 (ANT+) - Garmin 830,Kickr (ANT+) - Zwift,333,332,1
81664,762038,2020-12-10 18:05:25,wahoo,Zwift - FUSION DECEMBER CUP (A),SRM PM7 (ANT+) - Garmin 830,Kickr (ANT+) - Zwift,390,385,5
83284,762038,2020-12-15 01:25:17,wahoo,Zwift - 3R Volcano Circuit Sprint Flat Race - 1 Lap (6.6km/4.1mi 20m) (A),SRM PM7 (ANT+) - Zwift,Kickr (ANT+) - Garmin,408,405,3
84898,762038,2020-12-18 23:06:17,wahoo,Zwift - ASIA 120km Endurance Ride (A),SRM PM7 (ANT+) - Zwift,Kickr (ANT+) - Garmin,372,379,-7
85932,762038,2020-12-21 21:14:54,wahoo,Zwift - ZA Tri: TT Race - 40k ,SRM PM7 (ANT+) - Garmin,Kickr (ANT+) - Zwift,357,357,0
87649,762038,2020-12-27 00:08:24,wahoo,Zwift - 3R & ZID Merdeka Classique Flat Race Series - Round 4 of 4 (A),SRM PM7 (ANT+) - Zwift,Kickr (ANT+) - Garmin,364,366,-2
88392,762038,2020-12-28 23:15:36,wahoo,Zwift - 3R 50km LONDON-Greater London Flat Race (52km/32.4mi) (A),SRM PM7 (ANT+) - Garmin,Kickr (ANT+) - Zwift,363,366,-3
88852,762038,2020-12-30 02:50:56,wahoo,ZADA Test - Three Sisters,SRM PM7 (ANT+) - Garmin,Kickr (ANT+) - Zwift,399,397,2
90449,762038,2021-01-02 19:52:37,wahoo,Zwift - JETT Endurance Ride 100km 3.0~3.3w/kg (B),SRM PM7 (ANT+) - Garmin,Kickr (ANT+) - Zwift,411,413,-2
91431,762038,2021-01-04 21:00:49,wahoo,Zwift - TDZ Stage 1: Longer Ride,SRM PM7 (ANT+) - Garmin,Kickr (ANT+) - Zwift,306,312,-6
96644,762038,2021-01-14 00:47:05,wahoo,Zwift - Cycling Canada Wednesday Night Race Series (A),SRM PM7 (ANT+) - Garmin,Kickr (ANT+) - Zwift,381,377,4
101202,762038,2021-01-22 00:47:26,wahoo,Zwift - TDZ Stage 4: Standard Ride,SRM PM7 (ANT+) - Garmin,Kickr (ANT+) - Zwift,407,402,5
103169,762038,2021-01-26 01:00:29,wahoo,Zwift - TDZ Stage 5: Longer Ride,SRM PM7 (ANT+) - Zwift,Kickr (ANT+) - Garmin,374,375,-1
104940,762038,2021-01-29 00:56:45,wahoo,Zwift - TDZ Stage 5: Group Ride (B),SRM PM7 (ANT+) - Zwift,Kickr (ANT+) - Garmin,366,367,-1
107041,762038,2021-02-02 00:33:44,wahoo,Zwift - TDZ Stage 6: Longer Ride,SRM PM7 (ANT+) - Zwift,Kickr (ANT+) - Garmin,393,388,5
109155,762038,2021-02-05 00:57:57,wahoo,Zwift - TDZ Stage 7: Standard Ride,SRM PM7 (ANT+) - Zwift,Kickr (ANT+) - Garmin,365,353,12
113232,762038,2021-02-12 00:57:33,wahoo,Zwift - TDZ Stage 8: Group Ride,SRM PM7 (ANT+) - Zwift,Kickr (ANT+) - Garmin,393,390,3
115536,762038,2021-02-16 00:52:58,wahoo,Zwift - TDZ Stage 5: Shorter Ride,SRM PM7 (ANT+) - Zwift,Kickr (ANT+) - Garmin,317,312,5
121002,762038,2021-02-26 00:00:21,wahoo,Zwift - Haute Route Watopia 2021 Stage 1 (A),SRM PM7 (ANT+) - Zwift,Kickr (ANT+) - Garmin,400,396,4
121814,762038,2021-02-27 16:38:09,wahoo,Zwift - Zoom/Zwift Endurance Workout #22 w/ Coach Powell,SRM PM7 (ANT+) - Zwift,Kickr (ANT+) - Garmin,434,429,5
122724,762038,2021-03-02 00:41:31,wahoo,Zwift - The Stampede (ITT) by Herd Racing League (A),SRM PM7 (ANT+) - Zwift,Kickr (ANT+) - Garmin,398,395,3
124316,762038,2021-03-05 01:06:15,wahoo,Zwift - OFRRCC Time Trial Race (A),SRM PM7 (ANT+) - Zwift,Kickr (ANT+) - Garmin,440,441,-1
128125,762038,2021-03-13 16:34:45,wahoo,TBR Pancake Chase Race ! (A),SRM PM7 (ANT+) - Zwift,Kickr (ANT+) - Garmin,357,362,-5
128128,762038,2021-03-12 00:49:12,wahoo,Zwift - KISS Race Series - Americas PM (A),SRM PM7 (ANT+) - Zwift,Kickr (ANT+) - Garmin,342,342,0
128899,762038,2021-03-15 23:59:06,wahoo,Zwift - EVR Americas Race (A),SRM PM7 (ANT+) - Zwift,Kickr (ANT+) - Garmin,376,383,-7
129895,762038,2021-03-18 00:30:14,wahoo,Zwift - Austin Driveway Series Criterium (A),SRM PM7 (ANT+) - Zwift,Kickr (ANT+) - Garmin,345,346,-1
68484,860348,2020-11-06 12:59:47,wahoo,Zwift - ZA Road Group Ride: 2.2 - 2.7 w/kg,Sortie_v_lo_l_apr_s_midi (1),Wahoo Kickr (source principale),260,278,-18
68965,860348,2020-11-08 09:29:49,wahoo,Zwift -  SloZl - Slovenian Zwift League - Weekly Race  (A),racesloZI.test powertap pedals.calibate wahoo,Wahoo Kickr (source principale),387,411,-24
69343,860348,2020-11-09 16:55:22,wahoo,Zwift - Ventouro Social Group Ride (C),Rotor Inpower Left Crank,Wahoo Kickr (main source),304,321,-17
69887,860348,2020-11-10 18:12:06,wahoo,Zwift - Zwift Racing League | WTRL - EMEA E1 (MEN) -  Division 1 (A),Rotor Inpower Left Crank,Wahoo Kickr (main source),426,428,-2
72287,860348,2020-11-06 10:33:18,wahoo,Zwift - Zwift Racing League | WTRL - Men&#039;s EMEA E1 DIVISION 1 (A),Rotor Inpower Left Crank,Wahoo Kickr (main source),378,369,9
75084,860348,2020-11-24 18:11:59,wahoo,Zwift - Zwift Racing League | WTRL - Men&#039;s EMEA E1 DIVISION 1,Rotor Inpower Left Crank Garmin 810,Wahoo Kickr (main source),424,422,2
78080,860348,2020-12-01 18:21:44,wahoo,Zwift - Zwift Racing League | WTRL - Men&#039;s EMEA E1 DIVISION 1 (A),Rotor Inpower Left Crank Garmin 810,Wahoo Kickr (main source),406,398,8
79674,860348,2020-12-05 09:57:50,wahoo,Zwift - Nations Challenge // France (E),Rotor Inpower Left Crank Garmin 810,Wahoo Kickr (main source),338,337,1
81038,860348,2020-12-08 18:12:04,wahoo,Zwift - Zwift Racing League | WTRL - Men&#039;s EMEA E1 DIVISION 1 (A),Rotor Inpower Left Crank Garmin 810,Wahoo Kickr (main source),396,388,8
83553,860348,2020-12-15 18:24:05,wahoo,Zwift - Zwift Racing League | WTRL - Men&#039;s EMEA E1 DIVISION 1 (A),Rotor Inpower Left Crank Garmin 810,Wahoo Kickr (main source),384,378,6
95621,860348,2021-01-12 18:08:45,wahoo,Zwift - Zwift Racing League | WTRL - Men&#039;s/Mixed EMEA E1 DIVISION 1 (A),Rotor Inpower Left Crank,Wahoo Kickr (main source),404,400,4
99699,860348,2021-01-19 18:19:36,wahoo,Zwift - Zwift Racing League | WTRL - Men&#039;s/Mixed EMEA E1 DIVISION 1 (A),Rotor Inpower Left Crank,Wahoo Kickr (main source),369,362,7
103488,860348,2021-01-26 18:10:44,wahoo,Zwift - Zwift Racing League | WTRL - Men&#039;s/Mixed EMEA E1 DIVISION 1 (A),Rotor Inpower Left Crank Garmin 810,Wahoo Kickr (main source),447,439,8
107322,860348,2021-02-02 18:09:32,wahoo,Zwift - Zwift Racing League | WTRL - Men&#039;s/Mixed EMEA E1 DIVISION 1 (A),Rotor Inpower Left Crank Garmin 810,Wahoo Kickr (main source),416,398,18
111630,860348,2021-02-09 18:13:46,wahoo,Zwift - Zwift Racing League | WTRL - Men&#039;s/Mixed EMEA E1 DIVISION 1 (A),Rotor Inpower Left Crank Garmin 810,Wahoo Kickr (main source),376,363,13
112215,860348,2021-02-10 16:56:39,wahoo,Zwift - TDZ Stage 8: Group Ride,Rotor Inpower Left Crank Garmin 810,Wahoo Kickr (main source),384,360,24
119648,860348,2021-02-23 18:00:45,wahoo,Zwift - Zwift Racing League | WTRL - Men&#039;s/Mixed EMEA E1 DIVISION 1 (A),Rotor Inpower Left Crank Garmin 810,Wahoo Kickr (main source),428,422,6
122945,860348,2021-03-02 18:15:40,wahoo,Zwift - Zwift Racing League | WTRL - Men&#039;s/Mixed EMEA E1 DIVISION 1 (A),Rotor Inpower Left Crank Garmin 810,Wahoo Kickr (main source),400,383,17
129737,152797,2021-03-17 17:14:21,wahoo,Zwift - Masters SA (B),Favero,Wahoo Kickr V5,390,381,9
114892,468170,2021-02-14 18:14:57,wahoo,Zwift - TDZ Stage 2: Longer Ride,Quarq,Wahoo Kickr&#039;,220,218,2
64366,758151,2020-10-18 12:55:04,wahoo,Vince&#039;s Test,Favero Assioma Duo,Wahoo KICKR ,235,239,-4
124256,830405,2021-03-04 18:27:49,wahoo,FUSION SPRING CUP (A),Power2Max NG Eco / Rotor Cranks,Wahoo Kickr Core,449,442,7
124520,830405,2021-03-05 17:58:35,wahoo,KIRCHMAIR Race Series,Power2Max NG Eco / Rotor Cranks,Wahoo Kickr Core,358,354,4
124541,830405,2021-03-05 18:21:02,wahoo,KIRCHMAIR Race Series,Power2Max NG Eco / Rotor Cranks,Wahoo Kickr Core,367,365,2
125113,830405,2021-03-06 18:03:48,wahoo,3R Three Sisters Hilly Race (47km/29.2mi 879m) (A),Power2Max NG Eco / Rotor Cranks,Wahoo Kickr Core,418,417,1
127559,830405,2021-03-12 18:22:22,wahoo,KIRCHMAIR March Sprint Series 4/8,Power2Max NG Eco / Rotor Cranks,Wahoo Kickr Core,362,363,-1
128082,830405,2021-03-13 18:05:24,wahoo,3R Three Sisters Hilly Race (A) - SEE DESCRIPTION for HR avg,Power2Max NG Eco / Rotor Cranks,Wahoo Kickr Core,414,413,1
129151,830405,2021-03-16 18:21:10,wahoo,CeramicSpeed Race Series: Open Race (A),Power2Max NG Eco / Rotor Cranks,Wahoo Kickr Core,427,429,-2
62169,407134,2020-10-15 16:31:51,wahoo,Z2,Powertap P1S - Garmin Edge 520,Wahoo KICKR v5 - ZWIFT,176,182,-6
62627,407134,2020-10-17 08:04:13,wahoo,Zwift - DBR SufferDay League II (A),Powertap P1S - Garmin Edge 520,Wahoo KICKR v5 - ZWIFT,323,330,-7
63564,407134,2020-10-20 17:39:22,wahoo,Zwift - Zwift Racing League | WTRL - EMEA (MEN) - TTT Grp 2 (E),Powertap P1S - Garmin Edge 520,Wahoo KICKR v5 - Zwift,312,306,6
64596,407134,2020-10-24 07:41:24,wahoo,Zwift - DBR SufferDay League II (A),Powertap P1S - Garmin Edge 520,Wahoo KICKR v5 - Zwift,306,313,-7
72640,407134,2020-11-18 17:10:27,wahoo,Zwift - MIDWEEK Autumn Series by SZR (B),Powertap P1S - Garmin Edge 520,Wahoo KICKR v5 - Zwift,317,319,-2
73763,407134,2020-11-21 07:50:13,wahoo,Zwift - TEAM VEGAN Tofu Tornado XL (B),Powertap P1S - Garmin Edge 520,Wahoo KICKR v5 - Zwift,324,324,0
74615,407134,2020-11-23 17:33:49,wahoo,Zwift -  DBR Monday Race (B),Powertap P1S - Garmin Edge 520,Wahoo KICKR v5 - Zwift,302,300,2
75541,407134,2020-11-25 17:15:39,wahoo,Zwift - MIDWEEK Autumn Series by SZR (B),Powertap P1S - Garmin Edge 520,Wahoo KICKR v5 - Zwift,336,330,6
76803,407134,2020-11-28 08:48:53,wahoo,Zwift - DBR Saturday Race (B),Powertap P1S - Garmin Edge 520,Wahoo KICKR v5 - Zwift,314,313,1
78603,407134,2020-12-02 17:18:01,wahoo,Zwift - MIDWEEK Winter Series by SZR (B),Powertap P1S - Garmin Edge 520,Wahoo KICKR v5 - Zwift,316,316,0
79687,407134,2020-12-05 08:47:53,wahoo,Zwift - DBR Saturday Race (B),Powertap P1S - Garmin Edge 520,Wahoo KICKR v5 - Zwift,316,318,-2
80198,407134,2020-12-06 13:38:43,wahoo,Zwift - KISS 100 Race Series - Americas (B),Powertap P1S - Garmin Edge 520,Wahoo KICKR v5 - Zwift,330,330,0
81147,407134,2020-12-09 17:15:19,wahoo,Zwift - MIDWEEK Winter Series by SZR (B),Powertap P1S - Garmin Edge 520,Wahoo KICKR v5 - Zwift,324,324,0
84021,407134,2020-12-16 17:03:32,wahoo,Zwift - MIDWEEK Winter Series by SZR (B),Powertap P1S - Garmin Edge 520,Wahoo KICKR v5 - Zwift,309,309,0
85023,407134,2020-12-19 08:47:29,wahoo,Zwift - DBR Saturday Race (B),Powertap P1S - Garmin Edge 520,Wahoo KICKR v5 - Zwift,339,339,0
85381,407134,2020-12-20 10:28:11,wahoo,Zwift - Stages of DIRT (B),Powertap P1S - Garmin Edge 520,Wahoo KICKR v5 - Zwift,285,285,0
86605,407134,2020-12-23 17:08:08,wahoo,Zwift - MIDWEEK Winter Series by SZR (B),Powertap P1S - Garmin Edge 520,Wahoo KICKR v5 - Zwift,343,325,18
86893,407134,2020-12-24 10:06:22,wahoo,Zwift - KISS Race Series - Americas AM (B),Powertap P1S - Garmin Edge 520,Wahoo KICKR v5 - Zwift,327,328,-1
87360,407134,2020-12-26 08:44:53,wahoo,Zwift - DBR Saturday Race (B),Powertap P1S - Garmin Edge 520,Wahoo KICKR v5 - Zwift,309,307,2
89127,407134,2020-12-30 17:08:57,wahoo,Zwift - MIDWEEK Winter Series by SZR (B),Powertap P1S - Garmin Edge 520,Wahoo KICKR v5 - Zwift,344,347,-3
90152,407134,2021-01-02 08:45:28,wahoo,Zwift - DBR SufferDay League III (B),Powertap P1S - Garmin Edge 520,Wahoo KICKR v5 - Zwift,321,326,-5
91821,407134,2021-01-05 17:26:49,wahoo,Zwift - EVO CC Altibajos Group Ride with hilly after party [3-4.0 w/kg avg] (B),Powertap P1S - Garmin Edge 520,Wahoo KICKR v5 - Zwift,266,267,-1
92359,407134,2021-01-06 17:13:17,wahoo,Zwift - MIDWEEK Winter Series by SZR (B),Powertap P1S - Garmin Edge 520,Wahoo KICKR v5 - Zwift,317,317,0
93762,407134,2021-01-09 08:44:46,wahoo,Zwift - DBR SufferDay League III (B),Powertap P1S - Garmin Edge 520,Wahoo KICKR v5 - Zwift,347,353,-6
96400,407134,2021-01-13 17:11:08,wahoo,Zwift - MIDWEEK Winter Series by SZR (B),Powertap P1S - Garmin Edge 520,Wahoo KICKR v5 - Zwift,338,339,-1
98391,407134,2021-01-17 07:39:48,wahoo,Zwift - Team Italy & Frenchy Fuzion Endurance Race (B),Powertap P1S - Garmin Edge 520,Wahoo KICKR v5 - Zwift,318,320,-2
100331,407134,2021-01-20 17:12:27,wahoo,Zwift - MIDWEEK Winter Series by SZR (B),Powertap P1S - Garmin Edge 520,Wahoo KICKR v5 - Zwift,310,309,1
101809,407134,2021-01-23 08:45:31,wahoo,Zwift - DBR SufferDay League III (B),Powertap P1S - Garmin Edge 520,Wahoo KICKR v5 - Zwift,316,315,1
104155,407134,2021-01-27 17:13:11,wahoo,Zwift - MIDWEEK Winter Series by SZR (B),Powertap P1S - Garmin Edge 520,Wahoo KICKR v5 - Zwift,333,332,1
105490,407134,2021-01-30 08:48:17,wahoo,Zwift - DBR SufferDay League III (B),Powertap P1S - Garmin Edge 520,Wahoo KICKR v5 - Zwift,312,313,-1
106106,407134,2021-01-31 09:20:31,wahoo,Zwift - WKG Winter League 2020 / 2021  (B),Powertap P1S - Garmin Edge 520,Wahoo KICKR v5 - Zwift,313,325,-12
108201,407134,2021-02-03 17:15:49,wahoo,Zwift - MIDWEEK Winter Series by SZR (B),Powertap P1S - Garmin Edge 520,Wahoo KICKR v5 - Zwift,303,304,-1
109870,407134,2021-02-06 08:58:53,wahoo,Zwift - DBR SufferDay League III (B),Powertap P1S - Garmin Edge 520,Wahoo KICKR v5 - Zwift,296,300,-4
111497,407134,2021-02-09 16:22:44,wahoo,Zwift - TEAM VEGAN Tofu Tornado (B),Powertap P1S - Garmin Edge 520,Wahoo KICKR v5 - Zwift,313,317,-4
112266,407134,2021-02-10 17:12:04,wahoo,Zwift - MIDWEEK Winter Series by SZR (B),Powertap P1S - Garmin Edge 520,Wahoo KICKR v5 - Zwift,346,341,5
114006,407134,2021-02-13 08:49:46,wahoo,Zwift - DBR SufferDay League III (B),Powertap P1S - Garmin Edge 520,Wahoo KICKR v5 - Zwift,309,312,-3
116653,407134,2021-02-17 16:57:12,wahoo,Zwift - MIDWEEK Winter Series by SZR (B),Powertap P1S - Garmin Edge 520,Wahoo KICKR v5 - Zwift,316,315,1
118169,407134,2021-02-20 08:50:20,wahoo,Zwift - DBR SufferDay League III (B),Powertap P1S - Garmin Edge 520,Wahoo KICKR v5 - Zwift,295,302,-7
118616,407134,2021-02-21 09:17:57,wahoo,Zwift - ZRG-CC Race Day (B),Powertap P1S - Garmin Edge 520,Wahoo KICKR v5 - Zwift,308,318,-10
119660,407134,2021-02-23 17:12:07,wahoo,Zwift - ZESP ,Powertap P1S - Garmin Edge 520,Wahoo KICKR v5 - Zwift,319,322,-3
120306,407134,2021-02-24 17:08:57,wahoo,Zwift - MIDWEEK Winter Series by SZR (B),Powertap P1S - Garmin Edge 520,Wahoo KICKR v5 - Zwift,344,349,-5
121499,407134,2021-02-27 08:49:28,wahoo,Zwift - DBR SufferDay League III (B),Powertap P1S - Garmin Edge 520,Wahoo KICKR v5 - Zwift,322,327,-5
123603,407134,2021-03-03 17:08:22,wahoo,Zwift - Guayaba Race by PETA-Z (B),Powertap P1S - Garmin Edge 520,Wahoo KICKR v5 - Zwift,301,304,-3
124884,407134,2021-03-06 08:49:19,wahoo,Zwift - DBR SufferDay League III (B),Powertap P1S - Garmin Edge 530,Wahoo KICKR v5 - Zwift,327,330,-3
125342,407134,2021-03-07 08:37:53,wahoo,Zwift - Newbury Velo Road Race (B),Powertap P1S - Garmin Edge 530,Wahoo KICKR v5 - Zwift,320,324,-4
126178,407134,2021-03-09 16:48:05,wahoo,Zwift - 3R Volcano KOM After Party Race - 2 laps + climb (40.2km/25mi 286m) (B),Powertap P1S - Garmin Edge 530,Wahoo KICKR v5 - Zwift,299,305,-6
128288,407134,2021-03-14 07:44:46,wahoo,Zwift - Team Italy & Frenchy Fuzion Endurance Race (B),Powertap P1S - Garmin Edge 530,Wahoo KICKR v5 - Zwift,321,327,-6
129272,407134,2021-03-16 17:44:31,wahoo,Zwift - CeramicSpeed Race Series: Open Race (B),Powertap P1S - Garmin Edge 530,Wahoo KICKR v5 - Zwift,315,319,-4
88315,925106,2020-12-28 19:21:01,neo,Zwift - Team TFC Mad Monday Winter Series (B),Vector3,NeoBike,335,344,-9
89148,925106,2020-12-30 18:01:00,neo,Zwift - MIDWEEK Winter Series by SZR (B),Vector3,NeoBike,355,358,-3
89842,925106,2021-01-01 15:30:00,neo,Zwift - BST Mountaingoat Race (B),Vector3,NeoBike,339,346,-7
94913,925106,2021-01-11 17:45:01,neo,Zwift - SCF SWE Cup (A),Vector3,NeoBike,354,356,-2
99026,925106,2021-01-18 17:59:56,neo,Zwift - SZR Evening Joyride,Vector3,NeoBike,339,343,-4
100291,925106,2021-01-20 18:00:02,neo,Zwift - MIDWEEK Winter Series by SZR (A),Vector3,NeoBike,349,355,-6
101848,925106,2021-01-23 13:20:01,neo,Zwift - 3R Innsbruckring Flat Race - 5 Laps (44km/27.3mi 385m) (A),Vector3,NeoBike,346,349,-3
102828,925106,2021-01-25 17:30:00,neo,Zwift -  SCF SWE Cup Men (A),Vector3,NeoBike,361,366,-5
60133,170922,2020-10-07 16:39:26,wahoo,Zwift - DBR HEINO CUP III (A),Assioma,Wahoo kickr 5,352,341,11
61189,170922,2020-10-12 16:47:50,wahoo,Zwift - DBR Ride´N´Roll League (A),Assioma,Wahoo kickr 5,361,345,16
65445,170922,2020-10-27 17:47:07,wahoo,Zwift - Zwift Racing League | WTRL - EMEA E (MEN) -  Division 1 (A),Assioma,Wahoo kickr 5,397,386,11
69756,170922,2020-11-10 18:13:06,wahoo,Zwift - Zwift Racing League | WTRL - EMEA E1 (MEN) -  Division 1 (A),Assioma,Wahoo kickr 5,417,401,16
73156,170922,2020-11-19 18:54:18,wahoo,Zwift - World Championships Experience // Danish Cycling Federation,Assioma,Wahoo kickr 5,385,356,29
74340,170922,2020-11-22 17:55:46,wahoo,Zwift - Watopia,Assioma,Wahoo kickr 5,289,290,-1
75013,170922,2020-11-24 18:11:26,wahoo,Zwift - Zwift Racing League | WTRL - Men&#039;s EMEA E1 DIVISION 1,Assioma,Wahoo kickr 5,426,398,28
75566,170922,2020-11-25 17:51:11,wahoo,Zwift - Watopia,Assioma,Wahoo kickr 5,309,299,10
76072,170922,2020-11-26 18:25:49,wahoo,Zwift - WTRL NOPINZ WORLD TTT CHAMPIONSHIPS - Zone 8 (C),Assioma,Wahoo kickr 5,381,364,17
79385,170922,2020-12-01 17:39:21,wahoo,Zwift - Zwift Racing League | WTRL - Men&#039;s EMEA E1 DIVISION 1 (A),Assioma,Wahoo kickr 5,358,361,-3
80510,170922,2020-12-07 17:39:15,wahoo,Zwift -  DBR Monday Race (A),Assioma,Wahoo kickr 5,380,365,15
81172,170922,2020-12-09 18:12:08,wahoo,Zwift - DBR Wednesday Race (A),Assioma,Wahoo kickr 5,342,340,2
83779,170922,2020-12-15 17:35:41,wahoo,Zwift - Zwift Racing League | WTRL - Men&#039;s EMEA E1 DIVISION 1 (A),Assioma,Wahoo kickr 5,370,361,9
86194,170922,2020-12-22 17:55:34,wahoo,Zwift - UK Armed Forces Cycling Community Race Night (A),Assioma,Wahoo kickr 5,375,370,5
95598,170922,2021-01-12 17:33:33,wahoo,Zwift - GPLAMA - ULTIMATE WARM UP,Assioma,Wahoo kickr 5,375,367,8
97093,170922,2021-01-14 18:06:53,wahoo,Zwift - FUSION WINTER CUP (A),Assioma,Wahoo kickr 5,396,393,3
99695,170922,2021-01-19 17:38:42,wahoo,Zwift - zrl race,Assioma,Wahoo kickr 5,385,374,11
103490,170922,2021-01-26 17:28:30,wahoo,Zwift - Zwift Racing League | WTRL - Men&#039;s/Mixed EMEA E1 DIVISION 1 (A),Assioma,Wahoo kickr 5,401,392,9
107312,170922,2021-02-02 17:29:02,wahoo,Zwift - Zwift Racing League | WTRL - Men&#039;s/Mixed EMEA E1 DIVISION 1 (A),Assioma,Wahoo kickr 5,385,384,1
108219,170922,2021-02-03 17:52:14,wahoo,Zwift - Danmarks Cykle Union & Partners 4/6 (A),Assioma,Wahoo kickr 5,393,393,0
111592,170922,2021-02-09 17:33:10,wahoo,Zwift - Zwift Racing League | WTRL - Men&#039;s/Mixed EMEA E1 DIVISION 1 (A),Assioma,Wahoo kickr 5,400,386,14
115824,170922,2021-02-16 17:42:47,wahoo,Zwift - Zwift Racing League | WTRL - Men&#039;s/Mixed EMEA E1 DIVISION 1 (A),Assioma,Wahoo kickr 5,421,413,8
119571,170922,2021-02-23 17:37:26,wahoo,Zwift - Zwift Racing League | WTRL - Men&#039;s/Mixed EMEA E1 DIVISION 1 (A),Assioma,Wahoo kickr 5,396,385,11
37995,461615,2020-05-27 08:01:59,neo,Zwift - Aussie Crit Crushers Race 1 of 2 (B),stages,tacx neo,339,343,-4
37998,461615,2020-05-27 08:28:36,neo,Aussie Crit Crushers Race 2 of 2 (B),stages,tacx neo,297,301,-4
38264,461615,2020-05-28 11:46:55,neo,TTR Weekly RACE  (B),stages,tacx neo,318,306,12
38499,461615,2020-05-29 07:40:51,neo, Stage 5 Shorter Race A/B,stages,tacx neo,296,296,0
38806,461615,2020-05-31 09:42:32,neo,Stages of DIRT (B)race 1,stages,tacx neo,323,318,5
40149,461615,2020-06-07 09:42:23,neo,Stages of DIRT (B)race 2,stages,tacx neo,319,312,7
41622,461615,2020-06-14 09:42:17,neo,race 3 Stages of DIRT (B),stages,tacx neo,302,307,-5
42946,461615,2020-06-21 09:41:52,neo,stage 4: 6 Stages of DIRT (B),stages,tacx neo,320,323,-3
43915,461615,2020-06-28 09:42:22,neo,stage 5 Stages of DIRT (B),stages,tacx neo,320,313,7
44159,461615,2020-06-30 08:35:11,neo,Morning Mountain Race (A),stages,tacx neo,288,283,5
44789,461615,2020-07-04 08:56:05,neo,L&#039;Etape du Tour Stage 1 (E),stages,tacx neo,307,301,6
44960,461615,2020-07-05 09:42:38,neo,finale Stages of DIRT (B),stages,tacx neo,313,304,9
45883,461615,2020-07-11 06:55:40,neo,L&#039;Etape du Tour Stage 2 (tired),stages,tacx neo,228,219,9
46036,461615,2020-07-12 09:56:27,neo,L&#039;Etape du Tour Stage 2 + mont ventoux climb,stages,tacx neo,291,284,7
46796,461615,2020-07-18 06:56:21,neo,L&#039;Etape du Tour Stage 3 - Open,stages,tacx neo,305,298,7
48492,461615,2020-08-01 06:53:50,neo,100 mls Norseman Festival of Climbing: Race (E),stages,tacx neo,294,298,-4
51221,461615,2020-08-22 10:53:56,neo,TOWER 26 Race Series: 34 Mile Long Course Bike Segment,stages,tacx neo,284,279,5
60555,461615,2020-10-09 10:05:17,neo,bloody dropouts! ZA Road Race #1: 3.2 - 4 w/kg,stages,tacx neo,303,294,9
68151,461615,2020-11-05 15:34:18,neo, ZA Tri: TT Race. - 20k,stages,tacx neo,296,288,8
73647,461615,2020-11-20 18:54:23,neo,Zwift - Race 1 // Men // Z Pro Tri // Community (B),stages,tacx neo,327,324,3
73652,461615,2020-11-20 18:54:23,neo,Zwift - Race 2 // Men // Z Pro Tri // Community (B),stages,tacx neo,327,301,26
75072,461615,2020-11-24 18:34:46,neo,BEAT Series: Road Team Chase Race,stages,tacx neo,306,300,6
114536,461615,2021-02-14 09:33:57,neo,Chasing Cancellara Time Trial 2 (A),stages,tacx neo,293,293,0
116759,461615,2021-02-17 18:54:49,neo,Zwift Duathlon League - Bike,power2max,tacx neo,297,300,-3
120388,461615,2021-02-24 18:54:13,neo,Zwift Duathlon League race 2- Bike (B),power2max,tacx neo,302,301,1
123634,461615,2021-03-03 18:54:22,neo,Zwift Duathlon League - Bike (B),power2max,tacx neo,294,300,-6
126662,461615,2021-03-10 18:49:15,neo, Zwift Duathlon League - Bike (B),power2max,tacx neo,301,301,0
128766,461615,2021-03-15 19:22:17,neo, Aero Army Wyn TT Series (B),power2max,tacx neo,328,321,7
129552,461615,2021-03-17 10:01:51,neo,Zwift Duathlon League race 5- Bike (B),power2max,tacx neo,312,306,6
129698,461615,2021-03-17 17:59:50,neo,2021 Absa Cape Epic Pro/Am Race (C),power2max,tacx neo,284,282,2
82625,928979,2020-12-13 08:19:47,wahoo,Zwift - Team Italy & Frenchy Fuzion Endurance Race (B),Favero Assioma Duo,Wahoo KICKR (main source),342,343,-1
88730,928979,2020-12-29 18:55:23,wahoo,Zwift - Team Italy & Frenchy Fuzion League (B),Favero Assioma Duo,Wahoo KICKR (main source),322,330,-8
90116,928979,2021-01-02 09:29:52,wahoo,Zwift - DBR SufferDay League III (B),Favero Assioma Duo,Wahoo KICKR (main source),379,370,9
93809,928979,2021-01-09 09:29:53,wahoo,Zwift - DBR SufferDay League III (B),Favero Assioma Duo,Wahoo KICKR (main source),383,389,-6
101716,928979,2021-01-23 09:29:49,wahoo,Zwift - DBR SufferDay League III (B),Favero Assioma Duo,Wahoo KICKR (main source),357,354,3
105496,928979,2021-01-30 09:29:40,wahoo,Zwift - DBR SufferDay League III (B),Favero Assioma Duo,Wahoo KICKR (main source),344,346,-2
110328,928979,2021-02-06 09:29:45,wahoo,Zwift - DBR SufferDay League III (B),Favero Assioma Duo,Wahoo KICKR (main source),359,359,0
119885,928979,2021-02-23 19:47:26,wahoo,Zwift - 1 - GPLAMA WARM UP progressif,Assioma Duo,Wahoo KICKR (main source),349,343,6
70112,879561,2020-11-03 19:50:18,wahoo,Zwift - Zwift Racing League | WTRL - Men&#039;s EMEA W1 DIVISION 1 (B),Assioma Duo,Kickr Core,333,330,3
70119,879561,2020-10-27 19:40:41,wahoo,Zwift - Zwift Racing League | WTRL - EMEA W (MEN) -  Division 1 (B),Assioma Duo,Kickr Core,335,319,16
120052,879561,2021-02-23 18:42:34,wahoo,Zwift - Zwift Racing League | WTRL - Men&#039;s/Mixed EMEA W1 DIVISION 1 (B),Assioma Duo,Kickr Core,331,326,5
123357,879561,2021-03-02 18:52:26,wahoo,Zwift - KISS Race Series - EU PM (B),Assioma Duo,Kickr Core,323,330,-7
87762,919526,2020-12-27 07:54:27,wahoo,Zwift - test of scalefactor change to 0.95,4iiii (Scalefactor 0.95) ,Kickr,384,362,22
126591,919526,2021-03-10 15:52:10,wahoo,Zwift - Sydkysten Race (A),Quarq Dzero,Kickr,358,360,-2
127101,919526,2021-03-11 15:38:19,wahoo,Zwift - OH MY CRIT!! - The Double Race 1/2 (A),Quarq Dzero,Kickr,391,390,1
129200,919526,2021-03-16 18:08:32,wahoo,Zwift - CeramicSpeed Race Series: Open Race (A),Quarq Dzero,Kickr,400,393,7
101299,939891,2021-01-22 07:51:18,neo,Zwift - TDZ Stage 4: Longer Ride,ASSIOMA Duo,Tacx Neo,314,316,-2
102268,939891,2021-01-24 09:36:22,neo,Zwift - DBR Sunday Race (A),ASSIOMA Duo,Tacx Neo,314,319,-5
103237,939891,2021-01-26 08:04:01,neo,Zwift - DBR Morning Race (A),ASSIOMA Duo,Tacx Neo,340,340,0
104240,939891,2021-01-27 18:12:11,neo,Zwift - Danmarks Cykle Union & Partners 3/6 (A),ASSIOMA Duo,Tacx Neo,352,352,0
105026,939891,2021-01-29 08:39:02,neo,Zwift - TDZ Stage 6: Shorter Ride,ASSIOMA Duo,Tacx Neo,373,369,4
105559,939891,2021-01-30 09:12:20,neo,Zwift - Watopia,ASSIOMA Duo,Tacx Neo,360,357,3
107125,939891,2021-02-02 08:17:38,neo,Zwift - DBR Morning Race (A),ASSIOMA Duo,Tacx Neo,292,294,-2
108302,939891,2021-02-03 18:17:07,neo,Zwift - Danmarks Cykle Union & Partners 4/6 (A),ASSIOMA Duo,Tacx Neo,362,359,3
109325,939891,2021-02-05 08:57:40,neo,Zwift - TDZ Stage 7: Longer Ride,ASSIOMA Duo,Tacx Neo,314,312,2
110555,939891,2021-02-07 09:19:15,neo,Zwift - DBR Sunday Race (A),ASSIOMA Duo,Tacx Neo,344,344,0
112390,939891,2021-02-10 18:22:22,neo,Zwift - Danmarks Cykle Union & Partners 5/6 (A),ASSIOMA Duo,Tacx Neo,383,387,-4
116789,939891,2021-02-17 18:22:24,neo,Zwift - Danmarks Cykle Union & Partners 6/6 (A),ASSIOMA Duo,Tacx Neo,345,349,-4
123852,939891,2021-03-04 08:14:28,neo,Zwift - KISS Race Series - Down Under (A),ASSIOMA Duo,Tacx Neo,342,341,1
127856,939891,2021-03-13 09:16:09,neo,Zwift - [DBR] Saturday Race (A),ASSIOMA Duo,Tacx Neo,351,352,-1
129229,939891,2021-03-16 18:01:43,neo,Zwift - CeramicSpeed Race Series: Open Race (A),ASSIOMA Duo,Tacx Neo,328,328,0
14369,952363,2020-02-17 16:34:53,neo,Zwift - Test Puissance,Favero Assioma,Tacx Neo 1,265,250,15
14508,952363,2020-02-18 16:09:12,neo,Zwift - Watopia - Test Puissance 2 - Free Ride,Favero Assioma Duo,Tacx Neo 1,282,268,14
71807,823265,2020-11-15 22:45:40,wahoo,Zwift - France,Stages,Kickr Core,197,193,4
117998,560685,2021-02-19 23:03:32,wahoo,Zwift - 02/19/2021,stages PM,wahoo kickr,302,310,-8
119913,560685,2021-02-24 00:28:49,wahoo,Zwift - Zwift Racing League | WTRL - Women&#039;s AMERICAS E DIVISION 1 (A),stages PM,wahoo kickr,287,287,0
123237,560685,2021-03-03 00:34:45,wahoo,Zwift - Zwift Racing League | WTRL - Women&#039;s AMERICAS E DIVISION 1 (A),stages PM,wahoo kickr,279,278,1
125095,560685,2021-03-06 18:03:16,wahoo,Zwift - The Iceni Women&#039;s Series  (E),stages PM,wahoo kickr,284,285,-1
126336,560685,2021-03-10 00:21:35,wahoo,Zwift - NoBreakaways 6 vs 6 Match Race (E),stages PM,wahoo kickr,299,303,-4
128099,560685,2021-03-13 17:59:51,wahoo,Zwift - The Iceni Women&#039;s Series (A),stages PM,wahoo kickr,283,294,-11
50766,885598,2020-08-11 18:39:57,wahoo,Zwift - 3R Turbocharged Team Race Series - Round 5 (A),Favero Assioma Duo (secondary),Wahoo Kickr 2018 (primary),367,369,-2
51322,885598,2020-08-22 14:14:59,wahoo,Zwift - OH MY CRIT - Saturday Smash Race* (A),Favero Assioma Duo (primary),Wahoo Kickr 2018 (secondary),315,314,1
55119,885598,2020-09-14 18:00:01,wahoo,Zwift - Invitational League // Qualifying Race #1,Favero Assioma Duo (secondary),Wahoo Kickr 2018 (primary),372,356,16
55630,885598,2020-09-16 18:13:35,wahoo,Zwift - Deeside Thistle and Moray Firth Race (A),Favero Assioma Duo (primary),Wahoo Kickr 2018 (secondary),310,309,1
55631,885598,2020-09-15 18:43:59,wahoo,Zwift - 3R Sundown Race Series  (E),Favero Assioma Duo (primary),Wahoo Kickr 2018 (secondary),329,332,-3
57914,885598,2020-09-27 08:05:21,wahoo,Zwift - Erik Haugen [R3R]&#039;s Meetup - Three Sisters,Favero Assioma Duo (secondary),Wahoo Kickr 2018 (primary),331,316,15
59038,885598,2020-10-02 10:05:02,wahoo,Zwift - 3R Innsbruckring Flat Race - 4 Laps (35.2km/21.9mi 308m) (A),Favero Assioma Duo (secondary),Wahoo Kickr 2018 (primary),324,329,-5
87962,885598,2020-09-27 08:05:21,wahoo,Zwift - Three Sisters - Zada 27.9.2020,Favero Assioma Duo (secondary),Wahoo Kickr 2018 (primary),331,316,15
94588,885598,2021-01-10 18:14:58,wahoo,Zwift - 3R Watopia Hilly Reverse Race - 4 Laps (36.7km/22.8mi 400m) (A),Favero Assioma Duo (secondary),Wahoo Kickr 2018 (primary),314,314,0
95087,885598,2021-01-11 19:14:55,wahoo,Zwift - Premier Division // Zwift Racing League (men) (A),Favero Assioma Duo (secondary),Wahoo Kickr 2018 (primary),315,290,25
102955,885598,2021-01-25 19:04:58,wahoo,Zwift - Premier Division // Zwift Racing League (men) (A),Favero Assioma Duo (secondary),Wahoo Kickr 2018 (primary),342,349,-7
118797,885598,2021-02-20 09:04:59,wahoo,Zwift - 3R Endurance Series p/b OTE Sports- Stage 1 (E),Favero Assioma Duo (secondary),Wahoo Kickr 2018 (primary),304,305,-1
119152,885598,2021-02-22 19:09:59,wahoo,Zwift - Premier Division // Zwift Racing League (men) (A),Favero Assioma Duo (secondary),Wahoo Kickr 2018 (primary),347,349,-2
112622,797113,2021-02-10 18:46:13,neo,Zwift - Danmarks Cykle Union & Partners 5/6 (B),tacx neo,tacx neo,360,360,0
69176,933861,2020-11-08 18:51:08,wahoo,Zwift - The Alpe Dash by Herd Racing League (A),4iiii,Kickr 2018,333,330,3
69902,933861,2020-11-10 19:32:12,wahoo,Zwift - Zwift Racing League | WTRL - EMEA W1 (MEN) -  Division 2 (A),4iiii,Kickr 2018,377,379,-2
72629,933861,2020-11-17 19:42:37,wahoo,Zwift - Zwift Racing League | WTRL - Men&#039;s EMEA W1 DIVISION 2 (A),4iiii,Kickr 2018,322,323,-1
72632,933861,2020-11-18 17:51:38,wahoo,Zwift - MIDWEEK Autumn Series by SZR (A),4iiii,Kickr 2018,356,350,6
76242,933861,2020-11-26 18:33:54,wahoo,Zwift - WTRL NOPINZ WORLD TTT CHAMPIONSHIPS - Zone 8 (C),Evening_Ride (3),Kickr 2018,343,346,-3
80534,933861,2020-12-07 19:24:07,wahoo,Zwift - TugaZ Epic Recovery Ride  (D),4iiii,Kickr 2018,203,198,5
80934,933861,2020-12-08 19:35:45,wahoo,Zwift - Zwift Racing League | WTRL - Men&#039;s EMEA W1 DIVISION 2 (A),4iiii,Kickr 2018,345,330,15
119649,933861,2021-02-23 18:09:02,wahoo,Zwift - Zwift Racing League | WTRL - Men&#039;s/Mixed EMEA E2 DIVISION 5 (A),4iiii,Kickr 2018,325,324,1
126780,948550,2021-03-10 23:41:45,wahoo,One Hundred Eighty ONE! - France,Stages,Kickr,202,206,-4
128195,948550,2021-03-13 23:04:52,wahoo,Test James Pedals,James&#039; Pedals,Kickr,174,175,-1
62390,883972,2020-10-16 09:28:41,wahoo,Zwift - Watopia 3 Sisters,Garmin,Kickr,304,313,-9
65140,883972,2020-10-26 18:47:18,wahoo,Kickr / Garmin,Garmin,Kickr,304,308,-4
95205,883972,2021-01-11 19:54:04,wahoo,Zwift - Premier Division // Zwift Racing League (women) (A),Garmin,Kickr,328,319,9
99121,883972,2021-01-18 19:05:00,wahoo,Zwift - Premier Division // Zwift Racing League (women) (A),Garmin,Kickr,302,306,-4
103325,883972,2021-01-26 11:21:53,wahoo,Watopia 3 Sisters,Garmin single sided,Kickr,329,321,8
106826,883972,2021-02-01 18:56:16,wahoo,Zwift - Premier Division // Zwift Racing League (women) (A),Garmin single sided,Kickr,327,315,12
111130,883972,2021-02-08 19:54:00,wahoo,Zwift - Premier Division // Zwift Racing League (women) (A),Garmin single sided,Kickr,325,323,2
119226,883972,2021-02-22 19:58:40,wahoo,Zwift - Premier Division // Zwift Racing League (women) (A),Garmin single sided,Kickr,304,304,0
122492,883972,2021-03-01 19:06:59,wahoo,Zwift - Premier Division // Zwift Racing League (women) (A),Garmin single sided,Kickr,306,298,8
33171,939425,2020-05-10 08:29:46,wahoo,Zwift - dPAC.fit Climbers Day (A),New 4iiii,Wahoo Kickr core,355,359,-4
33993,939425,2020-05-12 17:40:13,wahoo,Zwift - Ivy APR&#039;s Meetup - Greater London 8,New 4iiii,Wahoo Kickr core,382,391,-9
34633,939425,2020-05-14 10:20:30,wahoo,Zwift - ZADA 3 Sisters test,New 4iiii,Wahoo Kickr core,349,364,-15
36693,939425,2020-05-21 17:48:12,wahoo,Zwift - Tour for All Invitational Race // Men (A),New 4iiii,Wahoo Kickr core,376,380,-4
38357,939425,2020-05-28 17:37:13,wahoo,Zwift - Tour for All Invitational Race // Men (A),New 4iiii,Wahoo Kickr core,357,371,-14
79837,939425,2020-12-05 16:21:23,wahoo,Zwift - TEAM VEGAN Tofu Tornado (A),New 4iiii,Wahoo Kickr core,370,372,-2
80021,939425,2020-12-06 08:57:46,wahoo,Zwift - 3R Watopia Road To Sky - 1 Lap (A),New 4iiii,Wahoo Kickr core,324,330,-6
84993,939425,2020-12-19 10:14:00,wahoo,Zwift - 3R Volcano Climb Race - 1 Lap (22.4km/14mi 204m) (A),New 4iiii,Wahoo Kickr core,348,362,-14
91558,939425,2021-01-05 08:49:23,wahoo,Zwift - 3R Whole Lotta Lava Hilly Race - 2 Laps (28.9km/12.53mi 336m) (A),New 4iiii,Wahoo Kickr core,345,351,-6
95646,939425,2021-01-12 18:03:09,wahoo,Zwift - Zwift Racing League | WTRL - Men&#039;s/Mixed EMEA E2 DIVISION 1 (A),New 4iiii,Wahoo Kickr core,381,388,-7
97328,954385,2021-01-14 18:50:10,neo,Zwift - BENELIGA 2020-2021 (E),4iiii left crank,Neo 1,419,391,28
97349,954385,2021-01-07 18:39:07,neo,Zwift - BENELIGA 2020-2021 (E),4iiii left crank,Neo 1,365,343,22
102806,954385,2021-01-21 19:01:23,neo,Zwift - The BZR Ronde Watopian League (B),4IIII left crank,Neo 1,392,380,12
116415,900666,2021-02-17 10:44:58,wahoo,Zwift - The Morning Grind by STPC (A),Stages L,Wahoo Kickr,398,410,-12
117641,900666,2021-02-19 10:04:58,wahoo,Zwift - 3R Innsbruckring Flat Race - 4 Laps (35.2km/21.9mi 308m) (A),Stages L,Wahoo Kickr,412,415,-3
122162,900666,2021-02-28 18:14:58,wahoo,Zwift - 3R Watopia Hilly Reverse Race - 4 Laps (36.7km/22.8mi 400m) (A),Giant Power Pro Ultegra 2021,Wahoo Kickr,347,335,12
125041,900666,2021-03-06 15:15:16,wahoo,Zwift - OH MY CRIT!! - Saturday Smash Race (A),Giant Power Pro Ultegra 2021,Wahoo Kickr,388,381,7
126974,900666,2021-03-11 16:14:59,wahoo,Zwift - OH MY CRIT!! - The Double Race 1/2 (A),Giant Power Pro Ultegra 2021,Wahoo Kickr,383,377,6
50757,846846,2020-08-19 18:14:48,wahoo,Zwift - Matt Smith (B)&#039;s Meetup - Douce France,Powertap Pedals,Wahoo Kickr,345,344,1
51231,846846,2020-08-22 13:01:00,wahoo,Zwift - Off The MAAP Stage 3 - Shorter Ride,Powertap Pedal&#039;s,Wahoo Kickr,319,319,0
51660,846846,2020-08-25 13:00:50,wahoo,Zwift - Off The MAAP Stage 4 - Longer Ride,Powertap Pedal&#039;s,Wahoo Kickr,310,315,-5
51893,846846,2020-08-25 19:49:59,wahoo,Zwift - AHDR Bacon Rolls with Caffeine  (B),Powertap Pedal&#039;s,Wahoo Kickr,285,287,-2
53124,846846,2020-09-02 18:40:00,wahoo,Zwift - ZHR Hare & Hounds Race (B),Powertap Pedal&#039;s,Wahoo Kickr,324,328,-4
56849,846846,2020-09-22 18:40:44,wahoo,Zwift - 3R Sundown Race Series  (B),Powertap Pedal&#039;s,Wahoo Kickr,324,331,-7
25343,888062,2020-04-16 21:14:28,wahoo,Zwift - The Gorby,Stages LR,Kickr Core,235,235,0
25344,888062,2020-04-16 21:14:24,wahoo,Zwift - The Gorby,Stages LR,Kickr Core,234,235,-1
25354,888062,2020-04-16 21:47:44,wahoo,Zwift - Ramp Test,Stages LR,Kickr Core,249,248,1
25689,888062,2020-04-18 00:15:02,wahoo,Zwift - The Cauberg Royal Classic Mens Workout,Stages LR,Kickr Core,214,213,1
62872,888062,2020-10-18 14:01:01,wahoo,Zwift - ZA Road 2020 - Segment Ride #1: London Course,Stages Left,Kickr Core,242,257,-15
70940,888062,2020-11-13 00:00:02,wahoo,Zwift - ZA Road Group Ride (B),Assioma Uno,Kickr Core,236,229,7
100175,888062,2021-01-19 23:02:23,wahoo,Zwift - TDZ Stage 4: Standard Ride,Quarq,Kickr Core,264,264,0
100176,888062,2021-01-19 23:01:59,wahoo,Zwift - TDZ Stage 4: Standard Ride,Quarq,Kickr Core,270,264,6
118833,888062,2021-02-21 18:45:00,wahoo,Zwift - The Alpe Dash by Herd Racing League (B),Quarq,Kickr Core,252,245,7
108924,969039,2021-02-04 19:19:47,wahoo,Zwift - BRT Criterium Racing League (B),Assioma duo,Wahoo kickr,340,326,14
110310,969039,2021-02-07 09:30:57,wahoo,Zwift - Zwift Fondo Series: Bambino Fondo,Assioma duo,Wahoo kickr,308,303,5
111644,969039,2021-02-09 18:32:17,wahoo,Zwift - Zwift Racing League | WTRL - Men&#039;s/Mixed EMEA E2 DIVISION 2 (B),Assioma duo,Wahoo kickr,324,319,5
22360,905844,2020-04-05 18:05:49,wahoo,Zwift - Yorkshire Grand Prix // Zwift Classic,S-Works Dual Sided Power Cranks,Wahoo Kickr 2017,194,193,1
24397,905844,2020-04-13 18:07:34,wahoo,Zwift - Trofeo Bologna // Zwift Classic (A),S-Works Dual Sided Power Cranks,Wahoo Kickr 2017,209,205,4
34021,905844,2020-05-12 18:15:01,wahoo,Zwift - Zwift NL - Easy roll - Rustig aan! (D),S-Works Dual Sided Power Cranks,Wahoo Kickr 2017,131,130,1
36242,905844,2020-05-19 18:12:58,wahoo,Zwift - Tour for All Invitational Race // Women (A),S-Works Dual Sided Power Cranks,Wahoo Kickr 2017,197,206,-9
37862,905844,2020-05-26 18:15:59,wahoo,Zwift - Tour for All Invitational Race // Women (A),S-Works Dual Sided Power Cranks,Wahoo Kickr 2017,194,189,5
40414,905844,2020-06-09 00:55:01,wahoo,ZADA - Three Sisters ,S-Works Dual Sided Power Cranks,Wahoo Kickr 2017,209,205,4
55814,905844,2020-09-17 17:56:45,wahoo,Zwift - Invitational League // Qualifying Race #2 (Women) (A),S-Works Dual Sided Power Cranks,Wahoo Kickr 2017,210,201,9
61230,905844,2020-10-12 17:42:45,wahoo,Zwift - Premier Division // Zwift Racing League (women) (A),S-Works Dual Sided Power Cranks,Wahoo Kickr 2017,195,186,9
63223,905844,2020-10-19 18:56:36,wahoo,Zwift - Premier Division // Zwift Racing League (women) (A),S-Works Dual Sided Power Cranks,Wahoo Kickr 2017,198,182,16
69522,905844,2020-11-09 19:04:33,wahoo,Zwift - Premier Division // Zwift Racing League (women) (A),S-Works Dual Sided Power Cranks,Wahoo Kickr 2017,213,202,11
119608,866501,2021-02-23 18:30:52,wahoo,Zwift - Zwift Racing League | WTRL - Men&#039;s/Mixed EMEA E2 DIVISION 8 (B),assioma duo,wahoo kickr,304,305,-1
6868,955487,2019-12-20 18:10:01,wahoo,3R Lutscher CCW Climbing Race - 1 Lap (22.1km/13.9mi 827m),Stages XTR 2gen,Kickr Core,437,433,4
7187,955487,2019-12-24 10:20:01,wahoo,Eat,Stages XTR 2gen,Kickr Core,478,464,14
7413,955487,2019-12-27 15:14:59,wahoo,3R,Stages XTR 2gen,Kickr Core,389,395,-6
7467,955487,2019-12-28 09:15:05,wahoo,ZHR Audax 100km,Stages XTR 2gen,Kickr Core,404,408,-4
7575,955487,2019-12-29 14:15:00,wahoo,KISS,Stages XTR 2gen,Kickr Core,380,381,-1
7644,955487,2019-12-30 13:15:16,wahoo,Magnum,Stages XTR 2gen,Kickr Core,435,436,-1
7725,955487,2019-12-31 11:29:59,wahoo,3R Volcano,Stages XTR 2gen,Kickr Core,408,415,-7
7974,955487,2020-01-03 14:44:59,wahoo,Crit City Race,Stages XTR 2gen,Kickr Core,452,454,-2
7976,955487,2020-01-03 15:15:07,wahoo,3R Sand,Stages XTR 2gen,Kickr Core,411,412,-1
8305,955487,2020-01-07 17:59:59,wahoo,ZRG,Stages XTR 2gen,Kickr Core,394,393,1
8322,955487,2020-01-07 19:00:09,wahoo,ZTPL,Stages XTR 2gen,Kickr Core,438,438,0
8756,955487,2020-01-10 16:05:01,wahoo,3R,Stages XTR 2gen,Kickr Core,393,397,-4
9350,955487,2020-01-14 18:59:43,wahoo,ZTPL,Stages XTR 2gen,Kickr Core,429,428,1
9518,955487,2020-01-15 18:59:56,wahoo,Fiets,Stages XTR 2gen,Kickr Core,466,465,1
9794,955487,2020-01-17 15:14:56,wahoo,3R Sand,Stages XTR 2gen,Kickr Core,403,400,3
10286,955487,2020-01-21 18:59:59,wahoo,ZTPL,Stages 2 gen XTR,Kickr Core,460,452,8
10520,955487,2020-01-22 18:59:57,wahoo,Fiets,Stages XTR 2gen,Kickr Core,407,413,-6
10773,955487,2020-01-24 14:44:56,wahoo,Crit,Stages XTR 2gen,Kickr Core,366,369,-3
10774,955487,2020-01-24 15:14:59,wahoo,3R Sand,Stages XTR 2gen,Kickr Core,371,371,0
10915,955487,2020-01-25 17:20:12,wahoo,EVR,Stages XTR 2gen,Kickr Core,355,361,-6
11057,955487,2020-01-26 14:14:56,wahoo,KISS,Stages XTR 2gen,Kickr Core,475,473,2
11360,955487,2020-01-28 18:59:56,wahoo,Pl league,Stages XTR 2gen,Kickr Core,419,440,-21
11663,955487,2020-01-30 16:14:57,wahoo,OH crit,Stages XTR 2gen,Kickr Core,430,437,-7
11680,955487,2020-01-30 17:04:56,wahoo,OH crit,Stages XTR 2gen,Kickr Core,403,413,-10
12007,955487,2020-02-01 13:44:58,wahoo,Stages XTR 2gen / Kickr Core,Stages XTR 2gen,Kickr Core,468,468,0
12251,955487,2020-02-03 15:15:46,wahoo,3R,Stages XTR 2gen,Kickr Core,430,436,-6
12255,955487,2020-02-03 16:04:57,wahoo,Harrogate,Stages XTR 2gen,Kickr Core,387,389,-2
12642,955487,2020-02-05 18:59:55,wahoo,Knwu,Stages XTR 2gen,Kickr Core,361,353,8
12741,955487,2020-02-06 16:14:57,wahoo,OH crit,Stages XTR 2gen,Kickr Core,370,371,-1
12912,955487,2020-02-07 17:30:58,wahoo,Tdz,Stages XTR 2gen,Kickr Core,424,431,-7
12921,955487,2020-02-07 18:04:54,wahoo,Kirchmair,Stages XTR 2gen,Kickr Core,437,437,0
12925,955487,2020-02-07 18:34:54,wahoo,Kiechmair,Stages XTR 2gen,Kickr Core,383,390,-7
13427,955487,2020-02-11 18:59:57,wahoo,ZwiftTeamPl,Stages XTR 2gen,Kickr Core,442,426,16
13549,955487,2020-02-12 13:09:54,wahoo,Tour de Zwift3,Stages XTR 2gen,Kickr Core,375,380,-5
13687,955487,2020-02-13 16:14:58,wahoo,OH Crit 1,Stages XTR 2gen,Kickr Core,492,495,-3
13689,955487,2020-02-13 17:05:07,wahoo,Oh Crit 2,Stages XTR 2gen,Kickr Core,413,419,-6
13745,955487,2020-02-13 18:59:58,wahoo,Stages XTR 2gen / Kickr Core,Stages XTR 2gen,Kickr Core,454,453,1
13940,955487,2020-02-14 15:09:55,wahoo,Tour de Zwift,Stages XTR 2gen,Kickr Core,384,386,-2
14245,955487,2020-02-16 14:59:57,wahoo,ZHR ,Stages XTR 2gen,Kickr Core,459,456,3
14462,955487,2020-02-18 10:19:56,wahoo,Eat the Pain,Stages XTR 2gen,Kickr Core,488,488,0
14552,955487,2020-02-18 19:00:00,wahoo,Zwift Team Pl,Stages XTR 2gen,Kickr Core,468,467,1
14898,955487,2020-02-20 17:05:10,wahoo,OH Crit 2,Stages XTR 2gen,Kickr Core,369,374,-5
14899,955487,2020-02-20 16:15:00,wahoo,OH Crit 1,Stages XTR 2gen,Kickr Core,391,394,-3
16345,955487,2020-03-01 13:59:53,wahoo,Zwift - Zwift Gran Fondo,Stages XTR 2gen,Kickr Core,405,408,-3
16452,955487,2020-03-02 13:14:56,wahoo,Magnum,Stages XTR 2gen,Kickr Core,459,448,11
16581,955487,2020-03-03 13:34:56,wahoo,Crit,Stages XTR 2gen,Kickr Core,424,439,-15
16584,955487,2020-03-03 14:05:19,wahoo,3R,Stages XTR 2gen,Kickr Core,488,511,-23
16645,955487,2020-03-03 18:59:58,wahoo,ZwiftTeamPl,Stages XTR 2gen,Kickr Core,425,421,4
17158,955487,2020-03-07 13:44:54,wahoo,WTRL Winter,Stages XTR 2gen,Kickr Core,401,405,-4
17553,955487,2020-03-10 19:00:00,wahoo,Team Pl,Stages XTR 2gen,Kickr Core,451,457,-6
17693,955487,2020-03-11 18:10:01,wahoo,Stage 1,Stages XTR 2gen,Kickr Core,392,397,-5
17800,955487,2020-03-12 16:09:59,wahoo,Stage 1 race,Stages XTR 2gen,Kickr Core,369,377,-8
18168,955487,2020-03-15 13:15:56,wahoo,KISS ,Stages XTR 2gen,Kickr Core,395,402,-7
18390,955487,2020-03-17 13:00:12,wahoo,Stage 3 Tour,Stages XTR 2gen,Kickr Core,400,399,1
18603,955487,2020-03-18 19:04:55,wahoo,Dbr,Stages XTR 2gen,Kickr Core,397,406,-9
18892,955487,2020-03-20 18:09:57,wahoo,3r,Stages XTR 2gen,Kickr Core,438,437,1
18960,955487,2020-03-21 08:34:58,wahoo,ZTPL,Stages XTR 2gen,Kickr Core,443,449,-6
19489,955487,2020-03-24 18:34:58,wahoo,ZTPL stage 2,Stages XTR 2gen,Kickr Core,505,505,0
19790,955487,2020-03-26 18:34:57,wahoo,ZTPL 3,Stages XTR 2gen,Kickr Core,452,452,0
20457,955487,2020-03-29 17:19:55,wahoo,3R London,Stages XTR 2gen,Kickr Core,479,482,-3
20867,955487,2020-03-31 17:34:56,wahoo,ZTPL 5,Stages XTR 2gen,Kickr Core,402,413,-11
21152,955487,2020-04-01 16:50:01,wahoo,Team Italy,Stages XTR 2gen,Kickr Core,464,467,-3
21477,955487,2020-04-02 17:35:01,wahoo,ZTPL 6,Stages XTR 2gen,Kickr Core,493,502,-9
21934,955487,2020-04-04 07:34:57,wahoo,ZTPL 7,Stages XTR 2gen,Kickr Core,442,441,1
23533,955487,2020-04-10 15:15:00,wahoo,3R Sand,Stages XTR 2gen,Kickr Core,416,413,3
23654,955487,2020-04-11 07:34:55,wahoo,ZTPL 1,Stages XTR 2gen,Kickr Core,462,466,-4
24034,955487,2020-04-12 13:14:59,wahoo,KISS,Stages XTR 2gen,Kickr Core,422,421,1
24601,955487,2020-04-14 17:34:54,wahoo,Ztpl 2,Stages XTR 2gen,Kickr Core,511,512,-1
24890,955487,2020-04-15 16:59:55,wahoo,Swedish,Stages XTR 2gen,Kickr Core,457,454,3
24927,955487,2020-04-15 17:54:55,wahoo,Usa,Stages XTR 2gen,Kickr Core,419,414,5
25216,955487,2020-04-16 16:04:56,wahoo,OH Crit ,Stages XTR 2gen,Kickr Core,461,462,-1
25759,955487,2020-04-18 07:34:55,wahoo,Ztpl 4,Stages XTR 2gen,Kickr Core,451,441,10
25869,955487,2020-04-18 14:14:56,wahoo,OH Crit ,Stages XTR 2gen,Kickr Core,453,453,0
26712,955487,2020-04-21 17:34:58,wahoo,Ztpl 5,Stages XTR 2gen,Kickr Core,422,420,2
27025,955487,2020-04-22 17:54:56,wahoo,Usc cycling,Stages XTR 2gen,Kickr Core,474,466,8
27338,955487,2020-04-23 16:04:58,wahoo,OH crit,Stages XTR 2gen,Kickr Core,406,410,-4
27378,955487,2020-04-23 17:34:55,wahoo,ZTPL 6,Stages XTR 2gen,Kickr Core,420,418,2
27835,955487,2020-04-25 07:34:55,wahoo,ZTPL 7,Stages XTR 2gen,Kickr Core,443,444,-1
30977,955487,2020-05-03 13:14:56,wahoo,Kiss,Stages XTR 2gen,Kickr Core,494,490,4
31239,955487,2020-05-04 14:14:56,wahoo,3R,Stages XTR 2gen,Kickr Core,425,423,2
31241,955487,2020-05-04 13:09:57,wahoo,Tour for all,Stages XTR 2gen,Kickr Core,390,392,-2
31688,955487,2020-05-05 17:14:56,wahoo,ZESP Hamster,Stages XTR 2gen,Kickr Core,436,430,6
32055,955487,2020-05-06 17:00:02,wahoo,Swedish,Stages XTR 2gen,Kickr Core,486,483,3
32440,955487,2020-05-07 16:39:56,wahoo,Tour,Stages XTR 2gen,Kickr Core,371,364,7
32443,955487,2020-05-07 16:04:55,wahoo,OH Crit 2,Stages XTR 2gen,Kickr Core,363,368,-5
32444,955487,2020-05-07 15:14:56,wahoo,OH Crit 1,Stages 2 gen XTR,Kickr Core,410,411,-1
32740,955487,2020-05-08 14:04:56,wahoo,3R,Stages XTR 2gen,Kickr Core,438,437,1
32741,955487,2020-05-08 13:09:55,wahoo,Tour 2,Stages XTR 2gen,Kickr Core,465,461,4
32905,955487,2020-05-09 08:59:56,wahoo,Eurosport,Stages XTR 2gen,Kickr Core,527,525,2
33272,955487,2020-05-10 10:30:13,wahoo,Mgcc,Stages XTR 2gen,Kickr Core,430,422,8
33606,955487,2020-05-11 14:14:54,wahoo,3R,Stages XTR 2gen,Kickr Core,364,363,1
33607,955487,2020-05-11 13:09:57,wahoo,Tour 2,Stages XTR 2gen,Kickr Core,443,440,3
33926,955487,2020-05-12 15:04:54,wahoo,3R wahoo,Stages XTR 2gen,Kickr Core,381,381,0
34313,955487,2020-05-13 14:59:56,wahoo,Crit,Stages XTR 2gen,Kickr Core,442,436,6
34357,955487,2020-05-13 16:59:55,wahoo,Swedish,Stages XTR 2gen,Kickr Core,402,399,3
34700,955487,2020-05-14 16:04:54,wahoo,OH Crit 2,Stages XTR 2gen,Kickr Core,450,449,1
34702,955487,2020-05-14 15:14:55,wahoo,OH Crit 1,Stages XTR 2gen,Kickr Core,437,437,0
35237,955487,2020-05-16 08:59:53,wahoo,EuroSport 2,Stages XTR 2gen,Kickr Core,478,475,3
36038,955487,2020-05-19 15:04:53,wahoo,3R Wahoo,Stages XTR 2gen,Kickr Core,451,447,4
36393,955487,2020-05-20 16:09:55,wahoo,Tour 5,Stages XTR 2gen,Kickr Core,488,486,2
36886,955487,2020-05-22 16:00:15,wahoo,ZTPL 2 base,Stages XTR 2gen,Kickr Core,347,349,-2
37001,955487,2020-05-23 08:59:53,wahoo,EuroSport 3,Stages XTR 2gen,Kickr Core,424,411,13
37602,955487,2020-05-25 13:04:54,wahoo,Tour 1,Stages XTR 2gen,Kickr Core,346,343,3
37808,955487,2020-05-26 14:44:55,wahoo,Tour 5,Stages XTR 2gen,Kickr Core,483,478,5
38304,955487,2020-05-28 15:05:09,wahoo,Tour 1,Stages XTR 2gen,Kickr Core,350,356,-6
38317,955487,2020-05-28 16:29:59,wahoo,Otakam ,Stages XTR 2gen,Kickr Core,484,479,5
38649,955487,2020-05-30 08:59:53,wahoo,EuroSport 4,Stages XTR 2gen,Kickr Core,496,487,9
38834,955487,2020-05-31 13:59:54,wahoo,ZHR ,Stages XTR 2gen,Kickr Core,428,431,-3
57228,955487,2020-09-24 15:15:03,wahoo,OH Crit 1,Stages XTR 2gen,Kickr Core,425,432,-7
57238,955487,2020-09-24 16:05:00,wahoo,OH Crit 2,Stages XTR 2gen,Kickr Core,360,358,2
57495,955487,2020-09-25 15:14:59,wahoo,3R Sand,Stages XTR 2gen,Kickr Core,455,459,-4
57521,955487,2020-09-25 17:00:01,wahoo,Kirchmair race 1,Stages XTR 2gen,Kickr Core,422,429,-7
57523,955487,2020-09-25 17:29:58,wahoo,Kirchmair race 2,Stages XTR 2gen,Kickr Core,418,428,-10
57722,955487,2020-09-26 13:59:59,wahoo,XRS Race,Stages XTR 2gen,Kickr Core,417,416,1
57751,955487,2020-09-26 15:29:58,wahoo, Vegan tofu,Stages XTR 2gen,Kickr Core,424,423,1
58032,955487,2020-09-28 12:39:58,wahoo,3r volcano Climb ,Stages XTR 2gen,Kickr Core,446,436,10
58033,955487,2020-09-28 15:15:50,wahoo,3r volcano sprint,Stages XTR 2gen,Kickr Core,389,390,-1
58267,955487,2020-09-29 15:05:02,wahoo,3r sundown,Stages XTR 2gen,Kickr Core,403,409,-6
58488,955487,2020-09-30 14:34:58,wahoo,3r sand,Stages XTR 2gen,Kickr Core,381,380,1
58497,955487,2020-09-30 16:09:59,wahoo,3r tick tok,Stages XTR 2gen,Kickr Core,403,399,4
58782,955487,2020-10-01 15:14:59,wahoo,OH Crit 1,Stages XTR 2gen,Kickr Core,380,370,10
58786,955487,2020-10-01 16:04:57,wahoo,OH Crit 2,Stages XTR 2gen,Kickr Core,372,372,0
59265,955487,2020-10-03 14:14:58,wahoo,OH Crit Saturday,Stages XTR 2gen,Kickr Core,462,452,10
59440,955487,2020-10-04 13:14:59,wahoo,KISS 100,Stages XTR 2gen,Kickr Core,354,365,-11
59572,955487,2020-10-05 12:39:59,wahoo,Zwift - 3R Volcano Climb Race - 1 Lap (22.4km/14mi 204m) (A),Stages XTR 2gen,Kickr Core,438,445,-7
59858,955487,2020-10-06 17:40:58,wahoo,Zwift - UK Armed Forces Cycling Community Race Night (A),Stages XTR 2gen,Kickr Core,363,371,-8
59859,955487,2020-10-06 16:29:59,wahoo,Zwift - ZHR Masters Europe (A),Stages XTR 2gen,Kickr Core,385,390,-5
60092,955487,2020-10-07 16:29:59,wahoo,Evo cc ,Stages XTR 2gen,Kickr Core,355,360,-5
60094,955487,2020-10-07 16:59:59,wahoo,Zwift - MIDWEEK Autumn Series by SZR (A),Stages XTR 2gen,Kickr Core,405,419,-14
60355,955487,2020-10-08 16:05:00,wahoo,Zwift - OH MY CRIT! - The Double Race 2/2 (A),Stages XTR 2gen,Kickr Core,419,419,0
60611,955487,2020-10-09 16:59:59,wahoo,Zwift - KIRCHMAIR Race Series (A),Stages XTR 2gen,Kickr Core,401,405,-4
60613,955487,2020-10-09 17:30:00,wahoo,Kirchmair 2,Stages XTR 2gen,Kickr Core,358,358,0
60822,955487,2020-10-10 14:14:59,wahoo,Zwift - OH MY CRIT - Saturday Smash Race (A),Stages XTR 2gen,Kickr Core,373,390,-17
61149,955487,2020-10-12 14:14:58,wahoo,Zwift - 3R Classique Reverse Flat Race - 5 Laps (32km/20.1mi 76m) (A),Stages XTR 2gen,Kickr Core,382,372,10
61522,955487,2020-10-13 16:29:59,wahoo,Zwift - ZHR Masters Europe (A),Stages XTR 2gen,Kickr Core,419,417,2
61540,955487,2020-10-13 17:30:00,wahoo,Zwift - ZTPL.CC Season Warm Up Race,Stages XTR 2gen,Kickr Core,373,384,-11
61917,955487,2020-10-14 17:00:00,wahoo,MIDWEQE,Stages XTR 2gen,Kickr Core,436,439,-3
62132,955487,2020-10-15 16:05:00,wahoo,Zwift - OH MY CRIT! - The Double Race 2/2 (A),Stages XTR 2gen,Kickr Core,394,387,7
62134,955487,2020-10-15 14:09:58,wahoo,Zwift - ZA Road Race #1: 4 - 5 w/kg,Stages XTR 2gen,Kickr Core,396,395,1
62482,955487,2020-10-16 17:04:59,wahoo,Zwift - Team WEZ Friday Race (A),Stages XTR 2gen,Kickr Core,404,406,-2
63470,955487,2020-10-20 17:29:59,wahoo,Zwift - ZTPL.CC Season Warm Up Race,Stages XTR 2gen,Kickr Core,395,395,0
63811,955487,2020-10-21 16:59:59,wahoo,midweek,Stages XTR 2gen,Kickr Core,404,402,2
64149,955487,2020-10-22 15:14:58,wahoo,Zwift - OH MY CRIT! - The Double Race 1/2 (A),Stages XTR 2gen,Kickr Core,395,398,-3
64161,955487,2020-10-22 16:04:58,wahoo,Zwift - OH MY CRIT! - The Double Race 2/2 (A),Stages XTR 2gen,Kickr Core,380,387,-7
64812,955487,2020-10-25 09:59:59,wahoo,Zwift - ZTPL.CC Season Opening Race (E),Stages XTR 2gen,Kickr Core,473,457,16
65501,955487,2020-10-27 18:29:59,wahoo,Zwift - ZTPL.CC Season Warm Up Race (E),Stages XTR 2gen,Kickr Core,384,385,-1
65762,955487,2020-10-28 13:29:59,wahoo,Zwift - ZHQ FutureWorks Circuit Race - Anti-sandbagging (A),Stages XTR 2gen,Kickr Core,359,368,-9
66093,955487,2020-10-29 16:29:59,wahoo,Zwift - OTAKAM Race Series (A),Stages XTR 2gen,Kickr Core,429,425,4
66207,955487,2020-10-29 18:06:09,wahoo,Zwift - WTRL Team Time Trial - Zone 3 (B),Stages XTR 2gen,Kickr Core,333,331,2
66485,955487,2020-10-30 17:04:59,wahoo,Zwift - Team WEZ Friday Race (A),Stages XTR 2gen,Kickr Core,428,419,9
66715,955487,2020-10-31 15:15:00,wahoo,Zwift - OH MY CRIT - Saturday Smash Race (A),Stages XTR 2gen,Kickr Core,403,417,-14
67607,955487,2020-11-03 18:29:59,wahoo,Zwift - ZTPL.CC 3daysINhell Stage 1 (E),Stages XTR 2gen,Kickr Core,419,409,10
67731,955487,2020-11-03 17:29:59,wahoo,Zwift - ZHQ FutureWorks Circuit Race - Anti-sandbagging (A),Stages XTR 2gen,Kickr Core,366,353,13
68119,955487,2020-11-05 13:30:00,wahoo,Zwift - ZHQ FutureWorks Circuit Race - Anti-sandbagging (A),Stages XTR 2gen,Kickr Core,383,370,13
68712,955487,2020-11-07 08:59:59,wahoo,Zwift - ZTPL.CC 3daysINhell Stage 2 (E),Stages XTR 2gen,Kickr Core,392,383,9
69313,955487,2020-11-09 15:15:49,wahoo,Zwift - 3R Volcano Circuit Sprint Flat Race - 1 Lap (6.6km/4.1mi 20m) (A),Stages XTR 2gen,Kickr Core,423,413,10
69798,955487,2020-11-10 18:29:59,wahoo,Zwift - ZTPL.CC 3daysINhell Stage 3 (E),Stages XTR 2gen,Kickr Core,447,454,-7
70223,955487,2020-11-11 17:15:05,wahoo,Zwift - 30-39 years,Stages XTR 2gen,Kickr Core,382,372,10
71257,955487,2020-11-14 08:59:58,wahoo,Zwift - ZTPL.CC Classic Race (E),Stages XTR 2gen,Kickr Core,429,431,-2
72259,955487,2020-11-17 18:29:59,wahoo,Zwift - ZTPL.CC 3daysINhell vol2 Stage 1 (E),Stages XTR 2gen,Kickr Core,426,429,-3
73610,955487,2020-11-20 17:59:58,wahoo,Zwift - KIRCHMAIR Race Series (A),Stages XTR 2gen,Kickr Core,398,403,-5
73612,955487,2020-11-20 18:29:57,wahoo,Zwift - KIRCHMAIR Race Series (A),Stages XTR 2gen,Kickr Core,373,378,-5
73614,955487,2020-11-20 17:29:57,wahoo,Zwift - EVO CC / Le Col - Sprint Race Series (A),Stages XTR 2gen,Kickr Core,446,451,-5
73746,955487,2020-11-21 09:00:01,wahoo,Zwift - ZTPL.CC ITT League (E),Stages XTR 2gen,Kickr Core,439,435,4
74532,955487,2020-11-23 15:15:47,wahoo,Zwift - 3R Volcano Circuit Sprint Flat Race - 1 Lap (6.6km/4.1mi 20m) (A),Stages XTR 2gen,Kickr Core,391,392,-1
74999,955487,2020-11-24 18:29:55,wahoo,Zwift - ZTPL.CC ITT League (E),Stages XTR 2gen,Kickr Core,460,463,-3
76059,955487,2020-11-26 18:59:54,wahoo,Zwift - ZTPL.CC ITT League (E),Stages XTR 2gen,Kickr Core,458,458,0
76719,955487,2020-11-28 08:59:53,wahoo,Zwift - ZTPL.CC ITT League (E),Stages XTR 2gen,Kickr Core,422,426,-4
78055,955487,2020-12-01 18:29:51,wahoo,Zwift - Watopia,Stages XTR 2gen,Kickr Core,409,413,-4
80149,955487,2020-12-06 16:04:48,wahoo,Zwift - Watopia,Stages XTR 2gen,Kickr Core,379,390,-11
83101,955487,2020-12-14 15:15:34,wahoo,3R volcano,Stages XTR 2gen,Kickr Core,419,413,6
85759,955487,2020-12-21 15:15:30,wahoo,Zwift - 3R Volcano Circuit Sprint Flat Race - 1 Lap (6.6km/4.1mi 20m) (A),Stages XTR 2gen,Kickr Core,406,409,-3
86190,955487,2020-12-22 18:29:38,wahoo,Zwift - Watopia,Stages XTR 2gen,Kickr Core,389,386,3
86593,955487,2020-12-23 17:14:39,wahoo,Mlaster-Plaster,Stages XTR 2gen,Kickr Core,426,425,1
87343,955487,2020-12-26 08:59:37,wahoo,Zwift - Watopia,Stages XTR 2gen,Kickr Core,438,442,-4
88699,955487,2020-12-29 18:29:35,wahoo,Zwift - Watopia,Stages XTR 2gen,Kickr Core,407,395,12
89094,955487,2020-12-30 15:59:34,wahoo,Zwift - Sydkysten Race (A),Stages XTR 2gen,Kickr Core,407,410,-3
90083,955487,2021-01-02 08:59:34,wahoo,Zwift - ZTPL.CC Classic Race (A),Stages XTR 2gen,Kickr Core,489,491,-2
90679,955487,2021-01-03 13:29:32,wahoo,Zwift - ZHQ FutureWorks Circuit Race - Anti-sandbagging (A),Stages XTR 2gen,Kickr Core,361,361,0
91847,955487,2021-01-05 18:29:32,wahoo,Zwift - ZTPL.CC Classic Race (E),Stages XTR 2gen,Kickr Core,397,386,11
95714,955487,2021-01-12 18:29:27,wahoo,Zwift - RCC Global Club Ride 3 Nov,Stages XTR 2gen,Kickr Core,415,420,-5
97777,955487,2021-01-16 08:59:25,wahoo,Zwift - Watopia,Stages XTR 2gen,Kickr Core,410,417,-7
98599,955487,2021-01-17 14:15:17,wahoo,Zwift - KISS 100 Race Series - Americas (A),Stages XTR 2gen,Kickr Core,394,403,-9
99760,955487,2021-01-19 18:29:23,wahoo,Zwift - The Carnival Race League Stage 1 with ZTPL.CC (A),Stages XTR 2gen,Kickr Core,392,390,2
102009,955487,2021-01-23 16:59:20,wahoo,Zwift - Watopia,Stages XTR 2gen,Kickr Core,443,454,-11
103518,955487,2021-01-26 18:29:18,wahoo,Zwift - The Carnival Race League Stage 3 with ZTPL.CC (A),Stages XTR 2gen,Kickr Core,374,383,-9
105806,955487,2021-01-30 16:59:17,wahoo,Zwift - The Carnival Race League Stage 4 with ZTPL.CC (A),Stages XTR 2gen,Kickr Core,452,457,-5
107468,955487,2021-02-02 18:29:15,wahoo,Zwift - The Carnival Race League Stage 5 with ZTPL.CC (A),Stages XTR 2gen,Kickr Core,440,451,-11
111677,955487,2021-02-09 18:29:11,wahoo,Zwift - ZTPL.CC Winter League 2021 Stage 7,Stages XTR 2gen,Kickr Core,399,406,-7
113576,955487,2021-02-12 16:59:08,wahoo,Zwift - ZTPL.CC 100km Ride (B),Stages XTR 2gen,Kickr Core,451,458,-7
114287,955487,2021-02-13 16:59:07,wahoo,Zwift - ZTPL.CC Winter League 2021 Stage 8 (A),Stages XTR 2gen,Kickr Core,447,464,-17
115821,955487,2021-02-16 18:29:07,wahoo,Zwift - ZTPL.CC Winter League 2021 Stage 9 (A),Stages XTR 2gen,Kickr Core,436,431,5
118357,955487,2021-02-20 16:59:03,wahoo,Zwift - ZTPL.CC Winter League 2021 Stage 10 (A),Stages XTR 2gen,Kickr Core,417,422,-5
119846,955487,2021-02-23 18:29:59,wahoo,Zwift - ZTPL.CC Winter League 2021 Stage 9 (A),Stages XTR 2gen,Kickr Core,420,423,-3
121791,955487,2021-02-27 16:59:59,wahoo,Zwift -  ZTPL.CC Winter League 2021 Stage 12 (A),Stages XTR 2gen,Kickr Core,436,441,-5
122063,955487,2021-02-28 11:29:58,wahoo,Zwift - MGCC Pretzel (B),Stages XTR 2gen,Kickr Core,410,401,9
122066,955487,2021-02-28 11:05:00,wahoo,Zwift - 3R Innsbruckring Sprint Race - 1 Lap (8.8km/5.5mi 77m) (A),Stages XTR 2gen,Kickr Core,446,461,-15
122895,955487,2021-03-02 17:19:57,wahoo,Zwift - WKG - CRITTY CRITTY BANG BANG (A),Stages XTR 2gen,Kickr Core,396,399,-3
123003,955487,2021-03-02 18:29:58,wahoo,Zwift - ZTPL.CC Classic Race,Stages XTR 2gen,Kickr Core,456,461,-5
124132,955487,2021-03-04 18:15:00,wahoo,Zwift - ZTPL.CC Interval Ride (B),Stages XTR 2gen,Kickr Core,465,466,-1
125482,955487,2021-03-07 16:30:37,wahoo,Zwift - MISTRZOSTWA ZTPL.CC (E),Stages XTR 2gen,Kickr Core,425,434,-9
126280,955487,2021-03-09 18:29:56,wahoo,Zwift - ZTPL.CC Classic Race,Stages XTR 2gen,Kickr Core,420,419,1
126282,955487,2021-03-09 17:09:56,wahoo,Zwift - 3R Volcano KOM After Party Race - 2 laps + climb (40.2km/25mi 286m) (A),Stages XTR 2gen,Kickr Core,372,380,-8
127164,955487,2021-03-11 17:29:55,wahoo,Zwift - ZHQ FutureWorks Circuit Race - Anti-sandbagging (A),Stages XTR 2gen,Kickr Core,339,345,-6
127536,955487,2021-03-12 17:59:54,wahoo,Zwift - KIRCHMAIR Race Series (A),Stages XTR 2gen,Kickr Core,390,399,-9
127555,955487,2021-03-12 18:29:55,wahoo,Zwift - KIRCHMAIR Race Series (A),Stages XTR 2gen,Kickr Core,420,425,-5
127832,955487,2021-03-13 09:29:54,wahoo,Zwift - [DBR] Saturday Race (A),Stages XTR 2gen,Kickr Core,446,438,8
128041,955487,2021-03-13 16:59:53,wahoo,Zwift - ZTPL.CC Racing Challenge (A),Stages XTR 2gen,Kickr Core,373,385,-12
46029,793765,2020-07-12 09:45:49,wahoo,Zwift - Stages of DIRT (A),vector3,kickr_core,240,250,-10
123652,956317,2021-03-03 17:20:00,wahoo,Assioma 030321 / Kickr 030321,Assioma 030321,Kickr 030321,149,155,-6
124751,956317,2021-03-04 17:35:25,wahoo,2021-03-04-173807-Assioma / 2021-03-04-18-35-09 Kickr,2021-03-04-173807-Assioma,2021-03-04-18-35-09 Kickr,257,262,-5
124752,956317,2021-03-04 18:29:53,wahoo,2021-03-04-182953-Assioma / 2021-03-04-19-12-32 Kickr,2021-03-04-182953-Assioma,2021-03-04-19-12-32 Kickr,297,311,-14
67461,979320,2020-11-03 06:23:45,wahoo,Favero Assioma Uno / Wahoo Kickr 2020,Favero Assioma Uno,Wahoo Kickr 2020,208,204,4
67615,979320,2020-11-03 18:34:54,wahoo,Favero Assioma Uno / Wahoo Kickr 2020,Favero Assioma Uno,Wahoo Kickr 2020,336,328,8
69784,979320,2020-11-10 18:15:11,wahoo,Favero Assioma Uno / Wahoo Kickr 2020,Favero Assioma Uno,Wahoo Kickr 2020,360,350,10
70823,979320,2020-11-12 18:30:10,wahoo,Favero Assioma Uno / Wahoo Kickr 2020,Favero Assioma Uno,Wahoo Kickr 2020,340,330,10
75088,979320,2020-11-24 18:15:21,wahoo,Favero Assioma Uno / Wahoo Kickr 2020,Favero Assioma Uno,Wahoo Kickr 2020,344,338,6
75611,979320,2020-11-25 19:00:22,wahoo,Favero Assioma Uno / Wahoo Kickr 2020,Favero Assioma Uno,Wahoo Kickr 2020,367,364,3
79078,979320,2020-12-03 18:29:57,wahoo,Favero Assioma Uno / Wahoo Kickr 2020,Favero Assioma Uno,Wahoo Kickr 2020,353,344,9
81673,979320,2020-12-10 18:30:10,wahoo,Wahoo Kickr 2020 / Favero Assioma Uno,Favero Assioma Uno,Wahoo Kickr 2020,336,325,11
84480,979320,2020-12-17 18:08:47,wahoo,Wahoo Kickr 2020 / Favero Assioma Uno,Favero Assioma Uno,Wahoo Kickr 2020,343,340,3
87423,979320,2020-12-26 08:33:52,wahoo,Wahoo Kickr 2020 / Favero Assioma Uno,Favero Assioma Uno,Wahoo Kickr 2020,361,352,9
90200,979320,2021-01-02 09:05:47,wahoo,Wahoo Kickr 2020 / Favero Assioma Uno,Favero Assioma Uno,Wahoo Kickr 2020,374,367,7
92986,979320,2021-01-07 18:07:29,wahoo,Wahoo Kickr 2020 / Favero Assioma Uno,Favero Assioma Uno,Wahoo Kickr 2020,338,336,2
95710,979320,2021-01-12 17:30:39,wahoo,Wahoo Kickr 2020 / Favero Assioma Uno,Favero Assioma Uno,Wahoo Kickr 2020,321,317,4
96479,979320,2021-01-13 18:06:43,wahoo,Wahoo Kickr 2020 / Favero Assioma Uno,Favero Assioma Uno,Wahoo Kickr 2020,355,342,13
100411,979320,2021-01-20 18:04:58,wahoo,Wahoo Kickr 2020 / Favero Assioma Uno,Favero Assioma Uno,Wahoo Kickr 2020,352,345,7
103553,979320,2021-01-26 17:37:18,wahoo,Wahoo Kickr 2020 / Favero Assioma Uno,Favero Assioma Uno,Wahoo Kickr 2020,372,373,-1
104229,979320,2021-01-27 18:03:55,wahoo,Wahoo Kickr 2020 / Favero Assioma Uno,Favero Assioma Uno,Wahoo Kickr 2020,375,374,1
107448,979320,2021-02-02 17:42:57,wahoo,Wahoo Kickr 2020 / Favero Assioma Uno,Favero Assioma Uno,Wahoo Kickr 2020,361,355,6
108334,979320,2021-02-03 17:31:41,wahoo,Wahoo Kickr 2020 / Favero Assioma Uno,Favero Assioma Uno,Wahoo Kickr 2020,361,355,6
111663,979320,2021-02-09 17:31:50,wahoo,Wahoo Kickr 2020 / Favero Assioma Uno,Favero Assioma Uno,Wahoo Kickr 2020,349,348,1
112421,979320,2021-02-10 18:02:16,wahoo,Wahoo Kickr 2020 / Favero Assioma Uno,Favero Assioma Uno,Wahoo Kickr 2020,370,356,14
115928,979320,2021-02-16 17:32:31,wahoo,Wahoo Kickr 2020 / Favero Assioma Uno,Favero Assioma Uno,Wahoo Kickr 2020,376,381,-5
116805,979320,2021-02-17 18:01:34,wahoo,Wahoo Kickr 2020 / Favero Assioma Uno,Favero Assioma Uno,Wahoo Kickr 2020,336,331,5
119701,979320,2021-02-23 17:45:15,wahoo,Wahoo Kickr 2020 / Favero Assioma Uno,Favero Assioma Uno,Wahoo Kickr 2020,347,340,7
123038,979320,2021-03-02 17:43:12,wahoo,Wahoo Kickr 2020 / Favero Assioma Uno,Favero Assioma Uno,Wahoo Kickr 2020,342,343,-1
124640,979320,2021-03-05 18:31:03,wahoo,Zwift - Zwift Racing League | WTRL Battle Royale Playoff - Men&#039;s Points Race (A),Favero Assioma Uno,Wahoo Kickr 2020,343,344,-1
127883,979320,2021-03-13 08:15:58,wahoo,Wahoo Kickr 2020 / Favero Assioma Uno,Favero Assioma Uno,Wahoo Kickr 2020,331,326,5
9312,904023,2020-01-14 17:38:55,neo,Tour de Zwift: Stage 1 Race,Assioma Duo,Neo 1,389,371,18
9394,904023,2020-01-14 19:34:48,neo,3R Ultimate Racing League - Round 2,Assioma Duo,Neo 1,391,379,12
9731,904023,2020-01-16 17:56:20,neo,Zwift - Tour de Zwift: Stage 2 Long Distance,Assioma Duo,Neo 1,407,389,18
11763,904023,2020-01-30 18:48:04,neo,KALAS Cup - Round 1,Assioma Duo,Neo 1,419,411,8
12865,904023,2020-02-06 18:55:55,neo,KALAS Cup - Round 2,Assioma Duo,Neo 1,441,433,8
13404,904023,2020-02-11 16:01:10,neo,Zwift - 3R Ultimate Racing League - Round 6 (A),Assioma Duo,Neo 1,382,370,12
13479,904023,2020-02-11 19:37:00,neo,Zwift - 3R Ultimate Racing League - Round 6 (A),Assioma Duo,Neo 1,392,384,8
13792,904023,2020-02-13 18:54:48,neo,Zwift - KALAS Cup - Round 3 (A),Assioma Duo,Neo 1,398,380,18
14135,904023,2020-02-15 13:04:47,neo,Zwift - The BMTR Fundo (A) - Win!,Assioma Duo,Neo 1,406,399,7
14507,904023,2020-02-18 15:55:39,neo,Zwift - 3R SuperCRITical Race Series - Round 1of4 (A),Assioma Duo,Neo 1,366,354,12
14551,904023,2020-02-18 18:53:30,neo,Zwift - ZwiftTeamPL League – Classic Series (A),Assioma Duo,Neo 1,427,414,13
14993,904023,2020-02-20 18:50:05,neo,Zwift - KALAS Cup - Round 4 (A),Assioma Duo,Neo 1,412,406,6
15562,904023,2020-02-25 16:00:34,neo,Zwift - 3R SuperCRITical Race Series - Round 2of4 (A),Assioma Duo,Neo 1,379,367,12
18764,904023,2020-03-19 18:45:22,neo,Zwift - KALAS Cup - Round 8 (A),Assioma Duo,Neo 1,407,399,8
19765,904023,2020-03-24 18:39:08,neo,FTP test // British Triathlon Winter Series TT Race (E),Assioma Duo,Neo 1,408,395,13
21653,904023,2020-04-03 06:36:16,neo,Zwift -  Haute Route Watopia Stage 1 (E),Assioma Duo,Neo 1,428,413,15
21924,904023,2020-04-04 06:58:37,neo,Zwift -  Haute Route Watopia Stage 2 (E),Assioma Duo,Neo 1,404,396,8
60354,904023,2020-10-08 16:33:49,neo,Zwift - Espresso,Assioma Duo,Neo 1,409,404,5
60725,904023,2020-10-10 05:20:23,neo,Zwift - XRS Races - The Saturday Classic (A),Assioma Duo,Neo 1,411,408,3
62160,904023,2020-10-15 16:45:54,neo,Zwift - WTRL TTT #78 PL,Assioma Duo,Neo 1,414,413,1
63579,904023,2020-10-20 18:33:59,neo,Zwift - Zwift Racing League | WTRL - EMEA (MEN) - TTT Grp 1 (B),Assioma Duo,Neo 1,399,392,7
64228,904023,2020-10-22 16:45:53,neo,Zwift - Espresso,Assioma Duo,Neo 1,413,412,1
66208,904023,2020-10-29 17:51:45,neo,Zwift - WTRL Team Time Trial Platinum League (C),Assioma Duo,Neo 1,405,405,0
78242,904023,2020-12-01 19:49:33,neo,Zwift - Zwift Racing League | WTRL - Men&#039;s EMEA W1 DIVISION 1 (A),Assioma Duo #2,Neo 1,434,424,10
80268,904023,2020-12-06 15:59:37,neo,Echelon Virtual Gila Stage 3: Gila Monster,Assioma Duo #2,Neo 1,429,414,15
82391,904023,2020-12-08 19:34:28,neo,Zwift - Zwift Racing League | WTRL - Men&#039;s EMEA W1 DIVISION 1 (A),Assioma Duo #2,Neo 1,425,415,10
82528,904023,2020-12-12 18:42:23,neo,"Echelon Racing League, Amateur Series - Bucks County Classic Crit",Assioma Duo #2,Neo 1,416,401,15
83909,904023,2020-12-15 19:31:15,neo,Zwift - Zwift Racing League | WTRL - Men&#039;s EMEA W1 DIVISION 1 (A),Assioma Duo #2,Neo 1,434,418,16
85605,904023,2020-12-20 17:27:08,neo,Echelon Racing League — Armed Forces Classic Crit,Assioma Duo #2,Neo 1,433,422,11
85609,904023,2020-12-19 18:31:07,neo,Echelon Racing League — Bucks County Classic Crit,Assioma Duo #2,Neo 1,432,418,14
87429,904023,2020-12-26 10:43:04,neo,2020-12-26 Morning endurance / recon,Assioma Duo #2,Neo 1,355,337,18
87707,904023,2020-10-11 13:14:56,neo,Zwift - KISS at Race 100 - Americas (A),Assioma Duo,Neo 1,391,386,5
87812,904023,2020-12-27 11:36:37,neo,Morning endurance & recon,Assioma Duo #2,Neo 1,314,310,4
87931,904023,2020-12-27 15:52:40,neo,Virtuslo.cc New Year Tour Stage 3,Assioma Duo #2,Neo 1,443,439,4
87995,904023,2020-12-27 20:26:36,neo,Echelon Community — Benton Park,Assioma Duo #2,Neo 1,353,352,1
90966,904023,2021-01-03 15:58:08,neo,Zwift - Zwift Fondo Series 2020/21 (A),Assioma Duo #2,Neo 1,431,424,7
94813,904023,2021-01-11 08:25:02,neo,Flanders Endurance Series,Assioma Duo #2,Neo 1,432,427,5
96481,904023,2021-01-13 16:53:21,neo,Virtuslo Palba Runda (RGT),Assioma Duo #2,Neo 1,385,420,-35
99229,904023,2021-01-18 19:23:42,neo,Zwift - Premier Division // Zwift Racing League (men) (A),Assioma Duo #2,Neo 1,429,417,12
111142,904023,2021-02-08 18:16:22,neo,Zwift - Premier Division // Zwift Racing League (men) (A),Assioma Duo #2,Neo 1,444,434,10
112481,904023,2021-02-10 18:49:19,neo,Zwift - Movistar Team Challenge // Round 1 (A),Assioma Duo #2,Neo 1,424,419,5
113696,904023,2021-02-12 18:50:27,neo,Zwift - Movistar Team Challenge // Round 1 (men),Assioma Duo #2,Neo 1,442,439,3
116846,904023,2021-02-17 18:49:12,neo,Zwift - Movistar Team Challenge // Round 2 (men) - Race 3/4,Assioma Duo #2,Neo 1,381,377,4
122608,904023,2021-03-01 19:43:10,neo,Zwift - Premier Division // Zwift Racing League (men) (A),Assioma Duo #2,Neo 1,429,426,3
43280,815941,2020-06-23 18:09:44,wahoo,Zwift - 4x5min anerobic ramps ,Garmin V3,kickr power,412,399,13
43401,815941,2020-06-24 17:58:57,wahoo,Zwift - 1hr z2,Garmin V3,kickr power,253,253,0
43404,815941,2020-06-24 17:58:54,wahoo,Zwift - 1hr z2,Garmin V3,kickr power,255,253,2
43591,815941,2020-06-25 17:37:02,wahoo,Zwift - 2x14min v02 max bowls + 1hr z2,Garmin V3,kickr power,392,397,-5
43841,815941,2020-06-27 17:44:36,wahoo,Zwift - something...,Garmin V3,kickr power,329,337,-8
19930,954257,2020-03-26 20:58:50,neo,Ride 26 mars (standing at 5wkg+),P2MAX,NEO,303,284,19
25596,954257,2020-04-17 16:07:13,neo,Frodissimo 3030,P2MAX2,NEO,286,300,-14
58464,954257,2020-09-29 22:45:12,neo,Zwift - Velocious Sport Tue Night Criterium (Race) (A),P2MAX2,NEO,309,290,19
4212,955094,2019-11-13 19:03:52,neo,Zwift - DBR HEINO CUP  (A),Garmin Vector 3,Tacx Neo,389,383,6
8010,955094,2020-01-03 14:04:31,neo,Zwift - 3R Innsbruckring Flat Race - 2 Laps (17.6km/10.9m 154m) (A),Garmin Vector 3,Tacx Neo,403,379,24
8011,955094,2020-01-03 14:45:15,neo,Zwift - Crit City Race (A),Garmin Vector 3,Tacx Neo,338,338,0
8185,955094,2020-01-05 07:00:16,neo,Zwift - Zwift Gran Fondo,Garmin Vector 3,Tacx Neo,375,378,-3
8534,955094,2020-01-08 13:24:46,neo,Zwift - 3R Volcano Flat 50k Race (50km/31mi 202m) (A),Garmin Vector 3,Tacx Neo,370,374,-4
9620,955094,2020-01-13 16:09:36,neo,Zwift - 3R Classique Reverse Flat Race - 4 Laps (26.9km/16.7mi 57m) (A),Garmin Vector 3,Tacx Neo,369,374,-5
10729,955094,2020-01-24 06:09:40,neo,Zwift - 3R Volcano Circuit Flat Race - 4 Laps (18.9km/11.7mi 80m) (A),Garmin Vector 3,Tacx Neo,355,364,-9
10953,955094,2020-01-24 18:34:19,neo,Zwift - KIRCHMAIR January Series 5/8 (A),Garmin Vector 3,Tacx Neo,364,373,-9
10954,955094,2020-01-24 19:04:32,neo,Zwift - KIRCHMAIR January Series 6/8 (A),Garmin Vector 3,Tacx Neo,342,343,-1
11525,955094,2020-01-29 13:25:48,neo,Zwift - 3R Volcano Flat 50k Race (50km/31mi 202m) (A),Garmin Vector 3,Tacx Neo,353,366,-13
32230,69680,2020-05-06 18:08:58,neo,Zwift - Z PRO TRI Race Series (A),Quarq dzeros,Neo,359,345,14
37509,69680,2020-05-20 14:49:11,neo,Zwift - Z PRO TRI Race Series: Men&#039;s B Race 6,Quarq dzeros,Tacx Neo,327,327,0
38206,69680,2020-05-27 14:29:54,neo,Zwift - Z PRO TRI Race Series: Men&#039;s B Race 7 (A),Quarq dzeros,Tacx Neo,355,345,10
39470,69680,2020-06-03 17:54:58,neo,Zwift - USA Cycling Race League by Indoor Specialist (A),Quarq dzeros,Tacx Neo,326,318,8
44578,69680,2020-07-02 17:25:50,neo,Zwift - Espresso,Quarq dzeros,Tacx Neo,341,324,17
80861,841941,2020-12-08 16:40:01,wahoo,Zwift - Team Italy Specialissima Race (A),Favero Assioma Duo,Wahoo Kickr 2018,336,329,7
81985,841941,2020-12-11 16:30:02,wahoo,Zwift - ZHQ FutureWorks Crit City Race - Anti-sandbagging (A),Favero Assioma Duo,Wahoo Kickr 2018,363,344,19
85776,841941,2020-12-21 16:45:10,wahoo,Zwift - Crit City Race (A),Favero Assioma Duo,Wahoo Kickr 2018,339,328,11
89095,841941,2020-12-30 17:29:57,wahoo,Zwift - ZHQ FutureWorks Circuit Race - Anti-sandbagging (A),Favero Assioma Duo,Wahoo Kickr 2018,366,350,16
90311,841941,2021-01-02 16:30:05,wahoo,Zwift - TEAM VEGAN Tofu Tornado (A),Favero Assioma Duo,Wahoo Kickr 2018,375,360,15
91262,841941,2021-01-04 16:10:11,wahoo,Zwift - 3R Classique Reverse Flat Race - 4 Laps (26.9km/16.7mi 57m) (A),Favero Assioma Duo,Wahoo Kickr 2018,357,347,10
91765,841941,2021-01-05 17:30:03,wahoo,Zwift - WTRL Racing (A),Favero Assioma Duo,Wahoo Kickr 2018,353,344,9
92285,841941,2021-01-06 16:30:07,wahoo,Zwift - ZHQ FutureWorks Crit City Race - Anti-sandbagging (A),Favero Assioma Duo,Wahoo Kickr 2018,360,349,11
94918,841941,2021-01-11 17:45:01,wahoo,Zwift - SCF SWE Cup (A),Favero Assioma Duo,Wahoo Kickr 2018,371,353,18
95575,841941,2021-01-12 16:30:01,wahoo,Zwift - ZHQ FutureWorks Crit City Race - Anti-sandbagging (A),Favero Assioma Duo,Wahoo Kickr 2018,358,342,16
98101,841941,2021-01-16 16:45:02,wahoo,Zwift - Crit City Race (A),Favero Assioma Duo,Wahoo Kickr 2018,352,340,12
99134,841941,2021-01-18 19:00:02,wahoo,Zwift -  SCF SWE Cup Men (A),Favero Assioma Duo,Wahoo Kickr 2018,369,354,15
100238,841941,2021-01-20 16:30:03,wahoo,Zwift - ZHQ FutureWorks Crit City Race - Anti-sandbagging (A),Favero Assioma Duo,Wahoo Kickr 2018,372,359,13
101459,841941,2021-01-22 16:45:04,wahoo,Zwift - Crit City Race (A),Favero Assioma Duo,Wahoo Kickr 2018,360,346,14
101461,841941,2021-01-22 18:00:04,wahoo,Zwift - KIRCHMAIR Race Series (A),Favero Assioma Duo,Wahoo Kickr 2018,344,336,8
102835,841941,2021-01-25 17:30:24,wahoo,Zwift -  SCF SWE Cup Men (A),Favero Assioma Duo,Wahoo Kickr 2018,346,347,-1
104088,841941,2021-01-27 17:05:14,wahoo,Zwift - Guayaba Race by PETA-Z (A),Favero Assioma Duo,Wahoo Kickr 2018,355,347,8
105171,841941,2021-01-29 16:45:15,wahoo,Zwift - Crit City Race (A),Favero Assioma Duo,Wahoo Kickr 2018,364,354,10
106760,841941,2021-02-01 19:00:18,wahoo,Zwift -  SCF SWE Cup Men (A),Favero Assioma Duo,Wahoo Kickr 2018,357,350,7
108835,841941,2021-02-04 17:30:22,wahoo,Zwift - EVO CC Sprint Race Series  (A),Favero Assioma Duo,Wahoo Kickr 2018,339,334,5
109378,841941,2021-02-05 16:36:18,wahoo,Zwift - SZ AW Party by SZR (A),Favero Assioma Duo,Wahoo Kickr 2018,375,369,6
110942,841941,2021-02-08 17:30:25,wahoo,Zwift -  SCF SWE Cup Men (A),Favero Assioma Duo,Wahoo Kickr 2018,368,363,5
112218,841941,2021-02-10 17:05:13,wahoo,Zwift - Guayaba Race by PETA-Z (A),Favero Assioma Duo,Wahoo Kickr 2018,375,368,7
113485,841941,2021-02-12 16:40:23,wahoo,Zwift - SZ AW Party by SZR (A),Favero Assioma Duo,Wahoo Kickr 2018,355,347,8
116595,841941,2021-02-17 17:05:13,wahoo,Zwift - Guayaba Race by PETA-Z (A),Favero Assioma Duo,Wahoo Kickr 2018,356,346,10
117767,841941,2021-02-19 16:30:16,wahoo,Zwift - SZ AW Party by SZR (A),Favero Assioma Duo,Wahoo Kickr 2018,368,354,14
119050,841941,2021-02-22 17:30:15,wahoo,Zwift -  SCF SWE Cup Men (A),Favero Assioma Duo,Wahoo Kickr 2018,394,372,22
121211,841941,2021-02-26 16:38:20,wahoo,Zwift - SZ AW Party by SZR (A),Favero Assioma Duo,Wahoo Kickr 2018,371,356,15
124501,841941,2021-03-05 16:40:15,wahoo,Zwift - SZ AW Party by SZR (A),Favero Assioma Duo,Wahoo Kickr 2018,366,354,12
60433,485032,2020-10-08 19:24:40,neo,Zwift - France,Powertap P1,Tacx Neo 1,128,127,1
60696,485032,2020-10-10 06:59:54,neo,Zwift - 2. Strength Endurance Rotations #1,Powertap P1,Tacx Neo 1,200,204,-4
8933,16178,2020-01-12 09:01:01,neo,Zwift - Danmarks Cykle Union 2020 Cup (B),Quarq DZero ,Tacx Neo,286,287,-1
9392,16178,2020-01-14 17:18:42,neo,Zwift - Watopia,Quarq DZero ,Tacx Neo,271,272,-1
9592,16178,2020-01-15 18:26:29,neo,Zwift - London,Quarq DZero ,Tacx Neo,290,295,-5
10513,16178,2020-01-21 16:22:01,neo,Zwift - Watopia,Quarq DZero ,Tacx Neo,271,263,8
10514,16178,2020-01-22 18:05:32,neo,Zwift - London,Quarq DZero ,Tacx Neo,264,256,8
12511,16178,2020-02-04 18:31:19,neo,Zwift - ,Quarq DZero ,Tacx Neo,307,305,2
26597,688137,2020-04-21 10:12:35,wahoo,Testing BRAND NEW KICKR 4.0,STAGES,KICKR 4.0,319,317,2
26992,688137,2020-04-22 17:17:09,wahoo,Ramp Test on KickR,STAGES,KICKR 4.0,358,363,-5
27374,688137,2020-04-23 16:51:43,wahoo,Zwift - 04/23/2020,STAGES,KICKR 4.0,314,326,-12
27988,688137,2020-04-25 14:11:47,wahoo,Race + 30 Vulcano Circuit laps,STAGES,KICKR 4.0,310,299,11
47315,688137,2020-07-22 15:26:28,wahoo,STAGES / KICKR 4.0,STAGES,KICKR 4.0,266,263,3
69779,688137,2020-11-10 17:31:32,wahoo,5x15mins SST,STAGES,KICKR 4.0,312,304,8
71166,688137,2020-11-13 18:00:21,wahoo,FTP TEST - 332W + Z2,STAGES,KICKR 4.0,279,266,13
71770,688137,2020-11-15 17:57:16,wahoo,2 hours zone 2,STAGES G1 (left crank),KICKR 4.0,286,270,16
76216,688137,2020-11-26 18:52:14,wahoo,WTRL NOPINZ WORLD TTT CHAMPIONSHIPS - Zone 7 (C) - 331W,STAGES G1 (left crank),KICKR 4.0,375,365,10
79088,688137,2020-12-03 19:08:20,wahoo,WTRL Team Time Trial - Zone 7 (C) - 38:05,STAGES G1 (left crank),KICKR 4.0,362,353,9
81612,688137,2020-12-10 18:54:12,wahoo,Killer Espresso race,STAGES G1 (left crank) - ZWIFT,KICKR 4.0 - GARMIN 520,345,344,1
82648,688137,2020-12-13 09:29:52,wahoo,Slovenian Zwift League - Weekly Race (A) - 312W,STAGES G1 (left crank) - ZWIFT,KICKR 4.0 - GARMIN 520,323,321,2
108341,688137,2021-02-03 18:58:14,wahoo,Movistar Team Challenge Community Qualifier Race #1 - 127th place out of 12000,STAGES G1 (left crank) - ZWIFT,KICKR 4.0 - GARMIN 520,364,350,14
108976,688137,2021-02-04 18:07:24,wahoo,Zwift - WTRL Team Time Trial - Zone 4 (C),STAGES G1 (left crank) - ZWIFT,KICKR 4.0 - GARMIN 520,340,332,8
110126,688137,2021-02-06 13:58:59,wahoo,XRS Races: Saturday Climbing Series (A) + 1hour zone 2,STAGES G1 (left crank) - ZWIFT,KICKR 4.0 - GARMIN 520,343,333,10
111726,688137,2021-02-09 18:34:37,wahoo,Zwift Racing League - SloZL Laibach - 330W,STAGES G1 (left crank) - ZWIFT,KICKR 4.0 - GARMIN 520,366,353,13
114195,688137,2021-02-13 16:29:53,wahoo,Zwift - Dr. Weebles Special,STAGES G1 (left crank),KICKR 4.0,330,349,-19
114330,688137,2021-02-13 18:04:58,wahoo,3R The 3 Sisters Hilly Race ,STAGES G1 (left crank),KICKR 4.0,332,321,11
127605,688137,2021-03-12 18:53:57,wahoo,Alpe FTP,STAGES G1 (left crank),KICKR 4.0,344,340,4
127611,688137,2021-03-06 16:37:41,wahoo,3 hours of 85% FTP,STAGES G1 (left crank),KICKR 4.0,305,288,17
83860,778683,2020-12-16 10:00:01,wahoo,Zwift - JETT Sub 2.5w/kg Enjoy Home Japan Ride (C),4iiii,kickr core,296,320,-24
83882,778683,2020-12-16 10:00:01,wahoo,Zwift - JETT Sub 2.5w/kg Enjoy Home Japan Ride (C),4iiii leftside meter,kickr core,296,320,-24
84205,778683,2020-12-17 11:40:03,wahoo,Zwift - Arise,4iiii leftside meter,kickr core,211,211,0
84207,778683,2020-12-17 11:40:02,wahoo,Zwift - Arise,4iiii leftside meter,kickr core,211,211,0
84236,778683,2020-12-17 12:04:59,wahoo,Zwift,2020-12-17-120458-ELEMNT_BOLT_F2E8-5-0[1],kickr core,211,213,-2
86076,778683,2020-12-22 12:25:59,wahoo,Zwift - EMU Japan Race (B),4iiii,kickr core,288,309,-21
86342,778683,2020-12-23 06:14:54,wahoo,Zwift - 3R Racing (A),4iiii leftside meter,kickr core,286,294,-8
